GIS_Number_valuations,Map_Name_valuations,Class_valuations,2009 Land,2009 Dwlg,2009 Improv,2009 Total
112625100100000,E-40 CHURCHES,Exempt,464400,0,473197,937597
112625100200000,E-40 CHURCHES,Exempt,663984,0,4315690,4979674
112630300100000,NE 160,Residential,30870,172518,0,203388
112630300200000,NE 160,Residential,29734,203234,0,232968
112630300300000,NE 160,Residential,29070,201623,0,230693
112630400100000,NE 160,Residential,30345,265629,0,295974
112630400200000,NE 160,Residential,28560,207729,0,236289
112630400300000,NE 160,Residential,28666,206749,0,235415
112630400400000,NE 160,Residential,29988,214093,0,244081
112630400500000,NE 160,Residential,28882,199796,0,228678
112630400600000,NE 160,Residential,28759,211755,0,240514
112630400700000,NE 160,Residential,26600,192780,0,219380
112630400800000,NE 160,Residential,28000,205942,0,233942
112630400900000,NE 160,Residential,29506,225199,0,254705
112630401000000,NE 160,Residential,29144,224583,0,253727
112630401100000,NE 160,Residential,30366,173280,0,203646
112630401200000,NE 160,Residential,30607,166124,0,196731
112630500100000,NE 160,Residential,30576,248512,0,279088
112630500200000,NE 160,Residential,28657,200902,0,229559
112630500300000,NE 160,Residential,28935,197751,0,226686
112630500400000,NE 160,Residential,29988,211315,0,241303
112630500500000,NE 160,Residential,28560,197722,0,226282
112630500600000,NE 160,Residential,28560,192547,0,221107
112630500700000,NE 160,Residential,32779,197321,0,230100
112630600100000,NE 160,Residential,29404,200887,0,230291
112630600200000,NE 160,Residential,29447,220322,0,249769
112630600300000,NE 160,Residential,29125,194015,0,223140
112630600400000,NE 160,Residential,30329,246307,0,276636
112630600500000,NE 160,Residential,30031,189671,0,219702
112630600600000,NE 160,Residential,26375,196849,0,223224
112630600700000,NE 160,Residential,28546,233350,0,261896
112630600800000,NE 160,Residential,27849,235211,0,263060
112630600900000,NE 160,Residential,29400,208027,0,237427
112630601000000,NE 160,Residential,26600,205368,0,231968
112630601100000,NE 160,Residential,29400,255602,0,285002
112630601200000,NE 160,Residential,28000,228437,0,256437
112630601300000,NE 160,Residential,26600,231804,0,258404
112630601400000,NE 160,Residential,29050,241151,0,270201
112630601500000,NE 160,Residential,27687,213819,0,241506
112630601600000,NE 160,Residential,29458,217976,0,247434
112630601700000,NE 160,Residential,26781,199675,0,226456
112630601800000,NE 160,Residential,27776,232483,0,260259
112630601900000,NE 160,Residential,30048,188895,0,218943
112630700100000,NE 160,Residential,30941,191148,0,222089
112632700100000,NE 160,Residential,29747,220426,0,250173
112632700200000,NE 160,Residential,31468,237118,0,268586
112632700300000,NE 160,Residential,31890,226275,0,258165
112632700400000,NE 160,Residential,27573,206567,0,234140
112632700500000,NE 160,Residential,28881,203278,0,232159
112632700600000,NE 160,Residential,28952,202022,0,230974
112632700700000,NE 160,Residential,27927,173651,0,201578
112632700800000,NE 160,Residential,29694,185189,0,214883
112632700900000,NE 160,Residential,29610,199394,0,229004
112632701000000,NE 160,Residential,29121,171081,0,200202
112632701100000,NE 160,Residential,27846,193331,0,221177
112632701200000,NE 160,Residential,29000,223586,0,252586
112632701300000,NE 160,Residential,28960,208551,0,237511
112632701400000,NE 160,Residential,30560,207874,0,238434
112632701500000,NE 160,Residential,28560,218297,0,246857
112632701600000,NE 160,Residential,29506,208149,0,237655
112632701700000,NE 160,Residential,28960,271061,0,300021
112632701800000,NE 160,Residential,26081,225486,0,251567
112632701900000,NE 160,Residential,29299,279991,0,309290
112632702000000,NE 160,Residential,28720,195528,0,224248
112632702100000,NE 160,Residential,28885,239073,0,267958
112632702200000,NE 160,Residential,26866,181101,0,207967
112632702300000,NE 160,Residential,29694,205621,0,235315
112632702400000,NE 160,Residential,29826,259838,0,289664
112632800100000,NE 160,Residential,30245,213872,0,244117
112632800200000,NE 160,Residential,71200,39154,0,110354
112632800300000,NE 160,Residential,55350,6396,0,61746
112632800400000,NE 160,Residential,53450,166033,0,219483
112632800500000,NE 160,Residential,30594,184248,0,214842
112632800600000,NE 160,Residential,30154,236359,0,266513
112632800700000,NE 160,Residential,28560,184962,0,213522
112632800800000,NE 160,Residential,30345,208950,0,239295
112632800900000,NE 160,Residential,29850,216440,0,246290
112632801000000,NE 160,Residential,32523,212477,0,245000
112632801100000,NE 160,Residential,30358,223820,0,254178
112632801200000,NE 160,Residential,29960,203356,0,233316
112632801300000,NE 160,Residential,30749,237950,0,268699
112632801400000,NE 160,Residential,29753,267752,0,297505
112632801500000,NE 160,Residential,29724,186723,0,216447
112632801600000,NE 160,Residential,28650,208719,0,237369
112632801700000,NE 160,Residential,29613,196263,0,225876
112632801800000,NE 160,Residential,28636,204047,0,232683
112632801900000,NE 160,Residential,29441,184368,0,213809
112632802000000,NE 160,Residential,30118,207259,0,237377
112632802100000,NE 160,Residential,28560,205835,0,234395
112632802200000,NE 160,Residential,29167,163923,0,193090
112632802300000,NE 160,Residential,27846,215637,0,243483
112632802400000,NE 160,Residential,29988,211275,0,241263
112632802500000,NE 160,Residential,28560,208825,0,237385
112632900100000,NE 160,Residential,30941,229752,0,260693
112632900200000,NE 160,Residential,28595,201867,0,230462
112632900300000,NE 160,Residential,27418,198962,0,226380
112632900400000,NE 160,Residential,29057,189990,0,219047
112632900500000,NE 160,Residential,29204,224475,0,253679
112632900600000,NE 160,Residential,27569,229343,0,256912
112632900700000,NE 160,Residential,29416,212594,0,242010
112632900800000,NE 160,Residential,27132,211401,0,238533
112632900900000,NE 160,Residential,28560,216141,0,244701
112632901000000,NE 160,Residential,29988,239756,0,269744
112632901100000,NE 160,Residential,28152,187203,0,215355
112632901200000,NE 160,Residential,28768,202970,0,231738
112632901300000,NE 160,Residential,29077,205864,0,234941
112635100100000,NE 160,Residential,30358,209537,0,239895
112635100200000,NE 160,Residential,28628,199209,0,227837
112635100300000,NE 160,Residential,29799,207269,0,237068
112635100400000,NE 160,Residential,28117,217490,0,245607
112635100500000,NE 160,Residential,31091,261088,0,292179
112635100600000,NE 160,Residential,30677,261418,0,292095
112635100700000,NE 160,Residential,28591,182863,0,211454
112635100800000,NE 160,Residential,29757,203305,0,233062
112635200100000,NE 160,Residential,28679,188297,0,216976
112635200200000,NE 160,Residential,30891,207218,0,238109
112635200300000,NE 160,Residential,29106,202798,0,231904
112635200400000,NE 160,Residential,30345,222711,0,253056
112635300100000,NE 160,Residential,30184,231840,0,262024
112635300200000,NE 160,Residential,28566,189352,0,217918
112635300300000,NE 160,Residential,30297,182154,0,212451
112635300400000,NE 160,Residential,28560,180069,0,208629
112635300500000,NE 160,Residential,28560,199034,0,227594
112635300600000,NE 160,Residential,28842,190143,0,218985
112635300700000,NE 160,Residential,28828,192409,0,221237
112635300800000,NE 160,Residential,29225,198450,0,227675
112635300900000,NE 160,Residential,28538,206516,0,235054
112635301000000,NE 160,Residential,28560,184620,0,213180
112635301100000,NE 160,Residential,28560,174444,0,203004
112635301200000,NE 160,Residential,28190,216666,0,244856
112635301300000,NE 160,Residential,29939,195782,0,225721
112635301400000,NE 160,Residential,30316,185593,0,215909
112635301500000,NE 160,Residential,29925,181715,0,211640
112635301600000,NE 160,Residential,30330,204600,0,234930
112635301700000,NE 160,Residential,28574,215416,0,243990
112635301800000,NE 160,Residential,29988,228623,0,258611
112635301900000,NE 160,Residential,27132,192549,0,219681
112635302000000,NE 160,Residential,29432,255317,0,284749
112635302100000,NE 160,Residential,29869,210291,0,240160
112635302200000,NE 160,Residential,29869,211483,0,241352
112635302300000,NE 160,Residential,29234,206355,0,235589
112635302400000,NE 160,Residential,28870,203752,0,232622
112635302500000,NE 160,Residential,29080,194491,0,223571
112635302600000,NE 160,Residential,30715,194999,0,225714
112635302700000,NE 160,Residential,31395,208843,0,240238
112635302800000,NE 160,Residential,29400,208754,0,238154
112635400100000,NE 160,Residential,28333,152961,0,181294
112635400200000,NE 160,Residential,28560,206056,0,234616
112635400300000,NE 160,Residential,29466,211967,0,241433
112635400400000,NE 160,Residential,29938,213402,0,243340
112635400500000,NE 160,Residential,30381,219932,0,250313
112635400600000,NE 160,Residential,33005,181836,0,214841
112635400700000,NE 160,Residential,32452,218716,0,251168
112635400800000,NE 160,Residential,29976,209240,0,239216
112635400900000,NE 160,Residential,29420,241397,0,270817
112635401000000,NE 160,Residential,29267,214578,0,243845
112635401100000,NE 160,Residential,28854,215036,0,243890
112635401200000,NE 160,Residential,29566,187362,0,216928
112635401300000,NE 160,Residential,29830,196171,0,226001
112635401400000,NE 160,Residential,30444,246800,0,277244
112635401500000,NE 160,Residential,30559,216591,0,247150
112635401600000,NE 160,Residential,30667,234963,0,265630
112635401700000,NE 160,Residential,46350,268387,0,314737
112635401800000,NE 160,Residential,31601,251070,0,282671
112635401900000,NE 160,Residential,30521,208124,0,238645
112635402000000,NE 160,Residential,30523,211677,0,242200
112635402100000,NE 160,Residential,30674,229490,0,260164
112635402200000,NE 160,Residential,29130,206736,0,235866
112635402300000,NE 160,Residential,30800,225767,0,256567
112635402400000,NE 160,Residential,29188,195041,0,224229
112635402500000,NE 160,Residential,28000,238867,0,266867
112635402600000,NE 160,Residential,29792,219269,0,249061
112635402700000,NE 160,Residential,29792,197222,0,227014
112635402800000,NE 160,Residential,29792,218880,0,248672
112635402900000,NE 160,Residential,29420,199302,0,228722
112635403000000,NE 160,Residential,28616,187321,0,215937
112635403100000,NE 160,Residential,29715,180783,0,210498
112635403200000,NE 160,Residential,30164,265960,0,296124
112635403300000,NE 160,Residential,30264,209310,0,239574
112635403400000,NE 160,Residential,29543,164864,0,194407
112635403500000,NE 160,Residential,28989,217424,0,246413
112635403600000,NE 160,Residential,30070,209698,0,239768
112635403700000,NE 160,Residential,31086,204723,0,235809
112635403800000,NE 160,Residential,30070,232674,0,262744
112635403900000,NE 160,Residential,29096,203044,0,232140
112635404000000,NE 160,Residential,30807,176381,0,207188
112635404100000,NE 160,Residential,28613,214487,0,243100
112635404200000,NE 160,Residential,29318,196947,0,226265
112635500100000,NE 160,Residential,30446,186779,0,217225
112635600100000,NE 160,Residential,31118,196406,0,227524
112635700100000,NE 160,Residential,32879,263088,0,295967
112635700300000,NE 160,Residential,29605,195143,0,224748
112635700400000,NE 160,Residential,29393,198409,0,227802
112635700500000,NE 160,Residential,28561,197201,0,225762
112637600100000,NE 160,Residential,28938,203146,0,232084
112637600200000,NE 160,Residential,29481,189394,0,218875
112637600300000,NE 160,Residential,29451,165848,0,195299
112637600400000,NE 160,Residential,29724,178185,0,207909
112637600500000,NE 160,Residential,29684,190101,0,219785
112637600600000,NE 160,Residential,28817,204606,0,233423
112637600700000,NE 160,Residential,29840,169870,0,199710
112637600800000,NE 160,Residential,29345,210073,0,239418
112637600900000,NE 160,Residential,26671,175725,0,202396
112637601000000,NE 160,Residential,29925,203393,0,233318
112637700100000,NE 160,Residential,28932,183750,0,212682
112637700200000,NE 160,Residential,26866,208027,0,234893
112637700300000,NE 160,Residential,29200,198231,0,227431
112637700400000,NE 160,Residential,29645,187023,0,216668
112637700500000,NE 160,Residential,29694,223629,0,253323
112637700600000,NE 160,Residential,27743,175585,0,203328
112637700700000,NE 160,Residential,29283,193579,0,222862
112637700800000,NE 160,Residential,26437,205580,0,232017
112637700900000,NE 160,Residential,27916,184044,0,211960
112637701000000,NE 160,Residential,26950,184215,0,211165
112637701100000,NE 160,Residential,29988,195191,0,225179
112637701200000,NE 160,Residential,29686,232442,0,262128
112637701300000,NE 160,Residential,29377,218511,0,247888
112637701400000,NE 160,Residential,28469,162187,0,190656
112637701500000,NE 160,Residential,30680,219993,0,250673
112637701600000,NE 160,Residential,30721,189784,0,220505
112637701700000,NE 160,Residential,29054,182822,0,211876
112637701800000,NE 160,Residential,29155,178285,0,207440
112637701900000,NE 160,Residential,29260,182924,0,212184
112637702000000,NE 160,Residential,27720,198084,0,225804
112637702100000,NE 160,Residential,27720,206101,0,233821
112637702200000,NE 160,Residential,29400,189481,0,218881
112637702300000,NE 160,Residential,28392,196299,0,224691
112637702400000,NE 160,Residential,29136,187089,0,216225
112637702500000,NE 160,Residential,28978,211037,0,240015
112637702600000,NE 160,Residential,30315,195592,0,225907
112637702700000,NE 160,Residential,28946,206723,0,235669
112637800100000,NE 160,Residential,28560,210703,0,239263
112637800200000,NE 160,Residential,27132,218002,0,245134
112637800300000,NE 160,Residential,29631,216015,0,245646
112637800400000,NE 160,Residential,29047,243304,0,272351
112637800500000,NE 160,Residential,28679,239059,0,267738
112637800600000,NE 160,Residential,29370,203442,0,232812
112637800700000,NE 160,Residential,28233,212467,0,240700
112637800800000,NE 160,Residential,28053,179137,0,207190
112637800900000,NE 160,Residential,28700,220546,0,249246
112637801000000,NE 160,Residential,29223,197610,0,226833
112637801100000,NE 160,Residential,30356,186490,0,216846
112637801200000,NE 160,Residential,28583,186575,0,215158
112637801300000,NE 160,Residential,28382,212919,0,241301
112637801400000,NE 160,Residential,28000,213374,0,241374
112637801500000,NE 160,Residential,28000,182310,0,210310
112637801600000,NE 160,Residential,26984,211035,0,238019
112637801700000,NE 160,Residential,28827,197954,0,226781
112637801800000,NE 160,Residential,28916,204802,0,233718
112637801900000,NE 160,Residential,29825,185981,0,215806
112637802000000,NE 160,Residential,28560,182384,0,210944
112637900100000,NE 160,Residential,30047,226950,0,256997
112637900200000,NE 160,Residential,28541,200783,0,229324
112637900300000,NE 160,Residential,29006,201253,0,230259
112637900400000,NE 160,Residential,28009,185994,0,214003
112637900500000,NE 160,Residential,29274,191920,0,221194
112637900600000,NE 160,Residential,30307,167330,0,197637
112637900700000,NE 160,Residential,29000,196060,0,225060
112637900800000,NE 160,Residential,28280,205775,0,234055
112637900900000,NE 160,Residential,31462,252602,0,284064
112637901000000,NE 160,Residential,29662,256107,0,285769
112638000100000,NE 160,Residential,29925,200745,0,230670
112638000200000,NE 160,Residential,26600,223791,0,250391
112638000300000,NE 160,Residential,29400,192286,0,221686
112638000400000,NE 160,Residential,28000,189298,0,217298
112638000500000,NE 160,Residential,28000,190984,0,218984
112638100100000,NE 160,Residential,31424,189498,0,220922
112638100200000,NE 160,Residential,29925,156434,0,186359
112638100300000,NE 160,Residential,29568,173384,0,202952
112638100400000,NE 160,Residential,30000,201653,0,231653
112638100500000,NE 160,Residential,28185,196999,0,225184
112638100600000,NE 160,Residential,27132,187129,0,214261
112638100700000,NE 160,Residential,28560,196672,0,225232
112638100800000,NE 160,Residential,28502,178832,0,207334
112638100900000,NE 160,Residential,27190,149699,0,176889
112638101000000,NE 160,Residential,28560,182337,0,210897
112638101100000,NE 160,Residential,28560,191788,0,220348
112638101200000,NE 160,Residential,27132,207864,0,234996
112638101300000,NE 160,Residential,29988,190268,0,220256
112638101400000,NE 160,Residential,28560,198386,0,226946
112638101500000,NE 160,Residential,28560,202635,0,231195
112638101600000,NE 160,Residential,27720,202347,0,230067
112638101700000,NE 160,Residential,30030,151942,0,181972
112638200100000,NE 160,Residential,30522,194766,0,225288
112638200200000,NE 160,Residential,25100,172366,0,197466
112638200300000,NE 160,Residential,29252,216020,0,245272
112638200400000,NE 160,Residential,30430,176317,0,206747
112638200500000,NE 160,Residential,29457,200658,0,230115
112638200600000,NE 160,Residential,29512,177667,0,207179
112638200700000,NE 160,Residential,29988,189473,0,219461
112638200800000,NE 160,Residential,27132,185525,0,212657
112638200900000,NE 160,Residential,27132,191984,0,219116
112638201000000,NE 160,Residential,29988,205641,0,235629
112638201100000,NE 160,Residential,31118,248436,0,279554
112638201200000,NE 160,Residential,29988,215142,0,245130
112638201300000,NE 160,Residential,28203,217407,0,245610
112638201400000,NE 160,Residential,26061,170522,0,196583
112638201500000,NE 160,Residential,29988,185226,0,215214
112638201600000,NE 160,Residential,27132,202859,0,229991
112638201700000,NE 160,Residential,29047,201712,0,230759
112638201800000,NE 160,Residential,30953,191805,0,222758
112638201900000,NE 160,Residential,31450,232848,0,264298
112638202000000,NE 160,Residential,28560,160478,0,189038
112638202100000,NE 160,Residential,28560,152314,0,180874
112638202200000,NE 160,Residential,28560,201893,0,230453
112638202300000,NE 160,Residential,30430,203326,0,233756
112638300100000,NE 160,Residential,29792,190710,0,220502
112638300200000,NE 160,Residential,29792,187032,0,216824
112712600400000,NE 110,Residential,49600,224664,0,274264
112712600500000,NE 110,Residential,51750,163912,0,215662
112712600600000,NE 110,Residential,53750,212305,0,266055
112712700200000,NE 163,Residential,38688,190395,0,229083
112712700300000,NE 163,Residential,35360,238047,0,273407
112712700400000,NE 163,Residential,35360,38422,0,73782
112712700500000,NE 163,Residential,35360,217843,0,253203
112712800100000,NE 163,Residential,37060,216372,0,253432
112715200100000,NE 101,Ag Land,14621,0,0,14621
112715200200000,NE 163,Residential,45099,254676,0,299775
112715200300000,NE 163,Residential,39600,251785,0,291385
112715200400000,NE 163,Residential,53508,270311,0,323819
112715200500000,NE 163,Residential,36040,116921,0,152961
112715200600000,NE 163,Residential,37093,234070,0,271163
112715200700000,NE 163,Residential,40693,233840,0,274533
112715200800000,NE 163,Residential,34880,228418,0,263298
112715200900000,NE 163,Residential,34880,244083,0,278963
112715201000000,NE 163,Residential,34880,236880,0,271760
112715201100000,NE 163,Residential,34880,255650,0,290530
112715201200000,NE 163,Residential,200,0,0,200
112715201300000,NE 163,Residential,200,0,0,200
112715201400000,NE 163,Residential,212,0,0,212
112715201500000,NE 163,Residential,280,0,0,280
112715201600000,NE 163,Residential,299,0,0,299
112715201700000,NE 163,Residential,225,0,0,225
112715201800000,NE 163,Residential,316,0,0,316
112715201900000,NE 163,Residential,286,0,0,286
112715202000000,NE 163,Residential,213,0,0,213
112715202100000,NE 163,Residential,181,0,0,181
112715202200000,NE 163,Residential,287,0,0,287
112715202300000,NE 163,Residential,56733,322745,0,379478
112715202400000,NE 163,Residential,277,0,0,277
112715202500000,NE 163,Residential,207,0,0,207
112715202600000,NE 163,Residential,318,0,0,318
112715300100000,NE 163,Residential,36915,235497,0,272412
112715300200000,NE 163,Residential,209,0,0,209
112715300300000,NE 163,Residential,201,0,0,201
112715300400000,NE 163,Residential,196,0,0,196
112715300500000,NE 163,Residential,193,0,0,193
112715300600000,NE 163,Residential,192,0,0,192
112715300700000,NE 163,Residential,191,0,0,191
112715300800000,NE 163,Residential,190,0,0,190
112715300900000,NE 163,Residential,190,0,0,190
112715301000000,NE 163,Residential,39200,246289,0,285489
112715301100000,NE 163,Residential,41373,245119,0,286492
112715301200000,NE 163,Residential,41813,220294,0,262107
112715301300000,NE 163,Residential,45387,251673,0,297060
112715400100000,NE 163,Residential,245,0,0,245
112715400200000,NE 163,Residential,214,0,0,214
112715400300000,NE 163,Residential,218,0,0,218
112715400400000,NE 163,Residential,186,0,0,186
112715400500000,NE 163,Residential,186,0,0,186
112715400600000,NE 163,Residential,186,0,0,186
112715400700000,NE 163,Residential,186,0,0,186
112715400800000,NE 163,Residential,186,0,0,186
112715400900000,NE 163,Residential,186,0,0,186
112715401000000,NE 163,Residential,186,0,0,186
112715401100000,NE 163,Residential,35700,191351,0,227051
112715401200000,NE 163,Residential,35700,217341,0,253041
112715401300000,NE 163,Residential,229,0,0,229
112717700100000,NE 101,Ag Land,10531,0,0,10531
112720401500000,NE 162,Ag Land,8398,0,0,8398
112720401600000,Empty,Exempt,0,0,0,0
112720401700000,NE 101,Ag Land,70,0,0,70
112722600400000,NE 162,Ag Land,61133,0,0,61133
112725100400000,NE 101,Ag Dwelling,31750,204708,0,236458
112727600100000,NE 101,Ag Land,33105,0,0,33105
112727600200000,NE 163,Residential,58240,0,0,58240
112727600300000,NE 163,Residential,35360,0,0,35360
112727600400000,NE 163,Residential,35360,41507,0,76867
112727600500000,NE 163,Residential,35360,161649,0,197009
112727600600000,NE 163,Residential,37440,233218,0,270658
112727700100000,NE 163,Residential,39900,298362,0,338262
112727700200000,NE 163,Residential,36120,0,0,36120
112727700300000,NE 163,Residential,36120,234866,0,270986
112727700400000,NE 163,Residential,36120,265660,0,301780
112727800100000,NE 163,Residential,49088,272934,0,322022
112727800200000,NE 163,Residential,46620,239053,0,285673
112727800300000,NE 163,Residential,50647,220200,0,270847
112727800400000,NE 163,Residential,45780,241155,0,286935
112727900100000,NE 163,Residential,36540,249429,0,285969
112727900200000,NE 163,Residential,36540,238843,0,275383
112727900300000,NE 163,Residential,33600,297158,0,330758
112727900400000,NE 163,Residential,33600,0,0,33600
112727900500000,NE 163,Residential,33320,0,0,33320
112727900600000,NE 163,Residential,32900,0,0,32900
112727900700000,NE 163,Residential,32309,0,0,32309
112727900800000,NE 163,Residential,31815,261386,0,293201
112727900900000,NE 163,Residential,35316,216567,0,251883
112727901000000,NE 163,Residential,35200,0,0,35200
112728100100000,NE 163,Residential,37380,0,0,37380
112728200100000,NE 163,Residential,37380,0,0,37380
112728200200000,NE 163,Residential,37380,0,0,37380
112730100100000,NE 101,Ag Land,14563,0,0,14563
112730100300000,NE 163,Residential,30269,130400,0,160669
112730100400000,NE 163,Residential,26948,150213,0,177161
112730100500000,NE 163,Residential,26948,160495,0,187443
112730100600000,NE 163,Residential,26948,147535,0,174483
112730100700000,NE 163,Residential,26948,151362,0,178310
112730100800000,NE 163,Residential,26948,134209,0,161157
112730100900000,NE 163,Residential,26948,143171,0,170119
112730101000000,NE 163,Residential,26948,166514,0,193462
112730101100000,NE 163,Residential,26948,136245,0,163193
112730101200000,NE 163,Residential,26948,175010,0,201958
112730101300000,NE 163,Residential,26948,136021,0,162969
112730101400000,NE 163,Residential,26948,113638,0,140586
112730101500000,NE 163,Residential,26948,133891,0,160839
112730101600000,NE 163,Residential,26948,125505,0,152453
112730101700000,NE 163,Residential,26948,151776,0,178724
112730101800000,NE 163,Residential,26948,132107,0,159055
112730101900000,NE 163,Residential,30000,183733,0,213733
112730102000000,NE 163,Residential,30000,152241,0,182241
112730102100000,NE 163,Residential,26948,137025,0,163973
112730102200000,NE 163,Residential,26948,148435,0,175383
112730102300000,NE 163,Residential,26948,151607,0,178555
112730102400000,NE 163,Residential,26948,167817,0,194765
112730102500000,NE 163,Residential,26948,151027,0,177975
112730102600000,NE 163,Residential,26948,158429,0,185377
112730102700000,NE 163,Residential,26948,145952,0,172900
112730102800000,NE 163,Residential,26948,164765,0,191713
112730102900000,NE 163,Residential,26948,134253,0,161201
112730103000000,NE 163,Residential,26948,137098,0,164046
112730103100000,NE 163,Residential,26948,153746,0,180694
112730103200000,NE 163,Residential,26948,179067,0,206015
112730103300000,NE 163,Residential,26948,169307,0,196255
112730103400000,NE 163,Residential,26948,182999,0,209947
112730103500000,NE 163,Residential,26948,163181,0,190129
112730103600000,NE 163,Residential,31349,133038,0,164387
112730200100000,NE 163,Residential,26000,152505,0,178505
112730200200000,NE 163,Residential,31532,155544,0,187076
112730200300000,NE 163,Residential,28620,155536,0,184156
112730200400000,NE 163,Residential,28620,153497,0,182117
112730200500000,NE 163,Residential,28620,169833,0,198453
112730200600000,NE 163,Residential,30600,173442,0,204042
112730200700000,NE 163,Residential,32980,36539,0,69519
112730200800000,NE 163,Residential,32000,150427,0,182427
112730200900000,NE 163,Residential,31040,151008,0,182048
112730201000000,NE 163,Residential,20,0,0,20
112730201100000,NE 163,Residential,15,0,0,15
112730300100000,NE 163,Residential,30000,148350,0,178350
112730300200000,NE 163,Residential,420,0,0,420
112730300300000,NE 163,Residential,420,0,0,420
112730300400000,NE 163,Residential,396,0,0,396
112730300500000,NE 163,Residential,26400,153472,0,179872
112730300600000,NE 163,Residential,26400,162324,0,188724
112730300700000,NE 163,Residential,26400,151323,0,177723
112730300800000,NE 163,Residential,26400,152107,0,178507
112730300900000,NE 163,Residential,26400,127570,0,153970
112730301000000,NE 163,Residential,26400,134488,0,160888
112730301100000,NE 163,Residential,26400,126129,0,152529
112730301200000,NE 163,Residential,26400,143643,0,170043
112730301300000,NE 163,Residential,26400,152047,0,178447
112730301400000,NE 163,Residential,26400,129567,0,155967
112730301500000,NE 163,Residential,26400,158271,0,184671
112730301600000,NE 163,Residential,26400,148868,0,175268
112730301700000,NE 163,Residential,26400,128485,0,154885
112730301800000,NE 163,Residential,26400,138465,0,164865
112730301900000,NE 163,Residential,26403,0,0,26403
112730302000000,NE 163,Residential,27141,133580,0,160721
112730400100000,NE 163,Residential,31200,151959,0,183159
112730400200000,NE 163,Residential,26948,144527,0,171475
112730400300000,NE 163,Residential,26948,171075,0,198023
112730400400000,NE 163,Residential,26948,129844,0,156792
112730400500000,NE 163,Residential,26948,157147,0,184095
112730400600000,NE 163,Residential,26948,135520,0,162468
112730400700000,NE 163,Residential,26948,164513,0,191461
112730400800000,NE 163,Residential,26948,135691,0,162639
112730400900000,NE 163,Residential,26948,171028,0,197976
112730401000000,NE 163,Residential,26948,151116,0,178064
112730401100000,NE 163,Residential,26948,138431,0,165379
112730401200000,NE 163,Residential,26948,155741,0,182689
112730401300000,NE 163,Residential,26948,157323,0,184271
112730401400000,NE 163,Residential,26948,149453,0,176401
112730401500000,NE 163,Residential,26948,155098,0,182046
112730401600000,NE 163,Residential,26948,150117,0,177065
112730401700000,NE 163,Residential,31093,165775,0,196868
112730401800000,NE 101,Residential,122,0,0,122
112730401900000,NE 163,Residential,32173,133765,0,165938
112730402000000,NE 163,Residential,26948,130966,0,157914
112730402100000,NE 163,Residential,26948,143395,0,170343
112730402200000,NE 163,Residential,26948,134460,0,161408
112730402300000,NE 163,Residential,26948,156454,0,183402
112730402400000,NE 163,Residential,26948,153854,0,180802
112730402500000,NE 163,Residential,26948,154036,0,180984
112730402600000,NE 163,Residential,26948,134592,0,161540
112730402700000,NE 163,Residential,26948,164589,0,191537
112730402800000,NE 163,Residential,26948,154774,0,181722
112730402900000,NE 163,Residential,26948,152517,0,179465
112730403000000,NE 163,Residential,26948,132105,0,159053
112730403100000,NE 163,Residential,26948,161251,0,188199
112730403200000,NE 163,Residential,26948,170303,0,197251
112730403300000,NE 163,Residential,26948,161192,0,188140
112730403400000,NE 163,Residential,26948,148043,0,174991
112730403500000,NE 163,Residential,31200,146815,0,178015
112730500100000,NE 163,Residential,30000,136869,0,166869
112730500200000,NE 163,Residential,26152,166789,0,192941
112730500300000,NE 163,Residential,26152,155115,0,181267
112730500400000,NE 163,Residential,26152,134104,0,160256
112730500500000,NE 163,Residential,26152,146311,0,172463
112730500600000,NE 163,Residential,26152,138137,0,164289
112730500700000,NE 163,Residential,26152,158812,0,184964
112730500800000,NE 163,Residential,26152,136510,0,162662
112730500900000,NE 163,Residential,26152,149348,0,175500
112730501000000,NE 163,Residential,26152,148923,0,175075
112730501100000,NE 163,Residential,26152,168685,0,194837
112730501200000,NE 163,Residential,26144,155071,0,181215
112730501300000,NE 163,Residential,26152,156234,0,182386
112730501400000,NE 163,Residential,26152,167621,0,193773
112730501500000,NE 163,Residential,26152,175842,0,201994
112730501600000,NE 163,Residential,26152,152017,0,178169
112730501700000,NE 163,Residential,30269,170059,0,200328
112732600200000,NE 162,Residential,42480,226725,0,269205
112732600300000,NE 162,Residential,49240,200941,0,250181
112732600400000,NE 162,Residential,45720,197375,0,243095
112732600500000,E-15 CITY,Exempt,0,0,0,0
112732600600000,NE 162,Residential,32912,154597,0,187509
112732600700000,NE 162,Residential,31680,163381,0,195061
112732600800000,NE 162,Residential,31640,157579,0,189219
112732600900000,NE 162,Residential,32160,231904,0,264064
112732601000000,NE 162,Residential,33070,183063,0,216133
112732601100000,NE 162,Residential,35075,186654,0,221729
112732601200000,NE 162,Residential,31304,176576,0,207880
112732601300000,NE 162,Residential,30633,152019,0,182652
112732601400000,NE 162,Residential,33535,187818,0,221353
112732601500000,E-15 CITY,Exempt,0,0,0,0
112732601600000,NE 162,Residential,32368,154122,0,186490
112732601700000,NE 162,Residential,33120,182370,0,215490
112732601800000,NE 162,Residential,33424,155834,0,189258
112732601900000,NE 162,Residential,31272,160504,0,191776
112732602000000,NE 162,Residential,30501,174342,0,204843
112732602100000,NE 162,Residential,31919,161012,0,192931
112732602200000,NE 101,Ag Land,11683,0,0,11683
112732700100000,NE 162,Residential,28527,167467,0,195994
112732700200000,NE 162,Residential,30620,163796,0,194416
112735100100000,NE 162,Residential,28811,165783,0,194594
112735100200000,NE 162,Residential,29120,181537,0,210657
112735100300000,NE 162,Residential,29120,148540,0,177660
112735100400000,NE 162,Residential,29120,137319,0,166439
112735100500000,NE 162,Residential,29447,163544,0,192991
112735100600000,NE 162,Residential,31121,183957,0,215078
112735100700000,NE 162,Residential,26637,145213,0,171850
112735200100000,NE 162,Residential,26920,157253,0,184173
112735200200000,NE 162,Residential,30845,196329,0,227174
112735200300000,NE 162,Residential,27456,167332,0,194788
112735200400000,NE 162,Residential,29781,153176,0,182957
112735200500000,NE 162,Residential,29120,164737,0,193857
112735200600000,NE 162,Residential,27456,142128,0,169584
112735200700000,NE 162,Residential,29120,162133,0,191253
112735200800000,NE 162,Residential,29536,151303,0,180839
112735200900000,NE 162,Residential,29536,187073,0,216609
112735201000000,NE 162,Residential,29120,150043,0,179163
112735201100000,NE 162,Residential,27456,176659,0,204115
112735201200000,NE 162,Residential,29120,166815,0,195935
112735201300000,NE 162,Residential,29120,160534,0,189654
112735201400000,NE 162,Residential,31175,169121,0,200296
112735201500000,NE 162,Residential,31650,139866,0,171516
112735300100000,NE 162,Residential,30477,154443,0,184920
112735300200000,NE 162,Residential,28560,179599,0,208159
112735300300000,NE 162,Residential,28560,139244,0,167804
112735300400000,NE 162,Residential,26928,161936,0,188864
112735300500000,NE 162,Residential,28560,163720,0,192280
112735300600000,NE 162,Residential,28560,166304,0,194864
112735300700000,NE 162,Residential,26928,167626,0,194554
112735300800000,NE 162,Residential,28560,125125,0,153685
112735300900000,NE 162,Residential,28560,158266,0,186826
112735301000000,NE 162,Residential,26928,148101,0,175029
112735301100000,NE 162,Residential,28560,154179,0,182739
112735301200000,NE 162,Residential,28560,151445,0,180005
112735301300000,NE 162,Residential,26928,136652,0,163580
112735301400000,NE 162,Residential,28840,159050,0,187890
112735301500000,NE 162,Residential,32916,175205,0,208121
112735301600000,NE 162,Residential,31492,142804,0,174296
112735301700000,NE 162,Residential,28560,161346,0,189906
112735301800000,NE 162,Residential,26928,173762,0,200690
112735301900000,NE 162,Residential,28560,155793,0,184353
112735302000000,NE 162,Residential,28560,157232,0,185792
112735302100000,NE 162,Residential,26928,184378,0,211306
112735302200000,NE 162,Residential,28560,179118,0,207678
112735302300000,NE 162,Residential,28560,172080,0,200640
112735302400000,NE 162,Residential,26928,165694,0,192622
112735302500000,NE 162,Residential,28560,188016,0,216576
112735302600000,NE 162,Residential,28560,170580,0,199140
112735302700000,NE 162,Residential,21114,171886,0,193000
112735302800000,NE 162,Residential,26932,162049,0,188981
112735302900000,NE 162,Residential,28560,154812,0,183372
112735303000000,NE 162,Residential,30965,154197,0,185162
112735400100000,NE 162,Residential,27218,136806,0,164024
112735400200000,NE 162,Residential,28560,174433,0,202993
112735400300000,NE 162,Residential,28560,159713,0,188273
112735400400000,NE 162,Residential,30192,165684,0,195876
112735400500000,NE 162,Residential,30192,183063,0,213255
112735400600000,NE 162,Residential,26928,155136,0,182064
112735400700000,NE 162,Residential,28560,152376,0,180936
112735400800000,NE 162,Residential,30192,155434,0,185626
112735400900000,NE 162,Residential,27520,159980,0,187500
112735401000000,NE 162,Residential,27532,186895,0,214427
112735401100000,NE 162,Residential,30192,173293,0,203485
112735401200000,NE 162,Residential,28560,184095,0,212655
112735401300000,NE 162,Residential,26928,160221,0,187149
112735401400000,NE 162,Residential,30192,163926,0,194118
112735401500000,NE 162,Residential,30192,183045,0,213237
112735401600000,NE 162,Residential,28560,181880,0,210440
112735401700000,NE 162,Residential,26928,168546,0,195474
112735401800000,NE 162,Residential,30931,159606,0,190537
112735402100000,NE 162,Residential,30625,177358,0,207983
112735402200000,NE 162,Residential,30488,176908,0,207396
112735402300000,NE 162,Residential,30001,195405,0,225406
112735402400000,NE 162,Residential,30282,207825,0,238107
112735402500000,NE 162,Residential,29786,225180,0,254966
112735402600000,NE 162,Residential,31239,163646,0,194885
112735402700000,NE 162,Residential,32844,188987,0,221831
112735402800000,NE 162,Residential,30750,199283,0,230033
112735402900000,NE 162,Residential,32947,206063,0,239010
112735403000000,NE 162,Residential,30186,177238,0,207424
112735403100000,NE 162,Residential,29813,201773,0,231586
112735403200000,NE 162,Residential,32634,209718,0,242352
112735403300000,NE 162,Residential,33415,199278,0,232693
112735403400000,NE 162,Residential,34243,174601,0,208844
112735403500000,NE 162,Residential,33832,151119,0,184951
112735403600000,NE 162,Residential,32401,179892,0,212293
112735403700000,NE 162,Residential,31920,151957,0,183877
112735403800000,NE 162,Residential,29934,166850,0,196784
112735403900000,NE 162,Residential,31135,208865,0,240000
112735404000000,NE 101,Residential,65550,149339,0,214889
112735404100000,E-15 CITY,Exempt,0,0,0,0
112737600100000,NE 101,Ag Land,51896,0,0,51896
112740100100000,NE 101,Ag Land,25962,0,0,25962
112740200100000,NE 163,Residential,30149,149692,0,179841
112740200200000,NE 163,Residential,27384,162820,0,190204
112740200300000,NE 163,Residential,27384,131567,0,158951
112740200400000,NE 163,Residential,27384,172051,0,199435
112740200500000,E-15 CITY,Exempt,0,0,0,0
112740200600000,NE 163,Residential,29052,152335,0,181387
112740200700000,NE 163,Residential,28172,151333,0,179505
112740200800000,NE 163,Residential,28680,139313,0,167993
112740200900000,NE 163,Residential,28680,161842,0,190522
112740201000000,NE 163,Residential,28680,159680,0,188360
112740201100000,NE 163,Residential,25587,151771,0,177358
112740300100000,NE 163,Residential,31351,156087,0,187438
112740300200000,NE 163,Residential,25800,158293,0,184093
112740300300000,NE 163,Residential,25800,139988,0,165788
112740300400000,NE 163,Residential,25800,149960,0,175760
112740300500000,NE 163,Residential,25800,140325,0,166125
112740300600000,NE 163,Residential,25800,129119,0,154919
112740300700000,NE 163,Residential,30000,135398,0,165398
112740300800000,NE 163,Residential,25800,146629,0,172429
112740300900000,NE 163,Residential,25800,150999,0,176799
112740301000000,NE 163,Residential,25800,136482,0,162282
112740301100000,NE 163,Residential,25800,132143,0,157943
112740301200000,NE 163,Residential,25800,162906,0,188706
112740301300000,NE 163,Residential,25800,155359,0,181159
112740301400000,NE 163,Residential,25800,119406,0,145206
112740301500000,NE 163,Residential,25800,153328,0,179128
112740301600000,NE 163,Residential,25800,127673,0,153473
112740301700000,NE 163,Residential,31596,156266,0,187862
112740301800000,NE 163,Residential,25800,162678,0,188478
112740301900000,NE 163,Residential,25800,149325,0,175125
112740302000000,NE 163,Residential,25800,125640,0,151440
112740302100000,NE 163,Residential,25800,150076,0,175876
112740302200000,NE 163,Residential,30000,170000,0,200000
112740400100000,NE 163,Residential,31292,153672,0,184964
112740400200000,NE 163,Residential,26372,114951,0,141323
112740400300000,NE 163,Residential,26372,156717,0,183089
112740400400000,NE 163,Residential,26372,159344,0,185716
112740400500000,NE 163,Residential,26372,129114,0,155486
112740400600000,NE 163,Residential,26372,135713,0,162085
112740400700000,NE 163,Residential,26372,129978,0,156350
112740400800000,NE 163,Residential,26372,122381,0,148753
112740400900000,NE 163,Residential,26372,150521,0,176893
112740401000000,NE 163,Residential,26372,125921,0,152293
112740401100000,NE 163,Residential,26372,162481,0,188853
112742600100000,NE 101,Ag Land,15388,0,0,15388
112742700201000,CONDO 501,Residential,13000,154336,0,167336
112742700201001,CONDO 501,Residential,15000,155582,0,170582
112742700301000,CONDO 501,Residential,14000,152895,0,166895
112742700301001,CONDO 501,Residential,14000,157305,0,171305
112742700401000,CONDO 501,Residential,14000,138788,0,152788
112742700401001,CONDO 501,Residential,13000,161268,0,174268
112742700501000,CONDO 501,Residential,14000,147181,0,161181
112742700501001,CONDO 501,Residential,13000,144678,0,157678
112742700601000,CONDO 501,Residential,14000,132786,0,146786
112742700601001,CONDO 501,Residential,13000,159036,0,172036
112742700701000,CONDO 501,Residential,13000,161068,0,174068
112742700701001,CONDO 501,Residential,13000,138093,0,151093
112742700801000,CONDO 501,Residential,14000,164174,0,178174
112742700801001,CONDO 501,Residential,13000,139138,0,152138
112742700901000,CONDO 501,Residential,13000,144551,0,157551
112742700901001,CONDO 501,Residential,13000,151085,0,164085
112742701000000,CONDO 501,Residential,26000,0,0,26000
112742701100000,CONDO 501,Residential,26000,0,0,26000
112742701200000,CONDO 501,Residential,26000,0,0,26000
112742701300000,CONDO 501,Residential,26000,0,0,26000
112742701401000,CONDO 501,Residential,13000,134993,0,147993
112742701401001,CONDO 501,Residential,13000,135969,0,148969
112742701500000,CONDO 501,Residential,26000,205984,0,231984
112742701600000,CONDO 501,Residential,26000,0,0,26000
112742701700000,CONDO 501,Residential,26000,0,0,26000
112742800101000,CONDO 501,Residential,15000,168832,0,183832
112742800101001,CONDO 501,Residential,14000,146884,0,160884
112742800201000,CONDO 501,Residential,14000,163502,0,177502
112742800201001,CONDO 501,Residential,14000,139021,0,153021
112742800301000,CONDO 501,Residential,15000,155087,0,170087
112742800301001,CONDO 501,Residential,14000,143350,0,157350
112742800401000,CONDO 501,Residential,14000,144033,0,158033
112742800401001,CONDO 501,Residential,14000,135494,0,149494
112742800501000,CONDO 501,Residential,14000,143219,0,157219
112742800501001,CONDO 501,Residential,13000,143577,0,156577
112742800601000,CONDO 500,Residential,15000,173854,0,188854
112742800601001,CONDO 500,Residential,13000,133743,0,146743
112742800701000,CONDO 501,Residential,15000,148102,0,163102
112742800701001,CONDO 501,Residential,12000,128763,0,140763
112742800800000,NE 163,Residential,30000,143079,0,173079
112742800900000,NE 163,Residential,25600,125704,0,151304
112742801000000,NE 163,Residential,25600,137970,0,163570
112742801100000,NE 163,Residential,25600,148474,0,174074
112742801200000,NE 163,Residential,25600,141259,0,166859
112742801300000,NE 163,Residential,25600,127816,0,153416
112742801400000,NE 163,Residential,25600,144609,0,170209
112742801500000,NE 163,Residential,25600,145999,0,171599
112742801600000,NE 163,Residential,25600,162327,0,187927
112742801700000,NE 163,Residential,25600,147310,0,172910
112742801800000,NE 163,Residential,25600,150437,0,176037
112742801900000,NE 163,Residential,25600,155834,0,181434
112742802000000,NE 163,Residential,25600,156327,0,181927
112742802100000,NE 163,Residential,30000,153098,0,183098
112742802201000,CONDO 501,Residential,13000,150876,0,163876
112742802201001,CONDO 501,Residential,13000,148784,0,161784
112742802301000,CONDO 501,Residential,13000,134458,0,147458
112742802301001,CONDO 501,Residential,13000,137276,0,150276
112742802401000,CONDO 501,Residential,15000,144089,0,159089
112742802401001,CONDO 501,Residential,13000,130492,0,143492
112742802501000,CONDO 501,Residential,14000,159065,0,173065
112742802501001,CONDO 501,Residential,14000,140717,0,154717
112742802601000,CONDO 501,Residential,12000,146585,0,158585
112742802601001,CONDO 501,Residential,14000,150125,0,164125
112742900101000,CONDO 501,Residential,14000,142746,0,156746
112742900101001,CONDO 501,Residential,12000,127034,0,139034
112742900201000,CONDO 501,Residential,14000,150148,0,164148
112742900201001,CONDO 501,Residential,14000,144080,0,158080
112742900300000,NE 163,Residential,30400,182525,0,212925
112742900400000,NE 163,Residential,30400,155713,0,186113
112742900500000,NE 163,Residential,30400,169926,0,200326
112742900600000,NE 163,Residential,26668,159633,0,186301
112742900700000,NE 163,Residential,26668,150840,0,177508
112742900800000,NE 162,Residential,25868,169310,0,195178
112742900900000,NE 163,Residential,26668,175554,0,202222
112742901000000,NE 163,Residential,26668,147702,0,174370
112742901100000,NE 163,Residential,26700,136200,0,162900
112742901200000,NE 163,Residential,26700,166759,0,193459
112742901300000,NE 163,Residential,26700,152181,0,178881
112742901400000,NE 163,Residential,26560,148872,0,175432
112743000100000,NE 163,Residential,26380,129871,0,156251
112743000200000,NE 163,Residential,30000,141000,0,171000
112743100100000,NE 163,Residential,30000,154126,0,184126
112743100200000,NE 163,Residential,26800,121772,0,148572
112743100300000,NE 163,Residential,26800,127579,0,154379
112743100400000,NE 163,Residential,26800,123419,0,150219
112743100500000,NE 163,Residential,26800,148809,0,175609
112743100600000,NE 163,Residential,26800,188263,0,215063
112743100700000,NE 163,Residential,26800,153929,0,180729
112743100800000,NE 163,Residential,26800,135992,0,162792
112743100900000,NE 163,Residential,26800,137939,0,164739
112743101000000,NE 163,Residential,26800,145114,0,171914
112743101100000,NE 163,Residential,26800,134688,0,161488
112743101200000,NE 163,Residential,26800,150921,0,177721
112743101300000,NE 163,Residential,26800,154986,0,181786
112743101400000,NE 163,Residential,26800,142954,0,169754
112743101500000,NE 163,Residential,26800,131209,0,158009
112743101600000,NE 163,Residential,30000,146619,0,176619
112743200100000,NE 163,Residential,26000,0,0,26000
112743200200000,CONDO 501,Residential,26000,0,0,26000
112743200300000,CONDO 501,Residential,26000,205459,0,231459
112743200401000,CONDO 501,Residential,13000,144061,0,157061
112743200401001,CONDO 501,Residential,13000,133870,0,146870
112743200500000,CONDO 501,Residential,26000,0,0,26000
112743200600000,CONDO 501,Residential,26000,0,0,26000
112743200701000,CONDO 501,Residential,13000,139772,0,152772
112743200701001,CONDO 501,Residential,13000,157311,0,170311
112743200800000,CONDO 501,Residential,26000,0,0,26000
112743200900000,CONDO 501,Residential,26000,0,0,26000
112743201001000,CONDO 501,Residential,13000,163183,0,176183
112743201001001,CONDO 501,Residential,13000,138114,0,151114
112743201100000,CONDO 501,Residential,26000,0,0,26000
112743201200000,CONDO 501,Residential,26000,0,0,26000
112743201300000,CONDO 501,Residential,26000,0,0,26000
112745100100000,NE 101,Ag Land,37590,0,0,37590
112745100200000,NE 101,Residential,63700,217714,0,281414
112747600100000,E-15 CITY,Exempt,0,0,0,0
112747600200000,NE 163,Residential,25867,125232,0,151099
112747600300000,NE 163,Residential,26000,141800,0,167800
112747600400000,NE 163,Residential,28000,145272,0,173272
112747600500000,NE 163,Residential,28000,142840,0,170840
112747600600000,NE 163,Residential,26000,128206,0,154206
112747600700000,NE 163,Residential,26000,135211,0,161211
112747600800000,NE 163,Residential,26000,147987,0,173987
112747600900000,NE 163,Residential,26000,125919,0,151919
112747601000000,NE 163,Residential,26000,114504,0,140504
112747601100000,NE 163,Residential,30333,141824,0,172157
112747601200000,NE 163,Residential,30526,138037,0,168563
112747601300000,NE 163,Residential,30800,164142,0,194942
112747601400000,NE 163,Residential,30400,129681,0,160081
112747601500000,NE 163,Residential,30400,130569,0,160969
112747601600000,NE 163,Residential,30905,138295,0,169200
112747700100000,NE 163,Residential,31716,130792,0,162508
112747700200000,NE 163,Residential,28152,132937,0,161089
112747700300000,NE 163,Residential,28152,124744,0,152896
112747700400000,NE 163,Residential,28152,135449,0,163601
112747700500000,NE 163,Residential,28152,171032,0,199184
112747700600000,NE 163,Residential,28152,136163,0,164315
112747700700000,NE 163,Residential,28152,135878,0,164030
112747700800000,NE 163,Residential,28152,138643,0,166795
112747700900000,NE 163,Residential,28152,169005,0,197157
112747701000000,NE 163,Residential,28152,138004,0,166156
112747701100000,NE 163,Residential,29995,131070,0,161065
112747800100000,NE 163,Residential,31486,150514,0,182000
112747800200000,NE 163,Residential,26260,136955,0,163215
112747800300000,NE 163,Residential,26260,137689,0,163949
112747800400000,NE 163,Residential,26260,136682,0,162942
112747800500000,NE 163,Residential,26260,135470,0,161730
112747800600000,NE 163,Residential,26260,129725,0,155985
112747800700000,NE 163,Residential,26260,162653,0,188913
112747800800000,NE 163,Residential,30516,156197,0,186713
112747800900000,NE 163,Residential,26839,112249,0,139088
112747801000000,NE 163,Residential,26260,139027,0,165287
112747801100000,NE 163,Residential,26260,159444,0,185704
112747801200000,NE 163,Residential,26260,139570,0,165830
112747801300000,NE 163,Residential,26480,138117,0,164597
112747801400000,NE 163,Residential,30602,141893,0,172495
112747801500000,NE 163,Residential,26000,132964,0,158964
112747801600000,NE 163,Residential,26000,115017,0,141017
112747801700000,NE 163,Residential,26000,141515,0,167515
112747801800000,NE 163,Residential,26000,139632,0,165632
112747801900000,NE 163,Residential,26000,127877,0,153877
112747802000000,NE 163,Residential,27367,131741,0,159108
112747802100000,NE 163,Residential,29422,140606,0,170028
112747802200000,NE 163,Residential,31484,156930,0,188414
112747802300000,NE 163,Residential,30897,134414,0,165311
112747802400000,NE 163,Residential,28323,169514,0,197837
112747802500000,NE 163,Residential,28323,148295,0,176618
112747802600000,NE 163,Residential,28262,135270,0,163532
112747802700000,NE 163,Residential,24365,151224,0,175589
112747802800000,NE 163,Residential,30031,160249,0,190280
112747802900000,NE 163,Residential,28804,160306,0,189110
112747803000000,NE 163,Residential,29180,126743,0,155923
112747803100000,NE 163,Residential,31280,165196,0,196476
112747803200000,NE 163,Residential,25810,132113,0,157923
112747803300000,NE 163,Residential,27300,173321,0,200621
112747803400000,NE 163,Residential,27300,135990,0,163290
112747803500000,NE 163,Residential,25740,153207,0,178947
112747803600000,NE 163,Residential,30057,129141,0,159198
112747803700000,NE 163,Residential,28157,148075,0,176232
112747900100000,NE 163,Residential,31208,141215,0,172423
112747900200000,NE 163,Residential,27263,150143,0,177406
112747900300000,NE 163,Residential,27263,137073,0,164336
112747900400000,NE 163,Residential,27263,134522,0,161785
112747900500000,NE 163,Residential,27263,140635,0,167898
112747900600000,NE 163,Residential,27263,117512,0,144775
112747900700000,NE 163,Residential,26928,141954,0,168882
112747900800000,NE 163,Residential,28152,163262,0,191414
112747900900000,NE 163,Residential,28152,150186,0,178338
112747901000000,NE 163,Residential,26928,134887,0,161815
112747901100000,NE 163,Residential,26928,134493,0,161421
112747901200000,NE 163,Residential,26928,131197,0,158125
112747901300000,NE 163,Residential,26928,134097,0,161025
112747901400000,NE 163,Residential,26928,150874,0,177802
112747901500000,NE 163,Residential,26928,152178,0,179106
112747901600000,NE 163,Residential,30785,141270,0,172055
112748000100000,NE 163,Residential,30853,138926,0,169779
112748000200000,NE 163,Residential,27300,124290,0,151590
112748000300000,NE 163,Residential,30263,132477,0,162740
112748000400000,NE 163,Residential,30562,134241,0,164803
112748000500000,NE 163,Residential,32257,154162,0,186419
112748000600000,NE 163,Residential,30872,138349,0,169221
112748000700000,NE 163,Residential,30471,143924,0,174395
112748000800000,NE 163,Residential,29208,147178,0,176386
112748000900000,NE 163,Residential,30492,135711,0,166203
112748001000000,NE 163,Residential,30805,171014,0,201819
112748001100000,NE 163,Residential,30523,119500,0,150023
112748001200000,NE 163,Residential,28379,157653,0,186032
112748001300000,NE 163,Residential,26693,158122,0,184815
112748001400000,NE 163,Residential,26000,153497,0,179497
112748001500000,NE 163,Residential,26000,134977,0,160977
112748001600000,NE 163,Residential,30561,146599,0,177160
112748100100000,NE 163,Residential,30722,126053,0,156775
112748100200000,NE 163,Residential,26000,138807,0,164807
112748100300000,NE 163,Residential,26000,107663,0,133663
112748100400000,NE 163,Residential,26359,149274,0,175633
112748100500000,NE 163,Residential,27300,108643,0,135943
112748100600000,NE 163,Residential,30720,125098,0,155818
112748100700000,NE 163,Residential,30934,131855,0,162789
112748100800000,NE 163,Residential,31787,162219,0,194006
112748100900000,NE 163,Residential,26000,127571,0,153571
112748101000000,NE 163,Residential,26520,161488,0,188008
112748101100000,NE 163,Residential,31456,141498,0,172954
112748101200000,NE 163,Residential,32191,130212,0,162403
112748101300000,NE 163,Residential,31353,162274,0,193627
112748101400000,NE 163,Residential,32634,149275,0,181909
112748101500000,NE 163,Residential,30172,146505,0,176677
112748101600000,NE 163,Residential,29568,134362,0,163930
112748101700000,NE 163,Residential,26520,158221,0,184741
112748101800000,NE 163,Residential,26000,147464,0,173464
112748101900000,NE 163,Residential,30905,149693,0,180598
112748102000000,NE 163,Residential,26260,132308,0,158568
112748102100000,NE 163,Residential,30704,148454,0,179158
112748102200000,NE 163,Residential,27300,118193,0,145493
112748102300000,NE 163,Residential,26260,120340,0,146600
112748102400000,NE 163,Residential,26000,126105,0,152105
112748102500000,NE 163,Residential,26000,145946,0,171946
112748102600000,NE 163,Residential,30601,117412,0,148013
112817600100000,Empty,Other,0,0,0,0
112817600200000,NE 162,Ag Dwelling,42428,82538,9664,134630
112840100100000,NE 162,Ag Land,22852,0,0,22852
112840100200000,NE 162,Residential,40513,331955,0,372468
112840100300000,NE 162,Residential,40400,226992,0,267392
112840100400000,NE 162,Residential,40400,251927,0,292327
112840100500000,NE 162,Residential,40400,241394,0,281794
112840100600000,NE 162,Residential,40400,231551,0,271951
112840100700000,NE 162,Residential,40400,244248,0,284648
112840100800000,NE 162,Residential,40400,250721,0,291121
112840100900000,NE 162,Residential,40400,206479,0,246879
112840101000000,NE 162,Residential,40400,237833,0,278233
112840101100000,NE 162,Residential,40400,240247,0,280647
112840101200000,NE 162,Residential,40400,211748,0,252148
112840101300000,NE 162,Residential,29444,152241,0,181685
112840200100000,NE 162,Residential,6120,0,0,6120
112840200200000,NE 162,Residential,30300,173885,0,204185
112840200300000,NE 162,Residential,40400,222291,0,262691
112840200400000,NE 162,Residential,40400,216169,0,256569
112840200500000,NE 162,Residential,40400,232887,0,273287
112840200600000,NE 162,Residential,40400,220997,0,261397
112840200700000,NE 162,Residential,42218,228405,0,270623
112840200800000,NE 162,Residential,42218,394118,0,436336
112840200900000,NE 162,Residential,42218,217460,0,259678
112840201000000,NE 162,Residential,41204,228345,0,269549
112840201100000,NE 162,Residential,71000,169208,0,240208
112840201200000,NE 162,Residential,40000,86797,0,126797
112842600100000,NE 162,Residential,39097,225997,0,265094
112842600200000,NE 162,Residential,34884,179238,0,214122
112842600300000,NE 162,Residential,34884,208300,0,243184
112842600400000,NE 162,Residential,34884,229931,0,264815
112842600500000,NE 162,Residential,36720,210121,0,246841
112842600600000,NE 162,Residential,36720,219621,0,256341
112842600700000,NE 162,Residential,38556,208972,0,247528
112842600800000,NE 162,Residential,38556,228642,0,267198
112842600900000,NE 162,Residential,42151,181623,0,223774
112842700100000,NE 162,Residential,42120,218388,0,260508
112842700200000,NE 162,Residential,37440,228417,0,265857
112842700300000,NE 162,Residential,37440,200260,0,237700
112842700400000,NE 162,Residential,34020,214145,0,248165
112842700500000,NE 162,Residential,37800,197363,0,235163
112842700600000,NE 162,Residential,43578,226815,0,270393
112842700700000,NE 162,Residential,42642,221020,0,263662
112842700800000,NE 162,Residential,34884,213110,0,247994
112842700900000,NE 162,Residential,36720,214559,0,251279
112842701000000,NE 162,Residential,36720,274313,0,311033
112842701100000,NE 162,Residential,33048,156423,0,189471
112842701200000,NE 162,Residential,36720,231147,0,267867
112842701300000,NE 162,Residential,36720,229280,0,266000
112842701400000,NE 162,Residential,34884,169206,0,204090
112842701500000,NE 162,Residential,36720,211082,0,247802
112842701600000,NE 162,Residential,33966,185471,0,219437
112842701700000,NE 162,Residential,36720,195935,0,232655
112842701800000,NE 162,Residential,37122,178878,0,216000
112842701900000,NE 162,Residential,40500,237131,0,277631
112842702000000,NE 162,Residential,50398,200090,0,250488
112842702100000,NE 162,Residential,42793,241040,0,283833
112842702200000,NE 162,Residential,41518,225312,0,266830
112842800200000,Empty,Other,0,0,0,0
112842900100000,NE 162,Residential,41310,180748,0,222058
112842900200000,NE 162,Residential,34425,197723,0,232148
112842900300000,NE 162,Residential,35802,230872,0,266674
112842900400000,NE 162,Residential,34344,167756,0,202100
112842900500000,NE 162,Residential,48769,176862,0,225631
112842900600000,NE 162,Residential,36252,168860,0,205112
112842900700000,NE 162,Residential,36720,235889,0,272609
112842900800000,NE 162,Residential,33048,187869,0,220917
112842900900000,NE 162,Residential,34884,222113,0,256997
112842901000000,NE 162,Residential,36720,174465,0,211185
112842901100000,NE 162,Residential,33048,170557,0,203605
112842901200000,NE 162,Residential,34884,204257,0,239141
112842901300000,NE 162,Residential,33048,158184,0,191232
112842901400000,NE 162,Residential,36720,215072,0,251792
112842901500000,NE 162,Residential,32576,159779,0,192355
112842901600000,NE 162,Residential,44960,206648,0,251608
112842901700000,NE 162,Residential,41616,173674,0,215290
112842901800000,NE 162,Residential,43012,204863,0,247875
112842901900000,NE 162,Residential,35256,176254,0,211510
112842902000000,NE 162,Residential,38473,190012,0,228485
112842902100000,NE 162,Residential,33507,205728,0,239235
112842902200000,NE 162,Residential,36720,224179,0,260899
112842902300000,NE 162,Residential,33048,200972,0,234020
112842902400000,NE 162,Residential,38556,231205,0,269761
112842902500000,NE 162,Residential,35263,208050,0,243313
112842902600000,NE 162,Residential,41004,248891,0,289895
112842902700000,NE 162,Residential,38604,207624,0,246228
112842902800000,NE 162,Residential,34425,174929,0,209354
112842902900000,NE 162,Residential,41310,228299,0,269609
112843000100000,NE 162,Residential,43650,271098,0,314748
112843000200000,NE 162,Residential,48323,230076,0,278399
112843000300000,NE 162,Residential,32400,166366,0,198766
112843000400000,NE 162,Residential,37179,201377,0,238556
112843000500000,NE 162,Residential,31212,183400,0,214612
112843000600000,NE 162,Residential,33048,197082,0,230130
112843000700000,NE 162,Residential,33201,225572,0,258773
112843000800000,NE 162,Residential,33222,172980,0,206202
112843000900000,NE 162,Residential,41623,180475,0,222098
112843001000000,NE 162,Residential,32521,235495,0,268016
112843001100000,NE 162,Residential,42900,201235,0,244135
112843001200000,NE 162,Residential,33824,203204,0,237028
112843001300000,NE 162,Residential,33118,184979,0,218097
112843001400000,NE 162,Residential,35880,186896,0,222776
112843001500000,NE 162,Residential,34845,180090,0,214935
112843001600000,NE 162,Residential,34050,187652,0,221702
112843100100000,NE 162,Residential,43886,235148,0,279034
112843100200000,NE 162,Residential,36259,250155,0,286414
112843100300000,NE 162,Residential,41769,238813,0,280582
112843100400000,NE 162,Residential,40117,239650,0,279767
112843100500000,NE 162,Residential,35166,210174,0,245340
112843100600000,NE 162,Residential,44860,225310,0,270170
112845100100000,NE 162,Residential,49459,248850,0,298309
112845100200000,NE 162,Residential,35802,250519,0,286321
112845100300000,NE 162,Residential,39750,191639,0,231389
112845100400000,NE 162,Residential,41148,173025,0,214173
112845100500000,NE 162,Residential,37620,221191,0,258811
112845100600000,NE 162,Residential,37796,197441,0,235237
112845100700000,NE 162,Residential,38260,223338,0,261598
112845100800000,NE 162,Residential,41835,276663,0,318498
112845100900000,NE 162,Residential,40682,213271,0,253953
112845101000000,NE 162,Residential,43734,231570,0,275304
112845101100000,NE 162,Residential,43000,251312,0,294312
112845101200000,E-15 CITY,Exempt,0,0,0,0
112845101400000,E-15 CITY,Exempt,0,0,0,0
112845101500000,E-15 CITY,Exempt,0,0,0,0
112847600100000,NE 162,Residential,38681,156249,0,194930
112847600200000,NE 162,Residential,28373,146853,0,175226
112847600300000,NE 162,Residential,30555,166094,0,196649
112847600400000,NE 162,Residential,28373,150015,0,178388
112847600500000,NE 162,Residential,30555,177685,0,208240
112847600600000,NE 162,Residential,28373,173096,0,201469
112847600700000,NE 162,Residential,30555,194350,0,224905
112847600800000,NE 162,Residential,28373,168563,0,196936
112847600900000,NE 162,Residential,32738,195513,0,228251
112847601000000,NE 162,Residential,28373,158763,0,187136
112847601100000,NE 162,Residential,32738,173472,0,206210
112847601200000,NE 162,Residential,32738,182398,0,215136
112847601300000,NE 162,Residential,34920,179051,0,213971
112847601400000,NE 162,Residential,40592,267093,0,307685
112847601500000,E-15 CITY,Exempt,0,0,0,0
112847700100000,NE 162,Residential,39079,199511,0,238590
112847700200000,NE 162,Residential,28512,172470,0,200982
112847700300000,NE 162,Residential,32400,172802,0,205202
112847700400000,NE 162,Residential,28512,162294,0,190806
112847700500000,NE 162,Residential,32400,147909,0,180309
112847700600000,NE 162,Residential,28512,185828,0,214340
112847700700000,NE 162,Residential,32400,183748,0,216148
112847700800000,NE 162,Residential,28512,157005,0,185517
112847700900000,NE 162,Residential,32400,181131,0,213531
112847701000000,NE 162,Residential,28512,183240,0,211752
112847701100000,NE 162,Residential,32400,155429,0,187829
112847701200000,NE 162,Residential,34560,190691,0,225251
112847701300000,NE 162,Residential,34560,187209,0,221769
112847701400000,NE 162,Residential,42052,172586,0,214638
112847701500000,E-15 CITY,Exempt,0,0,0,0
112847701600000,COMM NE,Commercial,125194,0,144806,270000
112847701700000,NE 162,Residential,7400,0,0,7400
112847701800000,NE 103,Residential,17120,130005,0,147125
112847701900000,NE 103,Residential,20330,119060,0,139390
112847702000000,NE 103,Residential,20330,146745,0,167075
112847702100000,NE 103,Residential,20351,139325,0,159676
112847702200000,NE 103,Residential,22967,127581,0,150548
112847702300000,NE 103,Residential,24120,141522,0,165642
112847702400000,NE 102,Residential,20738,172006,0,192744
112847702500000,NE 102,Residential,20738,120064,0,140802
112847702600000,NE 102,Residential,28980,120538,0,149518
112847702700000,NE 102,Residential,31273,168019,0,199292
112847702800000,NE 102,Residential,31363,234531,0,265894
112847702900000,NE 102,Residential,32151,170536,0,202687
112847703000000,NE 102,Residential,27720,158348,0,186068
112847703100000,NE 102,Residential,30096,153075,0,183171
112847703200000,NE 102,Residential,26928,147978,0,174906
112847703300000,NE 102,Residential,30888,141276,0,172164
112847703400000,NE 102,Residential,27720,136849,0,164569
112847703500000,NE 102,Residential,34984,124516,0,159500
112847800100000,NE 102,Residential,31301,112646,0,143947
112847800200000,NE 102,Residential,30096,135015,0,165111
112847800300000,NE 102,Residential,26136,148257,0,174393
112847800400000,NE 102,Residential,30096,138892,0,168988
112847800500000,NE 102,Residential,25872,134036,0,159908
112847800600000,NE 102,Residential,25344,152236,0,177580
112847800700000,NE 102,Residential,31775,133920,0,165695
112847800800000,NE 102,Residential,24938,180495,0,205433
112847800900000,NE 102,Residential,16560,106431,0,122991
112847801000000,NE 102,Residential,19319,148010,0,167329
112847801100000,NE 102,Residential,16987,126114,0,143101
112847801200000,NE 105,Residential,19515,113557,0,133072
112847801300000,NE 102,Residential,21500,123592,0,145092
112847801400000,NE 102,Residential,20037,111500,0,131537
112847801500000,NE 102,Residential,19380,129789,0,149169
112847801600000,NE 103,Residential,19380,155620,0,175000
112847900100000,NE 102,Residential,20849,120821,0,141670
112847900200000,NE 102,Residential,16995,122278,0,139273
112847900300000,NE 102,Residential,18865,140689,0,159554
112847900400000,NE 102,Residential,18208,125775,0,143983
112847900500000,NE 102,Residential,20449,114400,0,134849
112847900600000,NE 103,Residential,20672,148177,0,168849
112847900700000,NE 103,Residential,19250,152151,0,171401
112847900800000,NE 103,Residential,20325,146700,0,167025
112847900900000,NE 103,Residential,16665,127892,0,144557
112847901000000,NE 103,Residential,18724,136491,0,155215
112847901100000,NE 103,Residential,20825,144843,0,165668
112848000100000,NE 103,Residential,20766,148075,0,168841
113015100100000,NE 168,Ag Dwelling,28421,35520,0,63941
113017600100000,NE 168,Ag Land,24173,0,0,24173
113025200100000,NE 168,Ag Land,611,0,0,611
113025200700000,NE 168,Ag Land,9046,0,0,9046
113027700100000,NE 168,Ag Land,7141,0,0,7141
113030100100000,NE 168,Ag Land,43266,0,0,43266
113030100200000,NE 168,Residential,36600,0,0,36600
113032600100000,NE 168,Ag Land,41115,0,0,41115
113035100100000,NE 169,Residential,75750,221493,0,297243
113035100200000,NE 169,Residential,75600,279767,0,355367
113035100300000,NE 168,Residential,440,0,0,440
113035100400000,NE 169,Residential,76000,292591,0,368591
113035100500000,NE 169,Residential,76000,256724,0,332724
113035100600000,NE 169,Residential,76000,230831,0,306831
113035100700000,NE 169,Residential,75550,256718,0,332268
113035100800000,NE 169,Residential,75550,211976,0,287526
113035100900000,NE 168,Residential,900,0,0,900
113035200100000,NE 169,Residential,75000,232211,0,307211
113035200200000,NE 169,Residential,75800,262702,0,338502
113035200300000,NE 168,Ag Land,18069,0,0,18069
113035300100000,NE 169,Residential,77050,271295,0,348345
113035300200000,NE 169,Residential,77050,214888,0,291938
113035300300000,NE 169,Residential,75000,250502,0,325502
113035300400000,NE 169,Residential,75000,258750,0,333750
113037600100000,NE 168,Ag Land,49797,0,0,49797
113042600100000,NE 168,Residential,106600,97360,0,203960
113042600200000,E-40 CHURCHES,Exempt,5453,0,0,5453
113042600300000,E-40 CHURCHES,Exempt,7365,0,0,7365
113042600400000,NE 168,Residential,100450,123250,0,223700
113045100200000,NE 168,Residential,5057,0,0,5057
113045100300000,NE 168,Residential,58600,61245,0,119845
113045100400000,NE 168,Ag Land,37893,0,0,37893
113112600100000,NE 168,Ag Land,6622,0,0,6622
113112600200000,NE 168,Ag Land,37519,0,0,37519
113120100100000,NE 168,Ag Land,43775,0,26700,70475
113120100102000,NE 168,Residential,0,1000,0,1000
113122600100000,NE 168,Residential,12200,0,0,12200
113122600200000,NE 168,Ag Land,29816,0,0,29816
113125100100000,NE 168,Residential,50150,121490,0,171640
113125100200000,NE 168,Residential,50200,139635,0,189835
113125100300000,NE 168,Residential,50200,163261,0,213461
113125100400000,NE 168,Residential,50250,180024,0,230274
113125200100000,NE 168,Residential,50300,0,0,50300
113125200200000,NE 168,Residential,50350,0,0,50350
113125300100000,NE 168,Residential,50100,148536,0,198636
113125300200000,NE 168,Residential,50100,217442,0,267542
113125300300000,NE 168,Residential,40040,325204,0,365244
113125300400000,NE 168,Residential,50050,0,0,50050
113125300600000,NE 168,Ag Land,19110,0,0,19110
113125300700000,NE 168,Ag Land,2747,0,0,2747
113125400100000,NE 168,Residential,50300,166143,0,216443
113125400200000,NE 168,Residential,50500,140729,0,191229
113130100100000,NE 168,Residential,75000,165362,0,240362
113130100200000,NE 168,Residential,75250,231683,0,306933
113130100300000,NE 168,Residential,75250,187139,0,262389
113130100400000,NE 168,Residential,75250,228134,0,303384
113130100500000,NE 168,Residential,58500,176030,0,234530
113130100600000,NE 168,Residential,61343,185639,0,246982
113130100700000,NE 168,Residential,63270,175432,0,238702
113130100800000,NE 168,Residential,61393,212055,0,273448
113130200100000,NE 168,Residential,59495,197996,0,257491
113130200200000,NE 168,Residential,62141,221549,0,283690
113130200300000,NE 168,Residential,53294,290565,0,343859
113130300100000,NE 168,Residential,75150,113567,0,188717
113130300200000,NE 168,Residential,75150,139850,0,215000
113130300300000,NE 168,Residential,75150,268260,0,343410
113130300400000,NE 168,Residential,75150,250757,0,325907
113130300500000,NE 168,Residential,75150,184703,0,259853
113130300600000,NE 168,Residential,58500,159328,0,217828
113130300700000,NE 168,Residential,60645,212529,0,273174
113130300800000,NE 168,Residential,62130,247151,0,309281
113130300900000,NE 168,Residential,61560,171147,0,232707
113130301300000,NE 168,Residential,75100,122070,0,197170
113130301400000,NE 168,Residential,75100,147682,0,222782
113130301500000,NE 168,Residential,75100,157634,0,232734
113130301600000,NE 168,Residential,75100,191148,0,266248
113130301700000,NE 168,Residential,75100,108900,0,184000
113130400100000,NE 168,Residential,75150,135220,0,210370
113130400200000,NE 168,Residential,75150,219129,0,294279
113130400300000,NE 168,Residential,75150,242609,0,317759
113130400400000,NE 168,Residential,75200,128755,0,203955
113130401200000,NE 168,Residential,59951,167988,0,227939
113130401300000,NE 168,Residential,59411,175963,0,235374
113130401400000,NE 168,Residential,59189,259218,0,318407
113132600200000,NE 168,Residential,5250,0,0,5250
113132600300000,NE 168,Residential,32625,0,0,32625
113132600400000,NE 168,Residential,100,0,0,100
113132700100000,E-15 CITY,Exempt,0,0,0,0
113132700200000,NE 160,Residential,42350,199053,0,241403
113132700300000,NE 160,Residential,40700,219561,0,260261
113132700400000,NE 160,Residential,40700,227051,0,267751
113132700500000,NE 160,Residential,40700,269455,0,310155
113132700600000,NE 160,Residential,41800,256369,0,298169
113132700700000,NE 168,Residential,39484,275176,0,314660
113132700800000,NE 168,Residential,41346,303449,0,344795
113132700900000,NE 168,Residential,45290,188587,0,233877
113132701000000,E-15 CITY,Exempt,0,0,0,0
113132800100000,NE 160,Residential,44773,248565,0,293338
113132800200000,NE 160,Residential,44440,228681,0,273121
113132800300000,NE 160,Residential,44440,222765,0,267205
113132800400000,NE 160,Residential,44440,229056,0,273496
113132800500000,NE 160,Residential,44440,214034,0,258474
113132800600000,NE 160,Residential,44440,162391,0,206831
113132800700000,NE 160,Residential,42457,231435,0,273892
113132800800000,NE 160,Residential,42742,226851,0,269593
113132800900000,NE 160,Residential,44623,232868,0,277491
113132801000000,NE 160,Residential,44143,272991,0,317134
113132801100000,NE 160,Residential,43331,243408,0,286739
113132801200000,NE 160,Residential,44880,210877,0,255757
113132801300000,NE 160,Residential,44880,235964,0,280844
113132801400000,NE 160,Residential,44588,223414,0,268002
113132801500000,NE 168,Residential,214,0,0,214
113132801600000,NE 168,Residential,183,0,0,183
113132801700000,NE 168,Residential,177,0,0,177
113132801800000,NE 168,Residential,55273,223727,0,279000
113132801900000,NE 168,Residential,189,0,0,189
113132802000000,NE 168,Residential,45348,282325,0,327673
113132802100000,NE 168,Residential,57559,206842,0,264401
113132802200000,NE 168,Residential,57970,288666,0,346636
113132802300000,NE 168,Residential,45524,276734,0,322258
113132802400000,NE 168,Residential,159,0,0,159
113132802500000,NE 168,Residential,159,0,0,159
113132802600000,NE 168,Residential,299,0,0,299
113132802700000,NE 168,Residential,329,0,0,329
113132802800000,NE 168,Residential,52217,244731,0,296948
113132802900000,NE 168,Residential,52173,329012,0,381185
113132803000000,NE 168,Residential,63954,262352,0,326306
113132803100000,NE 168,Residential,67583,305245,0,372828
113132803200000,NE 168,Residential,214,0,0,214
113132900100000,NE 160,Residential,45312,209564,0,254876
113132900200000,NE 160,Residential,44440,200560,0,245000
113132900300000,NE 160,Residential,44440,198921,0,243361
113132900400000,NE 160,Residential,44440,256822,0,301262
113132900500000,NE 160,Residential,44440,180895,0,225335
113132900600000,NE 160,Residential,44440,188793,0,233233
113132900700000,NE 160,Residential,51959,373991,0,425950
113132900800000,NE 160,Residential,45751,239836,0,285587
113132900900000,NE 160,Residential,44440,218326,0,262766
113132901000000,NE 160,Residential,44440,250950,0,295390
113132901100000,NE 160,Residential,44440,210211,0,254651
113132901200000,NE 160,Residential,44440,188053,0,232493
113132901300000,NE 160,Residential,44440,185366,0,229806
113132901400000,NE 160,Residential,44389,0,0,44389
113133000100000,NE 168,Residential,57128,277027,0,334155
113133000200000,NE 168,Residential,293,0,0,293
113133000300000,NE 168,Residential,43639,184601,0,228240
113133000400000,NE 168,Residential,159,0,0,159
113133000500000,NE 168,Residential,152,0,0,152
113133100100000,NE 168,Residential,165,0,0,165
113133100200000,NE 168,Residential,159,0,0,159
113133100300000,NE 168,Residential,159,0,0,159
113133100400000,NE 168,Residential,56805,276050,0,332855
113133100500000,NE 168,Residential,183,0,0,183
113133100600000,NE 168,Residential,45348,300359,0,345707
113133200100000,NE 168,Residential,159,0,0,159
113133200200000,NE 168,Residential,165,0,0,165
113133200300000,NE 168,Residential,159,0,0,159
113133200400000,NE 168,Residential,43120,204306,0,247426
113133200500000,NE 168,Residential,43120,267484,0,310604
113133200600000,NE 168,Residential,159,0,0,159
113133200700000,NE 168,Residential,159,0,0,159
113133200800000,NE 168,Residential,214,0,0,214
113133200900000,NE 168,Residential,45815,223409,0,269224
113133201000000,NE 168,Residential,45815,232270,0,278085
113133201100000,NE 168,Residential,159,0,0,159
113133201200000,NE 168,Residential,159,0,0,159
113135100300000,Empty,Exempt,0,0,0,0
113135100500000,NE 160,Residential,38749,154626,0,193375
113135100600000,NE 160,Residential,38161,162722,0,200883
113135100700000,NE 160,Residential,36465,154840,0,191305
113135100800000,NE 160,Residential,35158,152710,0,187868
113135100900000,NE 160,Residential,42811,145249,0,188060
113135101000000,NE 160,Residential,40788,147382,0,188170
113135101100000,NE 160,Residential,39915,178355,0,218270
113135101200000,NE 160,Residential,41626,185638,0,227264
113135101300000,NE 160,Residential,40293,169241,0,209534
113135101400000,NE 160,Residential,42103,179171,0,221274
113135101500000,NE 160,Residential,39882,138212,0,178094
113135101600000,NE 160,Residential,33605,154013,0,187618
113135101700000,NE 160,Residential,36575,171343,0,207918
113135101800000,NE 160,Residential,35393,146675,0,182068
113135101900000,NE 160,Residential,35530,139432,0,174962
113135102000000,NE 160,Residential,40279,148066,0,188345
113135102100000,NE 160,Residential,42735,175216,0,217951
113135102200000,NE 160,Residential,43245,147172,0,190417
113135102300000,NE 160,Residential,38158,165576,0,203734
113135102400000,NE 160,Residential,40347,168446,0,208793
113135102500000,NE 160,Residential,39719,202222,0,241941
113135102600000,NE 160,Residential,36652,161734,0,198386
113135102700000,NE 160,Residential,40366,174741,0,215107
113135102800000,NE 160,Residential,35737,154855,0,190592
113135102900000,NE 160,Residential,34934,161707,0,196641
113135103000000,NE 160,Residential,39270,144944,0,184214
113135103100000,NE 160,Residential,35525,155548,0,191073
113135103200000,NE 160,Residential,42910,0,0,42910
113135103300000,NE 160,Residential,44000,210545,0,254545
113135103400000,NE 160,Residential,44000,223766,0,267766
113135103500000,NE 160,Residential,44000,224470,0,268470
113135103600000,NE 160,Residential,44000,247459,0,291459
113135103700000,NE 160,Residential,44000,213458,0,257458
113135103800000,NE 160,Residential,43286,211958,0,255244
113135200100000,NE 160,Residential,44000,358685,0,402685
113135200200000,NE 160,Residential,44000,179409,0,223409
113135200300000,NE 160,Residential,44000,284032,0,328032
113135200400000,NE 160,Residential,44000,243410,0,287410
113135200500000,NE 160,Residential,44000,287590,0,331590
113135200600000,NE 160,Residential,44000,280608,0,324608
113135200700000,NE 160,Residential,44000,289611,0,333611
113135200800000,NE 160,Residential,44000,250578,0,294578
113135200900000,NE 160,Residential,44000,185376,0,229376
113135201000000,NE 160,Residential,44000,208281,0,252281
113135201100000,NE 160,Residential,38500,0,0,38500
113135201200000,NE 160,Residential,20,0,0,20
113135201300000,NE 160,Residential,44000,265544,0,309544
113135201400000,NE 160,Residential,37327,0,0,37327
113135201500000,NE 160,Residential,520,0,0,520
113135201600000,NE 160,Residential,580,0,0,580
113135201700000,NE 160,Residential,44000,200879,0,244879
113135300100000,NE 160,Residential,40970,192978,0,233948
113135300200000,NE 160,Residential,38978,0,0,38978
113142600100000,NE 168,Residential,75750,163039,0,238789
113142600200000,NE 168,Residential,75000,129242,0,204242
113142600300000,NE 168,Residential,75050,116950,0,192000
113142600400000,NE 168,Residential,75050,123660,0,198710
113142600500000,NE 168,Residential,75000,136721,0,211721
113142700100000,NE 168,Residential,75450,145919,0,221369
113142700200000,NE 168,Residential,75350,185352,0,260702
113142700300000,NE 168,Residential,75550,176279,0,251829
113142700400000,NE 168,Residential,76100,160729,0,236829
113142700500000,NE 168,Residential,75000,159275,0,234275
113142700600000,NE 168,Residential,75000,115000,0,190000
113142700700000,NE 168,Residential,75000,150000,0,225000
113142700800000,NE 168,Residential,102850,233503,0,336353
113142700900000,NE 168,Residential,83600,224585,0,308185
113142800100000,NE 168,Residential,75250,138932,0,214182
113142800200000,NE 168,Residential,75150,175150,0,250300
113142800300000,NE 168,Residential,75150,147459,0,222609
113142800400000,NE 168,Residential,75300,120945,0,196245
113143000100000,NE 168,Residential,75250,163500,0,238750
113143000200000,NE 168,Residential,75000,185000,0,260000
113143000300000,NE 168,Residential,75150,204921,0,280071
113143000400000,NE 168,Residential,75150,194448,0,269598
113143000500000,NE 168,Residential,75150,129390,0,204540
113310100100000,NE 103,Residential,19703,145832,0,165535
113310100200000,NE 103,Residential,21510,133628,0,155138
113310100300000,NE 103,Residential,16914,147169,0,164083
113310100400000,NE 103,Residential,18810,134352,0,153162
113310100500000,NE 103,Residential,16284,123146,0,139430
113310100600000,NE 103,Residential,19863,130675,0,150538
113310100700000,NE 103,Residential,16830,139252,0,156082
113310100800000,NE 103,Residential,19192,139328,0,158520
113310100900000,NE 103,Residential,18394,115583,0,133977
113310101000000,NE 103,Residential,21375,146386,0,167761
113310101100000,NE 103,Residential,16497,104554,0,121051
113310101200000,NE 103,Residential,15641,145242,0,160883
113310101300000,NE 103,Residential,15641,138520,0,154161
113310101400000,NE 103,Residential,18845,135158,0,154003
113310101500000,NE 103,Residential,19680,122218,0,141898
113310101600000,NE 103,Residential,19338,122928,0,142266
113310101700000,NE 103,Residential,18810,129117,0,147927
113310101800000,NE 103,Residential,18790,137478,0,156268
113310101900000,NE 103,Residential,20808,122028,0,142836
113310102000000,NE 103,Residential,20460,150266,0,170726
113310102100000,NE 103,Residential,20218,119822,0,140040
113310102200000,NE 103,Residential,16369,150158,0,166527
113310102300000,NE 103,Residential,20479,128559,0,149038
113310102400000,NE 103,Residential,19541,130572,0,150113
113310102500000,NE 103,Residential,20924,128886,0,149810
113310102600000,NE 103,Residential,18473,122240,0,140713
113310102700000,NE 103,Residential,17820,118180,0,136000
113310102800000,NE 103,Residential,19868,134923,0,154791
113310102900000,NE 103,Residential,20971,144401,0,165372
113310103000000,NE 103,Residential,18563,149652,0,168215
113310103100000,NE 103,Residential,18563,131373,0,149936
113310103200000,NE 103,Residential,19800,126857,0,146657
113310103300000,NE 103,Residential,19513,146859,0,166372
113310200100000,NE 103,Residential,20861,143678,0,164539
113310200200000,NE 103,Residential,18810,121201,0,140011
113310200300000,NE 103,Residential,18810,126543,0,145353
113310200400000,NE 103,Residential,17417,138423,0,155840
113310200500000,NE 103,Residential,20116,154557,0,174673
113310200600000,NE 103,Residential,19192,145625,0,164817
113310200700000,NE 103,Residential,19885,135805,0,155690
113310200800000,NE 103,Residential,14550,104578,0,119128
113310200900000,NE 103,Residential,18915,124894,0,143809
113310201000000,NE 103,Residential,18430,151570,0,170000
113310201100000,NE 103,Residential,17770,149355,0,167125
113310201200000,NE 103,Residential,14308,105449,0,119757
113310201300000,NE 103,Residential,14773,112384,0,127157
113310201400000,NE 103,Residential,14850,134309,0,149159
113310201500000,NE 103,Residential,18810,136438,0,155248
113310201600000,NE 103,Residential,17325,134108,0,151433
113310201700000,NE 103,Residential,19757,123623,0,143380
113310300100000,NE 103,Residential,20206,144213,0,164419
113310300200000,NE 103,Residential,17500,124329,0,141829
113310300300000,NE 103,Residential,16250,148063,0,164313
113310300400000,NE 103,Residential,17636,129293,0,146929
113310300500000,NE 103,Residential,14850,137129,0,151979
113310300600000,NE 103,Residential,18315,125254,0,143569
113310300700000,NE 103,Residential,17737,134308,0,152045
113310300800000,NE 103,Residential,20327,140818,0,161145
113310300900000,NE 103,Residential,18902,146298,0,165200
113310301000000,NE 103,Residential,16125,129406,0,145531
113310301100000,NE 103,Residential,20715,150285,0,171000
113310301200000,NE 103,Residential,21064,132865,0,153929
113310301300000,NE 103,Residential,20149,132721,0,152870
113310301400000,NE 103,Residential,20026,133882,0,153908
113310301500000,NE 103,Residential,20167,127511,0,147678
113310301600000,NE 103,Residential,20071,140940,0,161011
113310301700000,NE 103,Residential,20100,122149,0,142249
113310301800000,NE 103,Residential,20667,123867,0,144534
113310301900000,NE 103,Residential,18150,113306,0,131456
113310302000000,NE 103,Residential,16830,139718,0,156548
113310302100000,NE 103,Residential,16063,140428,0,156491
113310302200000,NE 103,Residential,16063,131247,0,147310
113310302300000,NE 103,Residential,17445,106935,0,124380
113310302400000,NE 103,Residential,18398,110952,0,129350
113310302500000,NE 103,Residential,17677,132540,0,150217
113310302600000,NE 103,Residential,21505,128302,0,149807
113310400100000,NE 103,Residential,21780,121556,0,143336
113310400200000,NE 103,Residential,19075,135167,0,154242
113310400300000,NE 103,Residential,26626,126011,0,152637
113310400400000,NE 103,Residential,22064,136798,0,158862
113310400500000,NE 103,Residential,20701,135084,0,155785
113310400600000,NE 103,Residential,20531,135981,0,156512
113310400700000,NE 103,Residential,24302,147564,0,171866
113310400800000,NE 103,Residential,21742,134945,0,156687
113310500100000,NE 103,Residential,19520,144442,0,163962
113310500200000,NE 103,Residential,16413,118654,0,135067
113310500300000,NE 103,Residential,18061,116813,0,134874
113310500400000,NE 103,Residential,19635,124462,0,144097
113310500500000,NE 103,Residential,19617,129489,0,149106
113310500600000,NE 103,Residential,15449,135293,0,150742
113310500700000,NE 103,Residential,14550,127399,0,141949
113310500800000,NE 103,Residential,14550,132223,0,146773
113310500900000,NE 103,Residential,16170,132535,0,148705
113310501000000,NE 103,Residential,19963,135752,0,155715
113310501100000,NE 103,Residential,17298,133808,0,151106
113310501200000,NE 103,Residential,15158,110392,0,125550
113310501300000,NE 103,Residential,14100,116204,0,130304
113310501400000,NE 103,Residential,18080,117874,0,135954
113310501500000,NE 103,Residential,17636,122328,0,139964
113310501600000,NE 103,Residential,17595,132771,0,150366
113310501700000,NE 103,Residential,17338,126533,0,143871
113310501800000,NE 103,Residential,16289,122963,0,139252
113310501900000,NE 103,Residential,17500,101110,0,118610
113310502000000,NE 103,Residential,15500,104951,0,120451
113310502100000,NE 103,Residential,15725,137871,0,153596
113310502200000,NE 103,Residential,15000,137922,0,152922
113310502300000,NE 103,Residential,15620,132750,0,148370
113310502400000,NE 103,Residential,21350,124172,0,145522
113310502500000,E-40 CHURCHES,Exempt,387450,0,1105518,1492968
113310502600000,NE 103,Residential,25200,169800,0,195000
113310502700000,NE 103,Residential,25052,155109,0,180161
113310502800000,NE 103,Residential,26125,138857,0,164982
113310502900000,NE 103,Residential,25200,161683,0,186883
113310503000000,NE 103,Residential,24860,156385,0,181245
113310503100000,NE 103,Residential,24900,127493,0,152393
113310600100000,NE 103,Residential,21261,134594,0,155855
113310600200000,NE 103,Residential,20459,117903,0,138362
113310600300000,NE 103,Residential,16320,116459,0,132779
113310600400000,NE 103,Residential,20014,115011,0,135025
113310600500000,NE 103,Residential,21026,137557,0,158583
113310600600000,NE 103,Residential,16830,137559,0,154389
113312600100000,E-43 RELIG RECREAT'N,Exempt,712422,0,0,712422
113312600200000,E-70 CHARITY OTHER,Exempt,128520,0,279151,407671
113312600300000,NE 108,Residential,40113,124887,0,165000
113315100100000,NE 108,Residential,33089,129716,0,162805
113315100200000,NE 108,Residential,31928,97940,0,129868
113315100300000,NE 108,Residential,33075,97860,0,130935
113315100400000,NE 108,Residential,33075,99084,0,132159
113315100500000,NE 108,Residential,33075,114418,0,147493
113315100600000,NE 108,Residential,31605,90366,0,121971
113315100700000,NE 108,Residential,33600,116904,0,150504
113315100800000,NE 108,Residential,33972,100679,0,134651
113315100900000,NE 108,Residential,30565,77302,0,107867
113315101000000,NE 108,Residential,31605,104135,0,135740
113315101100000,NE 108,Residential,31605,98614,0,130219
113315101200000,NE 108,Residential,31605,103713,0,135318
113315101300000,NE 108,Residential,33075,104432,0,137507
113315101400000,NE 108,Residential,33075,108629,0,141704
113315101500000,NE 108,Residential,30158,97953,0,128111
113315101600000,NE 108,Residential,32585,83698,0,116283
113315101700000,NE 108,Residential,29645,103902,0,133547
113315101800000,NE 108,Residential,29645,90697,0,120342
113315101900000,NE 108,Residential,29645,115121,0,144766
113315102000000,NE 108,Residential,30583,92697,0,123280
113315102100000,NE 108,Residential,34450,112161,0,146611
113315102200000,NE 108,Residential,32928,89172,0,122100
113315102300000,NE 108,Residential,30642,78018,0,108660
113315102400000,NE 108,Residential,30642,89728,0,120370
113315102500000,NE 108,Residential,28267,137223,0,165490
113315102600000,NE 108,Residential,28267,97525,0,125792
113315102700000,NE 108,Residential,28734,102409,0,131143
113315102800000,NE 108,Residential,33163,78606,0,111769
113315102900000,NE 108,Residential,32170,89528,0,121698
113315103000000,NE 108,Residential,33405,91262,0,124667
113315103100000,NE 108,Residential,31600,78184,0,109784
113315103200000,NE 108,Residential,34300,104018,0,138318
113315103300000,NE 108,Residential,34320,129085,0,163405
113315103400000,NE 108,Residential,31920,81340,0,113260
113315103500000,NE 108,Residential,31968,92705,0,124673
113315103600000,NE 108,Residential,32592,99854,0,132446
113315103700000,NE 108,Residential,31932,90502,0,122434
113315103800000,NE 108,Residential,33653,91760,0,125413
113315103900000,E-15 CITY,Exempt,0,0,0,0
113315104000000,E-15 CITY,Exempt,0,0,0,0
113315200100000,NE 108,Residential,33075,108313,0,141388
113315200200000,NE 108,Residential,30380,91125,0,121505
113315200300000,NE 108,Residential,33075,89197,0,122272
113315200400000,NE 108,Residential,32400,103801,0,136201
113315200500000,NE 108,Residential,30960,93363,0,124323
113315200600000,NE 108,Residential,30960,100840,0,131800
113315200700000,NE 108,Residential,30816,95650,0,126466
113315200800000,NE 108,Residential,32998,105643,0,138641
113315200900000,NE 108,Residential,30960,80903,0,111863
113315201000000,NE 108,Residential,29040,84497,0,113537
113315201100000,NE 108,Residential,29040,90693,0,119733
113315201200000,NE 108,Residential,29040,77285,0,106325
113315201300000,NE 108,Residential,31200,83036,0,114236
113315201400000,NE 108,Residential,30550,83339,0,113889
113315201500000,NE 108,Residential,29040,77938,0,106978
113315201600000,NE 108,Residential,29040,73021,0,102061
113315201700000,NE 108,Residential,29040,76981,0,106021
113315201800000,NE 108,Residential,30960,83762,0,114722
113315201900000,NE 108,Residential,32520,95044,0,127564
113315202000000,NE 108,Residential,30816,93155,0,123971
113315202100000,NE 108,Residential,30960,94873,0,125833
113315202200000,NE 108,Residential,30960,75788,0,106748
113315202300000,NE 108,Residential,32400,82686,0,115086
113315300100000,NE 108,Residential,33075,118260,0,151335
113315300200000,NE 108,Residential,30380,91952,0,122332
113315300300000,NE 108,Residential,32400,91352,0,123752
113315300400000,NE 108,Residential,27802,91730,0,119532
113315300500000,NE 108,Residential,27840,90734,0,118574
113315300600000,NE 108,Residential,27840,98930,0,126770
113315300700000,NE 108,Residential,27840,88474,0,116314
113315300800000,NE 108,Residential,27840,91917,0,119757
113315300900000,NE 108,Residential,27227,91163,0,118390
113315301000000,NE 108,Residential,32400,92810,0,125210
113315301100000,NE 108,Residential,27360,90362,0,117722
113315301200000,NE 108,Residential,27360,83476,0,110836
113315301300000,NE 108,Residential,27360,80593,0,107953
113315301400000,NE 108,Residential,30550,113106,0,143656
113315301500000,NE 108,Residential,31200,81251,0,112451
113315301600000,NE 108,Residential,27360,86051,0,113411
113315301700000,NE 108,Residential,27360,97055,0,124415
113315301800000,NE 108,Residential,27360,81835,0,109195
113315301900000,NE 108,Residential,32400,96258,0,128658
113315302000000,NE 108,Residential,32520,104889,0,137409
113315302100000,NE 108,Residential,30960,88863,0,119823
113315302200000,NE 108,Residential,30960,93738,0,124698
113315302300000,NE 108,Residential,30960,105735,0,136695
113315302400000,NE 108,Residential,33160,113126,0,146286
113315400100000,NE 108,Residential,31094,108526,0,139620
113315400200000,NE 108,Residential,31416,91147,0,122563
113315500100000,NE 108,Residential,32148,86795,0,118943
113315500200000,NE 108,Residential,32148,81941,0,114089
113315600100000,NE 108,Residential,32148,90891,0,123039
113315600200000,NE 108,Residential,32148,86133,0,118281
113317600100000,E-40 CHURCHES,Exempt,456192,0,289743,745935
113317600200000,NE 103,Residential,13128,71432,0,84560
113317600300000,NE 103,Residential,11992,71714,0,83706
113317600400000,NE 103,Residential,12632,68705,0,81337
113317600500000,NE 103,Residential,13281,69352,0,82633
113317600600000,NE 103,Residential,25359,141755,0,167114
113317700100000,NE 103,Residential,26089,173443,0,199532
113317700200000,NE 103,Residential,14910,68731,0,83641
113317700300000,NE 103,Residential,18683,71762,0,90445
113317800100000,NE 108,Residential,32325,131780,0,164105
113317800200000,NE 108,Residential,31450,83762,0,115212
113317800300000,NE 108,Residential,29760,88833,0,118593
113317800400000,NE 108,Residential,28800,90416,0,119216
113317800500000,NE 108,Residential,27840,79472,0,107312
113317800600000,NE 108,Residential,29760,88998,0,118758
113317800700000,NE 108,Residential,27840,79067,0,106907
113317800800000,NE 108,Residential,29760,93488,0,123248
113317800900000,NE 108,Residential,28800,85046,0,113846
113317801000000,NE 108,Residential,29760,87740,0,117500
113317801100000,NE 108,Residential,31484,81031,0,112515
113317801200000,NE 108,Residential,33787,96807,0,130594
113317801300000,NE 108,Residential,31384,94000,0,125384
113317801400000,NE 108,Residential,31920,86575,0,118495
113317801500000,NE 108,Residential,31920,84059,0,115979
113317801600000,NE 108,Residential,31508,85796,0,117304
113317801700000,NE 108,Residential,33919,86902,0,120821
113317801800000,NE 108,Residential,30068,97642,0,127710
113317801900000,NE 108,Residential,29760,84301,0,114061
113317802000000,NE 108,Residential,28800,92087,0,120887
113317802100000,NE 108,Residential,29760,88097,0,117857
113317802200000,NE 108,Residential,29760,93713,0,123473
113317802300000,NE 108,Residential,27840,86954,0,114794
113317802400000,NE 108,Residential,27840,77093,0,104933
113317802500000,NE 108,Residential,28800,84110,0,112910
113317802600000,NE 108,Residential,29760,95950,0,125710
113317802700000,NE 108,Residential,30770,83729,0,114499
113317802800000,NE 108,Residential,31237,85119,0,116356
113317802900000,NE 108,Residential,29760,77851,0,107611
113317803000000,NE 108,Residential,28800,76618,0,105418
113317803100000,NE 108,Residential,27840,76115,0,103955
113317803200000,NE 108,Residential,27840,86702,0,114542
113317803300000,NE 108,Residential,29760,79992,0,109752
113317803400000,NE 108,Residential,29760,123170,0,152930
113317803500000,NE 108,Residential,28800,96242,0,125042
113317803600000,NE 108,Residential,29760,85290,0,115050
113317803700000,NE 108,Residential,31429,76082,0,107511
113317803800000,NE 108,Residential,32944,83172,0,116116
113317803900000,NE 108,Residential,31384,95260,0,126644
113317804000000,NE 108,Residential,31920,86435,0,118355
113317804100000,NE 108,Residential,31920,90226,0,122146
113317804200000,NE 108,Residential,32014,98721,0,130735
113317804300000,NE 108,Residential,36619,100033,0,136652
113317804400000,NE 108,Residential,30736,98576,0,129312
113317804500000,NE 108,Residential,28800,76829,0,105629
113317804600000,NE 108,Residential,28800,82674,0,111474
113317804700000,NE 108,Residential,32400,89241,0,121641
113317804800000,NE 108,Residential,32278,98512,0,130790
113317804900000,NE 108,Residential,28800,95057,0,123857
113317805000000,NE 108,Residential,28500,85622,0,114122
113317805100000,NE 108,Residential,28902,89660,0,118562
113317805200000,NE 108,Residential,31980,95700,0,127680
113317805300000,NE 108,Residential,31734,100924,0,132658
113317805400000,NE 108,Residential,33075,98901,0,131976
113317805500000,NE 108,Residential,32000,84697,0,116697
113317805600000,NE 108,Residential,31264,93959,0,125223
113317805700000,NE 108,Residential,33919,99079,0,132998
113317805800000,NE 108,Residential,32818,94123,0,126941
113317805900000,NE 108,Residential,31968,79454,0,111422
113317806000000,NE 108,Residential,31920,77694,0,109614
113317806100000,NE 108,Residential,32765,94447,0,127212
113317806200000,NE 108,Residential,33075,82269,0,115344
113317806300000,NE 108,Residential,32328,82099,0,114427
113317806400000,NE 108,Residential,33252,86579,0,119831
113317806500000,NE 108,Residential,35140,99520,0,134660
113317806600000,NE 108,Residential,32818,82118,0,114936
113317806700000,NE 108,Residential,31968,87055,0,119023
113317806800000,NE 108,Residential,31920,91783,0,123703
113317806900000,NE 108,Residential,31734,93150,0,124884
113317807000000,NE 108,Residential,33075,87704,0,120779
113317807100000,NE 108,Residential,32442,84901,0,117343
113317807200000,NE 108,Residential,33858,87235,0,121093
113317807300000,NE 108,Residential,33858,95036,0,128894
113317807400000,NE 108,Residential,32935,99606,0,132541
113317807500000,NE 108,Residential,30636,113921,0,144557
113317807600000,NE 108,Residential,27720,101383,0,129103
113317807700000,NE 108,Residential,30294,79950,0,110244
113317807800000,NE 108,Residential,30332,92342,0,122674
113317807900000,NE 108,Residential,29700,95547,0,125247
113317808000000,NE 108,Residential,30332,96099,0,126431
113317808100000,NE 108,Residential,31272,108736,0,140008
113317808200000,NE 108,Residential,31135,96644,0,127779
113317808300000,NE 108,Residential,30739,108206,0,138945
113317808400000,NE 108,Residential,31680,113320,0,145000
113317900100000,NE 108,Residential,31808,82174,0,113982
113317900200000,NE 108,Residential,31394,101336,0,132730
113317900300000,NE 108,Residential,28800,80893,0,109693
113317900400000,NE 108,Residential,26400,79778,0,106178
113317900500000,NE 108,Residential,26400,81322,0,107722
113317900600000,NE 108,Residential,27840,82014,0,109854
113317900700000,NE 108,Residential,28800,80356,0,109156
113317900800000,NE 108,Residential,28800,83325,0,112125
113317900900000,NE 108,Residential,26400,89474,0,115874
113317901000000,NE 108,Residential,28800,89918,0,118718
113317901100000,NE 108,Residential,30550,83338,0,113888
113317901200000,NE 108,Residential,30550,81380,0,111930
113317901300000,NE 108,Residential,28800,103050,0,131850
113317901400000,NE 108,Residential,26400,68409,0,94809
113317901500000,NE 108,Residential,28800,77742,0,106542
113317901600000,NE 108,Residential,28800,89444,0,118244
113317901700000,NE 108,Residential,27840,87523,0,115363
113317901800000,NE 108,Residential,26400,83198,0,109598
113317901900000,NE 108,Residential,26400,88146,0,114546
113317902000000,NE 108,Residential,28800,91710,0,120510
113318000100000,NE 108,Residential,30838,100831,0,131669
113318000200000,NE 108,Residential,31022,84011,0,115033
113318000300000,NE 108,Residential,30960,83221,0,114181
113318000400000,NE 108,Residential,28800,85829,0,114629
113318000500000,NE 108,Residential,30960,85642,0,116602
113318000600000,NE 108,Residential,31920,95366,0,127286
113318000700000,NE 108,Residential,30960,73234,0,104194
113318000800000,NE 108,Residential,28800,88468,0,117268
113318000900000,NE 108,Residential,28800,80646,0,109446
113318001000000,NE 108,Residential,28800,80482,0,109282
113318001100000,NE 108,Residential,30550,94087,0,124637
113318001200000,NE 108,Residential,30550,86841,0,117391
113318001300000,NE 108,Residential,28800,94724,0,123524
113318001400000,NE 108,Residential,28800,90657,0,119457
113318001500000,NE 108,Residential,28800,86432,0,115232
113318001600000,NE 108,Residential,30960,88316,0,119276
113318001700000,NE 108,Residential,31920,99498,0,131418
113318001800000,NE 108,Residential,30960,85869,0,116829
113318001900000,NE 108,Residential,28800,93912,0,122712
113318002000000,NE 108,Residential,30960,84855,0,115815
113318002100000,NE 108,Residential,31437,90665,0,122102
113318100100000,NE 108,Residential,33792,101910,0,135702
113318100200000,NE 108,Residential,32626,92898,0,125524
113318100300000,NE 108,Residential,34125,96242,0,130367
113318100400000,NE 108,Residential,30960,89034,0,119994
113318100500000,NE 108,Residential,30960,92718,0,123678
113318100600000,NE 108,Residential,31829,89008,0,120837
113318100700000,NE 108,Residential,32630,92537,0,125167
113318100800000,NE 108,Residential,30720,89107,0,119827
113318100900000,NE 108,Residential,28800,90453,0,119253
113318101000000,NE 108,Residential,28800,93427,0,122227
113318101100000,NE 108,Residential,31890,94082,0,125972
113318101200000,NE 108,Residential,32400,91387,0,123787
113318101300000,NE 108,Residential,30960,83904,0,114864
113318101400000,NE 108,Residential,29760,89680,0,119440
113318101500000,NE 108,Residential,30960,80503,0,111463
113318101600000,NE 108,Residential,30784,83792,0,114576
113318101700000,NE 108,Residential,31177,115905,0,147082
113318101800000,NE 108,Residential,28000,89687,0,117687
113318200100000,NE 108,Residential,32148,75019,0,107167
113318200200000,NE 108,Residential,32148,84200,0,116348
113318300100000,NE 108,Residential,32148,94754,0,126902
113318300200000,NE 108,Residential,32148,95166,0,127314
113340100100000,NE 108,Residential,31928,80190,0,112118
113340100200000,NE 108,Residential,30960,86058,0,117018
113340100300000,NE 108,Residential,32832,83911,0,116743
113340100400000,NE 108,Residential,30960,82861,0,113821
113340100500000,NE 108,Residential,31920,89534,0,121454
113340100600000,NE 108,Residential,32832,98349,0,131181
113340100700000,NE 108,Residential,32400,103117,0,135517
113340100800000,NE 108,Residential,33075,97843,0,130918
113340100900000,NE 108,Residential,33516,85119,0,118635
113340101000000,NE 108,Residential,32585,102004,0,134589
113340101100000,NE 108,Residential,31605,81872,0,113477
113340101200000,NE 108,Residential,33516,81028,0,114544
113340200100000,NE 108,Residential,31920,91216,0,123136
113340200200000,NE 108,Residential,31920,86196,0,118116
113340200300000,NE 108,Residential,30960,81503,0,112463
113340200400000,NE 108,Residential,30720,90754,0,121474
113340200500000,NE 108,Residential,30960,77331,0,108291
113340200600000,NE 108,Residential,31920,96830,0,128750
113340200700000,NE 108,Residential,32400,90463,0,122863
113340200800000,NE 108,Residential,32400,87730,0,120130
113340200900000,NE 108,Residential,31920,91152,0,123072
113340201000000,NE 108,Residential,30960,82717,0,113677
113340201100000,NE 108,Residential,30720,83607,0,114327
113340201200000,NE 108,Residential,30960,81080,0,112040
113340300100000,NE 108,Residential,31920,95820,0,127740
113340300200000,NE 108,Residential,31920,84595,0,116515
113340300300000,NE 108,Residential,30960,84067,0,115027
113340300400000,NE 108,Residential,30720,82287,0,113007
113340300500000,NE 108,Residential,30960,88473,0,119433
113340300600000,NE 108,Residential,31920,94685,0,126605
113340300700000,NE 108,Residential,32400,84953,0,117353
113340300800000,NE 108,Residential,32400,87276,0,119676
113340300900000,NE 108,Residential,31920,64027,0,95947
113340301000000,NE 108,Residential,30960,88322,0,119282
113340301100000,NE 108,Residential,30720,82396,0,113116
113340301200000,NE 108,Residential,30960,81976,0,112936
113340400100000,NE 108,Residential,31920,89219,0,121139
113340400200000,NE 108,Residential,31920,92747,0,124667
113340400300000,NE 108,Residential,30960,96584,0,127544
113340400400000,NE 108,Residential,30720,96408,0,127128
113340400500000,NE 108,Residential,30960,83927,0,114887
113340400600000,NE 108,Residential,31920,67292,0,99212
113340400700000,NE 108,Residential,32400,92490,0,124890
113340400800000,NE 108,Residential,32400,82623,0,115023
113340400900000,NE 108,Residential,31920,89228,0,121148
113340401000000,NE 108,Residential,30960,84451,0,115411
113340401100000,NE 108,Residential,30720,85267,0,115987
113340401200000,NE 108,Residential,30960,82155,0,113115
113340500100000,NE 108,Residential,31920,88591,0,120511
113340500200000,NE 108,Residential,28424,89746,0,118170
113340500300000,NE 108,Residential,28800,75946,0,104746
113340500400000,NE 108,Residential,30960,82544,0,113504
113340500500000,NE 108,Residential,30720,85312,0,116032
113340500600000,NE 108,Residential,30960,88445,0,119405
113340500700000,NE 108,Residential,31920,98131,0,130051
113340500800000,NE 108,Residential,32400,87533,0,119933
113340500900000,NE 108,Residential,32400,89752,0,122152
113340501000000,NE 108,Residential,31920,92602,0,124522
113340501100000,NE 108,Residential,30960,90654,0,121614
113340501200000,NE 108,Residential,30720,91194,0,121914
113340501300000,NE 108,Residential,30960,67479,0,98439
113340600100000,NE 108,Residential,33660,109332,0,142992
113340600200000,NE 108,Residential,34793,96523,0,131316
113340600300000,NE 108,Residential,34226,102264,0,136490
113340600400000,NE 108,Residential,32700,94609,0,127309
113340600500000,NE 108,Residential,32700,90551,0,123251
113340600600000,NE 108,Residential,32700,93731,0,126431
113340600700000,NE 108,Residential,32700,105966,0,138666
113340600800000,NE 108,Residential,32700,93306,0,126006
113340600900000,NE 108,Residential,32700,95428,0,128128
113340601000000,NE 108,Residential,32700,104047,0,136747
113340601100000,NE 108,Residential,32700,95368,0,128068
113340601200000,NE 108,Residential,32700,94603,0,127303
113340601300000,NE 108,Residential,32700,97980,0,130680
113340601400000,NE 108,Residential,32700,97178,0,129878
113340601500000,NE 108,Residential,32700,99360,0,132060
113340601600000,NE 108,Residential,32700,100272,0,132972
113340601700000,NE 108,Residential,32700,91509,0,124209
113340601800000,NE 108,Residential,36242,98122,0,134364
113340601900000,NE 108,Residential,37650,103024,0,140674
113340602000000,NE 108,Residential,32700,82989,0,115689
113340602101000,CONDO 501,Residential,18500,126270,0,144770
113340602101001,CONDO 501,Residential,18500,115092,0,133592
113340602101002,CONDO 501,Residential,18500,119969,0,138469
113340602101003,CONDO 501,Residential,18500,126220,0,144720
113340602101004,CONDO 501,Residential,18500,171685,0,190185
113340602101005,CONDO 501,Residential,18500,201600,0,220100
113340602101006,CONDO 501,Residential,18500,126336,0,144836
113340602101007,CONDO 501,Residential,18500,119485,0,137985
113340602101008,CONDO 501,Residential,18500,145815,0,164315
113340602101009,CONDO 501,Residential,18500,219210,0,237710
113340602101010,CONDO 501,Residential,18500,193456,0,211956
113340602101011,CONDO 501,Residential,18500,218536,0,237036
113340602101012,CONDO 501,Residential,18500,203161,0,221661
113340602101013,CONDO 501,Residential,18500,151644,0,170144
113340602101014,CONDO 501,Residential,18500,139939,0,158439
113340602101015,CONDO 501,Residential,18500,143944,0,162444
113340602101016,CONDO 501,Residential,18500,147995,0,166495
113340602101017,CONDO 501,Residential,18500,156347,0,174847
113340602101018,CONDO 501,Residential,18500,118757,0,137257
113340602101019,CONDO 501,Residential,18500,118131,0,136631
113340602101020,CONDO 501,Residential,18500,122738,0,141238
113340602101021,CONDO 501,Residential,18500,130556,0,149056
113340602101022,CONDO 501,Residential,18500,137099,0,155599
113340602101023,CONDO 501,Residential,18500,143131,0,161631
113340602101024,CONDO 501,Residential,18500,141124,0,159624
113340602101025,CONDO 501,Residential,18500,160241,0,178741
113340602101026,CONDO 501,Residential,18500,221161,0,239661
113340602101027,CONDO 501,Residential,18500,180373,0,198873
113340602101028,CONDO 501,Residential,18500,219235,0,237735
113340602101029,CONDO 501,Residential,18500,136490,0,154990
113340602101030,CONDO 501,Residential,18500,150262,0,168762
113340602101031,CONDO 501,Residential,18500,207467,0,225967
113340602101032,CONDO 501,Residential,18500,152773,0,171273
113340602101033,CONDO 501,Residential,18500,159661,0,178161
113340602101034,CONDO 501,Residential,18500,141816,0,160316
113340602101035,CONDO 501,Residential,18500,163903,0,182403
113340602101036,CONDO 501,Residential,18500,209304,0,227804
113340602101037,CONDO 501,Residential,18500,198149,0,216649
113340602101038,CONDO 501,Residential,18500,214484,0,232984
113340602101039,CONDO 501,Residential,18500,175718,0,194218
113340602101040,CONDO 501,Residential,18500,217635,0,236135
113340602101041,CONDO 501,Residential,18500,204417,0,222917
113340602101042,CONDO 501,Residential,18500,145864,0,164364
113340602101043,CONDO 501,Residential,18500,147974,0,166474
113340602101044,CONDO 501,Residential,18500,127733,0,146233
113340602101045,CONDO 501,Residential,18500,134974,0,153474
113340602101046,CONDO 501,Residential,18500,184578,0,203078
113340602101049,CONDO 501,Residential,18500,190549,0,209049
113340602200000,NE 108,Residential,33660,77279,0,110939
113342600100000,NE 108,Residential,31920,88184,0,120104
113342600200000,NE 108,Residential,30960,74927,0,105887
113342600300000,NE 108,Residential,31920,86095,0,118015
113342600400000,NE 108,Residential,30720,77933,0,108653
113342600500000,NE 108,Residential,30960,82224,0,113184
113342600600000,NE 108,Residential,31920,89564,0,121484
113342600700000,NE 108,Residential,32400,88254,0,120654
113342600800000,NE 108,Residential,32400,78802,0,111202
113342600900000,NE 108,Residential,31920,84977,0,116897
113342601000000,NE 108,Residential,30960,74470,0,105430
113342601100000,NE 108,Residential,30720,80542,0,111262
113342601200000,NE 108,Residential,30960,89932,0,120892
113342700100000,NE 108,Residential,28565,88000,0,116565
113342700200000,NE 108,Residential,30960,87608,0,118568
113342700300000,NE 108,Residential,31920,96387,0,128307
113342700400000,NE 108,Residential,30720,113399,0,144119
113342700500000,NE 108,Residential,30960,93864,0,124824
113342700600000,NE 108,Residential,31920,96492,0,128412
113342700700000,NE 108,Residential,32400,82776,0,115176
113342700800000,NE 108,Residential,32400,74244,0,106644
113342700900000,NE 108,Residential,31920,84566,0,116486
113342701000000,NE 108,Residential,30960,89494,0,120454
113342701100000,NE 108,Residential,30720,73220,0,103940
113342701200000,NE 108,Residential,30960,76673,0,107633
113342701300000,NE 108,Residential,28800,86900,0,115700
113342800100000,NE 108,Residential,30960,83405,0,114365
113342800200000,NE 108,Residential,30960,77163,0,108123
113342800300000,NE 108,Residential,31920,76133,0,108053
113342800400000,NE 108,Residential,30720,87724,0,118444
113342800500000,NE 108,Residential,30960,79156,0,110116
113342800600000,NE 108,Residential,31920,84056,0,115976
113342800700000,NE 108,Residential,32400,90035,0,122435
113342800800000,NE 108,Residential,32400,87904,0,120304
113342800900000,NE 108,Residential,31920,90826,0,122746
113342801000000,NE 108,Residential,30960,86138,0,117098
113342801100000,NE 108,Residential,30720,75986,0,106706
113342801200000,NE 108,Residential,31920,90095,0,122015
113342900100000,NE 108,Residential,32585,91579,0,124164
113342900200000,NE 108,Residential,31605,87013,0,118618
113342900300000,NE 108,Residential,31360,84711,0,116071
113342900400000,NE 108,Residential,31605,89671,0,121276
113342900500000,NE 108,Residential,32585,89753,0,122338
113342900600000,NE 108,Residential,33075,93070,0,126145
113343000100000,NE 108,Residential,35207,96156,0,131363
113343000200000,NE 108,Residential,35207,105483,0,140690
113343000300000,NE 108,Residential,32700,85857,0,118557
113343000400000,NE 108,Residential,32700,86744,0,119444
113343000500000,NE 108,Residential,33790,74945,0,108735
113343000600000,NE 108,Residential,33790,87461,0,121251
113343000700000,NE 108,Residential,33790,81603,0,115393
113343000800000,NE 108,Residential,32700,88862,0,121562
113343000900000,NE 108,Residential,32700,91835,0,124535
113343001000000,NE 108,Residential,32700,85174,0,117874
113343001100000,NE 108,Residential,32700,97342,0,130042
113343001200000,NE 108,Residential,32700,79753,0,112453
113343001300000,NE 108,Residential,32700,95526,0,128226
113343001400000,NE 108,Residential,36539,61348,0,97887
113343100100000,NE 108,Residential,35700,126834,0,162534
113343100200000,NE 108,Residential,35700,114757,0,150457
113347600100000,COMM NE,Commercial,778383,0,844233,1622616
113347600200000,APTS NE,Residential,346140,4418796,0,4764936
113347600301000,CONDO 500,Residential,7000,37051,0,44051
113347600301001,CONDO 500,Residential,7000,48076,0,55076
113347600301002,CONDO 500,Residential,7000,52326,0,59326
113347600301003,CONDO 500,Residential,7000,52326,0,59326
113347600301004,CONDO 500,Residential,7000,52326,0,59326
113347600301005,CONDO 500,Residential,7000,52326,0,59326
113347600301006,CONDO 500,Residential,7000,49752,0,56752
113347600301007,CONDO 500,Residential,7000,38736,0,45736
113347600301008,CONDO 500,Residential,7000,37537,0,44537
113347600301009,CONDO 500,Residential,7000,48563,0,55563
113347600301010,CONDO 500,Residential,7000,52813,0,59813
113347600301011,CONDO 500,Residential,7000,52813,0,59813
113347600301012,CONDO 500,Residential,7000,52813,0,59813
113347600301013,CONDO 500,Residential,7000,52813,0,59813
113347600301014,CONDO 500,Residential,7000,50249,0,57249
113347600301015,CONDO 500,Residential,7000,39223,0,46223
113347700100000,COMM NE,Commercial,247104,0,1289817,1536921
113347700300000,COMM NE,Commercial,7290,0,8237,15527
113347700400000,COMM NE,Commercial,245376,0,972810,1218186
113347700501000,CONDO 500,Residential,5000,41863,0,46863
113347700501001,CONDO 500,Residential,5000,41863,0,46863
113347700501002,CONDO 500,Residential,5000,42807,0,47807
113347700501003,CONDO 500,Residential,5000,42807,0,47807
113347700501004,CONDO 500,Residential,5000,41613,0,46613
113347700501005,CONDO 500,Residential,5000,41613,0,46613
113347700501006,CONDO 500,Residential,5000,46358,0,51358
113347700501007,CONDO 500,Residential,5000,46358,0,51358
113347700501008,CONDO 500,Residential,5000,44701,0,49701
113347700501009,CONDO 500,Residential,5000,44701,0,49701
113347700501010,CONDO 500,Residential,5000,47552,0,52552
113347700501011,CONDO 500,Residential,5000,47552,0,52552
113347700501012,CONDO 500,Residential,5000,44701,0,49701
113347700501013,CONDO 500,Residential,5000,44701,0,49701
113347700501014,CONDO 500,Residential,5000,47552,0,52552
113347700501015,CONDO 500,Residential,5000,47552,0,52552
113347700501016,CONDO 500,Residential,5000,41863,0,46863
113347700501017,CONDO 500,Residential,5000,44712,0,49712
113347700501018,CONDO 500,Residential,5000,54018,0,59018
113347700501019,CONDO 500,Residential,5000,54018,0,59018
113347700501020,CONDO 500,Residential,5000,55344,0,60344
113347700501021,CONDO 500,Residential,5000,55344,0,60344
113347700501022,CONDO 500,Residential,5000,42807,0,47807
113347700501023,CONDO 500,Residential,5000,45658,0,50658
113347700501024,CONDO 500,Residential,5000,55344,0,60344
113347700501025,CONDO 500,Residential,5000,55344,0,60344
113347700501026,CONDO 500,Residential,5000,54018,0,59018
113347700501027,CONDO 500,Residential,5000,54018,0,59018
113347700501028,CONDO 500,Residential,5000,46358,0,51358
113347700501029,CONDO 500,Residential,5000,41613,0,46613
113347700501030,CONDO 500,Residential,5000,55344,0,60344
113347700501031,CONDO 500,Residential,5000,55344,0,60344
113347700501032,CONDO 500,Residential,5000,47552,0,52552
113347700501033,CONDO 500,Residential,5000,44701,0,49701
113347700501034,CONDO 500,Residential,5000,55344,0,60344
113347700501035,CONDO 500,Residential,5000,55344,0,60344
113347700501036,CONDO 500,Residential,5000,47552,0,52552
113347700501037,CONDO 500,Residential,5000,44701,0,49701
113347700501038,CONDO 500,Residential,5000,41863,0,46863
113347700501039,CONDO 500,Residential,5000,44712,0,49712
113347700501040,CONDO 500,Residential,5000,54018,0,59018
113347700501041,CONDO 500,Residential,5000,54018,0,59018
113347700501042,CONDO 500,Residential,5000,55344,0,60344
113347700501043,CONDO 500,Residential,5000,55344,0,60344
113347700501044,CONDO 500,Residential,5000,42807,0,47807
113347700501045,CONDO 500,Residential,5000,45658,0,50658
113347700501046,CONDO 500,Residential,5000,55344,0,60344
113347700501047,CONDO 500,Residential,5000,55344,0,60344
113347700501048,CONDO 500,Residential,5000,54018,0,59018
113347700501049,CONDO 500,Residential,5000,54018,0,59018
113347700501050,CONDO 500,Residential,5000,46358,0,51358
113347700501051,CONDO 500,Residential,5000,41613,0,46613
113347700501052,CONDO 500,Residential,5000,55344,0,60344
113347700501053,CONDO 500,Residential,5000,55344,0,60344
113347700501054,CONDO 500,Residential,5000,47552,0,52552
113347700501055,CONDO 500,Residential,5000,44701,0,49701
113347700501056,CONDO 500,Residential,5000,55344,0,60344
113347700501057,CONDO 500,Residential,5000,55344,0,60344
113347700501058,CONDO 500,Residential,5000,47552,0,52552
113347700501059,CONDO 500,Residential,5000,44701,0,49701
113410100100000,NE 163,Residential,40308,62873,0,103181
113410100200000,E-40 CHURCHES,Exempt,625968,0,1227958,1853926
113410100300000,NE 163,Residential,27802,151005,0,178807
113410100400000,NE 163,Residential,24480,158992,0,183472
113410100500000,NE 163,Residential,24480,139476,0,163956
113410100600000,NE 163,Residential,27120,153340,0,180460
113410100700000,NE 163,Residential,27120,154161,0,181281
113410100800000,NE 163,Residential,28928,148725,0,177653
113410100900000,NE 163,Residential,26400,142554,0,168954
113410101000000,NE 163,Residential,30103,147427,0,177530
113410101100000,NE 163,Residential,28728,162244,0,190972
113410101200000,NE 163,Residential,27157,160561,0,187718
113410101300000,NE 163,Residential,27157,140185,0,167342
113410101400000,NE 163,Residential,29400,169842,0,199242
113410101500000,NE 163,Residential,25200,156039,0,181239
113410101600000,NE 163,Residential,29820,157647,0,187467
113410200100000,NE 163,Residential,28560,192804,0,221364
113410200200000,NE 163,Residential,27030,153002,0,180032
113410200300000,NE 163,Residential,27030,153666,0,180696
113410200400000,NE 163,Residential,30031,152955,0,182986
113410300100000,NE 163,Residential,33835,171158,0,204993
113410300200000,NE 163,Residential,24480,174724,0,199204
113410300300000,NE 163,Residential,25704,180034,0,205738
113410300400000,NE 163,Residential,24888,170134,0,195022
113410300500000,NE 163,Residential,28424,164581,0,193005
113410400200000,E-15 CITY,Exempt,0,0,0,0
113410400300000,NE 163,Residential,30715,155463,0,186178
113410400400000,NE 163,Residential,28711,164714,0,193425
113410400500000,COMM NE,Commercial,172800,0,621499,794299
113410400701000,COMM NE,Commercial,25272,0,54667,79939
113410400701001,COMM NE,Commercial,25272,0,54667,79939
113410400701002,COMM NE,Commercial,25272,0,54667,79939
113410400701003,COMM NE,Commercial,25272,0,54667,79939
113410400701004,COMM NE,Commercial,25272,0,121050,146322
113410400701005,COMM NE,Commercial,33696,0,160863,194559
113410400701006,COMM NE,Commercial,42120,0,202282,244402
113410400701007,COMM NE,Commercial,23587,0,0,23587
113410400701008,COMM NE,Commercial,23587,0,0,23587
113410400701009,COMM NE,Commercial,23587,0,0,23587
113410400701010,COMM NE,Commercial,23587,0,0,23587
113410400701011,COMM NE,Commercial,23587,0,112615,136202
113410400701012,COMM NE,Commercial,21060,0,99454,120514
113410400701013,COMM NE,Commercial,51948,0,238807,290755
113410400801000,CONDO 500,Residential,7500,72067,0,79567
113410400801001,CONDO 500,Residential,7500,72067,0,79567
113410400801002,CONDO 500,Residential,7500,72067,0,79567
113410400801003,CONDO 500,Residential,7500,72067,0,79567
113410400801004,CONDO 500,Residential,7500,73083,0,80583
113410400801005,CONDO 500,Residential,7500,73083,0,80583
113410400801006,CONDO 500,Residential,7500,73083,0,80583
113410400801007,CONDO 500,Residential,7500,73083,0,80583
113410400801008,CONDO 500,Residential,7500,73083,0,80583
113410400801009,CONDO 500,Residential,7500,73083,0,80583
113410400801010,CONDO 500,Residential,7500,73083,0,80583
113410400801011,CONDO 500,Residential,7500,73083,0,80583
113410400801012,CONDO 500,Residential,7500,72067,0,79567
113410400801013,CONDO 500,Residential,7500,72067,0,79567
113410400801014,CONDO 500,Residential,7500,72067,0,79567
113410400801015,CONDO 500,Residential,7500,72067,0,79567
113410400801016,CONDO 500,Residential,7500,73083,0,80583
113410400801017,CONDO 500,Residential,7500,73083,0,80583
113410400801018,CONDO 500,Residential,7500,72990,0,80490
113410400801019,CONDO 500,Residential,7500,72990,0,80490
113410400801020,CONDO 500,Residential,7500,72990,0,80490
113410400801021,CONDO 500,Residential,7500,72990,0,80490
113410400801022,CONDO 500,Residential,7500,72990,0,80490
113410400801023,CONDO 500,Residential,7500,72990,0,80490
113410400801024,CONDO 500,Residential,7500,71292,0,78792
113410400801025,CONDO 500,Residential,7500,71292,0,78792
113410400801026,CONDO 500,Residential,7500,71292,0,78792
113410400801027,CONDO 500,Residential,7500,71292,0,78792
113410400801028,CONDO 500,Residential,7500,72298,0,79798
113410400801029,CONDO 500,Residential,7500,72298,0,79798
113410400801030,CONDO 500,Residential,7500,72298,0,79798
113410400801031,CONDO 500,Residential,7500,72298,0,79798
113410400801032,CONDO 500,Residential,7500,72298,0,79798
113410400801033,CONDO 500,Residential,7500,72298,0,79798
113410400801034,CONDO 500,Residential,7500,72298,0,79798
113410400801035,CONDO 500,Residential,7500,72298,0,79798
113410400801036,CONDO 500,Residential,7500,72067,0,79567
113410400801037,CONDO 500,Residential,7500,72067,0,79567
113410400801038,CONDO 500,Residential,7500,72067,0,79567
113410400801039,CONDO 500,Residential,7500,72067,0,79567
113410400801040,CONDO 500,Residential,7500,73083,0,80583
113410400801041,CONDO 500,Residential,7500,73083,0,80583
113410400801042,CONDO 500,Residential,7500,73083,0,80583
113410400801043,CONDO 500,Residential,7500,73083,0,80583
113410400801044,CONDO 500,Residential,7500,73083,0,80583
113410400801045,CONDO 500,Residential,7500,73083,0,80583
113410400801046,CONDO 500,Residential,7500,73083,0,80583
113410400801047,CONDO 500,Residential,7500,73083,0,80583
113410401000000,COMM NE,Commercial,180900,0,19686,200586
113410401101000,COMM NE,Commercial,284040,0,1183338,1467378
113410401101001,COMM NE,Commercial,235440,0,641327,876767
113410401101002,COMM NE,Commercial,235440,0,0,235440
113410401101003,COMM NE,Commercial,93960,0,450604,544564
113410401200000,COMM NE,Commercial,212544,0,746533,959077
113410401300000,COMM NE,Commercial,115776,0,405372,521148
113410500100000,NE 163,Residential,29680,141841,0,171521
113410500200000,NE 163,Residential,25864,168278,0,194142
113410500300000,NE 163,Residential,25822,152713,0,178535
113410500400000,NE 163,Residential,26712,150655,0,177367
113410500500000,NE 163,Residential,26712,144506,0,171218
113410500600000,NE 163,Residential,31428,127824,0,159252
113412600100000,NE 163,Residential,27030,145911,0,172941
113412600200000,NE 163,Residential,27030,131036,0,158066
113412600300000,NE 163,Residential,27030,164494,0,191524
113412600400000,NE 163,Residential,27030,140705,0,167735
113412600500000,NE 163,Residential,27030,156106,0,183136
113412600600000,NE 163,Residential,27030,130821,0,157851
113412600700000,NE 163,Residential,27030,148969,0,175999
113412600800000,NE 163,Residential,28560,133426,0,161986
113412600900000,NE 163,Residential,30704,136902,0,167606
113412601000000,NE 163,Residential,27030,133759,0,160789
113412601100000,NE 163,Residential,27030,134161,0,161191
113412601200000,NE 163,Residential,27030,126449,0,153479
113412601300000,NE 163,Residential,27030,138893,0,165923
113412601400000,NE 163,Residential,27030,151447,0,178477
113412601500000,NE 163,Residential,27030,162509,0,189539
113412601600000,NE 163,Residential,27030,161643,0,188673
113412700100000,NE 163,Residential,30600,148558,0,179158
113412700200000,NE 163,Residential,28560,154446,0,183006
113412700300000,NE 163,Residential,28560,164048,0,192608
113412700401000,CONDO 501,Residential,9000,84765,0,93765
113412700401001,CONDO 501,Residential,9000,78783,0,87783
113412700401002,CONDO 501,Residential,9000,78783,0,87783
113412700401003,CONDO 501,Residential,9000,84765,0,93765
113412700401004,CONDO 501,Residential,9000,84765,0,93765
113412700401005,CONDO 501,Residential,9000,78783,0,87783
113412700401006,CONDO 501,Residential,9000,78783,0,87783
113412700401007,CONDO 501,Residential,9000,84765,0,93765
113412700401008,CONDO 501,Residential,9000,82392,0,91392
113412700401009,CONDO 501,Residential,9000,78783,0,87783
113412700401010,CONDO 501,Residential,9000,78783,0,87783
113412700401011,CONDO 501,Residential,9000,82392,0,91392
113412700401012,CONDO 501,Residential,9000,82392,0,91392
113412700401013,CONDO 501,Residential,9000,78783,0,87783
113412700401014,CONDO 501,Residential,9000,78783,0,87783
113412700401015,CONDO 501,Residential,9000,84765,0,93765
113412700401016,CONDO 501,Residential,9000,102808,0,111808
113412700401017,CONDO 501,Residential,9000,97078,0,106078
113412700401018,CONDO 501,Residential,9000,96579,0,105579
113412700401019,CONDO 501,Residential,9000,96859,0,105859
113412700401020,CONDO 501,Residential,9000,100934,0,109934
113412700401021,CONDO 501,Residential,9000,82392,0,91392
113412700401022,CONDO 501,Residential,9000,78783,0,87783
113412700401023,CONDO 501,Residential,9000,78783,0,87783
113412700401024,CONDO 501,Residential,9000,84765,0,93765
113412700401025,CONDO 501,Residential,9000,84765,0,93765
113412700401026,CONDO 501,Residential,9000,78783,0,87783
113412700401027,CONDO 501,Residential,9000,78783,0,87783
113412700401028,CONDO 501,Residential,9000,84765,0,93765
113412700401029,CONDO 501,Residential,9000,101444,0,110444
113412700401030,CONDO 501,Residential,9000,102631,0,111631
113412700401031,CONDO 501,Residential,9000,96344,0,105344
113412700401032,CONDO 501,Residential,9000,97588,0,106588
113412700401033,CONDO 501,Residential,9000,97433,0,106433
113412700401034,CONDO 501,Residential,9000,100920,0,109920
113412700500000,NE 163,Residential,31981,152119,0,184100
113412700600000,NE 163,Residential,24480,145711,0,170191
113412700700000,NE 163,Residential,25671,159600,0,185271
113412700800000,NE 163,Residential,28549,157238,0,185787
113412700900000,NE 163,Residential,31172,169912,0,201084
113412701000000,NE 163,Residential,30636,160958,0,191594
113412701100000,NE 163,Residential,28973,163350,0,192323
113412701200000,NE 163,Residential,28004,146646,0,174650
113412701300000,NE 163,Residential,25000,142597,0,167597
113412701400000,NE 163,Residential,25000,161281,0,186281
113412701500000,NE 163,Residential,25000,156693,0,181693
113412701600000,NE 163,Residential,25000,156989,0,181989
113412701700000,NE 163,Residential,28000,158628,0,186628
113412701800000,NE 163,Residential,30426,164728,0,195154
113412701900000,NE 163,Residential,30360,171993,0,202353
113412702000000,NE 163,Residential,29921,178735,0,208656
113412702100000,NE 163,Residential,27840,169216,0,197056
113412702200000,NE 163,Residential,28080,171214,0,199294
113412800200000,NE 163,Residential,29536,167218,0,196754
113412800300000,NE 163,Residential,28560,172636,0,201196
113412800400000,NE 163,Residential,23582,168110,0,191692
113412800500000,NE 163,Residential,26112,161124,0,187236
113412800600000,NE 163,Residential,24847,157509,0,182356
113412800700000,NE 163,Residential,24480,159551,0,184031
113412800800000,NE 163,Residential,25582,173255,0,198837
113412800900000,NE 163,Residential,24480,142353,0,166833
113412801000000,NE 163,Residential,24847,164386,0,189233
113412801100000,NE 163,Residential,24847,152869,0,177716
113412801200000,NE 163,Residential,23990,155809,0,179799
113412801300000,NE 163,Residential,24480,153678,0,178158
113412801400000,NE 163,Residential,24480,162456,0,186936
113412801500000,NE 163,Residential,24480,165740,0,190220
113412801600000,NE 163,Residential,24480,133009,0,157489
113412801700000,NE 163,Residential,26520,157757,0,184277
113412801800000,NE 163,Residential,22440,130752,0,153192
113412801900000,NE 163,Residential,24480,156629,0,181109
113412802000000,NE 163,Residential,24480,135361,0,159841
113412802100000,NE 163,Residential,24480,152143,0,176623
113412900100000,NE 163,Residential,25822,145523,0,171345
113412900200000,NE 163,Residential,25822,131441,0,157263
113412900300000,NE 163,Residential,25822,143848,0,169670
113412900400000,NE 163,Residential,25822,149894,0,175716
113412900500000,NE 163,Residential,25822,151479,0,177301
113412900600000,NE 163,Residential,25822,160452,0,186274
113412900700000,NE 163,Residential,25822,177329,0,203151
113412900800000,NE 163,Residential,25822,147093,0,172915
113412900900000,NE 163,Residential,25822,137022,0,162844
113412901000000,NE 163,Residential,29680,170938,0,200618
113412901100000,NE 163,Residential,31428,158312,0,189740
113412901200000,NE 163,Residential,26712,146598,0,173310
113412901300000,NE 163,Residential,26712,158426,0,185138
113412901400000,NE 163,Residential,26712,154849,0,181561
113412901500000,NE 163,Residential,26712,154256,0,180968
113412901600000,NE 163,Residential,26712,170930,0,197642
113412901700000,NE 163,Residential,26712,157524,0,184236
113412901800000,NE 163,Residential,26712,151315,0,178027
113412901900000,NE 163,Residential,26712,176924,0,203636
113413000100000,NE 163,Residential,25201,165459,0,190660
113413000200000,NE 163,Residential,25217,183225,0,208442
113413000300000,NE 163,Residential,26337,175063,0,201400
113413000400000,NE 163,Residential,26460,179120,0,205580
113413000500000,NE 163,Residential,26460,158225,0,184685
113413000600000,NE 163,Residential,26460,166282,0,192742
113413000700000,NE 163,Residential,26460,181036,0,207496
113413000800000,NE 163,Residential,26460,160428,0,186888
113413000900000,NE 163,Residential,26460,175941,0,202401
113413001000000,NE 163,Residential,31104,150532,0,181636
113413001100000,NE 163,Residential,31378,224551,0,255929
113413001200000,NE 163,Residential,31408,200262,0,231670
113413001300000,NE 163,Residential,31527,184538,0,216065
113413001400000,NE 163,Residential,31500,163126,0,194626
113413001500000,NE 163,Residential,32340,159226,0,191566
113413001600000,NE 163,Residential,32832,179841,0,212673
113413001700000,NE 163,Residential,32477,161408,0,193885
113413001800000,NE 163,Residential,33101,170209,0,203310
113413001900000,NE 163,Residential,28307,150319,0,178626
113413002000000,NE 163,Residential,28453,152093,0,180546
113413002100000,NE 163,Residential,30932,140639,0,171571
113413002200000,E-15 CITY,Exempt,0,0,0,0
113413002300000,NE 163,Residential,33182,178418,0,211600
113413002400000,NE 163,Residential,32308,159868,0,192176
113413002500000,NE 163,Residential,29963,143603,0,173566
113413002600000,NE 163,Residential,24752,151896,0,176648
113415100100000,E-40 CHURCHES,Exempt,582552,0,763124,1345676
113415100300000,NE 163,Residential,42050,301428,0,343478
113415100400000,NE 163,Residential,40675,263654,0,304329
113415100500000,NE 163,Residential,28000,304679,0,332679
113415100600000,NE 163,Residential,8443,0,0,8443
113415200100000,COMM NE,Commercial,350676,0,0,350676
113415200200000,COMM NE,Commercial,290995,0,384005,675000
113417600500000,COMM NE,Commercial,302400,0,691878,994278
113417600600000,COMM NE,Commercial,104427,0,372070,476497
113417600700000,NE 163,Commercial,247536,0,0,247536
113417600800000,COMM NE,Commercial,174636,0,1741917,1916553
113417600900000,COMM NE,Commercial,27350,0,165271,192621
113417700100000,COMM NE,Commercial,341550,0,609695,951245
113417700201000,CONDO 500,Residential,4500,50646,0,55146
113417700201001,CONDO 500,Residential,4500,50646,0,55146
113417700201002,CONDO 500,Residential,4500,50646,0,55146
113417700201003,CONDO 500,Residential,4500,50646,0,55146
113417700201004,CONDO 500,Residential,4500,50646,0,55146
113417700201005,CONDO 500,Residential,4500,50646,0,55146
113417700201006,CONDO 500,Residential,4500,50646,0,55146
113417700201007,CONDO 500,Residential,4500,50646,0,55146
113417700201008,CONDO 500,Residential,4500,50646,0,55146
113417700201009,CONDO 500,Residential,4500,50646,0,55146
113417700201010,CONDO 500,Residential,4500,50646,0,55146
113417700201011,CONDO 500,Residential,4500,50646,0,55146
113417700201012,CONDO 500,Residential,4500,50646,0,55146
113417700201013,CONDO 500,Residential,4500,50646,0,55146
113417700201014,CONDO 500,Residential,4500,50646,0,55146
113417700201015,CONDO 500,Residential,4500,50646,0,55146
113417700201016,CONDO 500,Residential,4500,50646,0,55146
113417700201017,CONDO 500,Residential,4500,50646,0,55146
113417700201018,CONDO 500,Residential,4500,50646,0,55146
113417700201019,CONDO 500,Residential,4500,50646,0,55146
113417700201020,CONDO 500,Residential,4500,50624,0,55124
113417700201021,CONDO 500,Residential,4500,50515,0,55015
113417700201022,CONDO 500,Residential,4500,52705,0,57205
113417700201023,CONDO 500,Residential,4500,52014,0,56514
113417700201024,CONDO 500,Residential,4500,50515,0,55015
113417700201025,CONDO 500,Residential,4500,50624,0,55124
113417700201026,CONDO 500,Residential,4500,52014,0,56514
113417700201027,CONDO 500,Residential,4500,52705,0,57205
113417700201028,CONDO 500,Residential,4500,50624,0,55124
113417700201029,CONDO 500,Residential,4500,50515,0,55015
113417700201030,CONDO 500,Residential,4500,52705,0,57205
113417700201031,CONDO 500,Residential,4500,52014,0,56514
113417700201032,CONDO 500,Residential,4500,50515,0,55015
113417700201033,CONDO 500,Residential,4500,50624,0,55124
113417700201034,CONDO 500,Residential,4500,52014,0,56514
113417700201035,CONDO 500,Residential,4500,52705,0,57205
113417700201036,CONDO 500,Residential,4500,50624,0,55124
113417700201037,CONDO 500,Residential,4500,50515,0,55015
113417700201038,CONDO 500,Residential,4500,52705,0,57205
113417700201039,CONDO 500,Residential,4500,52014,0,56514
113417700201040,CONDO 500,Residential,4500,50515,0,55015
113417700201041,CONDO 500,Residential,4500,50624,0,55124
113417700201042,CONDO 500,Residential,4500,52014,0,56514
113417700201043,CONDO 500,Residential,4500,52705,0,57205
113417700201044,CONDO 500,Residential,4500,50624,0,55124
113417700201045,CONDO 500,Residential,4500,50515,0,55015
113417700201046,CONDO 500,Residential,4500,52705,0,57205
113417700201047,CONDO 500,Residential,4500,52014,0,56514
113417700201048,CONDO 500,Residential,4500,50515,0,55015
113417700201049,CONDO 500,Residential,4500,50624,0,55124
113417700201050,CONDO 500,Residential,4500,52014,0,56514
113417700201051,CONDO 500,Residential,4500,52705,0,57205
113417700201052,CONDO 500,Residential,4500,50646,0,55146
113417700201053,CONDO 500,Residential,4500,50646,0,55146
113417700201054,CONDO 500,Residential,4500,50646,0,55146
113417700201055,CONDO 500,Residential,4500,50646,0,55146
113417700201056,CONDO 500,Residential,4500,50646,0,55146
113417700201057,CONDO 500,Residential,4500,50646,0,55146
113417700201058,CONDO 500,Residential,4500,50646,0,55146
113417700201059,CONDO 500,Residential,4500,50646,0,55146
113417700201060,CONDO 500,Residential,4500,50646,0,55146
113417700201061,CONDO 500,Residential,4500,50646,0,55146
113417700201062,CONDO 500,Residential,4500,50646,0,55146
113417700201063,CONDO 500,Residential,4500,50646,0,55146
113417700201064,CONDO 500,Residential,4500,50646,0,55146
113417700201065,CONDO 500,Residential,4500,50646,0,55146
113417700201066,CONDO 500,Residential,4500,50646,0,55146
113417700201067,CONDO 500,Residential,4500,50646,0,55146
113417700201068,CONDO 500,Residential,4500,50624,0,55124
113417700201069,CONDO 500,Residential,4500,50515,0,55015
113417700201070,CONDO 500,Residential,4500,52705,0,57205
113417700201071,CONDO 500,Residential,4500,52014,0,56514
113417700201072,CONDO 500,Residential,4500,50515,0,55015
113417700201073,CONDO 500,Residential,4500,50624,0,55124
113417700201074,CONDO 500,Residential,4500,52014,0,56514
113417700201075,CONDO 500,Residential,4500,52705,0,57205
113417700201076,CONDO 500,Residential,4500,50529,0,55029
113417700201077,CONDO 500,Residential,4500,50529,0,55029
113417700201078,CONDO 500,Residential,4500,52315,0,56815
113417700201079,CONDO 500,Residential,4500,52315,0,56815
113417700201080,CONDO 500,Residential,4500,50624,0,55124
113417700201081,CONDO 500,Residential,4500,50515,0,55015
113417700201082,CONDO 500,Residential,4500,52705,0,57205
113417700201083,CONDO 500,Residential,4500,52014,0,56514
113417700201084,CONDO 500,Residential,4500,50515,0,55015
113417700201085,CONDO 500,Residential,4500,50624,0,55124
113417700201086,CONDO 500,Residential,4500,52019,0,56519
113417700201087,CONDO 500,Residential,4500,52705,0,57205
113417700201088,CONDO 500,Residential,4500,50646,0,55146
113417700201089,CONDO 500,Residential,4500,50646,0,55146
113417700201090,CONDO 500,Residential,4500,50646,0,55146
113417700201091,CONDO 500,Residential,4500,50646,0,55146
113417700201092,CONDO 500,Residential,4500,50646,0,55146
113417700201093,CONDO 500,Residential,4500,50646,0,55146
113417700201094,CONDO 500,Residential,4500,50646,0,55146
113417700201095,CONDO 500,Residential,4500,50646,0,55146
113417700201096,CONDO 500,Residential,4500,50646,0,55146
113417700201097,CONDO 500,Residential,4500,50646,0,55146
113417700201098,CONDO 500,Residential,4500,50515,0,55015
113417700201099,CONDO 500,Residential,4500,50624,0,55124
113417700201100,CONDO 500,Residential,4500,51654,0,56154
113417700201101,CONDO 500,Residential,4500,52705,0,57205
113417700201102,CONDO 500,Residential,4500,50624,0,55124
113417700201103,CONDO 500,Residential,4500,50515,0,55015
113417700201104,CONDO 500,Residential,4500,52705,0,57205
113417700201105,CONDO 500,Residential,4500,52014,0,56514
113417700201106,CONDO 500,Residential,4500,50515,0,55015
113417700201107,CONDO 500,Residential,4500,50624,0,55124
113417700201108,CONDO 500,Residential,4500,52014,0,56514
113417700201109,CONDO 500,Residential,4500,52705,0,57205
113417700201110,CONDO 500,Residential,4500,50624,0,55124
113417700201111,CONDO 500,Residential,4500,50515,0,55015
113417700201112,CONDO 500,Residential,4500,52705,0,57205
113417700201113,CONDO 500,Residential,4500,52014,0,56514
113417700201114,CONDO 500,Residential,4500,50515,0,55015
113417700201115,CONDO 500,Residential,4500,50624,0,55124
113417700201116,CONDO 500,Residential,4500,52014,0,56514
113417700201117,CONDO 500,Residential,4500,52705,0,57205
113417700201118,CONDO 500,Residential,4500,50624,0,55124
113417700201119,CONDO 500,Residential,4500,50515,0,55015
113417700201120,CONDO 500,Residential,4500,52705,0,57205
113417700201121,CONDO 500,Residential,4500,52014,0,56514
113417700201122,CONDO 500,Residential,4500,50515,0,55015
113417700201123,CONDO 500,Residential,4500,50624,0,55124
113417700201124,CONDO 500,Residential,4500,52014,0,56514
113417700201125,CONDO 500,Residential,4500,52705,0,57205
113417700201126,CONDO 500,Residential,4500,50624,0,55124
113417700201127,CONDO 500,Residential,4500,50515,0,55015
113417700201128,CONDO 500,Residential,4500,52705,0,57205
113417700201129,CONDO 500,Residential,4500,52014,0,56514
113417700201130,CONDO 500,Residential,4500,50646,0,55146
113417700201131,CONDO 500,Residential,4500,50646,0,55146
113417700201132,CONDO 500,Residential,4500,50646,0,55146
113417700201133,CONDO 500,Residential,4500,50646,0,55146
113417700201134,CONDO 500,Residential,4500,50646,0,55146
113417700201135,CONDO 500,Residential,4500,50646,0,55146
113417700201136,CONDO 500,Residential,4500,50646,0,55146
113417700201137,CONDO 500,Residential,4500,50646,0,55146
113417700201138,CONDO 500,Residential,4500,50646,0,55146
113417700201139,CONDO 500,Residential,4500,50646,0,55146
113417700201140,CONDO 500,Residential,4500,50646,0,55146
113417700201141,CONDO 500,Residential,4500,50646,0,55146
113417700201142,CONDO 500,Residential,4500,50646,0,55146
113417700201143,CONDO 500,Residential,4500,50646,0,55146
113417700201144,CONDO 500,Residential,4500,50646,0,55146
113417700201145,CONDO 500,Residential,4500,50646,0,55146
113417700201146,CONDO 500,Residential,4500,50646,0,55146
113417700201147,CONDO 500,Residential,4500,50646,0,55146
113417700201148,CONDO 500,Residential,4500,50646,0,55146
113417700201149,CONDO 500,Residential,4500,50646,0,55146
113417700201150,CONDO 500,Residential,4500,50646,0,55146
113417700201151,CONDO 500,Residential,4500,50646,0,55146
113417700201152,CONDO 500,Residential,4500,50646,0,55146
113417700201153,CONDO 500,Residential,4500,50646,0,55146
113417700201154,CONDO 500,Residential,4500,50646,0,55146
113417700201155,CONDO 500,Residential,4500,50646,0,55146
113417700201156,CONDO 500,Residential,4500,50646,0,55146
113417700201157,CONDO 500,Residential,4500,50646,0,55146
113417700201158,CONDO 500,Residential,4500,50646,0,55146
113417700201159,CONDO 500,Residential,4500,50646,0,55146
113417700201160,CONDO 500,Residential,4500,50646,0,55146
113417700201161,CONDO 500,Residential,4500,50646,0,55146
113417700201162,CONDO 500,Residential,4500,50646,0,55146
113417700201163,CONDO 500,Residential,4500,50646,0,55146
113417700201164,CONDO 500,Residential,4500,50646,0,55146
113417700201165,CONDO 500,Residential,4500,50646,0,55146
113417700201166,CONDO 500,Residential,360,3478,0,3838
113417700201167,CONDO 500,Residential,360,3478,0,3838
113417700201168,CONDO 500,Residential,360,3478,0,3838
113417700201169,CONDO 500,Residential,360,3478,0,3838
113417700201170,CONDO 500,Residential,360,3478,0,3838
113417700201171,CONDO 500,Residential,360,3478,0,3838
113417700201172,CONDO 500,Residential,360,3478,0,3838
113417700201173,CONDO 500,Residential,360,3478,0,3838
113417700201174,CONDO 500,Residential,360,3478,0,3838
113417700201175,CONDO 500,Residential,360,3478,0,3838
113417700201176,CONDO 500,Residential,360,3478,0,3838
113417700201177,CONDO 500,Residential,360,3478,0,3838
113417700201178,CONDO 500,Residential,360,3478,0,3838
113417700201179,CONDO 500,Residential,360,3478,0,3838
113417700201180,CONDO 500,Residential,360,3478,0,3838
113417700201181,CONDO 500,Residential,360,3478,0,3838
113417700201182,CONDO 500,Residential,360,3478,0,3838
113417700201183,CONDO 500,Residential,360,3478,0,3838
113417700201184,CONDO 500,Residential,360,3478,0,3838
113417700201185,CONDO 500,Residential,360,3478,0,3838
113417700201186,CONDO 500,Residential,360,3478,0,3838
113417700201187,CONDO 500,Residential,360,3478,0,3838
113417700201188,CONDO 500,Residential,360,3478,0,3838
113417700201189,CONDO 500,Residential,360,3478,0,3838
113417700201190,CONDO 500,Residential,360,3478,0,3838
113417700201191,CONDO 500,Residential,360,3478,0,3838
113417700201192,CONDO 500,Residential,360,3478,0,3838
113417700201193,CONDO 500,Residential,360,3478,0,3838
113417700201194,CONDO 500,Residential,360,3478,0,3838
113417700201195,CONDO 500,Residential,360,3478,0,3838
113417700201196,CONDO 500,Residential,360,3478,0,3838
113417700201197,CONDO 500,Residential,360,3478,0,3838
113417700201198,CONDO 500,Residential,360,3478,0,3838
113417700201199,CONDO 500,Residential,360,3478,0,3838
113417700201200,CONDO 500,Residential,360,3478,0,3838
113417700201201,CONDO 500,Residential,360,3478,0,3838
113417700201202,CONDO 500,Residential,360,3478,0,3838
113417700201203,CONDO 500,Residential,360,3478,0,3838
113417700201204,CONDO 500,Residential,360,3478,0,3838
113417700201205,CONDO 500,Residential,360,3478,0,3838
113417700201206,CONDO 500,Residential,360,3478,0,3838
113417700201207,CONDO 500,Residential,360,3478,0,3838
113417700201208,CONDO 500,Residential,360,3478,0,3838
113417700201209,CONDO 500,Residential,360,3478,0,3838
113417700201210,CONDO 500,Residential,360,3478,0,3838
113417700201211,CONDO 500,Residential,360,3478,0,3838
113417700201212,CONDO 500,Residential,360,3478,0,3838
113417700201213,CONDO 500,Residential,360,3478,0,3838
113417700201214,CONDO 500,Residential,360,3478,0,3838
113417700201215,CONDO 500,Residential,360,3478,0,3838
113417700201216,CONDO 500,Residential,360,3478,0,3838
113417700201217,CONDO 500,Residential,360,3478,0,3838
113417700201218,CONDO 500,Residential,360,3478,0,3838
113417700201219,CONDO 500,Residential,360,3478,0,3838
113417700201220,CONDO 500,Residential,360,3478,0,3838
113417700201221,CONDO 500,Residential,360,3478,0,3838
113417700201222,CONDO 500,Residential,360,3478,0,3838
113417700201223,CONDO 500,Residential,360,3478,0,3838
113417700201224,CONDO 500,Residential,360,3478,0,3838
113417700201225,CONDO 500,Residential,360,3478,0,3838
113417700201226,CONDO 500,Residential,360,3478,0,3838
113417700201227,CONDO 500,Residential,360,3478,0,3838
113417700201228,CONDO 500,Residential,360,3478,0,3838
113417700201229,CONDO 500,Residential,360,3478,0,3838
113417700201230,CONDO 500,Residential,360,3478,0,3838
113417700201231,CONDO 500,Residential,360,3478,0,3838
113417700201232,CONDO 500,Residential,360,3478,0,3838
113417700201233,CONDO 500,Residential,360,3478,0,3838
113417700201234,CONDO 500,Residential,360,3478,0,3838
113417700201235,CONDO 500,Residential,360,3478,0,3838
113417700201236,CONDO 500,Residential,360,3478,0,3838
113417700201237,CONDO 500,Residential,360,3478,0,3838
113417700201238,CONDO 500,Residential,360,3478,0,3838
113417700201239,CONDO 500,Residential,360,3478,0,3838
113417700201240,CONDO 500,Residential,360,3478,0,3838
113417700201241,CONDO 500,Residential,360,3478,0,3838
113417700201242,CONDO 500,Residential,360,3478,0,3838
113417700201243,CONDO 500,Residential,360,3478,0,3838
113417700201244,CONDO 500,Residential,360,3478,0,3838
113417700201245,CONDO 500,Residential,360,3478,0,3838
113417700201246,CONDO 500,Residential,360,3478,0,3838
113417700201247,CONDO 500,Residential,360,3478,0,3838
113417700201248,CONDO 500,Residential,360,3478,0,3838
113417700201249,CONDO 500,Residential,360,3478,0,3838
113417700201250,CONDO 500,Residential,360,3478,0,3838
113417700201251,CONDO 500,Residential,360,3478,0,3838
113417700201252,CONDO 500,Residential,360,3478,0,3838
113417700201253,CONDO 500,Residential,360,3478,0,3838
113417700201254,CONDO 500,Residential,360,3478,0,3838
113417700201255,CONDO 500,Residential,360,3478,0,3838
113417700201256,CONDO 500,Residential,360,3478,0,3838
113417700201257,CONDO 500,Residential,360,3478,0,3838
113417700201258,CONDO 500,Residential,360,3478,0,3838
113417700201259,CONDO 500,Residential,360,3478,0,3838
113417700201260,CONDO 500,Residential,360,3478,0,3838
113417700201261,CONDO 500,Residential,360,3478,0,3838
113417700201262,CONDO 500,Residential,360,3478,0,3838
113417700201263,CONDO 500,Residential,360,3478,0,3838
113417700201264,CONDO 500,Residential,360,3478,0,3838
113417700201265,CONDO 500,Residential,360,3478,0,3838
113417700201266,CONDO 500,Residential,360,3478,0,3838
113417700201267,CONDO 500,Residential,360,3478,0,3838
113417700201268,CONDO 500,Residential,360,3478,0,3838
113417700201269,CONDO 500,Residential,360,3478,0,3838
113417700201270,CONDO 500,Residential,360,3478,0,3838
113417700201271,CONDO 500,Residential,360,3478,0,3838
113417700201272,CONDO 500,Residential,360,3478,0,3838
113417700201273,CONDO 500,Residential,360,3478,0,3838
113417700201274,CONDO 500,Residential,360,3478,0,3838
113417700201275,CONDO 500,Residential,360,3478,0,3838
113417700201276,CONDO 500,Residential,360,3478,0,3838
113417700201277,CONDO 500,Residential,360,3478,0,3838
113417700201278,CONDO 500,Residential,360,3478,0,3838
113417700201279,CONDO 500,Residential,360,3478,0,3838
113417700201280,CONDO 500,Residential,360,3478,0,3838
113417700201281,CONDO 500,Residential,360,3478,0,3838
113417700201282,CONDO 500,Residential,360,3478,0,3838
113417700201283,CONDO 500,Residential,360,3478,0,3838
113417700201284,CONDO 500,Residential,360,3478,0,3838
113417700201285,CONDO 500,Residential,360,3478,0,3838
113417700201286,CONDO 500,Residential,360,3478,0,3838
113417700201287,CONDO 500,Residential,360,3478,0,3838
113417700201288,CONDO 500,Residential,360,3478,0,3838
113417700201289,CONDO 500,Residential,360,3478,0,3838
113417700201290,CONDO 500,Residential,360,3478,0,3838
113417700201291,CONDO 500,Residential,360,3478,0,3838
113417700201292,CONDO 500,Residential,360,3478,0,3838
113417700201293,CONDO 500,Residential,360,3478,0,3838
113417700201294,CONDO 500,Residential,360,3478,0,3838
113417700201295,CONDO 500,Residential,360,3478,0,3838
113417700201296,CONDO 500,Residential,360,3478,0,3838
113417700201297,CONDO 500,Residential,360,3478,0,3838
113417700201298,CONDO 500,Residential,360,3478,0,3838
113417700201299,CONDO 500,Residential,360,3478,0,3838
113417700201300,CONDO 500,Residential,360,3478,0,3838
113417700201301,CONDO 500,Residential,360,3478,0,3838
113417700201302,CONDO 500,Residential,360,3478,0,3838
113417700201303,CONDO 500,Residential,360,3478,0,3838
113417700201304,CONDO 500,Residential,360,3478,0,3838
113417700201305,CONDO 500,Residential,360,3478,0,3838
113417700201306,CONDO 500,Residential,360,3478,0,3838
113417700201307,CONDO 500,Residential,360,3478,0,3838
113417700201308,CONDO 500,Residential,360,3478,0,3838
113417700201309,CONDO 500,Residential,360,3478,0,3838
113417700201310,CONDO 500,Residential,360,3478,0,3838
113417700201311,CONDO 500,Residential,360,3478,0,3838
113417700201312,CONDO 500,Residential,360,3478,0,3838
113417700201313,CONDO 500,Residential,360,3478,0,3838
113417700201314,CONDO 500,Residential,360,3478,0,3838
113417700201315,CONDO 500,Residential,360,3478,0,3838
113417700201316,CONDO 500,Residential,360,3478,0,3838
113417700201317,CONDO 500,Residential,360,3478,0,3838
113417700201318,CONDO 500,Residential,360,3478,0,3838
113417700201319,CONDO 500,Residential,360,3478,0,3838
113417700201320,CONDO 500,Residential,360,3478,0,3838
113417700201321,CONDO 500,Residential,360,3478,0,3838
113417700201322,CONDO 500,Residential,360,3478,0,3838
113417700201323,CONDO 500,Residential,360,3478,0,3838
113417700201324,CONDO 500,Residential,360,3478,0,3838
113417700201325,CONDO 500,Residential,360,3478,0,3838
113417700201326,CONDO 500,Residential,360,3478,0,3838
113417700201327,CONDO 500,Residential,360,3478,0,3838
113417700201328,CONDO 500,Residential,360,3478,0,3838
113417700201329,CONDO 500,Residential,360,3478,0,3838
113417700201330,CONDO 500,Residential,360,3478,0,3838
113417700201331,CONDO 500,Residential,360,3478,0,3838
113417700300000,E-15 CITY,Exempt,0,0,0,0
113417700400000,E-40 CHURCHES,Exempt,458525,0,558950,1017475
113420100201000,CONDO 501,Residential,15000,102784,0,117784
113420100201001,CONDO 501,Residential,15000,101662,0,116662
113420100201002,CONDO 501,Residential,15000,101662,0,116662
113420100201003,CONDO 501,Residential,15000,102754,0,117754
113420100201004,CONDO 501,Residential,15000,102167,0,117167
113420100201005,CONDO 501,Residential,15000,101662,0,116662
113420100201006,CONDO 501,Residential,15000,101046,0,116046
113420100201007,CONDO 501,Residential,15000,102754,0,117754
113420100201008,CONDO 501,Residential,15000,118933,0,133933
113420100201009,CONDO 501,Residential,15000,107941,0,122941
113420100201010,CONDO 501,Residential,15000,112467,0,127467
113420100201011,CONDO 501,Residential,15000,107941,0,122941
113420100201012,CONDO 501,Residential,15000,137050,0,152050
113420100201013,CONDO 501,Residential,15000,119966,0,134966
113420100201014,CONDO 501,Residential,15000,119966,0,134966
113420100201015,CONDO 501,Residential,15000,117906,0,132906
113420100201016,CONDO 501,Residential,15000,120225,0,135225
113420100201017,CONDO 501,Residential,15000,119995,0,134995
113420100201018,CONDO 501,Residential,15000,120582,0,135582
113420100201019,CONDO 501,Residential,15000,121340,0,136340
113420100201020,CONDO 501,Residential,15000,108999,0,123999
113420100201021,CONDO 501,Residential,15000,116231,0,131231
113420100201022,CONDO 501,Residential,15000,112221,0,127221
113420100201023,CONDO 501,Residential,15000,112970,0,127970
113420100201024,CONDO 501,Residential,15000,121340,0,136340
113420100201025,CONDO 501,Residential,15000,119995,0,134995
113420100201026,CONDO 501,Residential,15000,120582,0,135582
113420100201027,CONDO 501,Residential,15000,121357,0,136357
113420100201028,CONDO 501,Residential,15000,121927,0,136927
113420100201029,CONDO 501,Residential,15000,119995,0,134995
113420100201030,CONDO 501,Residential,15000,119995,0,134995
113420100201031,CONDO 501,Residential,15000,121340,0,136340
113420100201032,CONDO 501,Residential,15000,108999,0,123999
113420100201033,CONDO 501,Residential,15000,108999,0,123999
113420100201034,CONDO 501,Residential,15000,112996,0,127996
113420100201035,CONDO 501,Residential,15000,114349,0,129349
113420100301000,CONDO 501,Residential,15000,115865,0,130865
113420100301001,CONDO 501,Residential,15000,115865,0,130865
113420100301002,CONDO 501,Residential,15000,118558,0,133558
113420100301003,CONDO 501,Residential,15000,115865,0,130865
113420100401000,CONDO 501,Residential,15000,122591,0,137591
113420100401001,CONDO 501,Residential,15000,136126,0,151126
113420100401002,CONDO 501,Residential,15000,121232,0,136232
113420100401003,CONDO 501,Residential,15000,123546,0,138546
113420100401004,CONDO 501,Residential,15000,122591,0,137591
113420100401005,CONDO 501,Residential,15000,121232,0,136232
113420100401006,CONDO 501,Residential,15000,121232,0,136232
113420100401007,CONDO 501,Residential,15000,124168,0,139168
113420100401008,CONDO 501,Residential,15000,115865,0,130865
113420100401009,CONDO 501,Residential,15000,115865,0,130865
113420100401010,CONDO 501,Residential,15000,115865,0,130865
113420100401011,CONDO 501,Residential,15000,115865,0,130865
113420100501000,CONDO 501,Residential,15000,122591,0,137591
113420100501001,CONDO 501,Residential,15000,121232,0,136232
113420100501002,CONDO 501,Residential,15000,121232,0,136232
113420100501003,CONDO 501,Residential,15000,122591,0,137591
113420100501004,CONDO 501,Residential,15000,141683,0,156683
113420100501005,CONDO 501,Residential,15000,121232,0,136232
113420100501006,CONDO 501,Residential,15000,121232,0,136232
113420100501007,CONDO 501,Residential,15000,121938,0,136938
113420100501008,CONDO 501,Residential,15000,115865,0,130865
113420100501009,CONDO 501,Residential,15000,123148,0,138148
113420100501010,CONDO 501,Residential,15000,115865,0,130865
113420100501011,CONDO 501,Residential,15000,123148,0,138148
113420100601000,CONDO 501,Residential,15000,122591,0,137591
113420100601001,CONDO 501,Residential,15000,121232,0,136232
113420100601002,CONDO 501,Residential,15000,121232,0,136232
113420100601003,CONDO 501,Residential,15000,122591,0,137591
113420100601004,CONDO 501,Residential,15000,115865,0,130865
113420100601005,CONDO 501,Residential,15000,115865,0,130865
113420100601006,CONDO 501,Residential,15000,115865,0,130865
113420100601007,CONDO 501,Residential,15000,121805,0,136805
113420100601008,CONDO 501,Residential,15000,122591,0,137591
113420100601009,CONDO 501,Residential,15000,121232,0,136232
113420100601010,CONDO 501,Residential,15000,121232,0,136232
113420100601011,CONDO 501,Residential,15000,122591,0,137591
113420100701000,CONDO 501,Residential,15000,103844,0,118844
113420100701001,CONDO 501,Residential,15000,102710,0,117710
113420100701002,CONDO 501,Residential,15000,102710,0,117710
113420100701003,CONDO 501,Residential,15000,103844,0,118844
113420100701004,CONDO 501,Residential,15000,103844,0,118844
113420100701005,CONDO 501,Residential,15000,102710,0,117710
113420100701006,CONDO 501,Residential,15000,102710,0,117710
113420100701007,CONDO 501,Residential,15000,103844,0,118844
113420100701008,CONDO 501,Residential,15000,114161,0,129161
113420100701009,CONDO 501,Residential,15000,115282,0,130282
113420100701010,CONDO 501,Residential,15000,114161,0,129161
113420100701011,CONDO 501,Residential,15000,114695,0,129695
113420100800000,NE 159,Residential,26384,180229,0,206613
113420100900000,NE 159,Residential,26384,164833,0,191217
113420101000000,NE 159,Residential,26384,206342,0,232726
113420101100000,NE 159,Residential,26384,182738,0,209122
113420101200000,NE 159,Residential,27146,220858,0,248004
113420101300000,NE 159,Residential,28660,184196,0,212856
113420101400000,NE 159,Residential,30531,200846,0,231377
113420101500000,NE 159,Residential,32544,188947,0,221491
113420101600000,NE 159,Residential,29627,195678,0,225305
113420101700000,NE 159,Residential,31920,213301,0,245221
113420101800000,NE 159,Residential,28000,215866,0,243866
113420101900000,NE 159,Residential,30000,209420,0,239420
113420102000000,NE 159,Residential,31387,155117,0,186504
113420102100000,NE 159,Residential,33277,186668,0,219945
113420102200000,NE 159,Residential,32301,159823,0,192124
113420102300000,NE 159,Residential,32556,196879,0,229435
113420102400000,NE 159,Residential,31062,201377,0,232439
113420102500000,NE 159,Residential,31108,169088,0,200196
113420102600000,NE 159,Residential,27624,173373,0,200997
113420102700000,NE 159,Residential,28560,187937,0,216497
113420102800000,NE 159,Residential,32781,172545,0,205326
113420102900000,NE 159,Residential,32769,176893,0,209662
113420103000000,NE 159,Residential,33850,199791,0,233641
113420103100000,NE 159,Residential,32436,221852,0,254288
113420103200000,NE 159,Residential,33266,199771,0,233037
113420103300000,NE 159,Residential,31956,244000,0,275956
113420103400000,NE 159,Residential,28280,180958,0,209238
113420103500000,NE 159,Residential,28280,195895,0,224175
113420103600000,NE 159,Residential,28280,176366,0,204646
113420103700000,NE 159,Residential,32549,172955,0,205504
113420200200000,NE 159,Residential,34560,196356,0,230916
113420200300000,NE 159,Residential,33589,196079,0,229668
113420200400000,NE 159,Residential,32400,155827,0,188227
113420200500000,NE 159,Residential,34043,193340,0,227383
113420200600000,NE 159,Residential,37394,181645,0,219039
113420200700000,NE 159,Residential,37645,184090,0,221735
113420200800000,NE 159,Residential,34191,191223,0,225414
113420200900000,NE 159,Residential,31040,192496,0,223536
113420201000000,NE 159,Residential,29255,169319,0,198574
113420201100000,NE 159,Residential,31601,193418,0,225019
113420201200000,NE 159,Residential,31279,210865,0,242144
113420201300000,NE 159,Residential,32172,219475,0,251647
113420201400000,NE 159,Residential,29044,184998,0,214042
113420201500000,NE 159,Residential,32187,184003,0,216190
113420201600000,NE 159,Residential,28000,171433,0,199433
113420300100000,NE 159,Residential,27936,168776,0,196712
113420300200000,NE 159,Residential,27936,170762,0,198698
113420300300000,NE 159,Residential,29100,144223,0,173323
113420300400000,NE 159,Residential,35578,165355,0,200933
113420300500000,NE 159,Residential,33799,249887,0,283686
113420300600000,NE 159,Residential,34885,204517,0,239402
113420300700000,NE 159,Residential,34064,182921,0,216985
113420400100000,NE 159,Residential,34992,197914,0,232906
113420400200000,NE 159,Residential,32560,181070,0,213630
113420400300000,NE 159,Residential,31803,172474,0,204277
113420400400000,NE 159,Residential,30384,207501,0,237885
113420400500000,NE 159,Residential,33589,189632,0,223221
113420400600000,NE 159,Residential,29476,213133,0,242609
113420400700000,NE 159,Residential,29120,195644,0,224764
113420400800000,NE 159,Residential,33688,169114,0,202802
113420400900000,NE 159,Residential,33283,191874,0,225157
113420500100000,NE 159,Residential,34706,181019,0,215725
113420500200000,NE 159,Residential,46353,200912,0,247265
113420500300000,NE 159,Residential,34454,176957,0,211411
113420500400000,NE 159,Residential,37178,247868,0,285046
113420500500000,NE 159,Residential,37901,204296,0,242197
113420500600000,NE 159,Residential,33451,196086,0,229537
113420500700000,NE 159,Residential,30720,226715,0,257435
113420500800000,NE 159,Residential,31799,181778,0,213577
113420500900000,NE 159,Residential,36557,271702,0,308259
113420501000000,NE 159,Residential,33878,220266,0,254144
113420501100000,NE 159,Residential,34344,244884,0,279228
113420501200000,NE 159,Residential,37255,252292,0,289547
113422600100000,NE 159,Residential,32866,189157,0,222023
113422600200000,NE 159,Residential,29767,193821,0,223588
113422600300000,NE 159,Residential,26000,191472,0,217472
113422600400000,NE 159,Residential,24400,170777,0,195177
113422600500000,NE 159,Residential,27600,210877,0,238477
113422600600000,NE 159,Residential,27467,173064,0,200531
113422600700000,NE 159,Residential,30736,165791,0,196527
113422600800000,NE 159,Residential,29784,166019,0,195803
113422600900000,NE 159,Residential,28661,159968,0,188629
113422601000000,NE 159,Residential,28280,174394,0,202674
113422601100000,NE 159,Residential,32070,219745,0,251815
113422601200000,NE 159,Residential,31360,159742,0,191102
113422601300000,NE 159,Residential,32739,205151,0,237890
113422601400000,NE 159,Residential,31328,178838,0,210166
113422601500000,NE 159,Residential,30720,198345,0,229065
113422601600000,NE 159,Residential,28616,171092,0,199708
113422601700000,NE 159,Residential,27160,163853,0,191013
113422601800000,NE 159,Residential,32635,172584,0,205219
113422601900000,NE 159,Residential,32849,192934,0,225783
113422602000000,NE 159,Residential,27160,208816,0,235976
113422602100000,NE 159,Residential,27160,183532,0,210692
113422700100000,NE 159,Residential,32823,182250,0,215073
113422700200000,NE 159,Residential,31312,184283,0,215595
113422700300000,NE 159,Residential,27160,167458,0,194618
113422700400000,NE 159,Residential,27160,176684,0,203844
113422700500000,NE 159,Residential,27160,182654,0,209814
113422700600000,NE 159,Residential,31393,170014,0,201407
113422700700000,NE 159,Residential,31596,168493,0,200089
113422700800000,NE 159,Residential,27160,207788,0,234948
113422700900000,NE 159,Residential,27160,171278,0,198438
113422701000000,NE 159,Residential,27160,166124,0,193284
113422701100000,NE 159,Residential,27160,196133,0,223293
113422701200000,NE 159,Residential,29488,177172,0,206660
113422701300000,NE 159,Residential,30653,185227,0,215880
113422701400000,NE 159,Residential,29780,167174,0,196954
113422800100000,NE 162,Residential,41350,147653,0,189003
113422800200000,NE 159,Residential,36000,94743,0,130743
113422800300000,NE 159,Residential,34800,0,0,34800
113422800400000,NE 159,Residential,30000,160935,0,190935
113422800500000,NE 159,Residential,30000,163302,0,193302
113422800600000,NE 101,Residential,25200,134524,0,159724
113422800700000,NE 101,Residential,30400,173147,0,203547
113422800800000,NE 159,Residential,31416,148863,0,180279
113422800900000,NE 159,Residential,31416,163822,0,195238
113422801000000,NE 159,Residential,31416,157370,0,188786
113422801100000,NE 159,Residential,31108,149803,0,180911
113422801200000,NE 159,Residential,31108,148468,0,179576
113422801300000,NE 159,Residential,31108,142905,0,174013
113422801400000,NE 159,Residential,32623,163380,0,196003
113422801500000,NE 159,Residential,31512,185643,0,217155
113422801600000,NE 159,Residential,31512,153270,0,184782
113422801700000,NE 159,Residential,31512,155721,0,187233
113422801800000,NE 159,Residential,31512,173976,0,205488
113422801900000,NE 159,Residential,31200,180195,0,211395
113422802000000,NE 159,Residential,31200,163933,0,195133
113422802100000,NE 159,Residential,31200,176596,0,207796
113422802200000,NE 159,Residential,31200,172280,0,203480
113422802300000,NE 159,Residential,32492,131177,0,163669
113422900100000,NE 159,Residential,33712,161480,0,195192
113422900200000,NE 159,Residential,32485,158577,0,191062
113422900300000,NE 159,Residential,32190,182391,0,214581
113422900400000,NE 159,Residential,32362,157814,0,190176
113422900500000,NE 159,Residential,33863,208419,0,242282
113422900600000,NE 159,Residential,32660,166846,0,199506
113422900700000,NE 159,Residential,31808,174475,0,206283
113422900800000,NE 159,Residential,33320,190056,0,223376
113422900900000,NE 159,Residential,30133,161931,0,192064
113422901000000,NE 159,Residential,31311,169593,0,200904
113422901100000,NE 159,Residential,32365,143443,0,175808
113422901200000,NE 159,Residential,30450,158534,0,188984
113422901300000,NE 159,Residential,29120,140242,0,169362
113422901400000,NE 159,Residential,29120,163766,0,192886
113422901500000,NE 159,Residential,29120,147105,0,176225
113422901600000,NE 159,Residential,29120,164031,0,193151
113422901700000,NE 159,Residential,28574,148962,0,177536
113422901800000,NE 159,Residential,32893,174015,0,206908
113422901900000,NE 159,Residential,28549,154277,0,182826
113422902000000,NE 159,Residential,32472,175514,0,207986
113422902100000,NE 159,Residential,30456,158246,0,188702
113422902200000,NE 159,Residential,28800,169315,0,198115
113422902300000,NE 159,Residential,26000,152169,0,178169
113422902400000,NE 159,Residential,26000,162650,0,188650
113423000100000,NE 159,Residential,32171,167212,0,199383
113423000200000,NE 159,Residential,32473,151719,0,184192
113423000300000,NE 159,Residential,33048,166134,0,199182
113423000400000,NE 159,Residential,33928,170895,0,204823
113423000500000,NE 159,Residential,34508,176441,0,210949
113423000600000,NE 159,Residential,31920,184832,0,216752
113423100100000,NE 159,Residential,31280,197038,0,228318
113423100200000,NE 159,Residential,28980,160988,0,189968
113423100300000,NE 159,Residential,30940,156137,0,187077
113423100400000,NE 159,Residential,29744,183024,0,212768
113423100500000,NE 159,Residential,26000,154133,0,180133
113423100600000,NE 159,Residential,26000,157992,0,183992
113423100700000,NE 159,Residential,26000,164856,0,190856
113423100800000,NE 159,Residential,26000,186240,0,212240
113423100900000,NE 159,Residential,26000,140085,0,166085
113423101000000,NE 159,Residential,32535,173089,0,205624
113423101100000,NE 159,Residential,30873,156565,0,187438
113423101200000,NE 159,Residential,30520,179227,0,209747
113423200100000,NE 159,Residential,33002,238086,0,271088
113423200200000,NE 159,Residential,32438,147590,0,180028
113423200300000,NE 159,Residential,27160,156327,0,183487
113423200400000,NE 159,Residential,33326,165980,0,199306
113423200500000,NE 159,Residential,32736,168279,0,201015
113423200600000,NE 159,Residential,32742,171886,0,204628
113423200700000,NE 159,Residential,32695,209305,0,242000
113423200800000,NE 159,Residential,26384,171103,0,197487
113423200900000,NE 159,Residential,296,0,0,296
113423300200000,NE 159,Residential,29999,181099,0,211098
113425100100000,E-15 CITY,Exempt,0,0,0,0
113425200100000,NE 159,Residential,29328,146858,0,176186
113425200200000,NE 159,Residential,35752,168680,0,204432
113425200300000,NE 159,Residential,34200,144167,0,178367
113425300100000,NE 159,Residential,31500,151369,0,182869
113425300200000,NE 159,Residential,30000,158620,0,188620
113425400100000,NE 159,Residential,31416,174423,0,205839
113425400200000,NE 101,Residential,30400,170756,0,201156
113425400300000,E-15 CITY,Exempt,0,0,0,0
113425400400000,NE 159,Residential,32724,164147,0,196871
113425400500000,NE 159,Residential,31416,170478,0,201894
113425400600000,NE 159,Residential,31416,161966,0,193382
113425500100000,NE 159,Residential,32000,171676,0,203676
113425500200000,NE 159,Residential,28000,147231,0,175231
113425500300000,NE 159,Residential,28000,152639,0,180639
113425500400000,NE 159,Residential,28000,179896,0,207896
113425500500000,NE 159,Residential,28000,150717,0,178717
113425500600000,NE 159,Residential,28000,158275,0,186275
113425500700000,NE 159,Residential,28000,155067,0,183067
113425500800000,NE 159,Residential,28000,156814,0,184814
113425500900000,NE 159,Residential,32000,172452,0,204452
113425600200000,COMM NE,Commercial,81216,0,111124,192340
113425600300000,CONDO 506,Residential,224000,0,0,224000
113425600301000,CONDO 500,Residential,7000,68619,0,75619
113425600301001,CONDO 500,Residential,7000,68619,0,75619
113425600301002,CONDO 500,Residential,7000,68619,0,75619
113425600301003,CONDO 500,Residential,7000,66081,0,73081
113425600301004,CONDO 500,Residential,7000,69624,0,76624
113425600301005,CONDO 500,Residential,7000,69624,0,76624
113425600301006,CONDO 500,Residential,7000,69624,0,76624
113425600301007,CONDO 500,Residential,7000,69624,0,76624
113425600301008,CONDO 501,Residential,7000,110843,0,117843
113425600301009,CONDO 501,Residential,7000,137698,0,144698
113425600301010,CONDO 501,Residential,7000,110345,0,117345
113425600301011,CONDO 501,Residential,7000,137698,0,144698
113425600301012,CONDO 500,Residential,7000,69022,0,76022
113425600301013,CONDO 500,Residential,7000,69289,0,76289
113425600301014,CONDO 500,Residential,7000,69289,0,76289
113425600301015,CONDO 500,Residential,7000,69289,0,76289
113425600301016,CONDO 500,Residential,7000,70304,0,77304
113425600301017,CONDO 500,Residential,7000,70304,0,77304
113425600301018,CONDO 500,Residential,7000,70304,0,77304
113425600301019,CONDO 500,Residential,7000,70304,0,77304
113425600301020,CONDO 500,Residential,7000,70304,0,77304
113425600301021,CONDO 500,Residential,7000,70304,0,77304
113425600301022,CONDO 500,Residential,7000,70304,0,77304
113425600301023,CONDO 500,Residential,7000,70304,0,77304
113425600301024,CONDO 500,Residential,7000,69022,0,76022
113425600301025,CONDO 500,Residential,7000,69022,0,76022
113425600301026,CONDO 500,Residential,7000,69289,0,76289
113425600301027,CONDO 500,Residential,7000,69289,0,76289
113425600301028,CONDO 500,Residential,7000,70304,0,77304
113425600301029,CONDO 500,Residential,7000,70304,0,77304
113425600301030,CONDO 500,Residential,7000,70304,0,77304
113425600301031,CONDO 500,Residential,7000,70304,0,77304
113425600301032,CONDO 500,Residential,7000,70304,0,77304
113425600301033,CONDO 500,Residential,7000,70304,0,77304
113425600301034,CONDO 500,Residential,7000,70304,0,77304
113425600301035,CONDO 500,Residential,7000,70304,0,77304
113425600301036,CONDO 500,Residential,7000,69022,0,76022
113425600301037,CONDO 500,Residential,7000,69022,0,76022
113425600301038,CONDO 500,Residential,7000,69289,0,76289
113425600301039,CONDO 500,Residential,7000,69289,0,76289
113425600301040,CONDO 500,Residential,7000,70304,0,77304
113425600301041,CONDO 500,Residential,7000,70304,0,77304
113425600301042,CONDO 500,Residential,7000,70304,0,77304
113425600301043,CONDO 500,Residential,7000,70304,0,77304
113425600301044,CONDO 500,Residential,7000,70304,0,77304
113425600301045,CONDO 500,Residential,7000,70304,0,77304
113425600301046,CONDO 500,Residential,7000,70304,0,77304
113425600301047,CONDO 500,Residential,7000,70304,0,77304
113425600301048,CONDO 501,Residential,7000,111482,0,118482
113425600301049,CONDO 501,Residential,7000,154602,0,161602
113425600301050,CONDO 501,Residential,7000,111842,0,118842
113425600301051,CONDO 501,Residential,7000,152801,0,159801
113425600301052,CONDO 501,Residential,7000,111482,0,118482
113425600301053,CONDO 501,Residential,7000,154980,0,161980
113425600301054,CONDO 501,Residential,7000,111482,0,118482
113425600301055,CONDO 501,Residential,7000,136897,0,143897
113425600301056,CONDO 500,Residential,7000,69099,0,76099
113425600301057,CONDO 500,Residential,7000,69099,0,76099
113425600301058,CONDO 500,Residential,7000,69366,0,76366
113425600301059,CONDO 500,Residential,7000,69366,0,76366
113425600301060,CONDO 500,Residential,7000,70381,0,77381
113425600301061,CONDO 500,Residential,7000,70381,0,77381
113425600301062,CONDO 500,Residential,7000,70381,0,77381
113425600301063,CONDO 500,Residential,7000,70381,0,77381
113425600301064,CONDO 500,Residential,7000,70381,0,77381
113425600301065,CONDO 500,Residential,7000,70381,0,77381
113425600301066,CONDO 500,Residential,7000,70381,0,77381
113425600301067,CONDO 500,Residential,7000,70381,0,77381
113425600301068,CONDO 501,Residential,7000,110726,0,117726
113425600301069,CONDO 501,Residential,7000,139118,0,146118
113425600301070,CONDO 501,Residential,7000,111842,0,118842
113425600301071,CONDO 501,Residential,7000,139118,0,146118
113425600301072,CONDO 501,Residential,7000,144048,0,151048
113425600301073,CONDO 501,Residential,7000,155834,0,162834
113425600301074,CONDO 501,Residential,7000,148387,0,155387
113425600301075,CONDO 501,Residential,7000,157845,0,164845
113425600401000,CONDO 501,Residential,7000,94908,0,101908
113425600401001,CONDO 501,Residential,7000,104582,0,111582
113425600401002,CONDO 501,Residential,7000,94908,0,101908
113425600401003,CONDO 501,Residential,7000,104582,0,111582
113425600401004,CONDO 501,Residential,7000,82401,0,89401
113425600401005,CONDO 501,Residential,7000,90828,0,97828
113425600401006,CONDO 501,Residential,7000,82401,0,89401
113425600401007,CONDO 501,Residential,7000,90828,0,97828
113425600401008,CONDO 501,Residential,7000,104582,0,111582
113425600401009,CONDO 501,Residential,7000,94908,0,101908
113425600401010,CONDO 501,Residential,7000,104582,0,111582
113425600401011,CONDO 501,Residential,7000,94908,0,101908
113425600401012,CONDO 501,Residential,7000,90828,0,97828
113425600401013,CONDO 501,Residential,7000,82401,0,89401
113425600401014,CONDO 501,Residential,7000,90828,0,97828
113425600401015,CONDO 501,Residential,7000,82401,0,89401
113425600401016,CONDO 501,Residential,7000,96381,0,103381
113425600401017,CONDO 501,Residential,7000,96381,0,103381
113425600401018,CONDO 501,Residential,7000,96381,0,103381
113425600401019,CONDO 501,Residential,7000,96381,0,103381
113425600401020,CONDO 501,Residential,7000,96381,0,103381
113425600401021,CONDO 501,Residential,7000,100428,0,107428
113425600401022,CONDO 501,Residential,7000,96381,0,103381
113425600401023,CONDO 501,Residential,7000,96381,0,103381
113425600401024,CONDO 501,Residential,7000,96381,0,103381
113425600401025,CONDO 501,Residential,7000,96381,0,103381
113425700100000,COMM NE,Commercial,230850,0,852830,1083680
113425700200000,COMM NE,Commercial,211950,0,0,211950
113425700300000,COMM NE,Commercial,249750,0,0,249750
113425700401000,CONDO 501,Residential,7000,93713,0,100713
113425700401001,CONDO 501,Residential,7000,93713,0,100713
113425700401002,CONDO 501,Residential,7000,148297,0,155297
113425700401003,CONDO 501,Residential,7000,94695,0,101695
113425700401004,CONDO 501,Residential,7000,148297,0,155297
113425700401005,CONDO 501,Residential,7000,0,0,7000
113425700401006,CONDO 501,Residential,7000,0,0,7000
113425700401007,CONDO 501,Residential,7000,0,0,7000
113425700401008,CONDO 501,Residential,7000,0,0,7000
113425700401009,CONDO 501,Residential,7000,0,0,7000
113425700401010,CONDO 501,Residential,7000,0,0,7000
113425700401011,CONDO 501,Residential,7000,0,0,7000
113425700401012,CONDO 501,Residential,7000,8000,0,15000
113425700401013,CONDO 501,Residential,7000,8000,0,15000
113425700401014,CONDO 501,Residential,7000,149878,0,156878
113425700401015,CONDO 501,Residential,7000,94522,0,101522
113425700401016,CONDO 501,Residential,7000,149878,0,156878
113425800100000,E-15 CITY,Exempt,0,0,0,0
113425900100000,E-15 CITY,Exempt,0,0,0,0
113427600101001,CONDO 501,Residential,25500,197054,0,222554
113427600101002,CONDO 501,Residential,25500,194151,0,219651
113427600101003,CONDO 501,Residential,25500,212406,0,237906
113427600101004,CONDO 501,Residential,25500,212406,0,237906
113427600101005,CONDO 501,Residential,25500,213777,0,239277
113427600101006,CONDO 501,Residential,25500,213777,0,239277
113427600101007,CONDO 501,Residential,25500,187944,0,213444
113427600101008,CONDO 501,Residential,25500,212762,0,238262
113427600101009,CONDO 501,Residential,25500,215201,0,240701
113427600101010,CONDO 501,Residential,25500,216044,0,241544
113427600200000,NE 159,Residential,129200,0,0,129200
113427700101000,CONDO 501,Residential,13000,119434,0,132434
113427700101001,CONDO 501,Residential,13000,119434,0,132434
113427700101002,CONDO 501,Residential,13000,119434,0,132434
113427700101003,CONDO 501,Residential,13000,119434,0,132434
113427700101004,CONDO 501,Residential,13000,119434,0,132434
113427700101005,CONDO 501,Residential,13000,119434,0,132434
113427700101006,CONDO 501,Residential,13000,119434,0,132434
113427700101007,CONDO 501,Residential,13000,119434,0,132434
113427700101008,CONDO 501,Residential,13000,120309,0,133309
113427700101009,CONDO 501,Residential,13000,120309,0,133309
113427700101010,CONDO 501,Residential,13000,120309,0,133309
113427700101011,CONDO 501,Residential,13000,120309,0,133309
113427700101012,CONDO 501,Residential,13000,120309,0,133309
113427700101013,CONDO 501,Residential,13000,120309,0,133309
113427700101014,CONDO 501,Residential,13000,120309,0,133309
113427700101015,CONDO 501,Residential,13000,120309,0,133309
113427700101016,CONDO 501,Residential,13000,120309,0,133309
113427700101017,CONDO 501,Residential,13000,120309,0,133309
113427700101018,CONDO 501,Residential,13000,120309,0,133309
113427700101019,CONDO 501,Residential,13000,120309,0,133309
113427700201000,CONDO 501,Residential,13000,121550,0,134550
113427700201001,CONDO 501,Residential,13000,121550,0,134550
113427700201002,CONDO 501,Residential,13000,121550,0,134550
113427700201003,CONDO 501,Residential,13000,121550,0,134550
113427700201004,CONDO 501,Residential,13000,120309,0,133309
113427700201005,CONDO 501,Residential,13000,120309,0,133309
113427700201006,CONDO 501,Residential,13000,120309,0,133309
113427700201007,CONDO 501,Residential,13000,120309,0,133309
113427700201008,CONDO 501,Residential,13000,120309,0,133309
113427700201009,CONDO 501,Residential,13000,120309,0,133309
113427700201010,CONDO 501,Residential,13000,120309,0,133309
113427700201011,CONDO 501,Residential,13000,120309,0,133309
113427700201012,CONDO 501,Residential,13000,121550,0,134550
113427700201013,CONDO 501,Residential,13000,121550,0,134550
113427700201014,CONDO 501,Residential,13000,121550,0,134550
113427700201015,CONDO 501,Residential,13000,121550,0,134550
113427700201016,CONDO 501,Residential,13000,121550,0,134550
113427700201017,CONDO 501,Residential,13000,121550,0,134550
113427700201018,CONDO 501,Residential,13000,121550,0,134550
113427700201019,CONDO 501,Residential,13000,121550,0,134550
113427700300000,NE 159,Residential,20,0,0,20
113427800200000,NE 159,Residential,34200,89122,0,123322
113427800300000,NE 159,Residential,34200,76815,0,111015
113427800400000,NE 159,Residential,29963,146531,0,176494
113427800500000,NE 159,Residential,27044,145545,0,172589
113427800600000,NE 159,Residential,27040,183075,0,210115
113427800700000,NE 159,Residential,27040,197876,0,224916
113427800800000,NE 159,Residential,26484,176140,0,202624
113427800900000,NE 159,Residential,27004,154867,0,181871
113427801000000,NE 159,Residential,28000,166987,0,194987
113427801100000,NE 159,Residential,27972,133310,0,161282
113427801200000,NE 159,Residential,27960,147422,0,175382
113427801300000,NE 159,Residential,27937,130860,0,158797
113427801400000,NE 159,Residential,29653,156138,0,185791
113427801500000,NE 159,Residential,33914,239322,0,273236
113427801600000,NE 159,Residential,28859,150865,0,179724
113427801700000,NE 159,Residential,27958,186941,0,214899
113427801800000,NE 159,Residential,27300,163076,0,190376
113427801900000,NE 159,Residential,25740,146215,0,171955
113427802000000,NE 159,Residential,29104,163835,0,192939
113427802100000,NE 159,Residential,32429,150574,0,183003
113427802200000,NE 159,Residential,33223,161945,0,195168
113427802300000,NE 159,Residential,32308,144136,0,176444
113427802400000,NE 159,Residential,29680,183935,0,213615
113427802500000,NE 159,Residential,32000,161526,0,193526
113427802600000,NE 159,Residential,26000,160836,0,186836
113427802700000,NE 159,Residential,27820,132962,0,160782
113427802800000,NE 159,Residential,27820,152629,0,180449
113427802900000,NE 159,Residential,27820,187578,0,215398
113427803000000,NE 159,Residential,27420,157105,0,184525
113427803100000,NE 159,Residential,26520,144492,0,171012
113427803200000,NE 159,Residential,26520,136151,0,162671
113427803300000,NE 159,Residential,26520,158378,0,184898
113427803400000,NE 159,Residential,26520,158494,0,185014
113427803500000,NE 159,Residential,112800,0,0,112800
113427900100000,NE 159,Residential,40068,133556,0,173624
113427900200000,NE 159,Residential,32528,184496,0,217024
113427900300000,NE 159,Residential,32528,173116,0,205644
113427900400000,NE 159,Residential,32224,193817,0,226041
113427900500000,NE 159,Residential,37122,209504,0,246626
113427900600000,NE 159,Residential,36520,204285,0,240805
113427900700000,NE 159,Residential,39936,189049,0,228985
113427900800000,NE 159,Residential,40147,180444,0,220591
113427900900000,NE 159,Residential,40768,238967,0,279735
113427901000000,NE 159,Residential,38608,219424,0,258032
113427901100000,NE 159,Residential,38196,249910,0,288106
113427901200000,NE 159,Residential,38991,241864,0,280855
113427901300000,NE 159,Residential,40012,211545,0,251557
113427901400000,NE 159,Residential,38236,234602,0,272838
113427901500000,NE 159,Residential,38236,225408,0,263644
113427901600000,NE 159,Residential,38236,188387,0,226623
113427901700000,NE 159,Residential,38236,218245,0,256481
113427901800000,NE 159,Residential,38236,225975,0,264211
113427901900000,NE 159,Residential,38236,256468,0,294704
113427902000000,NE 159,Residential,38236,232315,0,270551
113427902100000,NE 159,Residential,38236,241427,0,279663
113427902200000,NE 159,Residential,39019,216286,0,255305
113428000100000,NE 159,Residential,31712,206346,0,238058
113428000200000,NE 159,Residential,26000,195398,0,221398
113428000300000,NE 159,Residential,26000,165360,0,191360
113428000400000,NE 159,Residential,26000,177412,0,203412
113428000500000,NE 159,Residential,26000,155913,0,181913
113428000600000,NE 159,Residential,26000,138169,0,164169
113428000700000,NE 159,Residential,26000,169232,0,195232
113428000800000,NE 159,Residential,26000,155836,0,181836
113428000900000,NE 159,Residential,26000,135610,0,161610
113428001000000,NE 159,Residential,26055,146117,0,172172
113428001100000,NE 159,Residential,26323,163950,0,190273
113428001200000,NE 159,Residential,25930,181045,0,206975
113428001300000,NE 159,Residential,25740,188166,0,213906
113428001400000,NE 159,Residential,26000,179921,0,205921
113428001500000,NE 159,Residential,26000,167123,0,193123
113428001600000,NE 159,Residential,26000,164206,0,190206
113428001700000,NE 159,Residential,26000,153393,0,179393
113428001800000,NE 159,Residential,26000,147293,0,173293
113428001900000,NE 159,Residential,26000,189260,0,215260
113428002000000,NE 159,Residential,26000,202572,0,228572
113428002100000,NE 159,Residential,26000,158285,0,184285
113428002200000,NE 159,Residential,31712,193262,0,224974
113430100100000,COMM NE,Commercial,225504,0,143796,369300
113430100200000,E-70 CHARITY OTHER,Exempt,382590,0,1990336,2372926
113430100300000,COMM NE,Commercial,1296,0,0,1296
113430200100000,COMM NE,Commercial,448362,0,0,448362
113430200200000,COMM NE,Commercial,167940,0,4359631,4527571
113432600101000,CONDO 500,Residential,5000,66293,0,71293
113432600101001,CONDO 500,Residential,5000,66293,0,71293
113432600101002,CONDO 500,Residential,5000,65997,0,70997
113432600101003,CONDO 500,Residential,5000,65997,0,70997
113432600101004,CONDO 500,Residential,5000,67418,0,72418
113432600101005,CONDO 500,Residential,5000,67418,0,72418
113432600101006,CONDO 500,Residential,5000,67418,0,72418
113432600101007,CONDO 500,Residential,5000,67418,0,72418
113432600101008,CONDO 500,Residential,5000,67418,0,72418
113432600101009,CONDO 500,Residential,5000,67418,0,72418
113432600101010,CONDO 500,Residential,5000,67418,0,72418
113432600101011,CONDO 500,Residential,5000,67418,0,72418
113432600101012,CONDO 500,Residential,5000,66293,0,71293
113432600101013,CONDO 500,Residential,5000,66293,0,71293
113432600101014,CONDO 500,Residential,5000,65997,0,70997
113432600101015,CONDO 500,Residential,5000,65997,0,70997
113432600101016,CONDO 500,Residential,5000,67418,0,72418
113432600101017,CONDO 500,Residential,5000,67418,0,72418
113432600101018,CONDO 500,Residential,5000,67418,0,72418
113432600101019,CONDO 500,Residential,5000,67418,0,72418
113432600101020,CONDO 500,Residential,5000,67418,0,72418
113432600101021,CONDO 500,Residential,5000,67418,0,72418
113432600101022,CONDO 500,Residential,5000,67418,0,72418
113432600101023,CONDO 500,Residential,5000,67418,0,72418
113432600101024,CONDO 500,Residential,5000,66332,0,71332
113432600101025,CONDO 500,Residential,5000,66332,0,71332
113432600101026,CONDO 500,Residential,5000,66036,0,71036
113432600101027,CONDO 500,Residential,5000,66036,0,71036
113432600101028,CONDO 500,Residential,5000,67457,0,72457
113432600101029,CONDO 500,Residential,5000,67457,0,72457
113432600101030,CONDO 500,Residential,5000,67457,0,72457
113432600101031,CONDO 500,Residential,5000,67457,0,72457
113432600101032,CONDO 500,Residential,5000,67457,0,72457
113432600101033,CONDO 500,Residential,5000,67457,0,72457
113432600101034,CONDO 500,Residential,5000,67457,0,72457
113432600101035,CONDO 500,Residential,5000,67457,0,72457
113432600101036,CONDO 500,Residential,5000,66332,0,71332
113432600101037,CONDO 500,Residential,5000,66332,0,71332
113432600101038,CONDO 500,Residential,5000,66036,0,71036
113432600101039,CONDO 500,Residential,5000,66036,0,71036
113432600101040,CONDO 500,Residential,5000,67457,0,72457
113432600101041,CONDO 500,Residential,5000,67457,0,72457
113432600101042,CONDO 500,Residential,5000,67457,0,72457
113432600101043,CONDO 500,Residential,5000,67457,0,72457
113432600101044,CONDO 500,Residential,5000,67457,0,72457
113432600101045,CONDO 500,Residential,5000,67457,0,72457
113432600101046,CONDO 500,Residential,5000,67457,0,72457
113432600101047,CONDO 500,Residential,5000,67457,0,72457
113432700101000,CONDO 500,Residential,5000,66370,0,71370
113432700101001,CONDO 500,Residential,5000,66370,0,71370
113432700101002,CONDO 500,Residential,5000,66074,0,71074
113432700101003,CONDO 500,Residential,5000,66074,0,71074
113432700101004,CONDO 500,Residential,5000,67495,0,72495
113432700101005,CONDO 500,Residential,5000,67495,0,72495
113432700101006,CONDO 500,Residential,5000,67495,0,72495
113432700101007,CONDO 500,Residential,5000,67495,0,72495
113432700101008,CONDO 500,Residential,5000,67495,0,72495
113432700101009,CONDO 500,Residential,5000,67495,0,72495
113432700101010,CONDO 500,Residential,5000,67495,0,72495
113432700101011,CONDO 500,Residential,5000,67495,0,72495
113432700101012,CONDO 500,Residential,5000,66370,0,71370
113432700101013,CONDO 500,Residential,5000,66370,0,71370
113432700101014,CONDO 500,Residential,5000,66074,0,71074
113432700101015,CONDO 500,Residential,5000,66074,0,71074
113432700101016,CONDO 500,Residential,5000,67495,0,72495
113432700101017,CONDO 500,Residential,5000,67495,0,72495
113432700101018,CONDO 500,Residential,5000,67495,0,72495
113432700101019,CONDO 500,Residential,5000,67495,0,72495
113432700101020,CONDO 500,Residential,5000,67495,0,72495
113432700101021,CONDO 500,Residential,5000,67495,0,72495
113432700101022,CONDO 500,Residential,5000,67495,0,72495
113432700101023,CONDO 500,Residential,5000,67495,0,72495
113432700200000,NE 101,Residential,92700,0,0,92700
113432700300000,NE 108,Residential,27846,66894,0,94740
113432800100000,COMM NE,Commercial,38394,0,0,38394
113432800200000,NE 101,Residential,51050,0,0,51050
113432800300000,COMM NE,Commercial,378540,0,2247584,2626124
113432900101000,CONDO 501,Residential,13500,0,0,13500
113432900101001,CONDO 501,Residential,13500,0,0,13500
113432900101002,CONDO 501,Residential,13500,0,0,13500
113432900101003,CONDO 501,Residential,13500,0,0,13500
113432900101004,CONDO 501,Residential,13500,0,0,13500
113432900101005,CONDO 501,Residential,13500,0,0,13500
113432900101006,CONDO 501,Residential,13500,0,0,13500
113432900101007,CONDO 501,Residential,13500,0,0,13500
113432900101008,CONDO 501,Residential,13500,118688,0,132188
113432900101009,CONDO 501,Residential,13500,130140,0,143640
113432900101010,CONDO 501,Residential,13500,123085,0,136585
113432900101011,CONDO 501,Residential,13500,109333,0,122833
113432900101012,CONDO 501,Residential,13500,119061,0,132561
113432900101013,CONDO 501,Residential,13500,126023,0,139523
113432900101014,CONDO 501,Residential,13500,124853,0,138353
113432900101015,CONDO 501,Residential,13500,110576,0,124076
113432900101016,CONDO 501,Residential,13500,126577,0,140077
113432900101017,CONDO 501,Residential,13500,128181,0,141681
113432900101018,CONDO 501,Residential,13500,125562,0,139062
113432900101019,CONDO 501,Residential,13500,116652,0,130152
113432900101020,CONDO 501,Residential,13500,126543,0,140043
113432900101021,CONDO 501,Residential,13500,132850,0,146350
113432900101022,CONDO 501,Residential,13500,126793,0,140293
113432900101023,CONDO 501,Residential,13500,111908,0,125408
113432900101024,CONDO 501,Residential,13500,119937,0,133437
113432900101025,CONDO 501,Residential,13500,126261,0,139761
113432900101026,CONDO 501,Residential,13500,121044,0,134544
113432900101027,CONDO 501,Residential,13500,114811,0,128311
113432900101028,CONDO 501,Residential,13500,0,0,13500
113432900101029,CONDO 501,Residential,13500,0,0,13500
113432900101030,CONDO 501,Residential,13500,0,0,13500
113432900101031,CONDO 501,Residential,13500,0,0,13500
113432900101032,CONDO 501,Residential,13500,131614,0,145114
113432900101033,CONDO 501,Residential,13500,131325,0,144825
113432900101034,CONDO 501,Residential,13500,134533,0,148033
113432900101035,CONDO 501,Residential,13500,128406,0,141906
113432900101036,CONDO 501,Residential,13500,115654,0,129154
113432900101037,CONDO 501,Residential,13500,117126,0,130626
113432900101038,CONDO 501,Residential,13500,121466,0,134966
113432900101039,CONDO 501,Residential,13500,106920,0,120420
113432900101040,CONDO 501,Residential,13500,110543,0,124043
113432900101041,CONDO 501,Residential,13500,117973,0,131473
113432900101042,CONDO 501,Residential,13500,122434,0,135934
113432900101043,CONDO 501,Residential,13500,110457,0,123957
113432900101044,CONDO 501,Residential,13500,114449,0,127949
113432900101045,CONDO 501,Residential,13500,116673,0,130173
113432900101046,CONDO 501,Residential,13500,117110,0,130610
113432900101047,CONDO 501,Residential,13500,101710,0,115210
113432900200000,COMM NE,Commercial,365580,0,1789091,2154671
113432900300000,COMM NE,Commercial,65610,0,53844,119454
113435100100000,COMM NE,Commercial,369630,0,1085539,1455169
113435100200000,COMM NE,Commercial,282312,0,1122347,1404659
113435100300000,COMM NE,Commercial,54918,0,53844,108762
113435100400000,E-01 FEDERAL,Exempt,0,0,0,0
113435100500000,INDUSTRIAL,Industrial,257200,0,607755,864955
113435100600000,INDUSTRIAL,Industrial,369400,0,2460846,2830246
113435100700000,INDUSTRIAL,Industrial,267400,0,1350424,1617824
113435100900000,COMM NE,Commercial,106245,0,286923,393168
113435200100000,COMM NE,Commercial,228150,0,534050,762200
113435200200000,COMM NE,Commercial,441936,0,2872766,3314702
113435200300000,COMM NE,Commercial,121905,0,426268,548173
113437600100000,COMM NE,Commercial,139050,0,726340,865390
113437600300000,COMM NE,Commercial,182250,0,574793,757043
113437600400000,COMM NE,Commercial,141750,0,705739,847489
113437600600000,COMM NE,Industrial,462213,0,4789171,5251384
113437700100000,COMM NE,Commercial,117180,0,352371,469551
113437700200000,COMM NE,Commercial,123660,0,320661,444321
113437700300000,COMM NE,Commercial,187650,0,0,187650
113437700400000,COMM NE,Commercial,252450,0,0,252450
113437800300000,NE 101,Residential,3700,0,0,3700
113437900100000,COMM NE,Commercial,5789,0,0,5789
113437900200000,Empty,Other,0,0,0,0
113437900300000,COMM NE,Commercial,373842,0,0,373842
113440100100000,NE 110,Exempt,44895,0,190320,235215
113440100200000,APTS NE,Commercial,19683,0,127671,147354
113440100300000,NE 110,Residential,36360,156182,0,192542
113440100400000,NE 110,Residential,36360,185519,0,221879
113440100500000,NE 110,Residential,36360,180409,0,216769
113440100600000,NE 110,Residential,37774,94226,0,132000
113440200100000,NE 110,Residential,16014,101107,0,117121
113440200200000,NE 110,Residential,15908,113758,0,129666
113440200300000,NE 110,Residential,15908,118058,0,133966
113440200400000,NE 110,Residential,15908,117561,0,133469
113440200500000,NE 110,Residential,15908,122666,0,138574
113440200600000,NE 110,Residential,15908,117822,0,133730
113440200700000,NE 110,Residential,15908,103590,0,119498
113440200800000,NE 110,Residential,15908,103618,0,119526
113440200900000,NE 110,Residential,15908,115228,0,131136
113440201000000,NE 110,Residential,15908,116466,0,132374
113440201101000,CONDO 501,Residential,7500,88738,0,96238
113440201101001,CONDO 501,Residential,7500,88899,0,96399
113440201101002,CONDO 501,Residential,7500,88899,0,96399
113440201101003,CONDO 501,Residential,7500,88738,0,96238
113440201101004,CONDO 501,Residential,7500,86175,0,93675
113440201101005,CONDO 501,Residential,7500,88899,0,96399
113440201101006,CONDO 501,Residential,7500,88899,0,96399
113440201101007,CONDO 501,Residential,7500,88738,0,96238
113440201101008,CONDO 501,Residential,7500,91816,0,99316
113440201101009,CONDO 501,Residential,7500,93065,0,100565
113440201101010,CONDO 501,Residential,7500,86336,0,93836
113440201101011,CONDO 501,Residential,7500,88738,0,96238
113440201101012,CONDO 501,Residential,7500,90163,0,97663
113440201101013,CONDO 501,Residential,7500,89806,0,97306
113440201101014,CONDO 501,Residential,7500,92914,0,100414
113440201101015,CONDO 501,Residential,7500,87054,0,94554
113440201101016,CONDO 501,Residential,7500,96118,0,103618
113440201101017,CONDO 501,Residential,7500,89806,0,97306
113440201101018,CONDO 501,Residential,7500,90130,0,97630
113440201101019,CONDO 501,Residential,7500,87054,0,94554
113440201101020,CONDO 501,Residential,7500,90836,0,98336
113440201101021,CONDO 501,Residential,7500,90350,0,97850
113440201101022,CONDO 501,Residential,7500,93724,0,101224
113440201101023,CONDO 501,Residential,7500,90836,0,98336
113440300100000,E-15 CITY,Exempt,0,0,0,0
113440300200000,APTS NE,Commercial,365040,0,3534992,3900032
113440300300000,COMM NE,Commercial,166234,0,650087,816321
113440400100000,NE 110,Residential,19980,125124,0,145104
113440400200000,NE 110,Residential,15750,117452,0,133202
113440400300000,NE 110,Residential,15750,104796,0,120546
113440400400000,NE 110,Residential,15750,104796,0,120546
113440400500000,NE 110,Residential,15750,97641,0,113391
113440400600000,NE 110,Residential,15750,116146,0,131896
113440400700000,NE 110,Residential,15750,108059,0,123809
113440400800000,NE 110,Residential,15750,126616,0,142366
113440400900000,NE 110,Residential,15750,103882,0,119632
113440401000000,NE 110,Residential,15750,124122,0,139872
113440401100000,APTS NE,Commercial,402840,0,1583218,1986058
113440401200000,APTS NE,Commercial,421740,0,1096370,1518110
113442600100000,APTS NE,Commercial,864000,0,7336000,8200000
113445100100000,NE 110,Residential,20358,96354,0,116712
113445100200000,NE 110,Residential,20370,146212,0,166582
113445100300000,NE 110,Residential,20370,118365,0,138735
113445100400000,NE 110,Residential,20370,124570,0,144940
113445100500000,NE 110,Residential,20370,153946,0,174316
113445100600000,NE 110,Residential,20370,140756,0,161126
113445100700000,NE 110,Residential,20370,139298,0,159668
113445100800000,NE 110,Residential,20370,125988,0,146358
113445100900000,NE 110,Residential,20370,114945,0,135315
113445101000000,NE 110,Residential,20370,129503,0,149873
113445101100000,NE 110,Residential,20790,183956,0,204746
113445101200000,NE 110,Residential,21420,177269,0,198689
113445101300000,NE 110,Residential,20318,118276,0,138594
113445101400000,NE 110,Residential,24236,113330,0,137566
113445101500000,NE 110,Residential,24240,138870,0,163110
113445101600000,NE 110,Residential,25785,136806,0,162591
113445200100000,NE 110,Residential,20532,120136,0,140668
113445200200000,NE 110,Residential,19200,113813,0,133013
113445200300000,NE 110,Residential,19200,87872,0,107072
113445200400000,NE 110,Residential,19200,96788,0,115988
113445200500000,NE 110,Residential,19200,110066,0,129266
113445200600000,NE 110,Residential,19200,126614,0,145814
113445200700000,NE 110,Residential,19200,89545,0,108745
113445200800000,NE 110,Residential,19200,101759,0,120959
113445200900000,NE 110,Residential,19206,128611,0,147817
113445201000000,NE 110,Residential,9000,0,0,9000
113445300100000,NE 110,Residential,21823,140890,0,162713
113445300200000,NE 110,Residential,21750,143865,0,165615
113445300300000,NE 110,Residential,21750,99372,0,121122
113445300400000,NE 110,Residential,21750,92344,0,114094
113445300500000,NE 110,Residential,21750,152360,0,174110
113445300600000,NE 110,Residential,21750,133784,0,155534
113445300700000,NE 110,Residential,21750,108520,0,130270
113445300800000,NE 110,Residential,21835,152694,0,174529
113445300900000,NE 110,Residential,21805,153221,0,175026
113445301000000,NE 110,Residential,21750,143450,0,165200
113445301100000,NE 110,Residential,21750,127942,0,149692
113445301200000,NE 110,Residential,21750,141805,0,163555
113445301300000,NE 110,Residential,21750,144236,0,165986
113445301400000,NE 110,Residential,21750,138850,0,160600
113445301500000,NE 110,Residential,21750,114938,0,136688
113445301600000,NE 110,Residential,21900,139574,0,161474
113445301800000,COMM NE,Commercial,272346,0,6306503,6578849
113445301900000,NE 110,Residential,22320,203707,0,226027
113445302000000,NE 110,Residential,23760,163908,0,187668
113445302100000,NE 110,Residential,23760,169332,0,193092
113445302200000,NE 110,Residential,23760,162740,0,186500
113445302300000,NE 110,Residential,24934,0,0,24934
113445302400000,NE 110,Residential,35055,181847,0,216902
113445400100000,NE 110,Residential,22418,140619,0,163037
113445400200000,NE 110,Residential,21750,129810,0,151560
113445400300000,NE 110,Residential,21750,115379,0,137129
113445400400000,NE 110,Residential,21750,110433,0,132183
113445400500000,NE 110,Residential,21750,109915,0,131665
113445400600000,NE 110,Residential,21750,85078,0,106828
113445400700000,NE 110,Residential,21750,128294,0,150044
113445400800000,NE 110,Residential,21779,135981,0,157760
113445401000000,NE 110,Residential,21966,96156,0,118122
113445401100000,NE 110,Residential,21210,111242,0,132452
113445401200000,NE 110,Residential,21210,107677,0,128887
113445401300000,NE 110,Residential,21210,99243,0,120453
113445401400000,NE 110,Residential,21210,155622,0,176832
113445401500000,NE 110,Residential,21210,116866,0,138076
113445401600000,NE 110,Residential,21210,129389,0,150599
113445401700000,NE 110,Residential,24795,111659,0,136454
113445500100000,NE 110,Residential,23562,125630,0,149192
113445500200000,NE 110,Residential,20502,117714,0,138216
113445500300000,NE 110,Residential,20502,126059,0,146561
113445500400000,NE 110,Residential,20502,116435,0,136937
113445500500000,NE 110,Residential,20502,81153,0,101655
113445500600000,NE 110,Residential,20502,117791,0,138293
113445500700000,NE 110,Residential,20502,108094,0,128596
113445500800000,NE 110,Residential,20518,134693,0,155211
113445500900000,NE 110,Residential,21624,92592,0,114216
113445501000000,NE 110,Residential,21624,82195,0,103819
113445501100000,NE 110,Residential,21624,67573,0,89197
113445501200000,NE 110,Residential,21624,77536,0,99160
113445501300000,NE 110,Residential,21624,118811,0,140435
113445501400000,NE 110,Residential,17479,247373,0,264852
113445501500000,NE 110,Residential,23943,229486,0,253429
113445501700000,COMM NE,Commercial,299678,0,1945354,2245032
113445501800000,COMM NE,Commercial,239884,0,0,239884
113445600100000,NE 110,Residential,25680,97348,0,123028
113445700100000,NE 110,Residential,21624,122635,0,144259
113445700200000,NE 110,Residential,21624,87295,0,108919
113445700300000,NE 110,Residential,21624,84158,0,105782
113445700400000,NE 110,Residential,21624,95735,0,117359
113445700500000,NE 110,Residential,21624,72218,0,93842
113445700700000,NE 110,Residential,34339,197135,0,231474
113445700800000,NE 110,Exempt,44215,0,166269,210484
113445800100000,NE 110,Residential,40525,46993,0,87518
113447600100000,E-15 CITY,Exempt,0,0,0,0
113447600201000,CONDO 501,Residential,8000,115018,0,123018
113447600201001,CONDO 501,Residential,8000,118633,0,126633
113447600201002,CONDO 501,Residential,8000,119681,0,127681
113447600201003,CONDO 501,Residential,8000,119681,0,127681
113447600201004,CONDO 501,Residential,8000,119222,0,127222
113447600201005,CONDO 501,Residential,8000,118602,0,126602
113447600301000,CONDO 500,Residential,7000,65217,0,72217
113447600301001,CONDO 500,Residential,7000,62826,0,69826
113447600301002,CONDO 500,Residential,7000,63224,0,70224
113447600301003,CONDO 500,Residential,7000,63246,0,70246
113447600301004,CONDO 500,Residential,7000,63689,0,70689
113447600301005,CONDO 500,Residential,7000,63291,0,70291
113447600301006,CONDO 500,Residential,7000,62826,0,69826
113447600301007,CONDO 500,Residential,7000,65683,0,72683
113447600301008,CONDO 500,Residential,7000,65571,0,72571
113447600301009,CONDO 500,Residential,7090,63179,0,70269
113447600301010,CONDO 500,Residential,7000,63577,0,70577
113447600301011,CONDO 500,Residential,7000,63179,0,70179
113447600301012,CONDO 500,Residential,7000,63179,0,70179
113447600301013,CONDO 500,Residential,7000,63643,0,70643
113447600301014,CONDO 500,Residential,7000,65571,0,72571
113447600301015,CONDO 500,Residential,7000,65571,0,72571
113447600301016,CONDO 500,Residential,200,2941,0,3141
113447600301017,CONDO 500,Residential,200,2941,0,3141
113447600301018,CONDO 500,Residential,200,2941,0,3141
113447600301019,CONDO 500,Residential,200,2941,0,3141
113447600301020,CONDO 500,Residential,200,3150,0,3350
113447600301021,CONDO 500,Residential,200,3150,0,3350
113447600301022,CONDO 500,Residential,200,3150,0,3350
113447600301023,CONDO 500,Residential,200,3150,0,3350
113447600301024,CONDO 500,Residential,200,3150,0,3350
113447600301025,CONDO 500,Residential,200,2941,0,3141
113447600301026,CONDO 500,Residential,200,3150,0,3350
113447600301027,CONDO 500,Residential,200,2941,0,3141
113447600301028,CONDO 500,Residential,200,3109,0,3309
113447600301029,CONDO 500,Residential,200,2903,0,3103
113447600301030,CONDO 500,Residential,200,2903,0,3103
113447600301031,CONDO 500,Residential,200,2903,0,3103
113447600301032,CONDO 500,Residential,200,2903,0,3103
113447600301033,CONDO 500,Residential,200,2903,0,3103
113447600301034,CONDO 500,Residential,200,2903,0,3103
113447600301035,CONDO 500,Residential,200,2903,0,3103
113447600301036,CONDO 500,Residential,200,2903,0,3103
113447600301037,CONDO 500,Residential,200,2903,0,3103
113447600301038,CONDO 500,Residential,200,3109,0,3309
113447600301039,CONDO 500,Residential,200,2903,0,3103
113447600301040,CONDO 500,Residential,200,2903,0,3103
113447600301041,CONDO 500,Residential,200,2903,0,3103
113447600301042,CONDO 500,Residential,200,2903,0,3103
113447600301043,CONDO 500,Residential,200,2903,0,3103
113447600400000,NE 110,Residential,23400,165230,0,188630
113447600500000,NE 110,Residential,22050,162857,0,184907
113447600600000,NE 110,Residential,24570,146525,0,171095
113447600700000,NE 110,Residential,23280,149569,0,172849
113447600800000,NE 110,Residential,23280,144701,0,167981
113447600900000,NE 110,Residential,23280,123914,0,147194
113447601000000,E-15 CITY,Exempt,0,0,0,0
113447601100000,NE 110,Residential,23280,135128,0,158408
113447601200000,NE 110,Residential,23280,150223,0,173503
113447601300000,NE 110,Residential,23280,167505,0,190785
113447601400000,NE 110,Residential,23280,152760,0,176040
113447601500000,NE 110,Residential,23280,138559,0,161839
113447601600000,NE 110,Residential,23280,153420,0,176700
113447601700000,NE 110,Residential,26308,186686,0,212994
113447601900000,E-15 CITY,Exempt,0,0,0,0
113447602000000,NE 110,Residential,29995,138823,0,168818
113447602100000,NE 110,Residential,25543,170457,0,196000
113447602200000,NE 110,Residential,22407,176246,0,198653
113447602300000,NE 110,Residential,26279,136120,0,162399
113447602400000,NE 110,Residential,27535,234734,0,262269
113447602500000,NE 110,Residential,24444,117826,0,142270
113447602600000,NE 110,Residential,24444,145380,0,169824
113447602700000,NE 110,Residential,24444,152512,0,176956
113447602800000,NE 110,Residential,24444,153147,0,177591
113447602900000,NE 110,Residential,24444,172339,0,196783
113447603000000,NE 110,Residential,24668,167034,0,191702
113447603100000,NE 110,Residential,22407,131531,0,153938
113447603200000,NE 110,Residential,22344,142108,0,164452
113447700100000,NE 110,Residential,25180,157739,0,182919
113447700200000,NE 110,Residential,22135,149073,0,171208
113447700300000,NE 110,Residential,25235,174606,0,199841
113447700400000,NE 110,Residential,25645,145683,0,171328
113447700500000,NE 110,Residential,25584,151753,0,177337
113447700600000,NE 110,Residential,23456,168940,0,192396
113447700700000,NE 110,Residential,23280,180936,0,204216
113447700800000,NE 110,Residential,23280,132231,0,155511
113447700900000,NE 110,Residential,23280,145797,0,169077
113447701000000,NE 110,Residential,23280,175143,0,198423
113447701100000,NE 110,Residential,23280,158899,0,182179
113447701200000,NE 110,Residential,23280,128897,0,152177
113447701300000,NE 110,Residential,23280,136720,0,160000
113447701400000,NE 110,Residential,23280,145998,0,169278
113447701500000,NE 110,Residential,23280,139488,0,162768
113447701600000,NE 110,Residential,24925,167253,0,192178
113447701700000,NE 110,Residential,23026,147294,0,170320
113447701800000,NE 110,Residential,22050,106053,0,128103
113447701900000,NE 110,Residential,22680,126458,0,149138
113447702000000,NE 110,Residential,22365,90449,0,112814
113447702100000,NE 110,Residential,22365,111314,0,133679
113447702200000,NE 110,Residential,22365,140442,0,162807
113447702300000,NE 110,Residential,22365,0,0,22365
113447702400000,NE 110,Residential,22680,102287,0,124967
113447702500000,NE 110,Residential,22050,148234,0,170284
113447702600000,NE 110,Residential,22578,142956,0,165534
113447702700000,NE 110,Residential,23004,128349,0,151353
113447702800000,NE 110,Residential,23430,132513,0,155943
113447702900000,NE 110,Residential,22650,168338,0,190988
113447703000000,NE 110,Residential,20661,140977,0,161638
113447703100000,NE 110,Residential,20661,105906,0,126567
113447703200000,NE 110,Residential,21880,100669,0,122549
113447703300000,NE 110,Residential,22968,46190,0,69158
113447800100000,NE 110,Residential,18793,89489,0,108282
113447800200000,NE 110,Residential,19176,135693,0,154869
113447800300000,NE 110,Residential,19176,142803,0,161979
113447800400000,NE 110,Residential,19176,111419,0,130595
113447800500000,NE 110,Residential,19380,110593,0,129973
113447800600000,NE 110,Residential,19992,117002,0,136994
113447800700000,NE 110,Residential,20400,128860,0,149260
113447800800000,NE 110,Residential,20554,150823,0,171377
113447800900000,NE 110,Residential,22842,116567,0,139409
113447801000000,NE 110,Residential,22312,118999,0,141311
113447900100000,NE 110,Residential,20370,145520,0,165890
113447900200000,NE 110,Residential,20370,123473,0,143843
113447900300000,NE 110,Residential,22464,135074,0,157538
113447900400000,NE 110,Residential,22464,137039,0,159503
113447900500000,NE 110,Residential,21216,117490,0,138706
113447900600000,NE 110,Residential,23712,138358,0,162070
113447900700000,NE 110,Residential,22464,147383,0,169847
113447900800000,NE 110,Residential,22464,112128,0,134592
113447900900000,NE 110,Residential,23850,115559,0,139409
113512600200000,NE 107,Residential,24629,125827,0,150456
113512600300000,NE 107,Residential,21420,137475,0,158895
113512600400000,NE 107,Residential,22950,145390,0,168340
113512600500000,NE 107,Residential,21806,132279,0,154085
113512600600000,NE 107,Residential,23868,165471,0,189339
113512600700000,NE 107,Residential,22360,130710,0,153070
113512600800000,NE 107,Residential,21945,153039,0,174984
113512600900000,NE 107,Residential,22091,130782,0,152873
113512601000000,NE 107,Residential,23532,156329,0,179861
113512601100000,NE 107,Residential,23714,135114,0,158828
113512601200000,NE 107,Residential,24033,141209,0,165242
113512601300000,NE 107,Residential,24720,141984,0,166704
113512601400000,NE 107,Residential,26249,144114,0,170363
113512601500000,NE 107,Residential,25509,130531,0,156040
113512601600000,NE 107,Residential,722,0,0,722
113512601700000,NE 107,Residential,699,0,0,699
113512700100000,NE 107,Residential,690,0,0,690
113512700200000,NE 107,Residential,495,0,0,495
113512700300000,NE 107,Residential,23460,128540,0,152000
113512700400000,NE 107,Residential,25086,169071,0,194157
113512700500000,NE 107,Residential,25335,104778,0,130113
113512700600000,NE 107,Residential,24840,132732,0,157572
113512700700000,NE 107,Residential,24920,142125,0,167045
113512700800000,NE 107,Residential,4625,0,0,4625
113512800100000,NE 107,Residential,26006,132482,0,158488
113512800200000,NE 107,Residential,18900,112077,0,130977
113512800300000,NE 107,Residential,25233,144614,0,169847
113512800400000,NE 107,Residential,20867,146522,0,167389
113512800500000,NE 107,Residential,22087,130217,0,152304
113512800600000,NE 107,Residential,21534,134623,0,156157
113512800700000,NE 107,Residential,21825,131126,0,152951
113512800800000,NE 107,Residential,22795,113944,0,136739
113512800900000,NE 107,Residential,21470,120146,0,141616
113512801000000,NE 107,Residential,25568,118019,0,143587
113512801100000,NE 107,Residential,26706,139019,0,165725
113512801200000,NE 107,Residential,23128,116574,0,139702
113512801300000,NE 107,Residential,24726,150368,0,175094
113512801400000,NE 107,Residential,23280,125440,0,148720
113512801500000,NE 107,Residential,22800,160518,0,183318
113512801600000,NE 107,Residential,22922,145567,0,168489
113512801700000,NE 107,Residential,20756,122571,0,143327
113512801800000,NE 107,Residential,23467,122214,0,145681
113512801900000,NE 107,Residential,25346,157614,0,182960
113512900100000,NE 107,Residential,24225,144768,0,168993
113512900200000,NE 107,Residential,21473,156503,0,177976
113512900300000,NE 107,Residential,23981,137788,0,161769
113512900400000,NE 107,Residential,24990,152778,0,177768
113512900500000,NE 107,Residential,23265,135653,0,158918
113512900600000,NE 107,Residential,22610,135101,0,157711
113512900700000,NE 107,Residential,22543,147857,0,170400
113512900800000,NE 107,Residential,23086,124666,0,147752
113512900900000,NE 107,Residential,23302,147861,0,171163
113512901000000,NE 107,Residential,21630,134228,0,155858
113512901100000,NE 107,Residential,25245,152666,0,177911
113512901200000,NE 107,Residential,26124,101158,0,127282
113512901300000,NE 107,Residential,21459,105398,0,126857
113512901400000,NE 107,Residential,22800,147095,0,169895
113512901500000,NE 107,Residential,24336,130370,0,154706
113515100100000,NE 107,Residential,4100,0,0,4100
113515100200000,NE 107,Residential,24211,132630,0,156841
113515100300000,NE 107,Residential,23250,142135,0,165385
113515100400000,NE 107,Residential,22816,123463,0,146279
113515100500000,NE 107,Residential,22560,123226,0,145786
113515100600000,NE 107,Residential,21181,99668,0,120849
113515100700000,NE 107,Residential,22295,109317,0,131612
113515100800000,NE 107,Residential,19600,131235,0,150835
113515100900000,NE 107,Residential,23616,127609,0,151225
113515101000000,NE 107,Residential,24057,112988,0,137045
113515200100000,NE 107,Residential,20807,136705,0,157512
113515200200000,NE 107,Residential,21298,128686,0,149984
113515200300000,NE 107,Residential,19896,126462,0,146358
113515200400000,NE 107,Residential,24582,142333,0,166915
113515200500000,NE 107,Residential,24000,118911,0,142911
113515200600000,NE 107,Residential,19080,100281,0,119361
113515200700000,NE 107,Residential,17395,123102,0,140497
113515200800000,NE 107,Residential,18334,100650,0,118984
113515200900000,NE 107,Residential,18612,98034,0,116646
113515201000000,NE 107,Residential,18246,97414,0,115660
113515201100000,NE 107,Residential,23226,101641,0,124867
113515201200000,NE 107,Residential,23226,100192,0,123418
113515201300000,NE 107,Residential,23226,112766,0,135992
113515201400000,NE 107,Residential,18963,122434,0,141397
113515201500000,NE 107,Residential,23520,111907,0,135427
113515201600000,NE 107,Residential,22089,108009,0,130098
113515201700000,NE 107,Residential,23610,103573,0,127183
113515201800000,NE 107,Residential,25114,138094,0,163208
113515201900000,NE 106,Residential,47040,273628,0,320668
113515202000000,NE 106,Residential,44109,182461,0,226570
113515202100000,NE 106,Residential,45485,253749,0,299234
113515202200000,NE 106,Residential,47740,213012,0,260752
113515202300000,NE 106,Residential,46464,231236,0,277700
113515202400000,NE 106,Residential,45148,241987,0,287135
113515202500000,NE 106,Residential,42984,220933,0,263917
113515202600000,NE 106,Residential,41333,231830,0,273163
113515202700000,NE 106,Residential,42432,304438,0,346870
113515202800000,NE 106,Residential,40000,252543,0,292543
113515202900000,NE 106,Residential,44687,0,0,44687
113515203000000,NE 106,Residential,42132,268622,0,310754
113515203100000,NE 106,Residential,48433,206858,0,255291
113515203200000,NE 106,Residential,45256,320071,0,365327
113515203300000,NE 106,Residential,42213,313374,0,355587
113515203400000,NE 106,Residential,36000,231660,0,267660
113515203500000,NE 106,Residential,45150,268794,0,313944
113515203600000,NE 106,Residential,48062,249419,0,297481
113515203700000,NE 106,Residential,46652,306499,0,353151
113515203800000,NE 106,Residential,43200,265719,0,308919
113515203900000,NE 106,Residential,44336,237653,0,281989
113515204000000,NE 106,Residential,46512,265306,0,311818
113515204100000,NE 106,Residential,40307,234681,0,274988
113515204200000,NE 106,Residential,40280,237397,0,277677
113515204300000,NE 106,Residential,42400,255769,0,298169
113515204400000,NE 106,Residential,40280,271181,0,311461
113515204500000,NE 106,Residential,40280,301918,0,342198
113515204600000,NE 106,Residential,47064,261437,0,308501
113515300100000,NE 106,Residential,42776,241576,0,284352
113515300200000,NE 106,Residential,43200,317212,0,360412
113515300300000,NE 106,Residential,46080,275911,0,321991
113515300400000,NE 106,Residential,40615,251011,0,291626
113515300500000,NE 106,Residential,43228,230628,0,273856
113515300600000,NE 106,Residential,40400,275149,0,315549
113515300700000,NE 106,Residential,40400,300992,0,341392
113515300800000,NE 106,Residential,40400,215721,0,256121
113515300900000,NE 106,Residential,39053,272054,0,311107
113515301000000,NE 106,Residential,47700,212220,0,259920
113515301100000,NE 106,Residential,48434,312846,0,361280
113515301200000,NE 106,Residential,42420,287709,0,330129
113515301300000,NE 106,Residential,43313,312010,0,355323
113515301400000,NE 106,Residential,45640,296097,0,341737
113515400100000,NE 107,Residential,22080,100980,0,123060
113515400200000,NE 107,Residential,17802,107820,0,125622
113515400300000,NE 107,Residential,17802,143069,0,160871
113515400400000,NE 107,Residential,20976,153821,0,174797
113515400500000,NE 107,Residential,21925,152020,0,173945
113515400600000,COMM NE,Commercial,34128,0,106492,140620
113515500100000,Empty,Exempt,0,0,0,0
113520100100000,NE 160,Residential,29191,169144,0,198335
113520100200000,NE 160,Residential,29565,231788,0,261353
113520100300000,NE 160,Residential,29021,164750,0,193771
113520200100000,NE 160,Residential,30047,208819,0,238866
113520200200000,NE 160,Residential,30256,229467,0,259723
113520300100000,NE 160,Residential,376,0,0,376
113520300200000,NE 160,Residential,39700,215694,0,255394
113520300300000,NE 107,Residential,23256,158732,0,181988
113520300400000,NE 107,Residential,19585,119027,0,138612
113520400100000,NE 160,Residential,29820,169750,0,199570
113520400200000,NE 160,Residential,28728,207605,0,236333
113520400300000,NE 160,Residential,28728,171638,0,200366
113520400400000,NE 160,Residential,28728,193215,0,221943
113520400500000,NE 160,Residential,30164,187858,0,218022
113520400600000,NE 160,Residential,29566,199209,0,228775
113520400700000,NE 160,Residential,28998,156981,0,185979
113520400800000,NE 160,Residential,30444,192629,0,223073
113520400900000,NE 160,Residential,28994,192654,0,221648
113520401000000,NE 160,Residential,28994,184183,0,213177
113520401100000,NE 160,Residential,30444,212413,0,242857
113520401200000,NE 160,Residential,30479,209246,0,239725
113520401300000,NE 160,Residential,31696,198561,0,230257
113520401400000,NE 160,Residential,28616,188280,0,216896
113520401500000,NE 160,Residential,31371,210379,0,241750
113520401600000,NE 105,Residential,25524,188009,0,213533
113520401700000,NE 105,Residential,24960,164860,0,189820
113520401800000,NE 105,Residential,24450,157339,0,181789
113520401900000,NE 105,Residential,25380,174832,0,200212
113520402000000,NE 160,Residential,24486,199858,0,224344
113520402100000,NE 160,Residential,25583,178599,0,204182
113520402200000,NE 160,Residential,25405,182313,0,207718
113520402300000,NE 160,Residential,25112,171112,0,196224
113520402400000,NE 160,Residential,25304,174961,0,200265
113520402500000,NE 160,Residential,25310,179178,0,204488
113520402600000,NE 160,Residential,25511,175510,0,201021
113520402700000,NE 160,Residential,26573,159025,0,185598
113520402800000,NE 160,Residential,26732,202593,0,229325
113520402900000,NE 160,Residential,25582,156488,0,182070
113520403000000,NE 160,Residential,24716,146739,0,171455
113520403100000,NE 160,Residential,23188,155310,0,178498
113520403200000,NE 160,Residential,23410,192978,0,216388
113520403300000,NE 160,Residential,23760,187323,0,211083
113520403400000,NE 160,Residential,24415,187620,0,212035
113520403500000,NE 160,Residential,23661,174136,0,197797
113520403600000,NE 160,Residential,23923,195203,0,219126
113520403700000,NE 105,Residential,25140,159570,0,184710
113520403800000,NE 105,Residential,25029,149535,0,174564
113520403900000,NE 105,Residential,23175,145068,0,168243
113520404000000,NE 107,Residential,23175,146077,0,169252
113520404100000,NE 107,Residential,24952,164808,0,189760
113520404200000,NE 107,Residential,24720,159901,0,184621
113520404300000,NE 107,Residential,25029,169282,0,194311
113520404400000,NE 107,Residential,24658,174258,0,198916
113520404500000,NE 107,Residential,24720,174542,0,199262
113520404600000,NE 107,Residential,22681,153438,0,176119
113520404700000,NE 107,Residential,24720,153444,0,178164
113520404800000,NE 107,Residential,24720,182387,0,207107
113520404900000,NE 107,Residential,23175,162327,0,185502
113520405000000,NE 107,Residential,26164,185164,0,211328
113520405100000,NE 160,Residential,30234,173989,0,204223
113520405200000,NE 160,Residential,33088,204895,0,237983
113520500100000,NE 107,Residential,25650,157453,0,183103
113520500200000,NE 107,Residential,21000,138628,0,159628
113520500300000,NE 107,Residential,21000,129889,0,150889
113520500400000,NE 107,Residential,21000,200199,0,221199
113520500500000,NE 107,Residential,24000,151195,0,175195
113520500600000,NE 107,Residential,24000,170881,0,194881
113520600100000,NE 107,Residential,25650,166914,0,192564
113520600200000,NE 107,Residential,20909,139214,0,160123
113520600300000,NE 107,Residential,23760,144790,0,168550
113520600400000,NE 107,Residential,22275,137200,0,159475
113520600500000,NE 107,Residential,23760,153737,0,177497
113520600600000,NE 107,Residential,22275,127562,0,149837
113520600700000,NE 107,Residential,22050,140495,0,162545
113520600800000,NE 107,Residential,25707,143959,0,169666
113520600900000,NE 107,Residential,22725,160624,0,183349
113520601000000,NE 107,Residential,22671,165499,0,188170
113520601100000,NE 107,Residential,25688,171004,0,196692
113520601200000,NE 107,Residential,25618,179037,0,204655
113520601300000,NE 107,Residential,24948,201082,0,226030
113520601400000,NE 107,Residential,25531,141741,0,167272
113520601500000,NE 107,Residential,26283,149923,0,176206
113520601600000,NE 107,Residential,27078,194474,0,221552
113520601700000,NE 107,Residential,25393,197874,0,223267
113520601800000,NE 107,Residential,25554,182856,0,208410
113520601900000,NE 107,Residential,25650,167782,0,193432
113520602000000,NE 107,Residential,22800,138432,0,161232
113520700100000,NE 107,Residential,25920,167206,0,193126
113520700200000,NE 107,Residential,20790,155454,0,176244
113520700300000,NE 105,Residential,22119,132845,0,154964
113520700400000,NE 105,Residential,25755,160092,0,185847
113520700500000,NE 105,Residential,25436,147789,0,173225
113520700600000,NE 105,Residential,25440,152297,0,177737
113520700700000,NE 105,Residential,25758,165955,0,191713
113520700800000,NE 105,Residential,25492,157482,0,182974
113520700900000,NE 107,Residential,21879,157615,0,179494
113520701000000,NE 107,Residential,23520,164904,0,188424
113520701100000,NE 107,Residential,22134,132320,0,154454
113520701200000,NE 107,Residential,21420,155242,0,176662
113520800100000,NE 107,Residential,25398,148216,0,173614
113520800200000,NE 107,Residential,19081,125249,0,144330
113520800300000,NE 107,Residential,19740,142828,0,162568
113520800400000,NE 107,Residential,26289,158567,0,184856
113522600100000,NE 105,Residential,24359,166936,0,191295
113522600200000,NE 105,Residential,25175,197472,0,222647
113522600300000,NE 105,Residential,23979,143433,0,167412
113522600400000,NE 105,Residential,24122,147690,0,171812
113522600500000,NE 105,Residential,23562,162289,0,185851
113522600600000,NE 105,Residential,23256,194205,0,217461
113522600700000,NE 105,Residential,22644,168908,0,191552
113522600800000,NE 105,Residential,24174,172144,0,196318
113522600900000,NE 105,Residential,23890,136856,0,160746
113522601000000,NE 105,Residential,25420,157439,0,182859
113522601100000,NE 105,Residential,29057,157276,0,186333
113522601200000,NE 105,Residential,24800,174788,0,199588
113522601300000,NE 105,Residential,25741,197433,0,223174
113522700100000,NE 105,Residential,28187,166125,0,194312
113522700200000,NE 105,Residential,26386,203433,0,229819
113522700300000,NE 105,Residential,25962,196940,0,222902
113522700400000,NE 105,Residential,25756,169208,0,194964
113522700500000,NE 105,Residential,25436,162258,0,187694
113522700600000,NE 105,Residential,25596,167859,0,193455
113522700700000,NE 105,Residential,23400,171862,0,195262
113522700800000,NE 105,Residential,25463,178947,0,204410
113522800100000,NE 105,Residential,27343,148497,0,175840
113522800200000,NE 105,Residential,25970,180194,0,206164
113522800300000,NE 105,Residential,26365,108000,0,134365
113522800400000,NE 105,Residential,22567,174131,0,196698
113522800500000,NE 105,Residential,20677,141841,0,162518
113522800600000,NE 105,Residential,24627,165232,0,189859
113522800700000,NE 105,Residential,22746,154377,0,177123
113522800800000,NE 105,Residential,24523,167106,0,191629
113522800900000,NE 105,Residential,24232,152817,0,177049
113522801000000,NE 105,Residential,23634,146682,0,170316
113522801100000,NE 105,Residential,25858,154281,0,180139
113522801200000,NE 105,Residential,25188,141210,0,166398
113522801300000,NE 105,Residential,24480,131192,0,155672
113522801400000,NE 105,Residential,22950,141778,0,164728
113522801500000,NE 105,Residential,24480,130675,0,155155
113522801600000,NE 105,Residential,22950,141308,0,164258
113522801700000,NE 105,Residential,24480,153419,0,177899
113522801800000,NE 105,Residential,22950,138844,0,161794
113522801900000,NE 105,Residential,26010,153483,0,179493
113522802000000,NE 105,Residential,25102,170897,0,195999
113522802100000,NE 105,Residential,23406,145942,0,169348
113522900100000,NE 105,Residential,25718,167674,0,193392
113522900200000,NE 105,Residential,22680,156212,0,178892
113522900300000,NE 105,Residential,25200,153630,0,178830
113522900400000,NE 105,Residential,25941,144659,0,170600
113522900500000,NE 105,Residential,22344,151636,0,173980
113522900600000,NE 105,Residential,22344,131277,0,153621
113522900700000,NE 105,Residential,25380,144229,0,169609
113522900800000,NE 105,Residential,24255,179755,0,204010
113522900900000,NE 105,Residential,23625,131071,0,154696
113522901000000,NE 105,Residential,25291,138056,0,163347
113522901100000,NE 105,Residential,23573,151019,0,174592
113522901200000,NE 105,Residential,22990,183405,0,206395
113523000100000,NE 105,Exempt,25273,0,171515,196788
113523000200000,NE 105,Residential,24243,188551,0,212794
113523000300000,NE 105,Residential,24354,164886,0,189240
113523000400000,NE 105,Residential,24857,148629,0,173486
113523000500000,NE 105,Residential,24960,148683,0,173643
113523000600000,NE 105,Residential,24960,185382,0,210342
113523000700000,NE 105,Residential,23712,165173,0,188885
113523000800000,NE 105,Residential,26076,179629,0,205705
113523000900000,NE 105,Residential,24597,182404,0,207001
113523001000000,NE 105,Residential,24388,156258,0,180646
113523001100000,NE 105,Residential,24480,152285,0,176765
113523001200000,NE 105,Residential,24072,154659,0,178731
113523001300000,NE 105,Residential,23358,171745,0,195103
113523001400000,NE 105,Residential,23690,161775,0,185465
113523001500000,NE 105,Residential,22725,151450,0,174175
113523001600000,NE 105,Residential,25236,158347,0,183583
113523001700000,NE 105,Residential,22500,126106,0,148606
113523001800000,NE 105,Residential,24452,148368,0,172820
113523001900000,NE 105,Residential,25532,124553,0,150085
113523002000000,NE 105,Residential,25271,168827,0,194098
113523002100000,NE 105,Residential,22725,125014,0,147739
113523002200000,NE 105,Residential,24240,151971,0,176211
113523002300000,NE 105,Residential,26260,145546,0,171806
113523002400000,NE 105,Residential,22725,153801,0,176526
113523002500000,NE 105,Residential,24240,124264,0,148504
113523002600000,NE 105,Residential,25927,145048,0,170975
113523002700000,NE 105,Residential,25650,163460,0,189110
113523002800000,NE 105,Residential,25398,123014,0,148412
113523002900000,NE 105,Residential,24824,147423,0,172247
113523003000000,NE 105,Residential,26190,138740,0,164930
113523003100000,NE 105,Residential,23680,146549,0,170229
113523003200000,NE 105,Residential,24174,140993,0,165167
113523003300000,NE 105,Residential,20624,127026,0,147650
113523003400000,NE 105,Residential,25264,119682,0,144946
113523003500000,NE 105,Residential,26275,155459,0,181734
113523003600000,NE 105,Residential,21930,121244,0,143174
113523003700000,NE 105,Residential,24585,155679,0,180264
113523003800000,NE 105,Residential,22800,147787,0,170587
113523003900000,NE 105,Residential,24558,147065,0,171623
113523004000000,NE 105,Residential,23833,117010,0,140843
113523004100000,NE 105,Residential,25789,180217,0,206006
113523004200000,NE 105,Residential,25586,172958,0,198544
113523004300000,NE 105,Residential,25137,172432,0,197569
113523004400000,NE 105,Residential,25200,159130,0,184330
113523004500000,NE 105,Residential,25224,153442,0,178666
113523004600000,NE 105,Residential,24648,154442,0,179090
113523004700000,NE 105,Residential,24495,126173,0,150668
113523004800000,NE 105,Residential,24735,178287,0,203022
113523100100000,NE 105,Residential,26254,154468,0,180722
113523100200000,NE 105,Residential,23814,160716,0,184530
113523100300000,NE 105,Residential,23955,156381,0,180336
113523100400000,NE 105,Residential,25800,169149,0,194949
113523100500000,NE 105,Residential,26343,171422,0,197765
113523100600000,NE 105,Residential,25440,167717,0,193157
113523100700000,NE 105,Residential,25393,158785,0,184178
113523100800000,NE 105,Residential,26299,135307,0,161606
113523100900000,NE 105,Residential,25494,172239,0,197733
113525100100000,NE 107,Residential,25240,129329,0,154569
113525100200000,NE 107,Residential,23197,153457,0,176654
113525100300000,NE 107,Residential,22800,174200,0,197000
113525100400000,NE 107,Residential,23040,175740,0,198780
113525100500000,NE 107,Residential,23280,161720,0,185000
113525100600000,NE 107,Residential,22275,134490,0,156765
113525100700000,NE 107,Residential,24000,160955,0,184955
113525100800000,NE 107,Residential,25500,165594,0,191094
113525100900000,NE 107,Residential,24000,187715,0,211715
113525101000000,NE 107,Residential,28350,179332,0,207682
113525101100000,NE 107,Residential,24000,189538,0,213538
113525101200000,NE 107,Residential,24000,192532,0,216532
113525101300000,NE 107,Residential,24000,166065,0,190065
113525101400000,NE 107,Residential,21600,0,0,21600
113525101500000,NE 107,Residential,24000,176357,0,200357
113525101600000,NE 107,Residential,23818,140126,0,163944
113525101700000,NE 107,Residential,26196,123927,0,150123
113525101800000,NE 107,Residential,23180,171799,0,194979
113525200100000,NE 107,Residential,25888,156778,0,182666
113525200200000,NE 107,Residential,25942,187117,0,213059
113525200300000,NE 107,Residential,27841,201899,0,229740
113525200400000,NE 107,Residential,29129,191962,0,221091
113525200500000,NE 107,Residential,26058,178238,0,204296
113525200600000,NE 107,Residential,23886,186991,0,210877
113525200700000,NE 107,Residential,23496,0,0,23496
113525200800000,NE 107,Residential,23100,155037,0,178137
113525300100000,NE 107,Residential,20952,121686,0,142638
113525300200000,NE 107,Residential,20708,110630,0,131338
113525300300000,NE 107,Residential,24948,93513,0,118461
113525300400000,NE 107,Residential,20790,117278,0,138068
113525300500000,NE 107,Residential,25200,97708,0,122908
113525300600000,NE 107,Residential,23400,125413,0,148813
113525300700000,NE 107,Residential,21210,125585,0,146795
113525300800000,NE 107,Residential,21420,115672,0,137092
113525300900000,NE 107,Residential,19931,127609,0,147540
113525301000000,NE 107,Residential,25404,107254,0,132658
113525301100000,NE 107,Residential,24150,134253,0,158403
113525301200000,NE 107,Residential,23833,125504,0,149337
113525301300000,NE 107,Residential,22157,91993,0,114150
113525301400000,NE 107,Residential,25975,113139,0,139114
113525301500000,NE 107,Residential,23310,85723,0,109033
113525301600000,NE 107,Residential,25260,97656,0,122916
113525301700000,NE 107,Residential,25210,130625,0,155835
113525301800000,NE 107,Residential,25525,125971,0,151496
113525301900000,NE 107,Residential,26031,101639,0,127670
113525302000000,NE 107,Residential,24010,91747,0,115757
113525302100000,NE 107,Residential,24010,113286,0,137296
113525302200000,NE 107,Residential,24010,98984,0,122994
113525302300000,NE 107,Residential,24010,106422,0,130432
113525400100000,NE 107,Residential,30278,249554,0,279832
113525400200000,NE 107,Residential,28080,205176,0,233256
113525400300000,NE 107,Residential,31489,225225,0,256714
113525400400000,NE 107,Residential,26634,110066,0,136700
113525400500000,NE 107,Residential,25725,133884,0,159609
113525400600000,NE 107,Residential,24873,108277,0,133150
113525400700000,NE 107,Residential,24417,112061,0,136478
113525400800000,NE 107,Residential,24512,110444,0,134956
113525400900000,NE 107,Residential,24907,124297,0,149204
113525401000000,NE 107,Residential,23802,126647,0,150449
113525401100000,NE 107,Residential,25323,114662,0,139985
113525401200000,NE 107,Residential,25606,102252,0,127858
113525401300000,NE 107,Residential,21612,108623,0,130235
113525401400000,NE 107,Residential,22869,91434,0,114303
113525401500000,NE 107,Residential,25916,90998,0,116914
113525401600000,NE 107,Residential,23688,94228,0,117916
113525401700000,NE 107,Residential,30216,166363,0,196579
113525401800000,NE 107,Residential,31741,168129,0,199870
113525401900000,NE 107,Residential,30059,171814,0,201873
113525402000000,NE 107,Residential,29568,167961,0,197529
113525402100000,NE 107,Residential,30696,174730,0,205426
113525402200000,NE 107,Residential,24938,101812,0,126750
113525402300000,NE 107,Residential,24938,97971,0,122909
113525500100000,NE 107,Residential,22511,109031,0,131542
113525500200000,NE 107,Residential,22290,115192,0,137482
113525500300000,NE 107,Residential,22270,97976,0,120246
113525500400000,NE 107,Residential,23896,110956,0,134852
113525500500000,NE 107,Residential,24544,109990,0,134534
113525500600000,NE 107,Residential,24197,130215,0,154412
113525500700000,NE 107,Residential,24393,108573,0,132966
113525500800000,NE 107,Residential,21258,94394,0,115652
113525500900000,NE 107,Residential,20671,118760,0,139431
113525501000000,NE 107,Residential,24498,116572,0,141070
113525501100000,NE 107,Residential,23140,95329,0,118469
113525501200000,NE 107,Residential,21868,114545,0,136413
113525501300000,NE 107,Residential,25267,162733,0,188000
113525501400000,NE 107,Residential,24872,94039,0,118911
113525501500000,NE 107,Residential,25841,99761,0,125602
113525501600000,NE 107,Residential,25906,110642,0,136548
113525501700000,NE 107,Residential,26250,111638,0,137888
113525501800000,NE 107,Residential,26003,103903,0,129906
113525501900000,NE 107,Residential,25988,123589,0,149577
113525502000000,NE 107,Residential,25988,125813,0,151801
113525502100000,NE 107,Residential,25988,129995,0,155983
113525600100000,NE 107,Residential,23478,117144,0,140622
113525600200000,NE 107,Residential,25686,97591,0,123277
113525600300000,NE 107,Residential,25436,100281,0,125717
113525600400000,NE 107,Residential,26489,112467,0,138956
113525600500000,NE 107,Residential,26307,94745,0,121052
113525600600000,NE 107,Residential,25599,102911,0,128510
113525600700000,NE 107,Residential,25416,106628,0,132044
113525600800000,NE 107,Residential,25305,108517,0,133822
113525600900000,NE 107,Residential,26813,160586,0,187399
113525601000000,NE 107,Residential,26281,109881,0,136162
113525601100000,NE 107,Residential,24038,88048,0,112086
113525700100000,NE 107,Residential,25490,82386,0,107876
113525700200000,NE 107,Residential,25827,123275,0,149102
113525700300000,NE 107,Residential,25358,95664,0,121022
113525700400000,NE 107,Residential,25917,125092,0,151009
113525800100000,NE 107,Residential,26726,104562,0,131288
113525800200000,NE 107,Residential,26006,107839,0,133845
113525800300000,NE 107,Residential,25235,114947,0,140182
113525800400000,NE 107,Residential,25988,106631,0,132619
113525800500000,NE 107,Residential,25436,102265,0,127701
113525800600000,NE 107,Residential,23559,103665,0,127224
113525800700000,NE 107,Residential,20447,107529,0,127976
113527600100000,NE 107,Residential,21000,154129,0,175129
113527600200000,NE 107,Residential,22500,167116,0,189616
113527600300000,NE 107,Residential,24898,138126,0,163024
113527600400000,NE 107,Residential,23910,168309,0,192219
113527700100000,NE 107,Residential,26507,168027,0,194534
113527700200000,NE 107,Residential,22104,136437,0,158541
113527700300000,NE 107,Residential,22998,150049,0,173047
113527700400000,NE 107,Residential,23994,151931,0,175925
113527700500000,NE 107,Residential,23760,160456,0,184216
113527700600000,NE 107,Residential,19200,137719,0,156919
113527700700000,NE 107,Residential,21420,172859,0,194279
113527700800000,NE 107,Residential,24480,162877,0,187357
113527700900000,NE 107,Residential,26163,149624,0,175787
113527701000000,NE 107,Residential,23520,150977,0,174497
113527701100000,NE 107,Residential,23520,169952,0,193472
113527701200000,NE 107,Residential,20580,120782,0,141362
113527701300000,NE 107,Residential,22950,148566,0,171516
113527701400000,NE 107,Residential,26365,132798,0,159163
113527701500000,NE 107,Residential,23427,190518,0,213945
113527701600000,NE 107,Residential,20332,172776,0,193108
113527701700000,NE 107,Residential,25718,149790,0,175508
113527701800000,NE 107,Residential,22295,159959,0,182254
113527701900000,NE 107,Residential,25317,161575,0,186892
113527702000000,NE 107,Residential,25004,163940,0,188944
113527800100000,NE 107,Residential,22116,155724,0,177840
113527800200000,NE 107,Residential,21462,170536,0,191998
113527800300000,NE 107,Residential,20988,152960,0,173948
113527800400000,NE 107,Residential,18563,141175,0,159738
113527800500000,NE 107,Residential,21518,171354,0,192872
113527800600000,NE 107,Residential,25650,157634,0,183284
113527800700000,NE 107,Residential,25650,138967,0,164617
113527800800000,NE 107,Residential,22800,168741,0,191541
113527800900000,NE 107,Residential,18303,155090,0,173393
113527801000000,NE 107,Residential,18330,140151,0,158481
113527900100000,NE 107,Residential,21375,167344,0,188719
113527900200000,NE 107,Residential,24500,162739,0,187239
113527900300000,NE 107,Residential,25602,138183,0,163785
113527900400000,NE 107,Residential,25625,146731,0,172356
113527900500000,NE 107,Residential,25650,163210,0,188860
113527900600000,NE 107,Residential,22800,179862,0,202662
113527900700000,NE 107,Residential,19950,159100,0,179050
113527900800000,NE 107,Residential,19665,159556,0,179221
113528000100000,NE 107,Residential,25578,152262,0,177840
113528000200000,NE 107,Residential,21898,139189,0,161087
113528000300000,NE 107,Residential,25293,135412,0,160705
113528000400000,NE 107,Residential,26074,106766,0,132840
113528000500000,NE 107,Residential,26068,158719,0,184787
113528000600000,NE 107,Residential,25313,124024,0,149337
113528000700000,NE 107,Residential,25468,116796,0,142264
113528000800000,NE 107,Residential,26277,142128,0,168405
113528000900000,NE 107,Residential,25463,100246,0,125709
113528100100000,NE 107,Residential,28952,114773,0,143725
113528100200000,NE 107,Residential,20424,144394,0,164818
113528100300000,NE 107,Residential,22843,156294,0,179137
113528100400000,NE 107,Residential,18612,145450,0,164062
113528100500000,NE 107,Residential,23124,119601,0,142725
113528100600000,NE 107,Residential,19740,118967,0,138707
113528100700000,NE 107,Residential,18189,145078,0,163267
113528100800000,NE 107,Residential,19740,120490,0,140230
113528100900000,NE 107,Residential,23688,113493,0,137181
113528101000000,NE 107,Residential,19740,105580,0,125320
113528101100000,NE 107,Residential,26436,119661,0,146097
113528101200000,NE 107,Residential,20898,104101,0,124999
113528101300000,NE 107,Residential,22908,117538,0,140446
113528101400000,NE 107,Residential,21221,110355,0,131576
113528101500000,NE 107,Residential,21221,100171,0,121392
113528101600000,NE 107,Residential,21221,138334,0,159555
113528101700000,NE 107,Residential,21221,109412,0,130633
113528101800000,NE 107,Residential,21221,107930,0,129151
113528101900000,NE 107,Residential,19740,101077,0,120817
113528102000000,NE 107,Residential,19740,111018,0,130758
113528102100000,NE 107,Residential,19740,99580,0,119320
113528102200000,NE 107,Residential,21824,114725,0,136549
113528102300000,NE 107,Exempt,20676,0,118347,139023
113528102400000,NE 107,Residential,22932,126736,0,149668
113528102500000,NE 107,Residential,20898,118774,0,139672
113528200100000,NE 107,Residential,25114,116908,0,142022
113528200200000,NE 107,Residential,20700,111561,0,132261
113528200300000,NE 107,Residential,19997,125391,0,145388
113528200400000,NE 107,Residential,21728,92601,0,114329
113528200500000,NE 107,Residential,22035,112148,0,134183
113528200600000,NE 107,Residential,26150,139026,0,165176
113528200700000,NE 107,Residential,21363,104583,0,125946
113528300100000,NE 107,Residential,25035,109337,0,134372
113528300200000,NE 107,Residential,24631,122283,0,146914
113528300300000,NE 107,Residential,23545,121556,0,145101
113528300400000,NE 107,Residential,22860,100683,0,123543
113528300500000,NE 107,Residential,22349,119186,0,141535
113528300600000,NE 107,Residential,21672,118138,0,139810
113528300700000,NE 107,Residential,21221,97470,0,118691
113528300800000,NE 107,Residential,21221,116805,0,138026
113528300900000,NE 107,Residential,21221,101464,0,122685
113528301000000,NE 107,Residential,21221,116478,0,137699
113528301100000,NE 107,Residential,21221,103724,0,124945
113528301200000,NE 107,Residential,21446,104967,0,126413
113528301300000,NE 107,Residential,21898,118087,0,139985
113528301400000,NE 107,Residential,22153,99975,0,122128
113528301500000,NE 107,Residential,21093,127415,0,148508
113528301600000,NE 107,Residential,20836,117744,0,138580
113528301700000,NE 107,Residential,20790,115768,0,136558
113528301800000,NE 107,Residential,20790,97414,0,118204
113528301900000,NE 107,Residential,22181,92816,0,114997
113528302000000,NE 107,Residential,22181,111291,0,133472
113528302100000,NE 107,Residential,22181,110819,0,133000
113528302200000,NE 107,Residential,22942,110096,0,133038
113528302300000,NE 107,Residential,22180,110949,0,133129
113528302400000,NE 107,Residential,21221,101225,0,122446
113528302500000,NE 107,Residential,21714,119758,0,141472
113528302600000,NE 107,Residential,25481,141656,0,167137
113528302700000,NE 107,Residential,24384,120472,0,144856
113528302800000,NE 107,Residential,25164,119212,0,144376
113528302900000,NE 107,Residential,21221,98012,0,119233
113528303000000,NE 107,Residential,20069,114725,0,134794
113528303100000,NE 107,Residential,21735,114010,0,135745
113528400100000,NE 107,Residential,26085,92511,0,118596
113528400200000,NE 107,Residential,25930,118654,0,144584
113528400300000,NE 107,Residential,25463,114518,0,139981
113528400400000,NE 107,Residential,25187,93902,0,119089
113528500100000,NE 107,Residential,26639,115128,0,141767
113528500200000,NE 107,Residential,25420,113174,0,138594
113528500300000,NE 107,Residential,23417,116720,0,140137
113528500400000,NE 107,Residential,24948,98512,0,123460
113528500500000,NE 107,Residential,24570,113288,0,137858
113528500600000,NE 107,Residential,24381,99008,0,123389
113528500700000,NE 107,Residential,24155,139798,0,163953
113528500800000,NE 107,Residential,23930,103249,0,127179
113528500900000,NE 107,Residential,23704,102996,0,126700
113528501000000,NE 107,Residential,25491,110922,0,136413
113528501100000,NE 107,Residential,22801,115442,0,138243
113528501200000,NE 107,Residential,25436,94838,0,120274
113528501300000,NE 107,Residential,23478,95373,0,118851
113528501400000,NE 107,Residential,25370,142857,0,168227
113528501500000,NE 107,Residential,26088,129353,0,155441
113528501600000,NE 107,Residential,25881,107710,0,133591
113530100100000,NE 107,Residential,30544,109100,0,139644
113530100200000,NE 107,Residential,24010,105082,0,129092
113530100300000,NE 107,Residential,25063,126249,0,151312
113530100400000,NE 107,Residential,25407,122472,0,147879
113530100500000,NE 107,Residential,25099,118002,0,143101
113530200100000,NE 107,Residential,25987,140323,0,166310
113530200200000,NE 107,Residential,25440,114233,0,139673
113530200300000,NE 107,Residential,23793,89374,0,113167
113530200400000,NE 107,Residential,26156,117171,0,143327
113530200500000,NE 107,Residential,25952,102342,0,128294
113530200600000,NE 107,Residential,25867,109813,0,135680
113530200700000,NE 107,Residential,26082,129006,0,155088
113530200800000,NE 107,Residential,26065,107033,0,133098
113530200900000,NE 107,Residential,26301,138244,0,164545
113530201000000,NE 107,Residential,25704,151983,0,177687
113530201100000,NE 107,Residential,25711,119256,0,144967
113530201200000,NE 107,Residential,23426,114864,0,138290
113530201300000,NE 107,Residential,21280,106109,0,127389
113530201400000,NE 107,Residential,24938,94396,0,119334
113530201500000,NE 107,Residential,21056,112520,0,133576
113530201600000,NE 107,Residential,21359,136573,0,157932
113530201700000,NE 107,Residential,22277,123394,0,145671
113530201800000,NE 107,Residential,23683,132355,0,156038
113530201900000,NE 107,Residential,24514,106265,0,130779
113530202000000,NE 107,Residential,25268,131969,0,157237
113530202100000,NE 107,Residential,26264,96677,0,122941
113530202200000,NE 107,Residential,24239,101488,0,125727
113530202300000,NE 107,Residential,22977,97341,0,120318
113530202400000,NE 107,Residential,25010,113499,0,138509
113530202500000,NE 107,Residential,24897,115547,0,140444
113530202600000,NE 107,Residential,20809,87153,0,107962
113530202700000,NE 107,Residential,25684,95716,0,121400
113530202800000,NE 107,Residential,25115,98122,0,123237
113530202900000,NE 107,Residential,24733,109787,0,134520
113530203000000,NE 107,Residential,28088,135925,0,164013
113530203100000,NE 107,Residential,26214,122335,0,148549
113530203200000,NE 107,Residential,25853,89575,0,115428
113530300100000,NE 107,Residential,25004,118058,0,143062
113530400100000,NE 107,Residential,26565,153495,0,180060
113530400200000,NE 107,Residential,25116,122839,0,147955
113530400300000,NE 107,Residential,25725,91599,0,117324
113530400400000,NE 107,Residential,26225,137426,0,163651
113530400500000,NE 107,Residential,26239,111535,0,137774
113530400600000,NE 107,Residential,25436,103600,0,129036
113530400700000,NE 107,Residential,26185,107104,0,133289
113530400800000,NE 107,Residential,25502,113376,0,138878
113530400900000,NE 107,Residential,24514,116117,0,140631
113530401000000,NE 107,Residential,24148,93710,0,117858
113530401100000,NE 107,Residential,25436,116855,0,142291
113530401200000,NE 107,Residential,26567,167932,0,194499
113530401300000,NE 107,Residential,25853,129696,0,155549
113530401400000,NE 107,Residential,26973,96148,0,123121
113530401500000,NE 107,Residential,21929,92151,0,114080
113530500100000,NE 107,Residential,25780,99079,0,124859
113530500200000,NE 107,Residential,23053,93347,0,116400
113530500300000,NE 107,Residential,21162,100204,0,121366
113530500400000,NE 107,Residential,21851,112580,0,134431
113530500500000,NE 107,Residential,21446,98129,0,119575
113530500600000,NE 107,Residential,21446,104072,0,125518
113530500700000,NE 107,Residential,24938,116603,0,141541
113530500800000,NE 107,Residential,24938,112261,0,137199
113530500900000,NE 107,Residential,24938,112431,0,137369
113530501000000,NE 107,Residential,24938,94987,0,119925
113530501100000,NE 107,Residential,26250,125563,0,151813
113530501200000,NE 107,Residential,22261,98823,0,121084
113530501300000,NE 107,Residential,26549,132491,0,159040
113530501400000,NE 107,Residential,21446,125668,0,147114
113530501500000,NE 107,Residential,21446,123635,0,145081
113530501600000,NE 107,Residential,21446,129153,0,150599
113530501700000,NE 107,Residential,21446,110885,0,132331
113530501800000,NE 107,Residential,24938,133686,0,158624
113530501900000,NE 107,Residential,21446,112934,0,134380
113530502000000,NE 107,Residential,21673,108891,0,130564
113530502100000,NE 107,Residential,23327,118340,0,141667
113530502200000,NE 107,Residential,25888,97173,0,123061
113530502300000,NE 107,Residential,21125,112241,0,133366
113530600100000,NE 107,Residential,27370,127755,0,155125
113530600200000,NE 107,Residential,25157,127058,0,152215
113530600300000,NE 107,Residential,22575,138865,0,161440
113530600400000,NE 107,Residential,22575,115786,0,138361
113530600500000,NE 107,Residential,22575,139128,0,161703
113530600600000,NE 107,Residential,22575,110218,0,132793
113530600700000,NE 107,Residential,22575,105506,0,128081
113530600800000,NE 107,Residential,22575,114263,0,136838
113530600900000,NE 107,Residential,24627,112710,0,137337
113530601000000,NE 107,Residential,25722,121457,0,147179
113530601100000,NE 107,Residential,25935,111771,0,137706
113530601200000,NE 107,Residential,25915,104319,0,130234
113530601300000,NE 107,Residential,28224,132791,0,161015
113530601400000,NE 107,Residential,29260,117277,0,146537
113530601500000,NE 107,Residential,27899,98599,0,126498
113530601600000,NE 107,Residential,25545,97745,0,123290
113530601700000,NE 107,Residential,23520,119895,0,143415
113530601800000,NE 107,Residential,25984,92775,0,118759
113530601900000,NE 107,Residential,25802,122121,0,147923
113530602000000,NE 107,Residential,27812,105743,0,133555
113530602100000,NE 107,Residential,30269,113975,0,144244
113530602200000,NE 107,Residential,31818,157627,0,189445
113530602300000,NE 107,Residential,26454,116862,0,143316
113530602400000,NE 107,Residential,25595,96369,0,121964
113530602500000,NE 107,Residential,19396,119691,0,139087
113530602600000,NE 107,Residential,24868,115171,0,140039
113530602700000,NE 107,Residential,21221,97947,0,119168
113530602800000,NE 107,Residential,25148,140653,0,165801
113530602900000,NE 107,Residential,21039,118386,0,139425
113530603000000,NE 107,Residential,19866,100714,0,120580
113530700100000,NE 107,Residential,25725,118087,0,143812
113530700200000,NE 107,Residential,26185,127251,0,153436
113530700300000,NE 107,Residential,26460,128747,0,155207
113530700400000,NE 107,Residential,26056,127588,0,153644
113530700500000,NE 107,Residential,27232,119937,0,147169
113530700600000,NE 107,Residential,27930,132604,0,160534
113530800100000,NE 107,Residential,26460,105957,0,132417
113530800200000,NE 107,Residential,25468,128820,0,154288
113530800300000,NE 107,Residential,25358,113807,0,139165
113530800400000,NE 107,Residential,23888,112707,0,136595
113530800500000,NE 107,Residential,25468,109361,0,134829
113530800600000,NE 107,Residential,26521,109012,0,135533
113530800700000,NE 107,Residential,30243,119124,0,149367
113530800800000,NE 107,Residential,28538,166175,0,194713
113530800900000,NE 107,Residential,28839,153378,0,182217
113530801000000,NE 107,Residential,26347,167811,0,194158
113532600100000,NE 107,Residential,26649,110961,0,137610
113532600600000,NE 107,Residential,25347,94153,0,119500
113532700100000,NE 107,Residential,26370,131908,0,158278
113532700200000,NE 107,Residential,26422,102086,0,128508
113532700300000,NE 107,Residential,24444,115057,0,139501
113532700400000,NE 107,Residential,23940,81932,0,105872
113532700500000,NE 107,Residential,26355,137392,0,163747
113532700600000,NE 107,Residential,25366,128352,0,153718
113532700700000,NE 107,Residential,25257,86521,0,111778
113532700800000,NE 107,Residential,25071,100377,0,125448
113532700900000,NE 107,Residential,24871,117447,0,142318
113532701000000,NE 107,Residential,24010,110325,0,134335
113532800100000,E-40 CHURCHES,Exempt,421632,0,480599,902231
113532800200000,NE 107,Residential,25464,111583,0,137047
113532800300000,NE 107,Residential,25436,137778,0,163214
113532800400000,NE 107,Residential,23134,126314,0,149448
113532800500000,NE 107,Residential,23134,118050,0,141184
113532800600000,NE 107,Residential,24276,118517,0,142793
113532800700000,NE 107,Residential,25061,121210,0,146271
113532800800000,NE 107,Residential,25806,132106,0,157912
113532800900000,NE 107,Residential,26979,117423,0,144402
113532900100000,NE 107,Residential,25836,119134,0,144970
113532900200000,NE 107,Residential,23399,82987,0,106386
113532900300000,NE 107,Residential,26855,109152,0,136007
113532900400000,NE 107,Residential,22540,93692,0,116232
113532900500000,NE 107,Residential,25123,91537,0,116660
113533000100000,NE 107,Residential,25728,101560,0,127288
113533000200000,NE 107,Residential,25430,105555,0,130985
113533000300000,NE 107,Residential,25760,118027,0,143787
113533000400000,NE 107,Residential,25161,109336,0,134497
113533000500000,NE 107,Residential,25108,83128,0,108236
113533000600000,NE 107,Residential,26250,111181,0,137431
113533000700000,NE 107,Residential,26972,89259,0,116231
113533000800000,NE 107,Residential,26239,107332,0,133571
113533000900000,NE 107,Residential,25794,110122,0,135916
113533001000000,NE 107,Residential,25490,118802,0,144292
113533001100000,NE 107,Residential,25935,109150,0,135085
113533001200000,NE 107,Residential,24938,90528,0,115466
113533001300000,NE 107,Residential,25704,89773,0,115477
113533001400000,NE 107,Residential,25933,96156,0,122089
113533001500000,NE 107,Residential,25379,110339,0,135718
113533001600000,NE 107,Residential,26712,114560,0,141272
113533001700000,NE 107,Residential,26040,122190,0,148230
113533001800000,NE 107,Residential,26101,124723,0,150824
113533001900000,NE 107,Residential,25400,111915,0,137315
113533002000000,NE 107,Residential,24881,110944,0,135825
113533002100000,NE 107,Residential,24494,104495,0,128989
113533002200000,NE 107,Residential,23828,114492,0,138320
113533002300000,NE 107,Residential,26184,103613,0,129797
113533100100000,NE 107,Residential,25558,117514,0,143072
113533100200000,NE 107,Residential,27070,103991,0,131061
113533100300000,NE 107,Residential,25565,140944,0,166509
113533100400000,NE 107,Residential,25565,98504,0,124069
113533100500000,NE 107,Exempt,25456,0,110814,136270
113533100600000,NE 107,Residential,25294,95390,0,120684
113533100700000,NE 107,Residential,25550,88234,0,113784
113533100800000,NE 107,Residential,26567,87150,0,113717
113533100900000,NE 107,Residential,26371,123866,0,150237
113533101000000,NE 107,Residential,25187,118385,0,143572
113533101100000,NE 107,Residential,26419,85427,0,111846
113533101200000,NE 107,Residential,26068,118353,0,144421
113533101300000,NE 107,Residential,25159,125145,0,150304
113533101400000,NE 107,Residential,26567,97552,0,124119
113533101500000,NE 107,Residential,23027,108152,0,131179
113533101600000,NE 107,Residential,25760,105355,0,131115
113533101700000,NE 107,Residential,22540,100788,0,123328
113533101800000,NE 107,Residential,25430,166543,0,191973
113533101900000,NE 107,Residential,25855,121091,0,146946
113533102000000,NE 107,Residential,26697,129707,0,156404
113533102100000,NE 107,Residential,25872,118606,0,144478
113533102200000,NE 107,Residential,23660,118998,0,142658
113533102300000,NE 107,Residential,25073,122976,0,148049
113533102400000,NE 107,Residential,26712,131205,0,157917
113533102500000,NE 107,Residential,30642,135188,0,165830
113533102600000,NE 107,Residential,29575,107530,0,137105
113533102700000,NE 107,Residential,26444,71068,0,97512
113533102800000,NE 107,Residential,26185,98508,0,124693
113533102900000,NE 107,Residential,26434,113302,0,139736
113533103000000,NE 107,Residential,26250,94412,0,120662
113533103100000,NE 107,Residential,26507,108948,0,135455
113533103200000,NE 107,Residential,27741,137887,0,165628
113533103300000,NE 107,Residential,34726,102147,0,136873
113533103400000,NE 107,Residential,32889,120255,0,153144
113533200100000,NE 107,Residential,25035,135165,0,160200
113533200200000,NE 107,Residential,25725,117428,0,143153
113533200300000,NE 107,Residential,25725,149455,0,175180
113533200400000,NE 107,Residential,26250,125680,0,151930
113533200500000,NE 107,Residential,26250,132188,0,158438
113533200600000,NE 107,Residential,26250,132449,0,158699
113533200700000,NE 107,Residential,22750,120933,0,143683
113533200800000,NE 107,Residential,26250,113076,0,139326
113533200900000,NE 107,Residential,25725,121577,0,147302
113533201000000,NE 107,Residential,25802,156264,0,182066
113533201100000,NE 107,Residential,26334,131286,0,157620
113533201200000,NE 107,Residential,26233,125659,0,151892
113533201300000,NE 107,Residential,22727,117357,0,140084
113533201400000,NE 107,Residential,22680,141023,0,163703
113533201500000,NE 107,Residential,22680,112018,0,134698
113533201600000,NE 107,Residential,22680,107258,0,129938
113533201700000,NE 107,Residential,26934,98924,0,125858
113535100300000,NE 164,Residential,31442,224745,0,256187
113535100400000,NE 164,Residential,30453,141202,0,171655
113535100500000,NE 164,Residential,30294,147504,0,177798
113535100600000,NE 164,Residential,30972,161112,0,192084
113535100700000,NE 164,Residential,31580,228476,0,260056
113535100800000,NE 164,Residential,32742,183307,0,216049
113535100900000,NE 164,Residential,29964,185072,0,215036
113535101000000,NE 164,Residential,30251,181560,0,211811
113535101100000,NE 164,Residential,31167,225860,0,257027
113535101200000,NE 164,Residential,28000,180041,0,208041
113535101300000,NE 164,Residential,32040,182177,0,214217
113535101400000,NE 163,Residential,29433,197379,0,226812
113535101500000,NE 164,Residential,28062,189790,0,217852
113535101600000,NE 164,Residential,57442,282008,0,339450
113535101700000,NE 164,Residential,53996,266329,0,320325
113535101800000,NE 164,Residential,50400,252104,0,302504
113535101900000,NE 164,Residential,56700,274024,0,330724
113535102000000,NE 164,Residential,55590,245994,0,301584
113535102100000,NE 164,Residential,54519,204790,0,259309
113535102200000,NE 164,Residential,57969,300270,0,358239
113535102300000,NE 164,Residential,59340,256211,0,315551
113535102400000,NE 164,Residential,55501,211153,0,266654
113535102600000,NE 164,Residential,57085,179516,0,236601
113535102700000,NE 164,Residential,54943,280650,0,335593
113535102900000,NE 164,Residential,56732,243758,0,300490
113535103000000,NE 164,Residential,53000,267431,0,320431
113535103100000,NE 164,Residential,56026,228374,0,284400
113535103200000,NE 164,Residential,51072,251911,0,302983
113535103300000,NE 164,Residential,56618,226631,0,283249
113535103400000,NE 164,Residential,57818,234250,0,292068
113535103500000,NE 164,Residential,48323,185259,0,233582
113535103600000,NE 164,Residential,51480,240592,0,292072
113535103700000,NE 164,Residential,54936,280849,0,335785
113535103800000,NE 164,Residential,55388,253144,0,308532
113535103900000,NE 164,Residential,57215,289960,0,347175
113535104000000,NE 164,Residential,54570,267013,0,321583
113535104100000,NE 164,Residential,57780,296822,0,354602
113535104200000,NE 164,Residential,55590,236469,0,292059
113535104300000,NE 164,Residential,56943,290605,0,347548
113535104400000,NE 164,Residential,47520,0,0,47520
113535104500000,NE 164,Residential,15299,0,0,15299
113535200100000,NE 164,Residential,31210,207545,0,238755
113535200200000,NE 164,Residential,31016,234962,0,265978
113535200300000,E-15 CITY,Exempt,0,0,0,0
113535200400000,NE 164,Residential,51660,296201,0,347861
113535200500000,NE 164,Residential,53550,282015,0,335565
113535200600000,NE 164,Residential,52920,262953,0,315873
113535200700000,NE 164,Residential,47250,244851,0,292101
113535200800000,NE 164,Residential,50400,313922,0,364322
113535200900000,NE 164,Residential,52296,263675,0,315971
113535201000000,NE 164,Residential,53372,299756,0,353128
113535201100000,NE 164,Residential,54773,341991,0,396764
113535201200000,NE 164,Residential,50400,329227,0,379627
113535201300000,NE 164,Residential,53550,258175,0,311725
113535201400000,NE 164,Residential,53934,244651,0,298585
113535201500000,NE 164,Residential,54167,303896,0,358063
113535201600000,NE 164,Residential,54167,269452,0,323619
113535201700000,NE 164,Residential,54167,294823,0,348990
113535201800000,NE 164,Residential,53382,256886,0,310268
113535201900000,NE 164,Residential,47700,248328,0,296028
113535300100000,NE 164,Residential,29900,155407,0,185307
113535300200000,NE 164,Residential,29967,167104,0,197071
113535300300000,NE 164,Residential,31410,231238,0,262648
113535300400000,NE 164,Residential,31120,175880,0,207000
113535400100000,NE 164,Residential,51012,336771,0,387783
113535400200000,NE 164,Residential,54734,237839,0,292573
113535400300000,NE 164,Residential,50400,254370,0,304770
113535400400000,NE 164,Residential,46809,264104,0,310913
113535400500000,NE 164,Residential,50400,257504,0,307904
113535400600000,NE 164,Residential,53550,288719,0,342269
113535400700000,NE 164,Residential,47250,343225,0,390475
113535400800000,NE 164,Residential,50400,231575,0,281975
113537600100000,NE 164,Residential,36777,220686,0,257463
113537600200000,NE 164,Residential,35700,235580,0,271280
113537600300000,NE 164,Residential,35700,190353,0,226053
113537600400000,NE 164,Residential,35700,187450,0,223150
113537600500000,NE 164,Residential,37928,173892,0,211820
113537700100000,NE 164,Residential,36847,201788,0,238635
113537700300000,NE 115,Residential,38540,0,0,38540
113537700400000,NE 164,Residential,37312,224692,0,262004
113537700500000,NE 164,Residential,35750,238528,0,274278
113537700600000,NE 164,Residential,35446,216157,0,251603
113537700700000,NE 164,Residential,36309,260595,0,296904
113537700800000,NE 164,Residential,36608,260349,0,296957
113537700900000,NE 164,Residential,37271,230510,0,267781
113537701000000,NE 164,Residential,36105,191855,0,227960
113537701200000,NE 164,Residential,49864,333771,0,383635
113537701300000,NE 164,Residential,53550,303516,0,357066
113537701400000,NE 164,Residential,53352,236077,0,289429
113537701500000,NE 164,Residential,53352,273734,0,327086
113537701600000,NE 164,Residential,54264,291184,0,345448
113537701700000,NE 164,Residential,53736,272754,0,326490
113537701800000,NE 164,Residential,49140,276708,0,325848
113537701900000,NE 164,Residential,54998,281935,0,336933
113537702000000,NE 164,Residential,57655,308659,0,366314
113537800100000,NE 164,Residential,37713,235803,0,273516
113537800200000,NE 164,Residential,35360,281819,0,317179
113537800300000,NE 164,Residential,35360,256665,0,292025
113537800400000,NE 164,Residential,35012,213439,0,248451
113537800500000,NE 164,Residential,37207,235415,0,272622
113537800600000,NE 164,Residential,38909,191799,0,230708
113537800700000,NE 164,Residential,35994,198970,0,234964
113537800800000,NE 164,Residential,30368,181530,0,211898
113537800900000,NE 164,Residential,36608,199568,0,236176
113537801000000,NE 164,Residential,36908,170739,0,207647
113537900100000,NE 164,Residential,35784,234711,0,270495
113537900200000,NE 164,Residential,31616,204679,0,236295
113537900300000,NE 164,Residential,36608,204132,0,240740
113542600100000,NE 107,Residential,29216,125818,0,155034
113542600200000,NE 107,Residential,26347,131076,0,157423
113542600300000,NE 107,Residential,26132,121283,0,147415
113542600500000,NE 107,Residential,25578,147532,0,173110
113542600600000,NE 107,Residential,26025,126378,0,152403
113542600700000,NE 107,Residential,25490,115680,0,141170
113542600800000,NE 107,Residential,25704,122999,0,148703
113542600900000,NE 107,Residential,25704,108822,0,134526
113542601000000,NE 107,Residential,25704,116211,0,141915
113542601100000,NE 107,Residential,25704,157756,0,183460
113542601200000,NE 107,Residential,25793,145985,0,171778
113542601300000,NE 107,Residential,27132,130354,0,157486
113542601400000,NE 107,Residential,27132,109203,0,136335
113542601500000,NE 107,Residential,25793,125320,0,151113
113542601600000,NE 107,Residential,25287,124921,0,150208
113542601700000,NE 107,Residential,26019,104020,0,130039
113542601800000,NE 107,Residential,26450,117324,0,143774
113542601900000,NE 107,Residential,26490,142268,0,168758
113542602000000,NE 107,Residential,24794,100697,0,125491
113542602100000,NE 107,Residential,25725,103634,0,129359
113542602200000,NE 107,Residential,26460,94365,0,120825
113542602300000,NE 107,Residential,25725,96030,0,121755
113542602400000,NE 107,Residential,26460,100794,0,127254
113542700100000,NE 107,Residential,25411,106560,0,131971
113542700200000,NE 107,Residential,22517,110877,0,133394
113542700300000,NE 107,Residential,22407,92440,0,114847
113542700400000,NE 107,Residential,25270,112336,0,137606
113542800100000,NE 107,Residential,24529,119072,0,143601
113542800200000,E-15 CITY,Exempt,0,0,0,0
113542800300000,NE 107,Residential,24967,101335,0,126302
113542800400000,NE 107,Residential,24969,122002,0,146971
113542800500000,NE 107,Residential,22919,96863,0,119782
113542800600000,NE 107,Residential,25704,127088,0,152792
113542800700000,NE 107,Residential,23098,99811,0,122909
113542800800000,NE 107,Residential,22491,133613,0,156104
113542800900000,NE 107,Residential,22491,106736,0,129227
113542801000000,NE 107,Residential,22491,99567,0,122058
113542801100000,NE 107,Residential,25187,123043,0,148230
113542801200000,NE 107,Residential,24817,124908,0,149725
113542801300000,NE 107,Residential,20160,96198,0,116358
113542801400000,NE 107,Residential,20160,93214,0,113374
113542801500000,NE 107,Residential,22034,102217,0,124251
113542801600000,NE 107,Residential,20370,114670,0,135040
113542801700000,NE 107,Residential,23765,101373,0,125138
113542801800000,NE 107,Residential,20370,94929,0,115299
113542801900000,NE 107,Residential,21932,120917,0,142849
113542802000000,NE 107,Residential,20370,103812,0,124182
113542900100000,NE 107,Residential,26241,116184,0,142425
113542900200000,NE 107,Residential,21945,114839,0,136784
113542900300000,NE 107,Residential,20580,104993,0,125573
113542900400000,NE 107,Residential,20503,92698,0,113201
113542900500000,NE 107,Residential,25725,143005,0,168730
113542900600000,NE 107,Residential,22680,106606,0,129286
113542900700000,NE 107,Residential,23520,94051,0,117571
113542900800000,NE 107,Residential,25357,114375,0,139732
113542900900000,NE 107,Residential,22591,124483,0,147074
113542901000000,NE 107,Residential,21840,109514,0,131354
113542901100000,NE 107,Residential,23072,103684,0,126756
113542901200000,NE 107,Residential,21210,98133,0,119343
113542901300000,NE 107,Residential,20790,93798,0,114588
113542901400000,NE 107,Residential,20370,96540,0,116910
113542901500000,NE 107,Residential,21714,99527,0,121241
113542901600000,NE 107,Residential,25316,111011,0,136327
122447800100000,NE 168,Ag Land,2861,0,0,2861
122447800200000,NE 168,Residential,50000,170908,0,220908
122510200200000,NE 168,Residential,69600,0,0,69600
122510200700000,NE 168,Ag Dwelling,22464,114841,7662,144967
122517600400000,NE 168,Ag Land,24489,0,0,24489
122517600500000,NE 168,Residential,123750,273062,0,396812
122517600600000,NE 168,Residential,108550,0,0,108550
122540100100000,NE 168,Ag Dwelling,53088,88233,11076,152397
122547600100000,NE 168,Residential,1440,0,0,1440
122547600200000,NE 169,Residential,75550,198654,0,274204
122547600300000,NE 169,Residential,75500,226034,0,301534
122547600400000,NE 169,Residential,75500,205328,0,280828
122547600500000,NE 169,Residential,75500,257603,0,333103
122547600600000,NE 169,Residential,75500,196736,0,272236
122547600700000,NE 169,Residential,75500,236029,0,311529
122547600800000,NE 169,Residential,75500,272976,0,348476
122547600900000,NE 169,Residential,75550,251338,0,326888
122547601000000,NE 169,Residential,75550,308432,0,383982
122547700100000,NE 169,Residential,75000,250276,0,325276
122547700200000,NE 169,Residential,75000,225898,0,300898
122547700300000,NE 169,Residential,75000,292703,0,367703
122547700400000,NE 169,Residential,75000,206715,0,281715
122547700500000,NE 169,Residential,75000,238606,0,313606
122547700600000,NE 169,Residential,75000,200016,0,275016
122547700700000,NE 169,Residential,75000,258477,0,333477
122547700800000,NE 169,Residential,75000,187826,0,262826
122547700900000,NE 169,Residential,75750,237048,0,312798
122547701000000,NE 168,Ag Dwelling,19278,300,20402,39980
123610100100000,NE 168,Ag Dwelling,16401,93157,1495,111053
123610100200000,NE 168,Residential,93700,4308,0,98008
123610100300000,NE 168,Residential,52800,132036,0,184836
123610100500000,NE 168,Residential,44620,316642,0,361262
123610100600000,NE 168,Residential,44620,330015,0,374635
123610100700000,NE 168,Residential,44620,320808,0,365428
123610100800000,NE 168,Residential,44620,329431,0,374051
123610100900000,NE 168,Residential,44620,350094,0,394714
123610101000000,NE 168,Residential,44620,333406,0,378026
123610101100000,NE 168,Residential,44620,315785,0,360405
123610101200000,NE 168,Residential,44620,280060,0,324680
123610101300000,NE 168,Residential,45080,334649,0,379729
123610101400000,NE 168,Residential,45080,0,0,45080
123610101500000,NE 168,Residential,45080,0,0,45080
123610101600000,NE 168,Residential,49291,130319,0,179610
123610200100000,NE 168,Residential,47276,296053,0,343329
123610200200000,NE 168,Residential,47142,341898,0,389040
123610200300000,NE 168,Residential,47142,347989,0,395131
123610200400000,NE 168,Residential,47142,0,0,47142
123610200500000,NE 168,Residential,47142,340183,0,387325
123610200600000,NE 168,Residential,47142,330982,0,378124
123610200700000,NE 168,Residential,47142,340632,0,387774
123610200800000,NE 168,Residential,47142,306025,0,353167
123610200900000,NE 168,Residential,47142,324726,0,371868
123610201000000,NE 168,Residential,47142,341347,0,388489
123610201100000,NE 168,Residential,47142,254103,0,301245
123610201200000,E-15 CITY,Exempt,0,0,0,0
123612600100000,NE 168,Residential,16300,0,0,16300
123612600700000,NE 168,Residential,72100,282976,0,355076
123617600100000,NE 168,Residential,52300,168346,0,220646
123617600200000,NE 168,Residential,51850,166995,0,218845
123617600300000,NE 168,Residential,51850,209732,0,261582
123617600400000,NE 168,Residential,51850,147351,0,199201
123617600500000,NE 168,Residential,51850,183494,0,235344
123617600600000,NE 168,Residential,51850,179206,0,231056
123617600700000,NE 168,Residential,51850,155568,0,207418
123617600800000,NE 168,Residential,51850,161867,0,213717
123617700100000,NE 168,Residential,51100,224642,0,275742
123617700200000,NE 168,Residential,50600,182427,0,233027
123617700300000,NE 168,Residential,50600,173654,0,224254
123617700400000,NE 168,Residential,50600,172759,0,223359
123617700500000,NE 168,Residential,50600,185547,0,236147
123617700600000,NE 168,Residential,50600,138606,0,189206
123617700700000,NE 168,Residential,50600,155715,0,206315
123617700800000,NE 168,Residential,50600,112338,0,162938
123617700900000,NE 168,Residential,50400,241947,0,292347
123617701000000,NE 168,Residential,50150,186630,0,236780
123617701100000,NE 168,Residential,50600,145792,0,196392
123617701200000,NE 168,Residential,50600,166408,0,217008
123617701300000,NE 168,Residential,50600,248494,0,299094
123617701400000,NE 168,Residential,50600,190119,0,240719
123617701500000,NE 168,Residential,50600,202248,0,252848
123617701600000,NE 168,Residential,51450,207508,0,258958
123617800100000,NE 168,Residential,50850,196646,0,247496
123617800200000,NE 168,Residential,50800,274888,0,325688
123617800300000,NE 168,Residential,50800,175509,0,226309
123617800400000,NE 168,Residential,51100,179360,0,230460
123617800500000,NE 168,Residential,50550,229140,0,279690
123617800600000,NE 168,Residential,51900,111899,0,163799
123617800700000,NE 168,Residential,50350,178359,0,228709
123617800800000,NE 168,Residential,50300,156347,0,206647
123640100100000,NE 168,Residential,50020,155234,0,205254
123640100200000,NE 168,Residential,50020,149974,0,199994
123640100300000,NE 168,Residential,50020,160053,0,210073
123640100400000,NE 168,Residential,50020,144807,0,194827
123640100500000,NE 168,Residential,50020,161596,0,211616
123640100600000,NE 168,Residential,50020,140545,0,190565
123640200100000,NE 168,Residential,50720,126499,0,177219
123640200200000,NE 168,Residential,50720,162280,0,213000
123640200300000,NE 168,Residential,50720,168569,0,219289
123640200400000,NE 168,Residential,50720,232170,0,282890
123640200500000,NE 168,Residential,50720,153139,0,203859
123640200700000,NE 168,Residential,50000,198577,0,248577
123640200800000,NE 168,Residential,50000,134993,0,184993
123640200900000,NE 168,Residential,50000,94741,0,144741
123640201000000,NE 168,Residential,45496,154057,0,199553
123640201100000,E-10 COUNTY,Exempt,0,0,0,0
123640201200000,NE 168,Ag Land,5814,0,0,5814
123640300100000,NE 160,Residential,40242,172667,0,212909
123640300200000,NE 160,Residential,40957,200432,0,241389
123640300300000,NE 160,Residential,41934,209068,0,251002
123640300400000,NE 160,Residential,48086,203385,0,251471
123640300500000,NE 160,Residential,45465,206114,0,251579
123640300600000,NE 160,Residential,44880,256064,0,300944
123640300700000,E-15 CITY,Exempt,0,0,0,0
123640300800000,NE 160,Residential,184,0,0,184
123640300900000,NE 160,Residential,184,0,0,184
123640301000000,NE 160,Residential,182,0,0,182
123640301100000,NE 160,Residential,183,0,0,183
123640301200000,NE 160,Residential,161,0,0,161
123640301300000,NE 160,Residential,184,0,0,184
123640301400000,NE 160,Residential,212,0,0,212
123640301500000,NE 160,Residential,48583,63029,0,111612
123640301600000,NE 160,Residential,53460,260521,0,313981
123640301700000,NE 160,Residential,184,0,0,184
123640301800000,NE 160,Residential,53162,213838,0,267000
123640400100000,NE 160,Residential,39440,0,0,39440
123640400200000,NE 160,Residential,39349,0,0,39349
123640400300000,NE 160,Residential,38867,0,0,38867
123640400400000,NE 160,Residential,39657,0,0,39657
123640400500000,NE 160,Residential,37433,208580,0,246013
123640400600000,NE 160,Residential,137,0,0,137
123640400700000,NE 160,Residential,49935,206586,0,256521
123640400800000,NE 160,Residential,199,0,0,199
123640400900000,NE 160,Residential,131,0,0,131
123640401000000,NE 160,Residential,163,0,0,163
123640401100000,NE 160,Residential,41780,212948,0,254728
123640401200000,NE 160,Residential,45375,216531,0,261906
123640401300000,NE 160,Residential,44942,214551,0,259493
123640401400000,NE 160,Residential,186,0,0,186
123640401500000,NE 168,Residential,341,0,0,341
123640401600000,NE 168,Residential,259,0,0,259
123642600100000,NE 160,Residential,309000,9852,0,318852
123642600700000,NE 168,Residential,51687,349755,0,401442
123642600800000,NE 168,Residential,48668,245187,0,293855
123642600900000,NE 168,Residential,47775,302831,0,350606
123642601000000,NE 168,Residential,46882,285954,0,332836
123642700100000,NE 168,Residential,45050,329424,0,374474
123642700200000,NE 168,Residential,44200,336888,0,381088
123642700300000,NE 168,Residential,43350,318529,0,361879
123642700400000,NE 168,Residential,53571,0,0,53571
123642700500000,NE 168,Residential,36110,0,0,36110
123642700600000,NE 160,Residential,79560,10605,0,90165
123642700700000,NE 160,Residential,56610,4545,0,61155
123642700800000,NE 160,Residential,83640,4545,0,88185
123642700900000,NE 160,Residential,62160,0,0,62160
123642701000000,NE 160,Residential,53760,303599,0,357359
123642701100000,NE 160,Residential,53280,381436,0,434716
123642701200000,NE 160,Residential,48960,346117,0,395077
123642800100000,NE 160,Residential,52700,0,0,52700
123642800200000,NE 160,Residential,46410,71548,0,117958
123642800300000,NE 160,Residential,46920,247243,0,294163
123642800400000,NE 160,Residential,54500,302788,0,357288
123642800500000,NE 160,Residential,62100,281354,0,343454
123645100300000,NE 160,Residential,48500,0,0,48500
123645100400000,NE 160,Residential,620,0,0,620
123645100500000,NE 160,Residential,45000,380879,0,425879
123645100600000,NE 160,Residential,44550,0,0,44550
123645100700000,NE 160,Residential,53883,351210,0,405093
123645100800000,NE 160,Residential,44550,290270,0,334820
123645100900000,NE 160,Residential,54000,289249,0,343249
123647600300000,NE 168,Residential,41760,122204,0,163964
123647600400000,NE 168,Residential,41760,100330,0,142090
123647600500000,NE 168,Residential,48307,139168,0,187475
123647600600000,NE 160,Residential,42709,173893,0,216602
123647600700000,NE 160,Residential,48279,206643,0,254922
123647600800000,NE 160,Residential,41360,170172,0,211532
123647600900000,NE 160,Residential,37268,162966,0,200234
123647601000000,NE 160,Residential,41218,203782,0,245000
123647601100000,NE 160,Residential,39447,209479,0,248926
123647601200000,NE 160,Residential,39276,255961,0,295237
123647601300000,NE 160,Residential,41166,0,0,41166
123647601400000,NE 160,Residential,42488,0,0,42488
123647601500000,NE 160,Residential,41195,183999,0,225194
123647601600000,NE 168,Residential,199,0,0,199
123647601700000,NE 168,Residential,325,0,0,325
123647601800000,NE 168,Residential,327,0,0,327
123647601900000,NE 168,Residential,35420,197696,0,233116
123647602100000,NE 168,Ag Land,4313,0,0,4313
123647602300000,NE 168,Ag Land,3292,0,0,3292
123647900100000,NE 160,Residential,42332,164675,0,207007
123647900200000,NE 160,Residential,38089,0,0,38089
123647900300000,NE 160,Residential,37923,220135,0,258058
123647900400000,NE 160,Residential,40922,178601,0,219523
123647900500000,NE 160,Residential,38676,172732,0,211408
123647900600000,NE 160,Residential,37955,167880,0,205835
123647900700000,NE 160,Residential,39119,149482,0,188601
123647900800000,NE 160,Residential,42110,182100,0,224210
123647900900000,NE 160,Residential,43524,216985,0,260509
123647901000000,NE 160,Residential,42831,0,0,42831
123647901100000,NE 160,Residential,35989,0,0,35989
123647901200000,NE 160,Residential,41167,187457,0,228624
123647901300000,NE 160,Residential,39579,212504,0,252083
123647901400000,NE 160,Residential,38987,212058,0,251045
123647901500000,NE 160,Residential,43237,206940,0,250177
123647901600000,NE 160,Residential,40236,212835,0,253071
123647901700000,NE 160,Residential,40889,198815,0,239704
123648000100000,NE 160,Residential,36989,0,0,36989
123648000200000,NE 160,Residential,37529,0,0,37529
123648000300000,NE 160,Residential,36959,229236,0,266195
123648000400000,NE 160,Residential,37589,0,0,37589
123648000500000,NE 160,Residential,36266,186234,0,222500
123648000600000,NE 168,Residential,7,0,0,7
123648000700000,NE 168,Residential,16,0,0,16
123648000800000,NE 168,Residential,170,0,0,170
123648000900000,NE 168,Residential,188,0,0,188
123648001000000,NE 168,Residential,202,0,0,202
123648001100000,NE 168,Residential,183,0,0,183
123648001200000,NE 168,Residential,161,0,0,161
123648001300000,NE 168,Residential,42680,39156,0,81836
123648001400000,NE 168,Residential,158,0,0,158
123648001500000,NE 168,Residential,162,0,0,162
123648001600000,NE 168,Residential,47283,178391,0,225674
123648001700000,NE 168,Residential,212,0,0,212
123648001800000,NE 168,Residential,283,0,0,283
123648001900000,NE 168,Residential,222,0,0,222
123648002000000,NE 168,Residential,225,0,0,225
123648002100000,NE 168,Residential,204,0,0,204
130140100100000,NE 161,Residential,42575,243306,0,285881
130140100200000,NE 161,Residential,76500,252589,0,329089
130140100300000,NE 161,Residential,42500,229598,0,272098
130140100400000,NE 161,Residential,42500,0,0,42500
130140100500000,NE 161,Residential,42500,0,0,42500
130140100600000,NE 161,Residential,42500,254855,0,297355
130140100700000,NE 161,Residential,42500,244217,0,286717
130140100800000,NE 161,Residential,42500,227179,0,269679
130140100900000,NE 161,Residential,47667,201842,0,249509
130140101000000,NE 161,Residential,42500,239134,0,281634
130140101100000,NE 161,Residential,42500,0,0,42500
130140200100000,NE 161,Residential,43350,237113,0,280463
130140200200000,NE 161,Residential,46750,251327,0,298077
130140200300000,NE 161,Residential,46027,278160,0,324187
130140200400000,NE 161,Residential,44752,341040,0,385792
130140200500000,NE 161,Residential,42349,291565,0,333914
130140200600000,NE 161,Residential,48675,225564,0,274239
130140200700000,NE 161,Residential,46315,332149,0,378464
130140200800000,NE 161,Residential,45591,224083,0,269674
130140200900000,NE 161,Residential,44752,227485,0,272237
130140201000000,NE 161,Residential,48150,0,0,48150
130140201200000,NE 161,Residential,1110,0,0,1110
130140201300000,NE 161,Residential,1090,0,0,1090
130140201400000,NE 161,Residential,1045,0,0,1045
130140201500000,NE 161,Residential,1050,0,0,1050
130140201600000,NE 161,Residential,55539,447737,0,503276
130140201700000,NE 161,Residential,58810,281874,0,340684
130140201800000,NE 161,Residential,55242,231877,0,287119
130140201900000,NE 161,Residential,61778,545745,0,607523
130140202000000,NE 161,Residential,59836,245238,0,305074
130140202100000,NE 161,Residential,73489,310186,0,383675
130140202200000,NE 161,Residential,65016,287385,0,352401
130140202300000,NE 161,Residential,61603,372658,0,434261
130140202400000,NE 161,Residential,56644,0,0,56644
130140202500000,NE 161,Residential,54683,258760,0,313443
130140202600000,NE 161,Residential,55080,0,0,55080
130140202700000,NE 161,Residential,55080,0,0,55080
130140300100000,NE 161,Residential,53742,245775,0,299517
130140300200000,NE 161,Residential,42797,262063,0,304860
130140300300000,NE 161,Residential,44550,244225,0,288775
130140300400000,NE 161,Residential,46863,288254,0,335117
130140300500000,NE 161,Residential,54000,0,0,54000
130140300600000,NE 161,Residential,54900,332507,0,387407
130140300700000,NE 161,Residential,53244,335615,0,388859
130140300800000,NE 161,Residential,56304,243568,0,299872
130140300900000,NE 161,Residential,53489,269613,0,323102
130140400100000,NE 128,Residential,18500,0,0,18500
130142700100000,NE 161,Residential,78100,0,0,78100
130142700200000,NE 161,Residential,47736,0,0,47736
130142700300000,NE 161,Residential,48960,254085,0,303045
130142700400000,NE 161,Residential,48960,0,0,48960
130142700500000,NE 161,Residential,47124,339866,0,386990
130142700600000,NE 161,Residential,47124,276170,0,323294
130142700700000,NE 161,Residential,48960,308042,0,357002
130142700800000,NE 161,Residential,47736,381319,0,429055
130142700900000,NE 161,Residential,43834,0,0,43834
130142701000000,NE 161,Residential,54810,337602,0,392412
130142701100000,NE 161,Residential,55003,0,0,55003
130142701200000,NE 161,Residential,62550,372611,0,435161
130142701300000,NE 161,Residential,56222,0,0,56222
130142701400000,NE 161,Residential,52020,234812,0,286832
130142701500000,NE 161,Residential,52020,0,0,52020
130142701600000,NE 161,Residential,57900,0,0,57900
130142800100000,NE 161,Residential,53489,324184,0,377673
130142800200000,NE 161,Residential,53560,225922,0,279482
130145100100000,E-41 RELIG SCHOOLS,Exempt,1173960,0,13473593,14647553
130145200100000,NE 128,Residential,32450,79682,0,112132
130147600100000,NE 128,Residential,120042,309702,0,429744
130147600200000,NE 128,Residential,58345,0,0,58345
130147600300000,NE 128,Residential,150000,598809,0,748809
130147600400000,NE 128,Residential,121769,638253,0,760022
130147600500000,NE 128,Residential,115851,389101,0,504952
130147600600000,NE 128,Residential,114501,303555,0,418056
130147600700000,NE 128,Residential,124499,503268,0,627767
130147600800000,NE 128,Residential,147558,552442,0,700000
130147600900000,NE 128,Residential,140251,575610,0,715861
130147601000000,NE 128,Residential,152550,416824,0,569374
130147601100000,NE 128,Residential,128414,590175,0,718589
130147601200000,NE 128,Residential,122429,429916,0,552345
130147601300000,NE 128,Residential,114379,407156,0,521535
130147601400000,NE 128,Residential,111100,319723,0,430823
130147601500000,NE 128,Residential,112320,467671,0,579991
130147601600000,NE 128,Residential,111240,658589,0,769829
130147601700000,NE 128,Residential,71974,0,0,71974
130147602000000,NE 128,Residential,65200,122714,0,187914
130147602700000,NE 128,Residential,2100,0,0,2100
130147800100000,NE 128,Residential,109036,540964,0,650000
130147800200000,NE 128,Residential,102960,477216,0,580176
130147800300000,NE 128,Residential,112320,591424,0,703744
130147800400000,NE 128,Residential,106609,352934,0,459543
130147800500000,NE 128,Residential,20,0,0,20
130147900100000,NE 128,Residential,110140,457054,0,567194
130147900200000,NE 128,Residential,112320,331205,0,443525
130147900300000,NE 128,Residential,83430,741570,0,825000
130147900400000,NE 128,Residential,53227,0,0,53227
131140100100000,NE 165,Residential,787600,1779834,0,2567434
131147600100000,E-15 CITY,Exempt,0,0,0,0
131212600300000,NE 128,Residential,50490,122626,0,173116
131220100100000,NE 165,Residential,44458,315370,0,359828
131220100200000,NE 165,Residential,43289,376172,0,419461
131220100300000,NE 165,Residential,48053,258186,0,306239
131220100400000,NE 165,Residential,46060,263940,0,310000
131220100500000,NE 165,Residential,49680,385572,0,435252
131220100600000,NE 165,Residential,51187,363117,0,414304
131220100700000,NE 165,Residential,49440,435999,0,485439
131220100800000,NE 165,Residential,60233,455593,0,515826
131220100900000,NE 165,Residential,58594,0,0,58594
131220101000000,NE 165,Residential,61803,477025,0,538828
131220101100000,NE 165,Residential,60690,374310,0,435000
131220101200000,NE 165,Residential,61803,482782,0,544585
131220101300000,NE 165,Residential,64065,481737,0,545802
131220101400000,NE 165,Residential,61651,402114,0,463765
131220101500000,NE 165,Residential,58743,0,0,58743
131220101600000,NE 165,Residential,59863,0,0,59863
131220101700000,NE 165,Residential,69572,490390,0,559962
131220101800000,NE 165,Residential,62510,504913,0,567423
131220101900000,NE 165,Residential,64365,345635,0,410000
131220102000000,NE 165,Residential,100400,609618,0,710018
131220102100000,NE 165,Residential,77974,0,0,77974
131220102200000,NE 165,Residential,104500,621577,0,726077
131220102300000,NE 165,Residential,86672,573327,0,659999
131220102400000,NE 165,Residential,86469,373481,0,459950
131220102500000,NE 165,Residential,100700,361433,0,462133
131220102600000,NE 165,Residential,84179,498830,0,583009
131220102900000,NE 165,Residential,46500,2190,0,48690
131220103000000,NE 165,Residential,50000,597152,0,647152
131220103100000,NE 165,Residential,56863,488322,0,545185
131220103200000,NE 165,Residential,51493,492707,0,544200
131220103300000,NE 165,Residential,51300,414575,0,465875
131220103400000,NE 165,Residential,51775,510404,0,562179
131220103500000,NE 165,Residential,63588,459765,0,523353
131220103600000,NE 165,Residential,63750,463192,0,526942
131220103700000,NE 165,Residential,63142,461858,0,525000
131220103800000,NE 165,Residential,61994,375992,0,437986
131220103900000,NE 165,Residential,48384,246592,0,294976
131220104000000,NE 165,Residential,49169,0,0,49169
131220104100000,NE 165,Residential,63832,547994,0,611826
131220104200000,NE 165,Residential,60180,408648,0,468828
131220104300000,NE 165,Residential,62006,447628,0,509634
131220104400000,NE 165,Residential,55767,447274,0,503041
131220104500000,NE 165,Residential,45900,0,0,45900
131220104600000,NE 165,Residential,58154,452769,0,510923
131220104700000,NE 165,Residential,49379,332315,0,381694
131220104800000,NE 165,Residential,50575,488384,0,538959
131220104900000,NE 165,Residential,52351,522678,0,575029
131220105000000,NE 165,Residential,56206,399176,0,455382
131220105100000,NE 165,Residential,49147,408819,0,457966
131222700100000,NE 165,Residential,81280,359958,0,441238
131222700200000,NE 165,Residential,78511,315489,0,394000
131222700300000,NE 165,Residential,70612,0,0,70612
131222700400000,NE 165,Residential,76152,0,0,76152
131222700500000,NE 165,Residential,82536,338669,0,421205
131222700600000,NE 165,Residential,80520,0,0,80520
131222700700000,NE 165,Residential,92500,0,0,92500
131222700800000,NE 165,Residential,87840,568366,0,656206
131222700900000,NE 165,Residential,100100,529108,0,629208
131222701000000,NE 165,Residential,74412,374112,0,448524
131222701100000,NE 165,Residential,81058,449087,0,530145
131222701200000,NE 165,Residential,82280,427720,0,510000
131222701300000,NE 165,Residential,104300,495880,0,600180
131222701400000,NE 165,Residential,104400,513997,0,618397
131222701500000,NE 165,Residential,92207,0,0,92207
131222701600000,NE 165,Residential,68972,0,0,68972
131222701700000,NE 165,Residential,83402,536104,0,619506
131222701800000,NE 165,Residential,92862,400788,0,493650
131222702000000,NE 151,Residential,3640,0,0,3640
131222702100000,NE 151,Residential,86580,600141,0,686721
131222702200000,NE 151,Residential,5421,0,0,5421
131222702300000,NE 151,Residential,84180,80721,0,164901
131222702400000,NE 151,Residential,5685,0,0,5685
131222800100000,NE 151,Residential,3725,0,0,3725
131225100100000,NE 165,Residential,96289,0,0,96289
131225100200000,NE 165,Residential,129500,620500,0,750000
131225100300000,NE 165,Residential,104400,0,0,104400
131225100500000,NE 165,Residential,97674,729446,0,827120
131225100600000,NE 165,Residential,653,0,0,653
131225100700000,NE 165,Residential,191,0,0,191
131225100800000,NE 165,Residential,125400,554128,0,679528
131225100900000,NE 165,Residential,100640,0,0,100640
131225101000000,NE 165,Residential,101040,0,0,101040
131225101100000,NE 165,Residential,101520,0,0,101520
131225101200000,NE 165,Residential,127900,601477,0,729377
131225101300000,NE 165,Residential,101600,1031171,0,1132771
131225101400000,NE 165,Residential,128360,788445,0,916805
131225101500000,NE 165,Residential,101440,675060,0,776500
131225101600000,NE 165,Residential,102160,0,0,102160
131225101700000,NE 165,Residential,103040,0,0,103040
131225101800000,NE 165,Residential,102480,613128,0,715608
131225101900000,NE 165,Residential,100320,0,0,100320
131225102000000,NE 165,Residential,101250,528909,0,630159
131225102200000,NE 151,Residential,9006,0,0,9006
131225102300000,NE 151,Residential,19943,0,0,19943
131225102400000,NE 151,Residential,127800,120413,0,248213
131225102500000,NE 151,Residential,9176,0,0,9176
131225102600000,NE 151,Residential,8955,0,0,8955
131225102700000,NE 151,Residential,26897,0,0,26897
131225102800000,NE 151,Residential,90476,538571,0,629047
131225102900000,NE 151,Residential,3373,0,0,3373
131225103000000,NE 151,Residential,3223,0,0,3223
131225103100000,NE 151,Residential,3768,0,0,3768
131225103200000,NE 151,Residential,69156,300976,0,370132
131225103400000,NE 151,Residential,11980,0,0,11980
131225103500000,NE 151,Residential,8497,0,0,8497
131225103600000,NE 151,Residential,8855,0,0,8855
131225103700000,NE 151,Residential,5265,0,0,5265
131227600100000,NE 151,Residential,65000,117729,0,182729
131227600200000,NE 151,Residential,84900,174879,0,259779
131227600300000,NE 165,Residential,100000,456000,0,556000
131227600400000,NE 165,Residential,85428,0,0,85428
131227600500000,NE 165,Residential,100400,536070,0,636470
131227600600000,NE 165,Residential,100960,577897,0,678857
131227600700000,NE 165,Residential,95957,542043,0,638000
131227600800000,NE 165,Residential,100080,582333,0,682413
131227700100000,NE 165,Residential,89154,641935,0,731089
131227700200000,NE 165,Residential,93380,651757,0,745137
131227800100000,NE 151,Residential,166800,177,0,166977
131227900100000,NE 165,Residential,104240,0,0,104240
131227900200000,NE 165,Residential,88920,537493,0,626413
131227900300000,NE 165,Residential,94160,786145,0,880305
131227900400000,NE 165,Residential,101200,0,0,101200
131227900600000,NE 151,Residential,60000,124198,0,184198
131227900700000,NE 151,Residential,60000,124101,0,184101
131227900800000,NE 165,Residential,100960,538861,0,639821
131227900900000,NE 165,Residential,105440,0,0,105440
131227901000000,NE 165,Residential,103680,0,0,103680
131230100300000,NE 151,Residential,40008,329532,0,369540
131230100400000,NE 151,Residential,38367,0,0,38367
131230100500000,NE 151,Residential,40498,274963,0,315461
131230100600000,NE 151,Residential,38367,0,0,38367
131230100700000,NE 151,Residential,40498,0,0,40498
131230100800000,NE 151,Residential,40498,310315,0,350813
131230100900000,NE 151,Residential,52087,0,0,52087
131230101000000,NE 151,Residential,74450,0,0,74450
131230200200000,NE 151,Residential,11500,0,0,11500
131230200300000,NE 151,Residential,72000,102107,0,174107
131230200600000,NE 151,Residential,63000,0,0,63000
131230200700000,NE 151,Residential,51333,0,0,51333
131230200800000,NE 151,Residential,87200,0,0,87200
131230200900000,NE 151,Residential,94370,0,0,94370
131230201000000,NE 151,Residential,93520,0,0,93520
131230201100000,NE 151,Residential,89833,0,0,89833
131230201200000,NE 151,Residential,51333,369751,0,421084
131230201300000,NE 151,Residential,57200,330219,0,387419
131230201400000,NE 151,Residential,57200,375172,0,432372
131230201500000,NE 151,Residential,52000,450966,0,502966
131230201600000,NE 151,Residential,50985,0,0,50985
131230201700000,NE 151,Residential,82113,0,0,82113
131230201800000,NE 151,Residential,129320,0,0,129320
131230300100000,NE 151,Residential,44160,262305,0,306465
131230300200000,NE 151,Residential,36260,203230,0,239490
131230300300000,NE 151,Residential,36260,277314,0,313574
131230300400000,NE 151,Residential,36260,197694,0,233954
131230300500000,NE 151,Residential,35358,0,0,35358
131230300600000,NE 151,Residential,38920,257300,0,296220
131230300700000,NE 151,Residential,42615,289446,0,332061
131230300800000,NE 151,Residential,38001,0,0,38001
131230300900000,NE 151,Residential,36300,0,0,36300
131230301000000,NE 151,Residential,31850,0,0,31850
131230301100000,NE 151,Residential,39157,0,0,39157
131230301200000,NE 151,Residential,41854,0,0,41854
131230301300000,NE 151,Residential,39447,0,0,39447
131230301400000,NE 151,Residential,42593,0,0,42593
131230301500000,NE 151,Residential,39100,301014,0,340114
131230301600000,NE 151,Residential,37568,264407,0,301975
131230301900000,NE 151,Residential,33320,261630,0,294950
131230302000000,NE 151,Residential,32830,273762,0,306592
131230302100000,NE 151,Residential,35280,289694,0,324974
131230302200000,NE 151,Residential,43995,301198,0,345193
131230302300000,NE 151,Residential,43200,322624,0,365824
131230302400000,NE 151,Residential,40800,276669,0,317469
131230302500000,NE 151,Residential,45394,0,0,45394
131230302600000,NE 151,Residential,2350,0,0,2350
131230302700000,NE 170,Residential,850,0,0,850
131230302800000,NE 151,Residential,43100,262099,0,305199
131230302900000,NE 151,Residential,50300,230555,0,280855
131230400100000,NE 151,Residential,49920,0,0,49920
131230400200000,NE 151,Residential,53040,0,0,53040
131230400300000,NE 151,Residential,53040,248169,0,301209
131230400400000,NE 151,Residential,49400,356516,0,405916
131232600200000,NE 151,Residential,212800,324384,0,537184
131232600300000,NE 151,Residential,118999,0,0,118999
131232600400000,NE 151,Residential,50985,0,0,50985
131232600500000,NE 151,Residential,52000,0,0,52000
131232600600000,NE 151,Residential,57200,0,0,57200
131232600900000,NE 151,Residential,61050,286509,0,347559
131232601000000,NE 151,Residential,1241,0,0,1241
131232601100000,NE 151,Residential,1137,0,0,1137
131232601200000,NE 151,Residential,1425,0,0,1425
131232601300000,NE 151,Residential,2109,0,0,2109
131232601400000,NE 151,Residential,86399,360381,0,446780
131232601500000,NE 151,Residential,10117,0,0,10117
131232601600000,NE 151,Residential,81951,382083,0,464034
131232601700000,NE 151,Residential,82,0,0,82
131232601800000,NE 151,Residential,63,0,0,63
131232601900000,NE 151,Residential,95,0,0,95
131232602000000,NE 151,Residential,70,0,0,70
131232602100000,NE 151,Residential,85,0,0,85
131232602200000,NE 151,Residential,113,0,0,113
131232602300000,NE 151,Residential,133,0,0,133
131232602400000,NE 151,Residential,117,0,0,117
131232602500000,NE 151,Residential,1591,0,0,1591
131232700100000,NE 151,Residential,49400,287383,0,336783
131232700200000,NE 151,Residential,49400,279533,0,328933
131232700300000,NE 151,Residential,2922,0,0,2922
131232700400000,NE 151,Residential,62,0,0,62
131232700500000,NE 151,Residential,54775,338212,0,392987
131232700600000,NE 151,Residential,54237,81350,0,135587
131232700700000,NE 151,Residential,77,0,0,77
131232700800000,NE 151,Residential,69,0,0,69
131232700900000,NE 151,Residential,98,0,0,98
131232701000000,NE 151,Residential,92,0,0,92
131232701100000,NE 151,Residential,70,0,0,70
131232701200000,NE 151,Residential,77,0,0,77
131232701300000,NE 151,Residential,90,0,0,90
131232701400000,NE 151,Residential,106,0,0,106
131232701500000,NE 151,Residential,89,0,0,89
131232701600000,NE 151,Residential,1186,0,0,1186
131235100300000,NE 151,Residential,46545,250483,0,297028
131235100400000,NE 151,Residential,46545,325313,0,371858
131235100500000,NE 151,Residential,47952,263622,0,311574
131235100600000,NE 151,Residential,45842,269158,0,315000
131235100700000,NE 151,Residential,45450,280094,0,325544
131235100800000,NE 151,Residential,50058,337942,0,388000
131235100900000,NE 151,Residential,48875,298830,0,347705
131235101000000,NE 151,Residential,57881,455526,0,513407
131235101100000,NE 151,Residential,56475,227004,0,283479
131235101200000,NE 151,Residential,48386,224902,0,273288
131235101300000,NE 151,Residential,64820,256210,0,321030
131235101400000,NE 151,Residential,40388,260493,0,300881
131235101500000,NE 151,Residential,59676,279978,0,339654
131235101600000,NE 151,Residential,55080,0,0,55080
131235101700000,NE 151,Residential,55080,11340,0,66420
131235101800000,NE 151,Residential,55892,288816,0,344708
131235101900000,NE 151,Residential,71410,333406,0,404816
131235102000000,NE 151,Residential,56150,318850,0,375000
131235102100000,NE 151,Residential,58629,387162,0,445791
131235102200000,NE 151,Residential,66980,328020,0,395000
131235102300000,NE 151,Residential,63625,346668,0,410293
131235102400000,NE 151,Residential,57270,414331,0,471601
131235102500000,NE 151,Residential,61608,365814,0,427422
131235102600000,NE 151,Residential,55080,355812,0,410892
131235102700000,NE 151,Residential,55262,314738,0,370000
131235102800000,NE 151,Residential,24500,0,0,24500
131235102900000,NE 151,Residential,23240,0,0,23240
131235103000000,NE 151,Residential,56150,323850,0,380000
131235103100000,NE 151,Residential,56160,273068,0,329228
131235103200000,NE 151,Residential,56160,286176,0,342336
131235103300000,NE 151,Residential,56160,198100,0,254260
131235103400000,NE 151,Residential,56160,53574,0,109734
131235103500000,NE 151,Residential,55000,0,0,55000
131235103600000,NE 151,Residential,1250,0,0,1250
131235200100000,NE 151,Residential,46980,262502,0,309482
131235200200000,NE 151,Residential,45360,270550,0,315910
131235200300000,NE 151,Residential,45081,273842,0,318923
131235200400000,NE 151,Residential,45360,220493,0,265853
131235200500000,NE 151,Residential,45360,304640,0,350000
131235200600000,NE 151,Residential,44012,298981,0,342993
131235200700000,NE 151,Residential,44779,313713,0,358492
131235200800000,NE 151,Residential,46638,186802,0,233440
131235200900000,NE 151,Residential,46332,173641,0,219973
131235201000000,NE 151,Residential,45360,171181,0,216541
131235201100000,NE 151,Residential,45360,174453,0,219813
131235201200000,NE 151,Residential,39162,240708,0,279870
131235201300000,NE 151,Residential,44409,227131,0,271540
131235201400000,NE 151,Residential,45894,216696,0,262590
131235300100000,NE 151,Residential,57339,0,0,57339
131235300200000,NE 151,Residential,56844,219005,0,275849
131235300300000,NE 151,Residential,56844,250821,0,307665
131235300400000,NE 151,Residential,56652,367141,0,423793
131237600100000,NE 151,Residential,45720,120210,0,165930
131237600200000,NE 151,Residential,44300,103851,0,148151
131237600300000,NE 151,Residential,45020,160861,0,205881
131237600500000,NE 150,Residential,20,0,0,20
131237600600000,NE 151,Residential,45920,169773,0,215693
131237600700000,NE 151,Residential,44300,189775,0,234075
131237600800000,NE 151,Residential,43670,305402,0,349072
131237600900000,NE 151,Residential,52826,0,0,52826
131237601000000,NE 151,Residential,52568,392868,0,445436
131237601100000,NE 151,Residential,52559,0,0,52559
131237601200000,NE 151,Residential,70100,420499,0,490599
131237601300000,NE 151,Residential,16900,0,0,16900
131237601400000,NE 151,Residential,62000,140564,0,202564
131237700100000,NE 151,Residential,40363,239509,0,279872
131237700200000,NE 151,Residential,36504,242746,0,279250
131237700300000,NE 151,Residential,36188,234066,0,270254
131237700400000,NE 151,Residential,37736,235645,0,273381
131237700500000,NE 151,Residential,39312,271313,0,310625
131237800100000,NE 151,Residential,49401,213818,0,263219
131237800200000,NE 151,Residential,47669,261757,0,309426
131237800300000,NE 151,Residential,52200,187039,0,239239
131237800400000,NE 151,Residential,52200,262030,0,314230
131237800500000,NE 151,Residential,52200,407919,0,460119
131237800600000,NE 151,Residential,46980,190129,0,237109
131237800700000,NE 151,Residential,51750,252347,0,304097
131237900100000,NE 151,Residential,41724,252639,0,294363
131237900200000,NE 151,Residential,42066,293068,0,335134
131237900300000,NE 151,Residential,46545,294180,0,340725
131237900400000,NE 151,Residential,49755,294337,0,344092
131237900500000,NE 151,Residential,45765,296232,0,341997
131238000100000,NE 151,Residential,50220,292991,0,343211
131238000200000,NE 151,Residential,46980,297657,0,344637
131238000300000,NE 151,Residential,44298,233147,0,277445
131238000400000,NE 151,Residential,48600,211380,0,259980
131240100200000,NE 151,Residential,10000,0,0,10000
131240100500000,NE 151,Residential,105150,0,0,105150
131240100600000,NE 151,Residential,103800,0,0,103800
131242700100000,NE 151,Residential,49011,282246,0,331257
131242700200000,NE 151,Residential,43224,353521,0,396745
131242700300000,NE 151,Residential,48052,0,0,48052
131242700400000,NE 151,Residential,42674,368247,0,410921
131242700500000,NE 151,Residential,51810,386407,0,438217
131242700700000,NE 151,Residential,81700,0,0,81700
131242700800000,NE 151,Residential,68800,328672,0,397472
131242700900000,NE 151,Residential,90600,11340,0,101940
131242701000000,NE 151,Residential,57800,298703,0,356503
131242701100000,NE 151,Residential,59850,0,0,59850
131242800100000,NE 151,Residential,51949,0,0,51949
131242800200000,NE 151,Residential,62416,0,0,62416
131242800300000,NE 151,Residential,49000,331000,0,380000
131242800500000,NE 151,Residential,70787,318880,0,389667
131242800600000,NE 151,Residential,2386,0,0,2386
131242800700000,NE 151,Residential,1915,0,0,1915
131242800800000,NE 151,Residential,43937,271760,0,315697
131242800900000,NE 151,Residential,1472,0,0,1472
131242801000000,NE 151,Residential,1476,0,0,1476
131242801100000,NE 151,Residential,1476,0,0,1476
131242801200000,NE 151,Residential,1345,0,0,1345
131242801300000,NE 151,Residential,1505,0,0,1505
131242801400000,NE 151,Residential,1458,0,0,1458
131242801500000,NE 151,Residential,1503,0,0,1503
131242801600000,NE 151,Residential,46653,353895,0,400548
131242801700000,NE 151,Residential,62573,413156,0,475729
131242801800000,NE 151,Residential,3542,0,0,3542
131242801900000,NE 151,Residential,57600,322779,0,380379
131242802000000,NE 151,Residential,59000,226354,0,285354
131242802200000,NE 151,Residential,48183,380651,0,428834
131242802400000,NE 151,Residential,51653,402899,0,454552
131242802500000,NE 151,Residential,41381,416049,0,457430
131242900100000,NE 151,Residential,43602,297128,0,340730
131242900200000,NE 151,Residential,45450,297694,0,343144
131242900300000,NE 151,Residential,44940,258770,0,303710
131242900400000,NE 151,Residential,49842,0,0,49842
131242900500000,NE 151,Residential,44100,0,0,44100
131242900600000,NE 151,Residential,44100,400103,0,444203
131242900700000,NE 151,Residential,1476,0,0,1476
131242900800000,NE 151,Residential,1476,0,0,1476
131242900900000,NE 151,Residential,1447,0,0,1447
131242901000000,NE 151,Residential,1568,0,0,1568
131242901100000,NE 151,Residential,66618,201294,0,267912
131242901200000,NE 151,Residential,1362,0,0,1362
131242901300000,NE 151,Residential,1701,0,0,1701
131242901400000,NE 151,Residential,48645,183356,0,232001
131242901500000,NE 151,Residential,3299,0,0,3299
131242901600000,NE 151,Residential,1688,0,0,1688
131242901700000,NE 151,Residential,1500,0,0,1500
131242901800000,NE 151,Residential,48975,357375,0,406350
131242901900000,NE 151,Residential,48992,197528,0,246520
131242902000000,NE 151,Residential,1679,0,0,1679
131242902100000,NE 151,Residential,35145,4860,0,40005
131242902200000,NE 151,Residential,34650,4860,0,39510
131242902300000,NE 151,Residential,1367,0,0,1367
131242902400000,NE 151,Residential,2658,0,0,2658
131243000100000,NE 151,Residential,41333,0,0,41333
131243000200000,NE 151,Residential,44239,0,0,44239
131243000300000,NE 151,Residential,44940,0,0,44940
131243000400000,NE 151,Residential,51744,0,0,51744
131243000500000,NE 151,Residential,48267,0,0,48267
131243000600000,NE 151,Residential,49300,0,0,49300
131243100100000,NE 151,Residential,47628,288702,0,336330
131243100200000,NE 151,Residential,48269,0,0,48269
131243100300000,NE 151,Residential,48500,0,0,48500
131245100200000,NE 150,Residential,60350,199661,0,260011
131245100300000,NE 150,Residential,60300,168367,0,228667
131245100400000,NE 150,Residential,60250,168381,0,228631
131245100500000,NE 150,Residential,20,0,0,20
131245100600000,NE 150,Residential,20,0,0,20
131245200100000,NE 150,Residential,60700,170877,0,231577
131245200200000,NE 150,Residential,61100,160705,0,221805
131245200300000,NE 150,Residential,60100,184406,0,244506
131245200400000,NE 150,Residential,20,0,0,20
131245200500000,NE 150,Residential,55370,193689,0,249059
131245200600000,NE 150,Residential,60300,165695,0,225995
131245200700000,NE 150,Residential,61050,225889,0,286939
131245200800000,NE 150,Residential,61150,207983,0,269133
131245201000000,NE 150,Residential,43721,173701,0,217422
131245201100000,NE 150,Residential,46446,140738,0,187184
131245201200000,NE 150,Residential,61750,236460,0,298210
131245201300000,NE 150,Residential,22000,0,0,22000
131245201400000,NE 150,Residential,63400,156600,0,220000
131245201500000,NE 150,Residential,60300,180278,0,240578
131245201600000,NE 150,Residential,20,0,0,20
131245300200000,NE 151,Residential,50490,0,0,50490
131245300900000,NE 151,Residential,970,0,0,970
131245301000000,NE 151,Residential,669,0,0,669
131245301100000,NE 151,Residential,59670,428456,0,488126
131245301600000,NE 151,Residential,64800,431969,0,496769
131245301700000,NE 151,Residential,105052,284854,0,389906
131245400100000,NE 151,Residential,50196,0,0,50196
131245400200000,NE 151,Residential,48672,0,0,48672
131245400300000,NE 151,Residential,49413,0,0,49413
131245400400000,NE 151,Residential,50792,243884,0,294676
131245400500000,NE 151,Residential,48614,0,0,48614
131245400600000,NE 151,Residential,47197,302403,0,349600
131245400800000,NE 151,Residential,55590,0,0,55590
131245400900000,NE 151,Residential,59417,291718,0,351135
131245401000000,NE 151,Residential,2220,0,0,2220
131247600500000,NE 151,Residential,11839,0,0,11839
131247600600000,NE 151,Residential,5725,0,0,5725
131247600700000,NE 151,Residential,3739,0,0,3739
131247600800000,NE 151,Residential,4828,0,0,4828
131247600900000,NE 151,Residential,81223,505122,0,586345
131247601000000,NE 151,Residential,73500,261013,0,334513
131247601100000,NE 151,Residential,106604,490047,0,596651
131247601200000,NE 151,Residential,4831,0,0,4831
131247601300000,NE 151,Residential,4051,0,0,4051
131247601400000,NE 151,Residential,2718,0,0,2718
131247601500000,NE 151,Residential,2575,0,0,2575
131247601600000,NE 151,Residential,2569,0,0,2569
131247601700000,NE 151,Residential,229659,0,0,229659
131247601800000,NE 151,Residential,81150,0,0,81150
131312700100000,NE 151,Ag Land,18188,0,0,18188
131320100100000,NE 151,Ag Dwelling,8481,108349,0,116830
131320200100000,NE 151,Residential,51750,232000,0,283750
131320200200000,NE 151,Residential,35313,111783,0,147096
131320200300000,NE 151,Residential,36563,143980,0,180543
131320300100000,NE 151,Residential,49050,240609,0,289659
131320300200000,NE 151,Residential,44712,303363,0,348075
131320300300000,NE 151,Residential,40875,150544,0,191419
131320300400000,NE 151,Residential,40875,128530,0,169405
131320400100000,NE 151,Residential,39360,147619,0,186979
131320400200000,NE 151,Residential,41605,185691,0,227296
131320400300000,NE 151,Residential,39322,196907,0,236229
131320400400000,NE 151,Residential,45985,191355,0,237340
131322600100000,NE 151,Residential,46539,214313,0,260852
131322600200000,NE 151,Residential,45412,170380,0,215792
131322600300000,NE 151,Residential,41053,207008,0,248061
131322600400000,NE 151,Residential,45126,167539,0,212665
131322600500000,NE 151,Residential,47087,264431,0,311518
131322600600000,NE 151,Residential,46105,158895,0,205000
131322600700000,NE 151,Residential,46091,236009,0,282100
131322600800000,NE 151,Residential,37427,165270,0,202697
131322600900000,NE 151,Residential,40875,193417,0,234292
131322601000000,NE 151,Residential,40875,169374,0,210249
131322601100000,NE 151,Residential,40875,153215,0,194090
131322601200000,NE 151,Residential,40875,171123,0,211998
131322601300000,NE 151,Residential,40875,124606,0,165481
131322601400000,NE 151,Residential,40875,143736,0,184611
131322700100000,NE 151,Residential,45985,244036,0,290021
131322700200000,NE 151,Residential,40875,256754,0,297629
131322700300000,NE 151,Residential,40875,164987,0,205862
131322700400000,NE 151,Residential,40875,221760,0,262635
131322700500000,NE 151,Residential,40875,296968,0,337843
131322700600000,NE 151,Residential,39967,172549,0,212516
131322700700000,NE 151,Residential,45075,226260,0,271335
131322700800000,NE 151,Residential,34960,138247,0,173207
131322700900000,NE 151,Residential,33656,185862,0,219518
131322701000000,NE 151,Residential,44887,175749,0,220636
131322701100000,NE 151,Residential,44799,262722,0,307521
131327600100000,E-15 CITY,Exempt,0,0,0,0
131330100100000,NW 302,Residential,85680,236407,0,322087
131335100700000,NW 302,Residential,111700,817942,0,929642
131335100800000,NW 302,Residential,2700,0,0,2700
131335100900000,NW 302,Residential,12250,0,0,12250
131337600500000,NW 302,Residential,35640,0,0,35640
131337600600000,NW 302,Residential,42000,0,0,42000
131337600700000,NW 302,Residential,50400,0,0,50400
131337600800000,NW 302,Residential,50880,0,0,50880
131337600900000,NW 302,Residential,62527,0,0,62527
131337601000000,NW 302,Residential,64800,0,0,64800
131337601100000,NW 302,Residential,110287,0,0,110287
131337601200000,NW 302,Residential,101489,0,0,101489
131337700100000,NW 302,Residential,31640,0,0,31640
131337700200000,NW 302,Residential,36380,0,0,36380
131337700300000,NW 302,Residential,34668,0,0,34668
131337700400000,NW 302,Residential,34240,0,0,34240
131337700500000,NW 302,Residential,36380,278281,0,314661
131337700600000,NW 302,Residential,56068,0,0,56068
131342600300000,NW 302,Residential,144400,95121,0,239521
131342600400000,NW 302,Residential,78250,173183,0,251433
131345100300000,NW 302,Residential,35272,0,0,35272
131345100400000,NW 302,Residential,36480,252298,0,288778
131345100500000,NW 302,Residential,39317,251943,0,291260
131345100600000,NW 302,Residential,37240,0,0,37240
131345100700000,NW 302,Residential,37813,217870,0,255683
131345100800000,NW 302,Residential,30480,0,0,30480
131345100900000,NW 302,Residential,41944,0,0,41944
131345101000000,E-15 CITY,Exempt,0,0,0,0
131345101400000,NW 302,Residential,1918,0,0,1918
131345101600000,NW 302,Ag Land,5358,0,0,5358
131345101700000,NW 302,Residential,829,0,0,829
131345101800000,NW 302,Residential,33660,259470,0,293130
131345200100000,NW 302,Residential,38080,300920,0,339000
131345200200000,NW 302,Residential,37248,217749,0,254997
131345200300000,NW 302,Residential,37800,191369,0,229169
131345200400000,NW 302,Residential,34340,217758,0,252098
131345200500000,NW 302,Residential,36360,194567,0,230927
131345200600000,NW 302,Residential,35304,204365,0,239669
131345200700000,NW 302,Residential,126,0,0,126
131345200800000,NW 302,Residential,36860,278411,0,315271
131345200900000,NW 302,Residential,38409,222359,0,260768
131345300100000,NW 302,Residential,38189,240791,0,278980
131345300200000,NW 302,Residential,37451,345772,0,383223
131345400200000,NW 302,Residential,41801,198242,0,240043
131345400300000,NW 302,Residential,42293,228349,0,270642
131345400400000,NW 302,Residential,40400,262129,0,302529
131345400500000,NW 302,Residential,46690,368737,0,415427
131347600300000,NW 302,Residential,41850,62103,0,103953
131347600700000,NW 302,Residential,33962,138911,0,172873
131347600800000,NW 302,Residential,25245,41522,0,66767
131410100100000,E-15 CITY,Exempt,0,0,0,0
131515200300000,NW 332,Residential,258125,0,0,258125
131515200500000,NW 332,Residential,7050,0,0,7050
131515200600000,NW 332,Residential,7050,0,0,7050
131515200700000,NW 332,Residential,67056,10710,0,77766
131515200800000,NW 332,Residential,68640,250801,0,319441
131515200900000,E-15 CITY,Exempt,0,0,0,0
131515201000000,NW 332,Residential,68392,242580,0,310972
131515201100000,NW 332,Residential,72360,206031,0,278391
131515201200000,NW 332,Residential,9696,0,0,9696
131515300100000,NW 332,Residential,55080,275179,0,330259
131515300200000,NW 332,Residential,4821,0,0,4821
131515300300000,NW 332,Residential,5424,0,0,5424
131515300400000,NW 332,Residential,8228,0,0,8228
131515300500000,NW 332,Residential,61924,242589,0,304513
131515300600000,NW 332,Residential,51816,241789,0,293605
131515300700000,NW 332,Residential,52020,298675,0,350695
131515400100000,NW 332,Residential,54060,237962,0,292022
131515400200000,NW 332,Residential,5676,0,0,5676
131515400300000,NW 332,Residential,70384,8160,0,78544
131515500100000,NW 332,Residential,8087,0,0,8087
131515500200000,NW 332,Residential,58320,187728,0,246048
131515500300000,NW 332,Residential,67625,183757,0,251382
131522600100000,E-15 CITY,Exempt,0,0,0,0
131522600200000,NW 332,Ag Land,28158,0,0,28158
131522600300000,NW 332,Ag Land,17205,0,0,17205
131525100100000,NW 332,Ag Land,43592,0,0,43592
131527600300000,NW 332,Ag Land,23438,0,0,23438
131527600400000,NW 332,Ag Land,27053,0,0,27053
131532600100000,E-15 CITY,Exempt,0,0,0,0
131542600200000,NW 332,Ag Dwelling,34300,100209,12723,147232
131542600400000,NW 332,Residential,66874,230658,0,297532
131542600500000,NW 332,Residential,4791,0,0,4791
131542600600000,NW 332,Residential,4775,0,0,4775
131542600700000,NW 332,Residential,4758,0,0,4758
131542600800000,NW 332,Residential,6044,0,0,6044
131542600900000,NW 332,Residential,6437,0,0,6437
131542601000000,NW 332,Residential,6049,0,0,6049
131542601100000,NW 332,Residential,9217,0,0,9217
131542601200000,E-15 CITY,Exempt,0,0,0,0
131542700100000,NW 332,Residential,5283,0,0,5283
131542700200000,NW 332,Residential,4870,0,0,4870
131542700300000,NW 332,Residential,5562,0,0,5562
131542700400000,NW 332,Residential,8496,0,0,8496
131542700500000,NW 332,Residential,4755,0,0,4755
131542700600000,NW 332,Residential,5426,0,0,5426
131542700700000,NW 332,Residential,3863,0,0,3863
131542700800000,NW 332,Residential,3931,0,0,3931
131542700900000,NW 332,Residential,4467,0,0,4467
131542800100000,NW 332,Residential,4520,0,0,4520
131542800200000,NW 332,Residential,4000,0,0,4000
131542800300000,NW 332,Residential,4155,0,0,4155
131542800400000,NW 332,Residential,5135,0,0,5135
132222600100000,NW 332,Ag Land,24859,0,0,24859
132222600200000,NW 332,Ag Land,23282,0,0,23282
132225100100000,NW 332,Ag Land,45956,0,0,45956
132225100200000,NW 332,Residential,45144,78450,0,123594
132232600100000,NW 332,Ag Land,37210,0,0,37210
132235100100000,NW 332,Ag Dwelling,45880,76609,0,122489
132237600100000,E-10 COUNTY,Exempt,0,0,0,0
132245100100000,E-10 COUNTY,Exempt,0,0,0,0
132245100200000,NW 332,Ag Land,46048,0,0,46048
132247600200000,NW 332,Ag Land,16251,0,0,16251
132247600400000,NW 322,Ag Land,20467,0,0,20467
132247600500000,NW 332,Residential,48127,171494,0,219621
132247600600000,NW 332,Residential,40375,209037,0,249412
132247600700000,NW 332,Residential,41695,156071,0,197766
132247600800000,NW 332,Residential,266,0,0,266
132247600900000,NW 332,Residential,262,0,0,262
132247601000000,NW 332,Residential,38000,156850,0,194850
132247601100000,NW 332,Residential,38000,155057,0,193057
132247601200000,NW 332,Residential,237,0,0,237
132247601300000,NW 332,Residential,264,0,0,264
132247601400000,NW 332,Residential,276,0,0,276
132247601500000,NW 332,Residential,381,0,0,381
132247700100000,NW 332,Residential,46157,194958,0,241115
132247700200000,NW 332,Residential,279,0,0,279
132247700300000,NW 332,Residential,40375,4590,0,44965
132247700400000,NW 332,Residential,28101,149904,0,178005
132247700500000,NW 332,Residential,38276,10710,0,48986
132247700600000,NW 332,Residential,42454,4590,0,47044
132247700700000,NW 332,Residential,283,0,0,283
132247700800000,NW 332,Residential,34672,8160,0,42832
132247700900000,NW 332,Residential,313,0,0,313
132247701000000,NW 332,Residential,325,0,0,325
132247701100000,NW 332,Residential,267,0,0,267
132247701200000,NW 332,Residential,39710,192694,0,232404
132247701300000,NW 332,Residential,65981,184587,0,250568
132247701400000,NW 332,Residential,0,0,0,0
132247701500000,E-15 CITY,Exempt,0,0,0,0
132340200200000,Empty,Exempt,0,0,0,0
132340200300000,NW 329,Residential,24056,89272,0,113328
132340200400000,NW 329,Residential,23914,94393,0,118307
132340200500000,NW 329,Residential,26209,90555,0,116764
132340200600000,NW 329,Residential,27390,96317,0,123707
132340200700000,NW 329,Residential,26536,95818,0,122354
132340200800000,NW 329,Residential,26683,113729,0,140412
132340200900000,NW 329,Residential,26670,73910,0,100580
132340201000000,NW 329,Residential,29316,100487,0,129803
132340300100000,NW 329,Residential,25995,94820,0,120815
132340300200000,NW 329,Residential,24832,101805,0,126637
132340300300000,NW 329,Residential,27645,98202,0,125847
132340300400000,NW 329,Residential,27645,94949,0,122594
132340300500000,NW 329,Residential,25175,91460,0,116635
132340400100000,NW 329,Residential,26293,99986,0,126279
132340400200000,NW 329,Residential,27234,96321,0,123555
132340400300000,NW 329,Residential,26937,87758,0,114695
132340400400000,NW 329,Residential,25867,80841,0,106708
132340400500000,NW 329,Residential,24522,100954,0,125476
132340400600000,NW 329,Residential,24522,93879,0,118401
132340400700000,NW 329,Residential,27791,93482,0,121273
132347600100000,NW 329,Residential,25175,91226,0,116401
132347600200000,NW 329,Residential,25175,94233,0,119408
132347600300000,NW 329,Residential,25175,133504,0,158679
132347600400000,NW 329,Residential,25175,102109,0,127284
132347600500000,NW 329,Residential,25175,105354,0,130529
132347600600000,NW 329,Residential,27645,108705,0,136350
132347700100000,NW 329,Residential,24522,88629,0,113151
132347700200000,NW 329,Residential,24522,88789,0,113311
132347700300000,NW 329,Residential,24522,86216,0,110738
132347700400000,NW 329,Residential,24522,103717,0,128239
132347700500000,NW 329,Residential,24522,95725,0,120247
132347700600000,NW 329,Residential,24522,84324,0,108846
132347700700000,NW 329,Residential,27238,93016,0,120254
132347700800000,NW 329,Residential,24832,94565,0,119397
132347700900000,NW 329,Residential,27238,105394,0,132632
132347701000000,NW 329,Residential,24522,86465,0,110987
132347701100000,NW 329,Residential,24522,94564,0,119086
132347701200000,NW 329,Residential,24522,100256,0,124778
132347701300000,NW 329,Residential,24522,79381,0,103903
132347800100000,NW 329,Residential,24056,96286,0,120342
132347800200000,NW 329,Residential,24056,79785,0,103841
132347800300000,NW 329,Residential,25802,117780,0,143582
132347800400000,NW 329,Residential,25802,95481,0,121283
132347800500000,NW 329,Residential,24832,106203,0,131035
132347800600000,NW 329,Residential,24832,90964,0,115796
132347800700000,NW 329,Residential,24832,89376,0,114208
132347800800000,NW 329,Residential,24832,99480,0,124312
132347800900000,NW 329,Residential,26384,103199,0,129583
132347801000000,Empty,Exempt,0,0,0,0
132347900100000,NW 329,Residential,27373,104974,0,132347
132347900200000,NW 329,Residential,24832,86405,0,111237
132347900300000,NW 329,Residential,24832,97348,0,122180
132347900400000,NW 329,Residential,24832,114551,0,139383
132347900500000,NW 329,Residential,24832,99573,0,124405
132347900600000,NW 329,Residential,24832,100713,0,125545
132347900700000,NW 329,Residential,24832,93703,0,118535
132347900800000,NW 329,Residential,24832,90909,0,115741
132347900900000,NW 329,Residential,24832,81803,0,106635
132347901000000,NW 329,Residential,24832,94304,0,119136
132347901100000,NW 329,Residential,24832,93517,0,118349
132347901200000,NW 329,Residential,27373,100866,0,128239
132348000100000,NW 329,Residential,27238,97799,0,125037
132348000200000,NW 329,Residential,24832,95387,0,120219
132348000300000,NW 329,Residential,27238,75721,0,102959
132348000400000,NW 329,Residential,25802,96625,0,122427
132348000500000,NW 329,Residential,24716,94288,0,119004
132348000600000,NW 329,Residential,24716,88830,0,113546
132348000700000,NW 329,Residential,24716,97441,0,122157
132348000800000,NW 329,Residential,24716,111939,0,136655
132348000900000,NW 329,Residential,24716,98275,0,122991
132348001000000,NW 329,Residential,24716,83727,0,108443
132348001100000,NW 329,Residential,24716,98121,0,122837
132348001200000,NW 329,Residential,25802,102525,0,128327
132348001300000,NW 329,Residential,27238,86904,0,114142
132348001400000,NW 329,Residential,24832,109205,0,134037
132348001500000,NW 329,Residential,27238,106421,0,133659
132348001600000,NW 329,Residential,25802,98088,0,123890
132348001700000,NW 329,Residential,24716,100096,0,124812
132348001800000,NW 329,Residential,24716,90332,0,115048
132348001900000,NW 329,Residential,24716,109419,0,134135
132348002000000,NW 329,Residential,24716,96023,0,120739
132348002100000,NW 329,Residential,24716,103662,0,128378
132348002200000,NW 329,Residential,24716,108572,0,133288
132348002300000,NW 329,Residential,24716,92418,0,117134
132348002400000,NW 329,Residential,25802,95339,0,121141
132348100100000,NW 329,Residential,28557,109665,0,138222
132348100200000,NW 329,Residential,25802,78304,0,104106
132348100300000,NW 329,Residential,25802,84310,0,110112
132348100400000,NW 329,Residential,25802,83289,0,109091
132348100500000,NW 329,Residential,25802,103396,0,129198
132348100600000,NW 329,Residential,25802,100932,0,126734
132348100700000,NW 329,Residential,25802,87608,0,113410
132348100800000,NW 329,Residential,26772,120011,0,146783
132410100100000,NW 337,Residential,30000,118060,0,148060
132410100500000,E-15 CITY,Exempt,0,0,0,0
132410100700000,NW 337,Residential,51100,127955,0,179055
132410100800000,NW 337,Residential,53500,84048,0,137548
132410100900000,NW 337,Residential,41400,148110,0,189510
132410200400000,NW 309,Residential,40460,254540,0,295000
132412600100000,NW 339,Residential,34319,165214,0,199533
132412600200000,NW 339,Residential,34680,178253,0,212933
132412600300000,NW 339,Residential,34680,177777,0,212457
132412600400000,NW 339,Residential,34680,203907,0,238587
132412600500000,NW 339,Residential,33320,198007,0,231327
132412600600000,NW 309,Residential,31360,144245,0,175605
132412600700000,NW 309,Residential,31360,173035,0,204395
132412600800000,NW 309,Residential,34365,208288,0,242653
132412600900000,NW 309,Residential,32248,236425,0,268673
132412601000000,NW 309,Residential,32367,210065,0,242432
132412601100000,NW 309,Residential,35711,185198,0,220909
132412601200000,NW 309,Residential,34353,260630,0,294983
132412700100000,NW 309,Residential,35436,208823,0,244259
132412700200000,NW 309,Residential,35578,148049,0,183627
132412700300000,NW 309,Residential,34896,136936,0,171832
132412800200000,NW 339,Residential,33141,197219,0,230360
132412800300000,NW 339,Residential,31280,209534,0,240814
132412800400000,NW 339,Residential,31280,245631,0,276911
132412800500000,NW 339,Residential,31620,191477,0,223097
132412800600000,NW 339,Residential,32319,185143,0,217462
132412800700000,NW 339,Residential,29732,197191,0,226923
132412800800000,NW 342,Ag Land,12680,0,1467,14147
132412800900000,NW 309,Residential,32399,0,0,32399
132412801000000,NW 309,Residential,32399,282776,0,315175
132412801100000,NW 309,Residential,32313,185420,0,217733
132412801200000,NW 309,Residential,32040,254320,0,286360
132412801300000,NW 309,Residential,31445,0,0,31445
132412801400000,NW 309,Residential,31331,183807,0,215138
132412900100000,NW 339,Residential,33393,191446,0,224839
132412900200000,NW 339,Residential,34157,209312,0,243469
132412900300000,NW 339,Residential,32301,188069,0,220370
132412900400000,NW 339,Residential,31950,156906,0,188856
132412900500000,NW 339,Residential,35343,166069,0,201412
132412900600000,NW 339,Residential,35272,0,0,35272
132412900700000,NW 339,Residential,34084,170052,0,204136
132412900800000,NW 339,Residential,36030,228441,0,264471
132412900900000,NW 339,Residential,34836,212637,0,247473
132412901000000,NW 339,Residential,35607,145632,0,181239
132412901100000,NW 339,Residential,35992,166387,0,202379
132412901200000,NW 339,Residential,35319,198183,0,233502
132412901300000,NW 339,Residential,35404,203979,0,239383
132412901400000,NW 339,Residential,34016,163448,0,197464
132412901500000,NW 309,Residential,63700,15812,0,79512
132412901600000,NW 339,Residential,27211,0,0,27211
132412901700000,NW 339,Residential,33409,271698,0,305107
132412901800000,NW 339,Residential,33062,200414,0,233476
132412901900000,NW 339,Residential,33001,248138,0,281139
132412902000000,NW 339,Residential,32981,178736,0,211717
132413000100000,NW 309,Residential,31929,113294,0,145223
132413000200000,NW 309,Residential,31559,125115,0,156674
132413000300000,NW 309,Residential,33115,184951,0,218066
132413000400000,NW 309,Residential,29207,179626,0,208833
132413000500000,NW 309,Residential,30835,174620,0,205455
132413000600000,NW 309,Residential,33120,131019,0,164139
132413000700000,NW 339,Residential,33728,188561,0,222289
132413000800000,NW 339,Residential,32079,164295,0,196374
132413000900000,NW 339,Residential,34775,157514,0,192289
132413001000000,NW 339,Residential,35402,177017,0,212419
132413001100000,NW 339,Residential,35425,208143,0,243568
132413001200000,NW 339,Residential,34453,219599,0,254052
132413001300000,NW 339,Residential,38118,0,0,38118
132413001400000,NW 339,Residential,33787,281309,0,315096
132413001500000,NW 339,Residential,35618,168073,0,203691
132413001600000,NW 339,Residential,36443,249571,0,286014
132413001700000,NW 339,Residential,38235,190500,0,228735
132413001800000,NW 339,Residential,36508,243392,0,279900
132413001900000,NW 339,Residential,34669,171455,0,206124
132413002000000,NW 339,Residential,35156,170309,0,205465
132413002100000,NW 339,Residential,34519,151057,0,185576
132413002200000,NW 339,Residential,34757,197496,0,232253
132413002300000,NW 339,Residential,37060,164692,0,201752
132413002400000,NW 337,Residential,64200,26464,0,90664
132413100100000,NW 337,Residential,29264,117872,0,147136
132413200100000,NW 309,Residential,37471,235654,0,273125
132413200700000,NW 309,Residential,36720,279417,0,316137
132413200800000,NW 309,Residential,36193,62249,0,98442
132413200900000,NW 309,Residential,33048,232020,0,265068
132413201000000,NW 309,Residential,36720,0,0,36720
132415100200000,NW 337,Residential,61250,128723,0,189973
132415200100000,NW 309,Residential,61950,39567,0,101517
132415200200000,NW 309,Residential,72950,35566,0,108516
132415200300000,NW 309,Residential,64450,168431,0,232881
132415200500000,NW 342,Residential,900,0,0,900
132415200600000,NW 342,Residential,28900,156506,0,185406
132415200700000,NW 342,Residential,29070,189579,0,218649
132415200800000,NW 342,Residential,28305,164005,0,192310
132415200900000,NW 342,Residential,27455,190290,0,217745
132415201000000,NW 342,Residential,28305,153082,0,181387
132415201100000,NW 342,Residential,26350,118932,0,145282
132415201200000,NW 342,Residential,26350,118558,0,144908
132415201300000,NW 342,Residential,26350,117966,0,144316
132415201400000,NW 339,Residential,45040,229596,0,274636
132415201500000,NW 339,Residential,44887,270489,0,315376
132415201600000,NW 339,Residential,44460,0,0,44460
132415201700000,NW 339,Residential,56120,380398,0,436518
132415201800000,NW 339,Residential,64521,850502,0,915023
132415201900000,NW 339,Residential,59816,426685,0,486501
132415202000000,NW 339,Residential,39351,0,0,39351
132415202100000,NW 339,Residential,39900,0,0,39900
132415202200000,NW 339,Residential,39900,303121,0,343021
132415202300000,NW 339,Residential,39900,0,0,39900
132415202400000,E-15 CITY,Exempt,0,0,0,0
132415300100000,Empty,Exempt,0,0,0,0
132415300200000,E-15 CITY,Exempt,0,0,0,0
132415300300000,NW 342,Residential,27815,141596,0,169411
132415300400000,NW 342,Residential,26665,129457,0,156122
132415300500000,NW 342,Residential,27994,161129,0,189123
132415300600000,NW 342,Residential,28457,151649,0,180106
132415300700000,NW 342,Residential,29437,150562,0,179999
132415300800000,NW 342,Residential,28091,155164,0,183255
132415300900000,NW 342,Residential,28019,144579,0,172598
132415301000000,NW 342,Residential,26130,132706,0,158836
132415301100000,NW 342,Residential,25925,163543,0,189468
132415301200000,NW 342,Residential,25925,154939,0,180864
132415301300000,NW 342,Residential,25925,145143,0,171068
132415301400000,NW 342,Residential,27540,128055,0,155595
132415301500000,E-15 CITY,Exempt,0,0,0,0
132415301600000,NW 337,Residential,31065,55774,0,86839
132415400100000,NW 342,Residential,30603,162610,0,193213
132415400200000,NW 342,Residential,25713,132862,0,158575
132415400300000,NW 342,Residential,28050,113601,0,141651
132415400400000,NW 342,Residential,28050,139372,0,167422
132415400500000,NW 342,Residential,26563,157761,0,184324
132415400600000,NW 342,Residential,22932,158654,0,181586
132415400700000,NW 342,Residential,21943,158193,0,180136
132415400800000,NW 342,Residential,22698,142144,0,164842
132415400900000,NW 342,Residential,25767,144891,0,170658
132415401000000,NW 342,Residential,27806,139594,0,167400
132415401100000,NW 342,Residential,30300,116018,0,146318
132415401200000,NW 342,Residential,28552,130601,0,159153
132417600100000,NW 337,Residential,54000,69998,0,123998
132417600200000,NW 309,Residential,41540,177350,0,218890
132417600300000,NW 309,Residential,37583,167970,0,205553
132417600400000,NW 309,Residential,44472,166468,0,210940
132417600500000,NW 309,Residential,44872,148769,0,193641
132417600600000,NW 309,Residential,60020,339364,0,399384
132417600700000,NW 309,Residential,40120,173726,0,213846
132417600800000,NW 309,Residential,66450,177615,0,244065
132417600900000,NW 309,Residential,76550,65639,0,142189
132417601000000,NW 309,Residential,71300,158059,0,229359
132417601100000,NW 337,Residential,57000,129307,0,186307
132417601200000,NW 309,Residential,20,0,0,20
132417601300000,NW 309,Residential,20,0,0,20
132417601400000,NW 309,Residential,20,0,0,20
132417601500000,NW 309,Residential,20,0,0,20
132417601600000,NW 309,Residential,20,0,0,20
132417700100000,APTS NW,Commercial,386640,0,2935517,3322157
132417700200000,NW 315,Residential,27467,165984,0,193451
132417700300000,NW 315,Residential,28804,204298,0,233102
132417700400000,NW 315,Residential,33045,165122,0,198167
132417700500000,NW 315,Residential,29513,181199,0,210712
132417700600000,NW 315,Residential,29348,160005,0,189353
132417700800000,NW 315,Residential,35760,240701,0,276461
132417700900000,NW 315,Residential,29548,182912,0,212460
132417701000000,NW 315,Residential,33988,178763,0,212751
132417701100000,NW 315,Residential,33498,204139,0,237637
132417701200000,NW 315,Residential,31373,215637,0,247010
132417701300000,NW 315,Residential,31560,148338,0,179898
132417701400000,NW 315,Residential,30720,186930,0,217650
132417701500000,NW 315,Residential,30720,156887,0,187607
132417701600000,NW 315,Residential,33819,215026,0,248845
132417701700000,NW 315,Residential,29788,203861,0,233649
132417701800000,NW 315,Residential,32044,146356,0,178400
132417701900000,NW 315,Residential,31172,155098,0,186270
132417702000000,NW 309,Residential,46604,49078,0,95682
132417702100000,NW 315,Residential,31202,187835,0,219037
132417702200000,NW 315,Residential,26842,180467,0,207309
132417702300000,NW 315,Residential,27867,157029,0,184896
132417702400000,NW 315,Residential,31040,180479,0,211519
132417702500000,NW 315,Residential,30720,190256,0,220976
132417702600000,NW 315,Residential,30720,152783,0,183503
132417702700000,NW 315,Residential,34560,176025,0,210585
132417702800000,NW 315,Residential,41827,183132,0,224959
132417702900000,NW 315,Residential,40972,206157,0,247129
132417703000000,NW 315,Residential,42851,204182,0,247033
132417703100000,NW 315,Residential,48663,150208,0,198871
132417703200000,NW 315,Residential,160,0,0,160
132420100300000,NW 309,Residential,575,0,0,575
132420100400000,NW 309,Residential,575,0,0,575
132420100500000,NW 309,Residential,1255,0,0,1255
132420100600000,NW 309,Residential,39828,272195,0,312023
132420100700000,NW 309,Residential,39936,192944,0,232880
132420100800000,NW 309,Residential,41684,274682,0,316366
132420100900000,NW 309,Residential,46070,0,0,46070
132420101000000,NW 309,Residential,30600,186011,0,216611
132420101100000,NW 309,Residential,30600,105411,0,136011
132420101200000,NW 309,Residential,155,0,0,155
132420101300000,NW 309,Residential,31320,180349,0,211669
132420101400000,NW 309,Residential,35290,192084,0,227374
132420200100000,NW 309,Residential,39932,221287,0,261219
132420200200000,NW 309,Residential,34944,209050,0,243994
132420200300000,NW 309,Residential,35942,247896,0,283838
132420200500000,NW 309,Residential,45338,209418,0,254756
132420200600000,NW 309,Residential,41512,287084,0,328596
132420200700000,NW 309,Residential,47643,306179,0,353822
132420300100000,NW 309,Residential,33480,140909,0,174389
132420300200000,NW 309,Residential,30000,143515,0,173515
132420300300000,NW 309,Residential,30000,171861,0,201861
132420300400000,NW 309,Residential,30000,150701,0,180701
132420300500000,NW 309,Residential,30000,133603,0,163603
132420300600000,NW 309,Residential,30000,141922,0,171922
132420300700000,NW 309,Residential,30000,149949,0,179949
132420300800000,NW 309,Residential,29777,171597,0,201374
132420300900000,NW 309,Residential,31282,155560,0,186842
132420301000000,NW 309,Residential,26640,112764,0,139404
132420400100000,NW 309,Residential,32717,133998,0,166715
132420400200000,NW 309,Residential,34406,207130,0,241536
132420400300000,NW 309,Residential,36809,254228,0,291037
132420400400000,NW 309,Residential,34452,264344,0,298796
132420400500000,NW 309,Residential,33024,199296,0,232320
132420400600000,NW 309,Residential,37128,273257,0,310385
132420400700000,NW 309,Residential,37128,270459,0,307587
132420400800000,NW 309,Residential,35496,244504,0,280000
132420400900000,NW 309,Residential,35088,239445,0,274533
132420401000000,NW 309,Residential,37128,237958,0,275086
132420401100000,NW 309,Residential,42083,366141,0,408224
132420401700000,NW 309,Residential,51400,205563,0,256963
132420402000000,NW 309,Residential,25600,107828,0,133428
132420402100000,NW 309,Residential,27934,146347,0,174281
132420402200000,NW 309,Residential,30000,124232,0,154232
132420402300000,NW 309,Residential,30000,154270,0,184270
132420402400000,NW 309,Residential,30000,173614,0,203614
132420402500000,NW 309,Residential,30000,124283,0,154283
132420402600000,NW 309,Residential,29483,128764,0,158247
132420402700000,NW 309,Residential,29940,136135,0,166075
132420500600000,NW 337,Residential,60000,197791,0,257791
132422600200000,NW 309,Residential,44185,265957,0,310142
132422600300000,NW 309,Residential,65500,141770,0,207270
132422601300000,NW 309,Residential,48199,305908,0,354107
132422601400000,NW 309,Residential,45629,301498,0,347127
132422601500000,NW 309,Residential,43978,0,0,43978
132422601600000,NW 309,Residential,41948,0,0,41948
132422601700000,NW 309,Residential,41946,0,0,41946
132422700200000,NW 302,Residential,121000,0,0,121000
132422800100000,NW 309,Residential,48988,272642,0,321630
132422800200000,NW 309,Residential,46359,301756,0,348115
132422800300000,NW 309,Residential,45501,353958,0,399459
132422800400000,NW 309,Residential,36754,0,0,36754
132422800500000,NW 309,Residential,36384,0,0,36384
132422900100000,NW 309,Residential,42925,0,0,42925
132422900200000,NW 309,Residential,14406,0,0,14406
132422900300000,NW 309,Residential,43656,0,0,43656
132422900400000,NW 309,Residential,46944,0,0,46944
132422900500000,NW 309,Residential,44090,0,0,44090
132422900600000,NW 309,Residential,56270,0,0,56270
132422900700000,NW 309,Residential,34272,0,0,34272
132422900800000,NW 309,Residential,37370,0,0,37370
132423000100000,NW 345,Residential,17226,159392,0,176618
132423000200000,NW 345,Residential,18281,0,0,18281
132423000300000,NW 345,Residential,18432,0,0,18432
132423000400000,NW 345,Residential,20497,0,0,20497
132423000500000,NW 345,Residential,23626,144710,0,168336
132423000600000,NW 345,Residential,60010,0,0,60010
132423000700000,NW 345,Residential,27068,172369,0,199437
132423000800000,NW 345,Residential,21815,196710,0,218525
132423000900000,NW 345,Residential,21261,156938,0,178199
132423001000000,NW 345,Residential,22618,167709,0,190327
132423001100000,NW 345,Residential,21680,154283,0,175963
132423001200000,NW 345,Residential,17234,132135,0,149369
132423001300000,NW 345,Residential,17226,0,0,17226
132423001400000,NW 345,Residential,17160,160177,0,177337
132423001500000,NW 345,Residential,17745,164759,0,182504
132423001600000,NW 345,Residential,18810,163185,0,181995
132423001700000,NW 345,Residential,19404,146187,0,165591
132423001800000,NW 345,Residential,19800,156923,0,176723
132423001900000,NW 345,Residential,20196,175880,0,196076
132423002000000,NW 345,Residential,6750,0,0,6750
132423100100000,NW 345,Residential,24030,167328,0,191358
132423100200000,NW 345,Residential,19998,183996,0,203994
132423100300000,NW 345,Residential,20592,151935,0,172527
132423100400000,NW 345,Residential,20394,169173,0,189567
132423100500000,NW 345,Residential,19602,159542,0,179144
132423100600000,NW 345,Residential,21372,148496,0,169868
132423100700000,NW 345,Residential,20592,147874,0,168466
132423100800000,NW 345,Residential,20592,164633,0,185225
132423100900000,NW 345,Residential,20592,0,0,20592
132423101000000,NW 345,Residential,20592,0,0,20592
132423200100000,NW 345,Residential,25553,170243,0,195796
132423200200000,NW 345,Residential,19320,171061,0,190381
132423200300000,NW 345,Residential,20151,176861,0,197012
132423200400000,NW 345,Residential,24520,182448,0,206968
132423300100000,NW 345,Residential,20598,0,0,20598
132423300200000,NW 345,Residential,18900,175687,0,194587
132423300300000,NW 345,Residential,18900,174440,0,193340
132423300400000,NW 345,Residential,18900,179738,0,198638
132423400100000,NW 345,Residential,19320,169955,0,189275
132423400200000,NW 345,Residential,20372,175182,0,195554
132425100200000,NW 345,Residential,19005,147453,0,166458
132425100300000,NW 345,Residential,18414,151243,0,169657
132425100400000,NW 345,Residential,20339,149217,0,169556
132425100500000,NW 345,Residential,22292,155478,0,177770
132425100600000,NW 345,Residential,17675,147419,0,165094
132425100700000,NW 345,Residential,21576,191904,0,213480
132425100800000,NW 345,Residential,13985,158265,0,172250
132425100900000,NW 345,Residential,16216,165684,0,181900
132425101000000,NW 345,Residential,21028,156854,0,177882
132425101100000,E-15 CITY,Exempt,0,0,0,0
132425200200000,NW 345,Residential,20085,147531,0,167616
132425300200000,NW 345,Residential,25524,187184,0,212708
132425300300000,NW 345,Residential,19788,163497,0,183285
132425300400000,NW 345,Residential,20127,150077,0,170204
132425300500000,NW 345,Residential,34915,211125,0,246040
132425300700000,NW 345,Residential,56400,0,0,56400
132425300800000,NW 345,Residential,22181,151243,0,173424
132425300900000,NW 345,Residential,20187,150419,0,170606
132425301000000,NW 345,Residential,19341,217619,0,236960
132425301100000,NW 345,Residential,24102,240672,0,264774
132425301200000,NW 345,Residential,24102,11130,0,35232
132425301300000,NW 345,Residential,22330,0,0,22330
132425400100000,NW 345,Residential,20769,156230,0,176999
132425400200000,NW 345,Residential,20733,146427,0,167160
132425400300000,NW 345,Residential,20733,146823,0,167556
132425400400000,NW 345,Residential,20940,146427,0,167367
132425400500000,NW 345,Residential,20940,174773,0,195713
132425400600000,NW 345,Residential,20940,146037,0,166977
132425400700000,NW 345,Residential,20940,174714,0,195654
132425400800000,NW 345,Residential,21148,146806,0,167954
132425400900000,NW 345,Residential,21148,143326,0,164474
132425401000000,NW 345,Residential,21148,155724,0,176872
132425401100000,NW 345,Residential,20784,142282,0,163066
132425500100000,NW 345,Residential,19967,144343,0,164310
132425500200000,NW 345,Residential,20663,151042,0,171705
132425500300000,NW 345,Residential,19020,144947,0,163967
132425500400000,NW 345,Residential,19020,142674,0,161694
132425500500000,NW 345,Residential,19020,144947,0,163967
132425500600000,NW 345,Residential,19020,145549,0,164569
132425500700000,NW 345,Residential,19020,146616,0,165636
132425500800000,NW 345,Residential,19020,164406,0,183426
132425500900000,NW 345,Residential,19020,153655,0,172675
132425501000000,NW 345,Residential,19020,173752,0,192772
132425501100000,NW 345,Residential,19020,145635,0,164655
132425501200000,NW 345,Residential,19020,155840,0,174860
132425501300000,NW 345,Residential,19759,171018,0,190777
132425501400000,NW 345,Residential,19967,144174,0,164141
132425501500000,NW 345,Residential,19967,144947,0,164914
132425501600000,NW 345,Residential,19967,146041,0,166008
132425501700000,NW 345,Residential,19967,155353,0,175320
132425501800000,NW 345,Residential,19967,145648,0,165615
132425501900000,NW 345,Residential,19967,142674,0,162641
132425502000000,NW 345,Residential,19967,145648,0,165615
132425502100000,NW 345,Residential,19967,142674,0,162641
132425502200000,NW 345,Residential,19967,143482,0,163449
132425600100000,NW 345,Residential,21891,147531,0,169422
132425600200000,NW 309,Residential,93250,0,0,93250
132425600300000,NW 345,Residential,19901,128702,0,148603
132425600400000,NW 345,Residential,19901,141974,0,161875
132425600500000,NW 345,Residential,19901,146041,0,165942
132425600600000,NW 345,Residential,19901,146041,0,165942
132425600700000,NW 345,Residential,19901,154469,0,174370
132425600800000,NW 345,Residential,19901,150598,0,170499
132425600900000,NW 345,Residential,19901,144708,0,164609
132425601000000,NW 345,Residential,19901,146952,0,166853
132425601100000,NW 345,Residential,19901,144947,0,164848
132425601200000,NW 345,Residential,19901,159369,0,179270
132425601300000,NW 345,Residential,20977,160967,0,181944
132425601400000,NW 345,Residential,19992,175625,0,195617
132425601500000,NW 345,Residential,19901,147104,0,167005
132425601600000,NW 345,Residential,19901,154993,0,174894
132425601700000,NW 345,Residential,19901,161426,0,181327
132425601800000,NW 345,Residential,19901,151429,0,171330
132425601900000,NW 345,Residential,19901,179399,0,199300
132425602000000,NW 345,Residential,19901,157160,0,177061
132425602100000,NW 345,Residential,19901,193400,0,213301
132425602200000,NW 345,Residential,19901,177723,0,197624
132425602300000,NW 345,Residential,19901,159375,0,179276
132425602400000,NW 345,Residential,19901,157898,0,177799
132425700200000,NW 345,Residential,51450,0,0,51450
132425700400000,NW 345,Residential,22464,204867,0,227331
132425700500000,NW 345,Residential,22464,183448,0,205912
132425700600000,NW 345,Residential,22464,140246,0,162710
132425700700000,NW 345,Residential,22464,164532,0,186996
132425700800000,NW 345,Residential,22464,0,0,22464
132425700900000,NW 345,Residential,22464,222768,0,245232
132425701000000,NW 345,Residential,22464,225360,0,247824
132425701100000,NW 345,Residential,22464,183548,0,206012
132425701200000,NW 345,Residential,22464,170392,0,192856
132425701300000,NW 345,Residential,22464,159364,0,181828
132425701400000,NW 345,Residential,22464,241253,0,263717
132425800100000,NW 345,Residential,21087,0,0,21087
132425800200000,NW 345,Residential,21934,152069,0,174003
132427600100000,NW 337,Residential,39195,93391,0,132586
132427600200000,NW 337,Residential,28890,47744,0,76634
132427600300000,NW 337,Residential,33900,130359,0,164259
132427600400000,NW 337,Residential,33900,161234,0,195134
132427600500000,NW 337,Residential,36000,177527,0,213527
132427600600000,NW 337,Residential,36393,74267,0,110660
132427600800000,NW 337,Residential,37800,96278,0,134078
132427600900000,NW 337,Residential,37800,130603,0,168403
132427601000000,NW 337,Residential,37800,65742,0,103542
132427601100000,NW 337,Residential,22680,0,0,22680
132427601200000,NW 337,Residential,37800,105855,0,143655
132427601300000,NW 337,Residential,37800,108434,0,146234
132427601400000,NW 337,Residential,37800,75686,0,113486
132427601500000,NW 337,Residential,37800,82694,0,120494
132427601600000,NW 337,Residential,34581,127378,0,161959
132427700100000,NW 337,Residential,42646,69030,0,111676
132427700200000,NW 337,Residential,31590,102911,0,134501
132427700300000,NW 337,Residential,35100,76217,0,111317
132427700400000,NW 337,Residential,35100,131302,0,166402
132427700500000,NW 337,Residential,35100,104346,0,139446
132427700600000,NW 337,Residential,35100,150080,0,185180
132427700700000,NW 337,Residential,31124,175536,0,206660
132427700800000,NW 337,Residential,22950,75636,0,98586
132427700900000,NW 337,Residential,29431,120585,0,150016
132427701000000,NW 337,Residential,29970,103526,0,133496
132427701100000,NW 337,Residential,29970,87376,0,117346
132427701200000,NW 337,Residential,29970,95922,0,125892
132427701300000,NW 337,Residential,29970,76599,0,106569
132427701500000,NW 337,Residential,29970,114649,0,144619
132427701600000,NW 337,Residential,29970,82476,0,112446
132427701700000,NW 337,Residential,29970,88394,0,118364
132427701800000,NW 337,Residential,29970,106213,0,136183
132427701900000,NW 337,Residential,29548,77049,0,106597
132427702000000,NW 337,Residential,30709,92572,0,123281
132427702100000,NW 337,Residential,30709,78236,0,108945
132427702200000,NW 337,Residential,29548,78929,0,108477
132427702300000,NW 337,Residential,29970,90043,0,120013
132427702400000,NW 337,Residential,29970,116964,0,146934
132427702500000,NW 337,Residential,29970,96728,0,126698
132427702600000,NW 337,Residential,29970,129578,0,159548
132427702700000,NW 337,Residential,21316,126281,0,147597
132427702800000,NW 337,Residential,24103,114854,0,138957
132427800100000,NW 337,Residential,33109,89938,0,123047
132427800200000,NW 337,Residential,33257,50229,0,83486
132427800300000,NW 337,Residential,37500,123247,0,160747
132427800400000,NW 337,Residential,37500,127509,0,165009
132427800500000,NW 337,Residential,37500,95796,0,133296
132427800600000,NW 337,Residential,37500,135692,0,173192
132427800700000,NW 337,Residential,30000,0,0,30000
132427800800000,NW 337,Residential,37500,63494,0,100994
132430100100000,NW 337,Residential,36750,86712,0,123462
132430100200000,NW 337,Residential,40260,66212,0,106472
132430100300000,NW 337,Residential,34749,100920,0,135669
132430100400000,NW 337,Residential,31860,136358,0,168218
132430100500000,NW 337,Residential,28890,140094,0,168984
132430100600000,NW 337,Residential,23760,0,0,23760
132430100700000,NW 337,Residential,25344,0,0,25344
132430100800000,NW 337,Residential,26884,58960,0,85844
132430100900000,NW 337,Residential,37440,69222,0,106662
132430101000000,NW 337,Residential,25175,135788,0,160963
132430101100000,NW 337,Residential,26122,88863,0,114985
132430101200000,NW 337,Residential,20268,104439,0,124707
132430101300000,NW 337,Residential,37500,145222,0,182722
132430200100000,NW 337,Residential,49640,76751,0,126391
132430200200000,NW 337,Residential,17473,91890,0,109363
132430200300000,NW 337,Residential,39487,68288,0,107775
132430200400000,NW 337,Residential,71300,79918,0,151218
132430200600000,NW 337,Residential,63850,99545,0,163395
132430200700000,NW 309,Residential,22897,125975,0,148872
132430200800000,NW 309,Residential,21420,122985,0,144405
132430200900000,NW 309,Residential,21420,148580,0,170000
132430201000000,NW 309,Residential,21420,123141,0,144561
132430201100000,NW 309,Residential,24255,137615,0,161870
132430201200000,NW 309,Residential,24255,171157,0,195412
132430201300000,NW 309,Residential,24435,140639,0,165074
132430201400000,NW 309,Residential,25187,131196,0,156383
132430201500000,NW 309,Residential,27386,139202,0,166588
132430201600000,NW 309,Residential,28006,120797,0,148803
132430201700000,NW 309,Residential,27386,172120,0,199506
132430201800000,NW 309,Residential,24482,169211,0,193693
132430201900000,NW 309,Residential,24255,155045,0,179300
132430202000000,NW 309,Residential,24255,169564,0,193819
132430202100000,NW 309,Residential,1150,0,0,1150
132430300200000,NW 337,Residential,38376,93116,0,131492
132430300300000,NW 337,Residential,27468,98613,0,126081
132430300400000,NW 337,Residential,27468,119857,0,147325
132430300500000,NW 337,Residential,37125,111283,0,148408
132430300700000,NW 337,Residential,37125,95135,0,132260
132430300800000,NW 337,Residential,37125,103200,0,140325
132430300900000,NW 337,Residential,37125,87538,0,124663
132430301000000,NW 337,Residential,30636,72100,0,102736
132430301100000,NW 337,Residential,38605,79349,0,117954
132430301200000,NW 337,Residential,37125,105054,0,142179
132430301300000,NW 337,Residential,37125,103806,0,140931
132430301400000,NW 337,Residential,37125,89202,0,126327
132430301500000,NW 337,Residential,37125,64383,0,101508
132430301600000,NW 337,Residential,37125,62776,0,99901
132430301700000,NW 337,Residential,37125,156616,0,193741
132430301800000,NW 337,Residential,31500,90401,0,121901
132430301900000,NW 337,Residential,27468,61404,0,88872
132430302100000,NW 337,Residential,27403,142332,0,169735
132430302200000,NW 337,Residential,55800,0,0,55800
132430302300000,NW 337,Residential,55800,99370,0,155170
132432600100000,NW 345,Residential,22118,140773,0,162891
132432600200000,NW 345,Residential,22766,146973,0,169739
132432600300000,NW 345,Residential,23871,152378,0,176249
132432600400000,NW 345,Residential,22032,158791,0,180823
132432600500000,NW 345,Residential,20777,150952,0,171729
132432600600000,NW 345,Residential,19291,174857,0,194148
132432600700000,NW 345,Ag Land,10856,0,0,10856
132432600800000,NW 345,Residential,20198,167061,0,187259
132432600900000,NW 345,Residential,20790,167862,0,188652
132432601000000,NW 345,Residential,23718,145148,0,168866
132432601100000,NW 345,Residential,24778,174609,0,199387
132432601200000,NW 345,Residential,25459,164409,0,189868
132432601300000,NW 345,Residential,23192,148755,0,171947
132432601400000,NW 345,Residential,22938,157690,0,180628
132432700100000,NW 345,Residential,19551,166577,0,186128
132432700200000,NW 345,Residential,19020,129928,0,148948
132432700300000,NW 345,Residential,19175,142562,0,161737
132432700400000,NW 345,Residential,20254,151987,0,172241
132432700500000,NW 345,Residential,20079,154939,0,175018
132432700600000,NW 345,Residential,20211,145648,0,165859
132432800100000,NW 345,Residential,19901,161007,0,180908
132432800200000,NW 345,Residential,19899,162386,0,182285
132432800300000,NW 345,Residential,22481,161115,0,183596
132432800400000,NW 345,Residential,21258,140436,0,161694
132432800500000,NW 345,Residential,21369,154917,0,176286
132432800900000,NW 345,Residential,18360,141237,0,159597
132432801000000,NW 345,Residential,22770,168668,0,191438
132432801100000,NW 345,Residential,20070,143177,0,163247
132432801200000,NW 345,Residential,19901,170622,0,190523
132432801300000,NW 345,Residential,19901,169731,0,189632
132432801400000,NW 345,Residential,21122,195416,0,216538
132432801500000,NW 345,Residential,20045,173474,0,193519
132432801600000,NW 345,Residential,20400,0,0,20400
132432900200000,NW 345,Residential,20740,147667,0,168407
132432900600000,NW 345,Residential,22631,0,0,22631
132432900700000,NW 345,Residential,23917,0,0,23917
132432900800000,NW 345,Residential,21494,0,0,21494
132432900900000,NW 345,Residential,19434,0,0,19434
132432901000000,NW 345,Residential,22464,170376,0,192840
132432901100000,NW 345,Residential,22464,192994,0,215458
132432901200000,NW 345,Residential,22464,176056,0,198520
132432901300000,NW 345,Residential,21528,175600,0,197128
132433000100000,NW 345,Residential,20544,160578,0,181122
132433000200000,NW 345,Residential,19264,153467,0,172731
132433100100000,NW 326,Residential,69750,97714,0,167464
132433100200000,NW 326,Residential,69850,0,0,69850
132435100100000,NW 326,Residential,26887,133798,0,160685
132435100200000,NW 326,Residential,23312,90508,0,113820
132435100300000,NW 326,Residential,26725,108520,0,135245
132435100400000,NW 326,Residential,29171,116323,0,145494
132435100500000,NW 326,Residential,24755,113720,0,138475
132435100600000,NW 326,Residential,27608,126842,0,154450
132435100700000,NW 326,Residential,23040,121122,0,144162
132435100800000,NW 326,Residential,24960,109762,0,134722
132435100900000,NW 326,Residential,24552,101516,0,126068
132435101000000,NW 326,Residential,26400,97152,0,123552
132435101100000,NW 326,Residential,25515,100679,0,126194
132435101200000,NW 326,Residential,25693,105453,0,131146
132435101300000,NW 326,Residential,23712,123319,0,147031
132435101400000,NW 326,Residential,24662,103927,0,128589
132435101500000,NW 326,Residential,23560,101623,0,125183
132435101600000,NW 326,Residential,27075,108829,0,135904
132435101700000,NW 326,Residential,27075,118158,0,145233
132435101800000,NW 326,Residential,24402,113051,0,137453
132435101900000,NW 326,Residential,26790,105754,0,132544
132435102000000,NW 326,Residential,26885,115117,0,142002
132435200100000,NW 326,Residential,26171,112368,0,138539
132435200200000,NW 326,Residential,24922,112836,0,137758
132435200300000,NW 326,Residential,23808,107608,0,131416
132435200400000,NW 326,Residential,24922,119822,0,144744
132435200500000,NW 326,Residential,23808,127822,0,151630
132435200600000,NW 326,Residential,26380,131389,0,157769
132435300100000,NW 326,Residential,26486,138071,0,164557
132435300200000,NW 326,Residential,23312,101372,0,124684
132435300300000,NW 326,Residential,24402,108239,0,132641
132435300400000,NW 326,Residential,26790,113911,0,140701
132435300500000,NW 326,Residential,24402,118223,0,142625
132435300600000,NW 326,Residential,26076,112943,0,139019
132435300700000,NW 326,Residential,19247,117662,0,136909
132435300800000,NW 326,Residential,22936,103219,0,126155
132435300900000,NW 326,Residential,24641,110430,0,135071
132435301000000,NW 326,Residential,24189,100722,0,124911
132435301100000,NW 326,Residential,23312,127027,0,150339
132435301200000,NW 326,Residential,26790,129768,0,156558
132435301300000,NW 326,Residential,23312,128635,0,151947
132435301400000,NW 326,Residential,24402,112410,0,136812
132435301500000,NW 326,Residential,26790,122534,0,149324
132435301600000,NW 326,Residential,24402,127613,0,152015
132435301700000,NW 326,Residential,24402,121936,0,146338
132435301800000,NW 326,Residential,25129,129659,0,154788
132435400100000,NW 326,Residential,27369,110025,0,137394
132435400200000,NW 326,Residential,23654,105779,0,129433
132435400300000,NW 326,Residential,28465,126497,0,154962
132435400400000,NW 326,Residential,25544,109602,0,135146
132435400500000,NW 326,Residential,26896,129730,0,156626
132435400600000,NW 326,Residential,26539,116645,0,143184
132435400700000,NW 326,Residential,25840,115844,0,141684
132435400800000,NW 326,Residential,28859,105158,0,134017
132435500100000,NW 326,Residential,27635,117571,0,145206
132435500200000,NW 326,Residential,24480,112083,0,136563
132435500300000,NW 326,Residential,24480,101380,0,125860
132435500400000,NW 326,Residential,26479,137348,0,163827
132435500500000,NW 326,Residential,26479,101086,0,127565
132435500600000,NW 326,Residential,26479,108769,0,135248
132435500700000,NW 326,Residential,26479,113684,0,140163
132435500800000,NW 326,Residential,27348,117310,0,144658
132435500900000,NW 326,Residential,29036,111833,0,140869
132435501000000,NW 326,Residential,27490,110674,0,138164
132435501100000,NW 326,Residential,26787,105942,0,132729
132435501200000,NW 326,Residential,25700,115246,0,140946
132435501300000,NW 326,Residential,25700,127000,0,152700
132435501400000,NW 326,Residential,26141,114241,0,140382
132435501500000,NW 326,Residential,27178,109616,0,136794
132435501600000,NW 326,Residential,28534,114923,0,143457
132435501700000,NW 326,Residential,26557,145299,0,171856
132435501800000,NW 326,Residential,23200,124981,0,148181
132435501900000,NW 326,Residential,27608,119489,0,147097
132435502000000,NW 326,Residential,22200,127510,0,149710
132435502100000,NW 326,Residential,25960,134809,0,160769
132435502200000,NW 326,Residential,24360,152625,0,176985
132435502300000,NW 326,Residential,27360,124064,0,151424
132435502400000,NW 326,Residential,28326,131295,0,159621
132435502500000,NW 326,Residential,29427,134440,0,163867
132435502600000,NW 326,Residential,27187,119161,0,146348
132435502700000,NW 326,Residential,27082,141070,0,168152
132435502800000,NW 326,Residential,27636,130390,0,158026
132435502900000,NW 326,Residential,27212,126008,0,153220
132435503000000,NW 326,Residential,25944,133277,0,159221
132435503100000,NW 326,Residential,28422,150712,0,179134
132435503200000,NW 326,Residential,29702,141999,0,171701
132435503300000,NW 326,Residential,29088,115518,0,144606
132435503400000,NW 326,Residential,29702,138392,0,168094
132435503500000,NW 326,Residential,27773,132324,0,160097
132435503600000,NW 326,Residential,26645,128984,0,155629
132435503700000,NW 326,Residential,27588,148078,0,175666
132435503800000,NW 326,Residential,26524,152898,0,179422
132435503900000,NW 326,Residential,26714,156853,0,183567
132435504000000,NW 326,Residential,26565,122734,0,149299
132435504100000,NW 326,Residential,26928,113611,0,140539
132435504200000,NW 326,Residential,26585,120202,0,146787
132435504300000,NW 326,Residential,27283,114885,0,142168
132435504400000,NW 326,Residential,26825,120904,0,147729
132435504500000,NW 326,Residential,23760,120662,0,144422
132435504600000,NW 326,Residential,25344,118140,0,143484
132435504700000,NW 326,Residential,27839,107161,0,135000
132435504800000,NW 326,Residential,27839,107732,0,135571
132435504900000,NW 326,Residential,27086,124538,0,151624
132435505000000,NW 326,Residential,24453,145234,0,169687
132435505100000,NW 326,Residential,27086,107154,0,134240
132435505200000,NW 326,Residential,23760,103876,0,127636
132435505300000,NW 326,Residential,27388,114379,0,141767
132435505400000,NW 326,Residential,23322,122536,0,145858
132435505500000,NW 326,Residential,22672,106661,0,129333
132435505600000,NW 326,Residential,24804,97142,0,121946
132435505700000,NW 326,Residential,23040,99086,0,122126
132435505800000,NW 326,Residential,23040,117466,0,140506
132435505900000,NW 326,Residential,23040,102753,0,125793
132435506000000,NW 326,Residential,23040,105696,0,128736
132435506100000,NW 326,Residential,24922,107408,0,132330
132435506200000,NW 326,Residential,25920,102122,0,128042
132435506300000,NW 326,Residential,25920,107930,0,133850
132435506400000,NW 326,Residential,24922,119914,0,144836
132435506500000,NW 326,Residential,25920,123179,0,149099
132435506600000,NW 326,Residential,25920,90891,0,116811
132435506700000,NW 326,Residential,21579,114243,0,135822
132435506800000,NW 326,Residential,26423,115812,0,142235
132435506900000,NW 326,Residential,28657,121707,0,150364
132435600100000,NW 326,Residential,27197,108181,0,135378
132435600200000,NW 326,Residential,27197,100742,0,127939
132435600300000,NW 326,Residential,24000,109008,0,133008
132435600400000,NW 326,Residential,25960,95633,0,121593
132435600500000,NW 326,Residential,25960,110268,0,136228
132435600600000,NW 326,Residential,25960,103622,0,129582
132435600700000,NW 326,Residential,25960,110604,0,136564
132435600800000,NW 326,Residential,27360,104562,0,131922
132435600900000,NW 326,Residential,26597,126735,0,153332
132435601000000,NW 326,Residential,27529,116265,0,143794
132435601100000,NW 326,Residential,28866,124624,0,153490
132435601200000,NW 326,Residential,28866,115544,0,144410
132435601300000,NW 326,Residential,25960,114817,0,140777
132435601400000,NW 326,Residential,25960,104605,0,130565
132435601500000,NW 326,Residential,24000,107399,0,131399
132435700100000,NW 326,Residential,22320,120346,0,142666
132435700200000,NW 326,Residential,26505,118721,0,145226
132435700300000,NW 326,Residential,24240,129490,0,153730
132435700400000,NW 326,Residential,22220,109842,0,132062
132435700500000,NW 326,Residential,23836,119318,0,143154
132435700600000,NW 326,Residential,22220,105818,0,128038
132435700700000,NW 326,Residential,24644,126601,0,151245
132435700800000,NW 326,Residential,24240,136071,0,160311
132435700900000,NW 326,Residential,27592,105392,0,132984
132435701500000,NW 345,Residential,171250,0,0,171250
132437600100000,NW 337,Residential,40314,90639,0,130953
132437600200000,NW 337,Residential,21696,101733,0,123429
132437600300000,NW 337,Residential,43243,21757,0,65000
132437600400000,NW 337,Residential,32314,149819,0,182133
132437600500000,NW 337,Residential,33233,79302,0,112535
132437600600000,NW 337,Residential,29430,0,0,29430
132437600700000,NW 337,Residential,64350,160629,0,224979
132437600800000,NW 337,Residential,50760,172009,0,222769
132437600900000,NW 337,Residential,60750,64920,0,125670
132437700100000,NW 309,Residential,35802,151464,0,187266
132437800100000,COMM NW,Commercial,48600,0,262,48862
132437800200000,NW 326,Residential,33015,71420,0,104435
132437800300000,NW 326,Residential,28821,115523,0,144344
132437800400000,NW 326,Residential,27540,115802,0,143342
132437800500000,NW 326,Residential,27122,121367,0,148489
132437800600000,NW 326,Residential,27472,152592,0,180064
132437800700000,NW 326,Residential,28016,141295,0,169311
132437800800000,NW 326,Residential,28302,127491,0,155793
132437800900000,NW 326,Residential,28448,140176,0,168624
132437801000000,NW 326,Residential,28177,118982,0,147159
132437801100000,NW 326,Residential,28219,139075,0,167294
132437801200000,NW 326,Residential,27706,138095,0,165801
132437801300000,NW 326,Residential,27550,125711,0,153261
132437801400000,NW 326,Residential,28864,149744,0,178608
132437801500000,NW 326,Residential,29172,135247,0,164419
132437801600000,NW 326,Residential,28907,128427,0,157334
132437801700000,NW 326,Residential,28642,138483,0,167125
132437801800000,NW 326,Residential,28376,115579,0,143955
132437801900000,NW 326,Residential,28111,128773,0,156884
132437802000000,NW 326,Residential,28334,115219,0,143553
132437802100000,NW 326,Residential,30030,129665,0,159695
132437900100000,NW 326,Residential,27486,120059,0,147545
132437900200000,NW 326,Residential,27166,134628,0,161794
132437900300000,NW 326,Residential,27581,126493,0,154074
132437900400000,NW 326,Residential,27468,145279,0,172747
132437900500000,NW 326,Residential,27953,124886,0,152839
132437900600000,NW 326,Residential,28682,123962,0,152644
132437900700000,NW 326,Residential,26961,126318,0,153279
132437900800000,NW 326,Residential,27524,140042,0,167566
132437900900000,NW 326,Residential,27331,131261,0,158592
132437901000000,NW 326,Residential,27382,126927,0,154309
132437901100000,NW 326,Residential,26058,144911,0,170969
132438000100000,NW 326,Residential,28127,137978,0,166105
132438000200000,NW 326,Residential,26772,131135,0,157907
132438000300000,NW 326,Residential,29842,110158,0,140000
132438000400000,NW 326,Residential,24180,110988,0,135168
132438000500000,NW 326,Residential,27543,126873,0,154416
132438000600000,NW 326,Residential,25637,133830,0,159467
132438000700000,NW 326,Residential,25898,135755,0,161653
132438000800000,NW 326,Residential,21528,168173,0,189701
132438000900000,NW 326,Residential,29302,126760,0,156062
132438001000000,NW 326,Residential,27676,132831,0,160507
132438001100000,NW 326,Residential,28710,117378,0,146088
132438001200000,NW 326,Residential,30138,148567,0,178705
132438001300000,NW 326,Residential,27005,121383,0,148388
132438001400000,NW 326,Residential,26676,133804,0,160480
132438001500000,NW 326,Residential,28967,133255,0,162222
132438001600000,NW 326,Residential,27050,119466,0,146516
132438001700000,NW 326,Residential,27676,119389,0,147065
132438001800000,NW 326,Residential,27925,115980,0,143905
132438001900000,NW 326,Residential,27075,116723,0,143798
132438002000000,NW 326,Residential,28175,111503,0,139678
132438002100000,NW 326,Residential,28687,131616,0,160303
132438002200000,NW 326,Residential,26894,137636,0,164530
132438002300000,NW 326,Residential,32062,61560,0,93622
132438002400000,NW 326,Residential,35904,81868,0,117772
132438002500000,NW 326,Residential,44282,110803,0,155085
132438002600000,NW 326,Residential,64500,110595,0,175095
132438002700000,E-15 CITY,Exempt,0,0,0,0
132438002702000,COMM NW,Commercial,0,0,22285,22285
132438002800000,NW 326,Residential,64150,113179,0,177329
132438002900000,NW 326,Residential,33696,87571,0,121267
132438003000000,NW 326,Residential,25680,139171,0,164851
132440100100000,NW 315,Residential,29969,177066,0,207035
132440200100000,NW 337,Residential,70650,0,0,70650
132440200300000,NW 337,Residential,53100,0,0,53100
132440200400000,NW 337,Residential,8550,0,0,8550
132440200500000,NW 337,Residential,5050,0,0,5050
132440200600000,NW 315,Residential,28109,161790,0,189899
132440200700000,NW 315,Residential,33307,163233,0,196540
132440200800000,NW 315,Residential,32563,154638,0,187201
132440200900000,NW 315,Residential,25633,168045,0,193678
132440201000000,NW 315,Residential,34224,154776,0,189000
132440201100000,NW 315,Residential,27633,141911,0,169544
132440201200000,NW 315,Residential,28465,147140,0,175605
132440201300000,NW 315,Residential,44840,143384,0,188224
132440201400000,NW 315,Residential,30680,134715,0,165395
132440201500000,NW 337,Residential,41888,91128,0,133016
132440201600000,NW 337,Residential,41888,133874,0,175762
132440201700000,NW 337,Residential,42602,79510,0,122112
132440201800000,NW 337,Residential,40592,144488,0,185080
132440201900000,NW 337,Residential,43322,87998,0,131320
132440202000000,NW 337,Residential,33355,178936,0,212291
132440202100000,NW 337,Residential,30680,42083,0,72763
132440202200000,NW 337,Residential,11400,7695,0,19095
132440202300000,NW 337,Residential,26400,61107,0,87507
132440300100000,NW 337,Residential,52100,66203,0,118303
132440300200000,NW 337,Residential,31590,84738,0,116328
132440300300000,NW 305,Residential,27216,160974,0,188190
132440300400000,NW 305,Residential,27136,107520,0,134656
132440300500000,NW 305,Residential,26880,136722,0,163602
132440300600000,NW 305,Residential,26624,151079,0,177703
132440300700000,NW 305,Residential,26624,154521,0,181145
132440300800000,NW 305,Residential,26463,153799,0,180262
132440300900000,NW 337,Residential,42399,0,0,42399
132440301000000,NW 305,Residential,27454,178705,0,206159
132440301100000,NW 337,Residential,43424,251447,0,294871
132440301200000,NW 337,Residential,43424,0,0,43424
132440301300000,NW 337,Residential,71750,211543,0,283293
132440301400000,NW 337,Residential,40332,82632,0,122964
132440301500000,NW 337,Residential,48644,100066,0,148710
132440301600000,NW 337,Residential,60520,0,0,60520
132440301700000,NW 305,Residential,28561,177211,0,205772
132440301800000,NW 305,Residential,26733,153168,0,179901
132440301900000,NW 305,Residential,27832,182677,0,210509
132440302000000,NW 305,Residential,28547,175638,0,204185
132440302100000,NW 305,Residential,26624,163503,0,190127
132440302200000,NW 305,Residential,26624,155216,0,181840
132440302300000,NW 305,Residential,26624,149715,0,176339
132440302400000,NW 305,Residential,26624,175671,0,202295
132440302500000,NW 305,Residential,25856,160184,0,186040
132440302600000,NW 305,Residential,26334,182729,0,209063
132442600100000,NW 315,Residential,28973,109501,0,138474
132442600200000,NW 315,Residential,25026,104386,0,129412
132442600300000,NW 315,Residential,25026,92566,0,117592
132442600400000,NW 315,Residential,25026,103512,0,128538
132442600500000,NW 315,Residential,25026,108647,0,133673
132442600600000,NW 315,Residential,25026,91653,0,116679
132442600700000,NW 315,Residential,25026,100201,0,125227
132442600800000,NW 315,Residential,17199,107413,0,124612
132442600900000,NW 315,Residential,17199,5719,0,22918
132442700100000,NW 315,Residential,24987,104889,0,129876
132442700200000,NW 315,Residential,34398,160925,0,195323
132442700300000,NW 315,Residential,31115,38170,0,69285
132442700400000,NW 315,Residential,28858,64849,0,93707
132442700500000,NW 315,Residential,22068,121085,0,143153
132442700600000,NW 315,Residential,42120,84118,0,126238
132442700700000,NW 315,Residential,39690,96783,0,136473
132442700800000,NW 315,Residential,25026,98420,0,123446
132442700900000,NW 315,Residential,25026,117805,0,142831
132442701000000,NW 315,Residential,25026,96678,0,121704
132442701100000,NW 315,Residential,25026,104125,0,129151
132442701200000,NW 315,Residential,25026,103833,0,128859
132442701300000,NW 315,Residential,25026,116613,0,141639
132442800100000,NW 315,Residential,30555,100399,0,130954
132442800200000,NW 315,Residential,26496,116496,0,142992
132442800300000,NW 315,Residential,33120,141284,0,174404
132442800400000,NW 315,Residential,33120,134716,0,167836
132442800500000,NW 315,Residential,33776,130895,0,164671
132442800700000,NW 315,Residential,35249,171170,0,206419
132442800800000,NW 315,Residential,34869,147554,0,182423
132442800900000,NW 315,Residential,34768,168294,0,203062
132442801000000,NW 315,Residential,32400,121228,0,153628
132442801100000,NW 315,Residential,32400,135580,0,167980
132442801200000,NW 315,Residential,29340,0,0,29340
132442801300000,NW 315,Residential,28896,207499,0,236395
132442801400000,NW 315,Residential,27767,204254,0,232021
132442801500000,NW 337,Residential,38038,89071,0,127109
132442801600000,NW 315,Residential,30221,164416,0,194637
132442801700000,NW 315,Residential,30912,137416,0,168328
132442801800000,NW 315,Residential,30867,139486,0,170353
132442801900000,NW 315,Residential,27455,88155,0,115610
132442802000000,NW 315,Residential,31231,125690,0,156921
132442802100000,NW 315,Residential,24024,103246,0,127270
132442802200000,NW 315,Residential,24024,0,0,24024
132442802300000,APTS NW,Commercial,24805,0,255155,279960
132442802400000,NW 315,Residential,24024,111595,0,135619
132442802500000,NW 315,Residential,24024,96012,0,120036
132442802600000,NW 315,Residential,24840,41682,0,66522
132442802700000,NW 315,Residential,24840,35292,0,60132
132442802800000,NW 315,Residential,25698,38759,0,64457
132442802900000,NW 315,Residential,30555,118905,0,149460
132442803000000,NW 315,Residential,30555,80595,0,111150
132442803100000,NW 315,Residential,30555,118785,0,149340
132442803200000,NW 315,Residential,20,0,0,20
132442803300000,NW 337,Residential,37174,164696,0,201870
132442803400000,NW 337,Residential,36944,217892,0,254836
132442803500000,NW 337,Residential,39906,221080,0,260986
132442900100000,NW 337,Residential,67050,131058,0,198108
132442900200000,NW 337,Residential,67050,49986,0,117036
132442900300000,NW 337,Residential,82650,78597,0,161247
132442900400000,NW 337,Residential,33920,72095,0,106015
132442900500000,NW 337,Residential,169200,0,0,169200
132442900600000,NW 337,Residential,61250,41850,0,103100
132445100100000,NW 337,Residential,35050,0,0,35050
132445100200000,NW 337,Residential,16020,32797,0,48817
132445100300000,NW 337,Residential,28419,19060,0,47479
132445100400000,NW 337,Residential,31152,41641,0,72793
132445100500000,NW 337,Residential,54100,143257,0,197357
132445100600000,NW 337,Residential,56750,56884,0,113634
132445100700000,NW 337,Residential,68800,77974,0,146774
132445100800000,NW 337,Residential,21240,35175,0,56415
132445100900000,NW 337,Residential,21240,99816,0,121056
132445101000000,NW 337,Residential,21240,79212,0,100452
132445101100000,NW 337,Residential,28320,85683,0,114003
132445101200000,COMM NW,Commercial,195750,0,442995,638745
132445101300000,NW 337,Residential,32816,38925,0,71741
132445200100000,NW 337,Residential,30090,110633,0,140723
132445200200000,NW 337,Residential,28320,61730,0,90050
132445200300000,NW 337,Residential,31948,85310,0,117258
132445200400000,NW 337,Residential,24780,109075,0,133855
132445200500000,NW 337,Residential,29205,88973,0,118178
132445200600000,NW 337,Residential,29205,92862,0,122067
132445200700000,NW 337,Residential,33453,91385,0,124838
132445200800000,COMM NW,Commercial,42120,0,0,42120
132445200900000,COMM NW,Commercial,280368,0,371718,652086
132445201000000,NW 337,Residential,32978,70079,0,103057
132445201100000,NW 337,Residential,34098,39281,0,73379
132445201200000,NW 337,Residential,31860,4567,0,36427
132445201300000,NW 337,Residential,33842,39795,0,73637
132445201400000,NW 337,Residential,30351,81988,0,112339
132445201500000,NW 337,Residential,21825,103231,0,125056
132445201600000,NW 337,Residential,21534,69775,0,91309
132445201700000,NW 337,Residential,29051,84294,0,113345
132445201800000,NW 337,Residential,31152,0,0,31152
132445201900000,NW 337,Residential,38940,161919,0,200859
132445202000000,NW 337,Residential,51552,70668,0,122220
132445202100000,NW 337,Residential,51552,63778,0,115330
132445202200000,NW 337,Residential,44604,118587,0,163191
132445202300000,NW 337,Residential,28320,92413,0,120733
132445202400000,NW 337,Residential,40120,84670,0,124790
132445202500000,NW 337,Residential,37760,61057,0,98817
132445202600000,NW 337,Residential,51552,77451,0,129003
132447600100000,NW 337,Residential,39305,7913,0,47218
132447600200000,NW 337,Residential,19620,78171,0,97791
132447600300000,NW 324,Residential,23436,86971,0,110407
132447600400000,NW 324,Residential,23180,96974,0,120154
132447600500000,NW 324,Residential,23180,100979,0,124159
132447600600000,NW 324,Residential,23180,89258,0,112438
132447600700000,NW 324,Residential,23180,74733,0,97913
132447600800000,NW 324,Residential,23180,94850,0,118030
132447600900000,NW 324,Residential,23180,94764,0,117944
132447601000000,NW 324,Residential,23180,107588,0,130768
132447601100000,NW 324,Residential,23180,88307,0,111487
132447601200000,NW 324,Residential,23962,112127,0,136089
132447601300000,NW 337,Residential,75700,0,0,75700
132447601400000,E-40 CHURCHES,Exempt,382428,0,476342,858770
132447700100000,NW 324,Residential,23894,82380,0,106274
132447700200000,NW 324,Residential,23180,92991,0,116171
132447700300000,NW 324,Residential,23180,87278,0,110458
132447700400000,NW 324,Residential,23180,99363,0,122543
132447700500000,NW 324,Residential,23180,84120,0,107300
132447700600000,NW 324,Residential,23180,101549,0,124729
132447700700000,NW 324,Residential,23180,89614,0,112794
132447700800000,NW 324,Residential,23180,81148,0,104328
132447700900000,NW 324,Residential,23180,96874,0,120054
132447701000000,NW 324,Residential,23556,153513,0,177069
132447701100000,NW 337,Residential,33384,93054,0,126438
132447701200000,NW 337,Residential,31421,20565,0,51986
132447701300000,NW 337,Residential,35437,85558,0,120995
132447701400000,COMM NW,Commercial,67341,0,319682,387023
132447701500000,COMM NW,Commercial,336960,0,526735,863695
132447800200000,NW 301,Residential,33408,107104,0,140512
132447800300000,NW 337,Residential,28050,106900,0,134950
132447800400000,NW 337,Residential,32393,94618,0,127011
132447800500000,NW 337,Residential,29205,86672,0,115877
132447800600000,NW 337,Residential,29264,90209,0,119473
132447800700000,NW 337,Residential,25245,100927,0,126172
132447800800000,NW 337,Residential,25245,43052,0,68297
132447800900000,NW 337,Residential,23796,78647,0,102443
132447801000000,NW 337,Residential,23871,75158,0,99029
132447801100000,NW 337,Residential,29340,191597,0,220937
132447801200000,NW 337,Residential,29340,112450,0,141790
132447801300000,NW 337,Residential,33862,120837,0,154699
132447801400000,NW 337,Residential,35162,109520,0,144682
132447801500000,NW 324,Residential,28403,88568,0,116971
132447801600000,NW 324,Residential,26858,116752,0,143610
132447801700000,NW 324,Residential,26858,90464,0,117322
132447801800000,NW 324,Residential,27454,121474,0,148928
132447801900000,NW 324,Residential,26040,111913,0,137953
132447802000000,NW 324,Residential,26858,90575,0,117433
132447802300000,E-40 CHURCHES,Exempt,550800,0,196148,746948
132447900100000,NW 324,Residential,27637,108366,0,136003
132447900200000,NW 324,Residential,27900,106664,0,134564
132447900300000,NW 324,Residential,27900,101422,0,129322
132447900400000,NW 324,Residential,27900,99566,0,127466
132447900500000,NW 324,Residential,26040,80380,0,106420
132447900600000,NW 324,Residential,26784,121166,0,147950
132447900700000,NW 324,Residential,27900,106109,0,134009
132447900800000,NW 324,Residential,27900,102185,0,130085
132447900900000,NW 324,Residential,27900,107749,0,135649
132447901000000,NW 324,Residential,27900,108870,0,136770
132447901100000,NW 324,Residential,27900,119897,0,147797
132447901200000,NW 324,Residential,28165,96244,0,124409
132448000100000,NW 324,Residential,36190,125354,0,161544
132448000200000,NW 337,Residential,38940,68366,0,107306
132448000300000,NW 337,Residential,43920,66860,0,110780
132448000400000,NW 337,Residential,34456,105484,0,139940
132448000500000,NW 337,Residential,40479,38990,0,79469
132448000600000,NW 337,Residential,37760,193436,0,231196
132448000700000,NW 337,Residential,31452,84787,0,116239
132448000800000,NW 337,Residential,27540,100211,0,127751
132448000900000,NW 337,Residential,25500,86891,0,112391
132448001000000,NW 337,Residential,28050,56188,0,84238
132448001100000,NW 324,Residential,25760,81240,0,107000
132448001200000,NW 324,Residential,25760,87823,0,113583
132510100100000,NW 324,Residential,27743,67152,0,94895
132510100200000,COMM NW,Commercial,40499,0,0,40499
132510100300000,COMM NW,Commercial,40499,0,59264,99763
132510100400000,COMM NW,Commercial,40499,0,0,40499
132510100501000,CONDO 500,Residential,5000,71509,0,76509
132510100501001,CONDO 500,Residential,5000,71509,0,76509
132510100501002,CONDO 500,Residential,5000,72654,0,77654
132510100501003,CONDO 500,Residential,5000,72654,0,77654
132510100501004,CONDO 500,Residential,5000,75331,0,80331
132510100501005,CONDO 500,Residential,5000,75331,0,80331
132510100501006,CONDO 500,Residential,5000,71509,0,76509
132510100501007,CONDO 500,Residential,5000,71509,0,76509
132510100501008,CONDO 500,Residential,5000,72654,0,77654
132510100501009,CONDO 500,Residential,5000,72654,0,77654
132510100501010,CONDO 500,Residential,5000,72654,0,77654
132510100501011,CONDO 500,Residential,5000,72654,0,77654
132510100501012,CONDO 500,Residential,5000,71509,0,76509
132510100501013,CONDO 500,Residential,5000,74186,0,79186
132510100501014,CONDO 500,Residential,5000,72654,0,77654
132510100501015,CONDO 500,Residential,5000,75331,0,80331
132510100501016,CONDO 500,Residential,5000,75331,0,80331
132510100501017,CONDO 500,Residential,5000,75331,0,80331
132510100501018,CONDO 500,Residential,5000,74186,0,79186
132510100501019,CONDO 500,Residential,5000,71509,0,76509
132510100501020,CONDO 500,Residential,5000,75331,0,80331
132510100501021,CONDO 500,Residential,5000,72654,0,77654
132510100501022,CONDO 500,Residential,5000,72654,0,77654
132510100501023,CONDO 500,Residential,5000,72654,0,77654
132510100501024,CONDO 500,Residential,5000,71509,0,76509
132510100501025,CONDO 500,Residential,5000,71509,0,76509
132510100501026,CONDO 500,Residential,5000,72654,0,77654
132510100501027,CONDO 500,Residential,5000,72654,0,77654
132510100501028,CONDO 500,Residential,5000,72654,0,77654
132510100501029,CONDO 500,Residential,5000,72654,0,77654
132510100501030,CONDO 500,Residential,5000,71509,0,76509
132510100501031,CONDO 500,Residential,5000,71509,0,76509
132510100501032,CONDO 500,Residential,5000,72654,0,77654
132510100501033,CONDO 500,Residential,5000,72654,0,77654
132510100501034,CONDO 500,Residential,5000,72654,0,77654
132510100501035,CONDO 500,Residential,5000,72654,0,77654
132510100601000,CONDO 500,Residential,5000,45881,0,50881
132510100601001,CONDO 500,Residential,5000,45881,0,50881
132510100601002,CONDO 500,Residential,5000,47203,0,52203
132510100601003,CONDO 500,Residential,5000,47203,0,52203
132510100601004,CONDO 500,Residential,5000,45881,0,50881
132510100601005,CONDO 500,Residential,5000,45881,0,50881
132510100601006,CONDO 500,Residential,5000,47203,0,52203
132510100601007,CONDO 500,Residential,5000,47203,0,52203
132510100601008,CONDO 500,Residential,5000,44181,0,49181
132510100601009,CONDO 500,Residential,5000,44181,0,49181
132510100601010,CONDO 500,Residential,5000,42859,0,47859
132510100601011,CONDO 500,Residential,5000,42859,0,47859
132510100601012,CONDO 500,Residential,5000,44181,0,49181
132510100601013,CONDO 500,Residential,5000,44181,0,49181
132510100601014,CONDO 500,Residential,5000,44181,0,49181
132510100601015,CONDO 500,Residential,5000,44181,0,49181
132510100700000,NW 324,Residential,56700,11200,0,67900
132510100800000,NW 324,Residential,56700,64961,0,121661
132510100900000,NW 324,Residential,68000,99912,0,167912
132510101000000,NW 324,Residential,68500,553423,0,621923
132510101100000,NW 324,Residential,55400,110845,0,166245
132510101200000,NW 324,Residential,20265,61843,0,82108
132510101300000,NW 324,Residential,50850,85112,0,135962
132510101400000,NW 324,Residential,50850,120122,0,170972
132510101500000,NW 324,Residential,50850,145832,0,196682
132510101600000,NW 324,Residential,50850,132568,0,183418
132510101900000,COMM NW,Commercial,251910,0,326191,578101
132510102000000,COMM NW,Commercial,257850,0,210657,468507
132510102100000,COMM NW,Commercial,313200,0,223628,536828
132510102200000,COMM NW,Commercial,286200,0,240245,526445
132510102300000,COMM NW,Commercial,286200,0,529495,815695
132510102400000,COMM NW,Commercial,159667,0,120367,280034
132510102500000,COMM NW,Commercial,418500,0,471134,889634
132510102502000,COMM NW,Commercial,0,0,62065,62065
132510102600000,NW 301,Commercial,114806,0,363999,478805
132510102700000,NW 324,Residential,54650,0,0,54650
132512600100000,NW 324,Residential,56700,121215,0,177915
132512600200000,NW 324,Residential,60500,182192,0,242692
132512600300000,NW 324,Residential,5950,0,0,5950
132512600400000,NW 324,Residential,82500,0,0,82500
132512600600000,Empty,Other,0,0,0,0
132512600700000,Empty,Other,0,0,0,0
132512600800000,NW 324,Residential,58200,95704,0,153904
132512600900000,NW 327,Residential,30464,124044,0,154508
132512601000000,NW 327,Residential,30464,121951,0,152415
132512601100000,NW 327,Residential,30464,101043,0,131507
132512601200000,NW 327,Residential,30464,112738,0,143202
132512601300000,NW 327,Residential,22855,103362,0,126217
132512601400000,NW 327,Residential,22855,103998,0,126853
132512601500000,NW 324,Residential,34957,98904,0,133861
132512601600000,NW 324,Residential,41269,107117,0,148386
132512601700000,NW 324,Residential,56700,195055,0,251755
132512601800000,NW 324,Residential,56700,147217,0,203917
132512601900000,NW 324,Residential,56700,46587,0,103287
132512602000000,NW 324,Residential,56700,175805,0,232505
132512602100000,NW 324,Residential,56700,303458,0,360158
132512602200000,NW 324,Residential,46062,75722,0,121784
132512602300000,NW 324,Residential,48835,0,0,48835
132512602400000,NW 324,Residential,44540,360048,0,404588
132512602500000,NW 324,Residential,42556,312365,0,354921
132512602600000,NW 324,Residential,42567,266781,0,309348
132515100100000,E-15 CITY,Exempt,0,0,0,0
132515100200000,E-15 CITY,Exempt,0,0,0,0
132515100300000,E-15 CITY,Exempt,0,0,0,0
132515200100000,E-15 CITY,Exempt,0,0,0,0
132515300500000,NW 335,Residential,23400,81690,0,105090
132515300600000,NW 335,Residential,23400,73865,0,97265
132515300700000,NW 335,Residential,26707,54645,0,81352
132515300800000,E-15 CITY,Exempt,0,0,0,0
132515300900000,NW 335,Residential,30240,120666,0,150906
132515301000000,NW 335,Residential,28402,78898,0,107300
132515301100000,NW 335,Residential,27711,85711,0,113422
132515301200000,NW 335,Residential,21630,55759,0,77389
132515301300000,NW 335,Residential,20790,48244,0,69034
132515400200000,NW 335,Residential,22701,77245,0,99946
132515400300000,NW 335,Residential,26062,67504,0,93566
132515400401000,CONDO 500,Residential,8000,93815,0,101815
132515400401001,CONDO 500,Residential,8000,88005,0,96005
132515400401002,CONDO 500,Residential,8000,88005,0,96005
132515400401003,CONDO 500,Residential,8000,88005,0,96005
132515400401004,CONDO 500,Residential,8000,88005,0,96005
132515400401005,CONDO 500,Residential,8000,87845,0,95845
132515400401006,CONDO 500,Residential,8000,87845,0,95845
132515400401007,CONDO 500,Residential,8000,94415,0,102415
132515400401008,CONDO 500,Residential,8000,85442,0,93442
132515400401009,CONDO 500,Residential,8000,88005,0,96005
132515400401010,CONDO 500,Residential,8000,88005,0,96005
132515400401011,CONDO 500,Residential,8000,87845,0,95845
132515400401012,CONDO 505,Residential,8000,85281,0,93281
132515400401013,CONDO 505,Residential,8000,88005,0,96005
132515400401014,CONDO 505,Residential,8000,85442,0,93442
132515400401015,CONDO 505,Residential,8000,85442,0,93442
132515400401016,CONDO 505,Residential,8000,85442,0,93442
132515400401017,CONDO 505,Residential,8000,85281,0,93281
132515400401018,CONDO 500,Residential,8000,85970,0,93970
132515400401019,CONDO 500,Residential,8000,87569,0,95569
132515400401020,CONDO 500,Residential,8000,87569,0,95569
132515400401021,CONDO 500,Residential,8000,92481,0,100481
132515500100000,NW 335,Residential,27540,77415,0,104955
132515500200000,NW 335,Residential,23085,61754,0,84839
132515500300000,NW 335,Residential,23868,79621,0,103489
132515500400000,NW 335,Residential,21021,67765,0,88786
132515500500000,NW 335,Residential,19110,0,0,19110
132515500600000,NW 335,Residential,17820,0,0,17820
132515500700000,NW 335,Residential,23306,95336,0,118642
132515500800000,NW 335,Residential,18720,96000,0,114720
132515500900000,NW 335,Residential,18720,104157,0,122877
132515501000000,NW 335,Residential,18720,83870,0,102590
132515501100000,APTS NW,Commercial,13414,0,124719,138133
132515501200000,NW 335,Residential,21492,65670,0,87162
132515501300000,NW 335,Residential,21400,60632,0,82032
132515501400000,CONVERSIONS,Commercial,17360,0,82442,99802
132515501500000,NW 335,Residential,27612,104663,0,132275
132515501600000,APTS NW,Commercial,14458,0,121309,135767
132515501700000,NW 335,Residential,23730,53433,0,77163
132515501800000,NW 335,Residential,24798,77329,0,102127
132515501900000,NW 335,Residential,25620,88101,0,113721
132515502000000,NW 335,Residential,25272,107583,0,132855
132515502100000,NW 335,Residential,26973,94551,0,121524
132515502200000,NW 335,Residential,21185,109293,0,130478
132515600100000,NW 335,Residential,25431,136222,0,161653
132515600200000,NW 335,Residential,35538,118318,0,153856
132515600300000,NW 335,Residential,33441,125559,0,159000
132515600400000,NW 335,Residential,33280,104811,0,138091
132515600500000,NW 335,Residential,35274,144113,0,179387
132515600600000,NW 335,Residential,30009,119756,0,149765
132515600700000,NW 335,Residential,32280,147105,0,179385
132515600800000,NW 335,Residential,32292,146707,0,178999
132515600900000,NW 335,Residential,33575,160099,0,193674
132515601000000,NW 335,Residential,27160,112986,0,140146
132515601100000,NW 335,Residential,31040,144296,0,175336
132515601200000,NW 335,Residential,31394,144730,0,176124
132515601300000,NW 335,Residential,31450,148164,0,179614
132515601400000,NW 335,Residential,20,0,0,20
132515601500000,NW 335,Residential,32763,145629,0,178392
132515601600000,NW 335,Residential,32000,122559,0,154559
132515601700000,NW 335,Residential,33398,149615,0,183013
132515601800000,NW 335,Residential,48859,126807,0,175666
132515601900000,Empty,Exempt,0,0,0,0
132515700100000,NW 335,Residential,32646,158457,0,191103
132515700200000,NW 335,Residential,23256,118827,0,142083
132515700300000,NW 335,Residential,32105,145197,0,177302
132515700400000,NW 335,Residential,32685,148850,0,181535
132515700500000,NW 335,Residential,32300,140761,0,173061
132515700600000,NW 335,Residential,25181,125297,0,150478
132515700700000,NW 335,Residential,29139,127102,0,156241
132515700800000,NW 335,Residential,32365,130321,0,162686
132515700900000,NW 335,Residential,29563,113814,0,143377
132515701000000,NW 335,Residential,31579,113684,0,145263
132517600100000,COMM NW,Commercial,285768,0,259095,544863
132517600200000,E-15 CITY,Exempt,0,0,0,0
132517600301000,CONDO 500,Residential,4500,37610,0,42110
132517600301001,CONDO 500,Residential,4500,37610,0,42110
132517600301002,CONDO 500,Residential,4500,37610,0,42110
132517600301003,CONDO 500,Residential,4500,37610,0,42110
132517600301004,CONDO 500,Residential,4500,37963,0,42463
132517600301005,CONDO 500,Residential,4500,37963,0,42463
132517600301006,CONDO 500,Residential,4500,35793,0,40293
132517600301007,CONDO 500,Residential,4500,35793,0,40293
132517600301008,CONDO 500,Residential,4500,35793,0,40293
132517600301009,CONDO 500,Residential,4500,35793,0,40293
132517600301010,CONDO 500,Residential,4500,35793,0,40293
132517600301011,CONDO 500,Residential,4500,35793,0,40293
132517600400000,NW 324,Residential,20700,99337,0,120037
132517600500000,NW 324,Residential,21060,64200,0,85260
132517600600000,NW 324,Residential,21420,79485,0,100905
132517600700000,NW 324,Residential,21780,86408,0,108188
132517600800000,NW 324,Residential,26077,91044,0,117121
132517600900000,NW 324,Residential,20820,91086,0,111906
132517601000000,NW 324,Residential,21081,93409,0,114490
132517601200000,COMM NW,Commercial,22900,0,0,22900
132517700100000,COMM NW,Commercial,105127,0,145622,250749
132517700200000,COMM NW,Commercial,253800,0,421200,675000
132517700300000,NW 324,Residential,22806,91106,0,113912
132517700400000,NW 324,Residential,23552,104488,0,128040
132517700500000,NW 324,Residential,23552,88267,0,111819
132517700600000,NW 324,Residential,23257,98489,0,121746
132517700700000,NW 324,Residential,24437,91134,0,115571
132517700800000,NW 324,Residential,25080,89738,0,114818
132517700900000,NW 324,Residential,25194,123781,0,148975
132517701000000,NW 324,Residential,22560,93158,0,115718
132517701100000,NW 324,Residential,23552,95156,0,118708
132517701200000,NW 324,Residential,23296,97069,0,120365
132517701300000,NW 324,Residential,23296,81373,0,104669
132517701400000,NW 324,Exempt,23296,0,106286,129582
132517701500000,NW 324,Residential,23296,98163,0,121459
132517701600000,NW 324,Residential,23296,95846,0,119142
132517701700000,NW 324,Residential,23332,97750,0,121082
132517701800000,NW 324,Residential,24315,87949,0,112264
132517701900000,NW 324,Residential,24064,89732,0,113796
132517702000000,NW 324,Residential,24064,76683,0,100747
132517702100000,NW 324,Residential,24064,86228,0,110292
132517702200000,NW 324,Residential,24064,92603,0,116667
132517702300000,NW 324,Residential,24064,87689,0,111753
132517702400000,NW 324,Residential,24064,95630,0,119694
132517702500000,NW 324,Residential,27072,100130,0,127202
132517702600000,NW 324,Residential,26611,104236,0,130847
132517702700000,COMM NW,Commercial,90000,0,5000,95000
132517702800000,COMM NW,Commercial,114100,0,356108,470208
132517800100000,NW 324,Residential,24546,99209,0,123755
132517800200000,NW 324,Residential,27615,92893,0,120508
132517800300000,NW 324,Residential,23296,94196,0,117492
132517800400000,NW 324,Residential,23296,102751,0,126047
132517800500000,NW 324,Residential,23296,90788,0,114084
132517800600000,NW 324,Residential,23296,98963,0,122259
132517800700000,NW 324,Residential,23296,91563,0,114859
132517800800000,NW 324,Residential,23296,86246,0,109542
132517800900000,NW 324,Residential,25480,83223,0,108703
132517801000000,NW 324,Residential,25480,104378,0,129858
132517801100000,NW 324,Residential,25480,90776,0,116256
132517801200000,NW 324,Residential,25480,95460,0,120940
132517801300000,NW 324,Residential,23338,87827,0,111165
132517801400000,NW 324,Residential,23338,99448,0,122786
132517801500000,NW 324,Residential,23296,88077,0,111373
132517801600000,NW 324,Residential,23296,86533,0,109829
132517801700000,NW 324,Residential,25080,90408,0,115488
132517801800000,NW 324,Residential,25480,98088,0,123568
132517801900000,NW 324,Residential,27784,101475,0,129259
132517802000000,NW 324,Residential,30560,90333,0,120893
132517802100000,NW 324,Residential,30555,97604,0,128159
132517802200000,NW 324,Residential,28208,99527,0,127735
132517802300000,NW 324,Residential,25480,109671,0,135151
132517802400000,NW 324,Residential,30781,106311,0,137092
132517802500000,NW 324,Residential,29028,101871,0,130899
132517802600000,NW 324,Residential,27873,114907,0,142780
132517802700000,NW 324,Residential,28565,88739,0,117304
132517802800000,NW 324,Residential,25216,126868,0,152084
132517802900000,NW 324,Residential,22693,91557,0,114250
132517803000000,NW 324,Residential,23296,88623,0,111919
132517900100000,NW 324,Residential,28436,88894,0,117330
132517900200000,NW 324,Residential,23138,93420,0,116558
132517900300000,NW 324,Residential,21840,96215,0,118055
132517900400000,NW 324,Residential,22444,95150,0,117594
132517900500000,NW 324,Residential,23296,90204,0,113500
132517900600000,NW 324,Residential,23296,95262,0,118558
132517900700000,NW 324,Residential,23296,90138,0,113434
132517900800000,NW 324,Residential,23296,94252,0,117548
132517900900000,NW 324,Residential,23296,82072,0,105368
132517901000000,NW 324,Residential,23296,107181,0,130477
132517901100000,NW 324,Residential,23296,106223,0,129519
132517901200000,NW 324,Residential,23338,94399,0,117737
132517901300000,NW 324,Residential,23508,87337,0,110845
132517901400000,NW 324,Residential,25480,87069,0,112549
132517901500000,NW 324,Residential,25480,90908,0,116388
132517901600000,NW 324,Residential,25480,99713,0,125193
132517901700000,NW 324,Residential,25480,92822,0,118302
132517901800000,NW 324,Residential,25480,98060,0,123540
132517901900000,NW 324,Residential,23296,84381,0,107677
132517902000000,NW 324,Residential,23296,87977,0,111273
132517902100000,NW 324,Residential,23296,96518,0,119814
132517902200000,NW 324,Residential,23296,89423,0,112719
132518000100000,NW 324,Residential,24873,96110,0,120983
132518000400000,NW 324,Residential,52600,0,0,52600
132518000500000,NW 324,Residential,23381,100689,0,124070
132518000600000,NW 324,Residential,23296,89717,0,113013
132518000700000,NW 324,Residential,23296,104928,0,128224
132518000800000,NW 324,Residential,23296,132390,0,155686
132518000900000,NW 324,Residential,23296,102243,0,125539
132518001000000,NW 324,Residential,23296,88583,0,111879
132518001100000,NW 324,Residential,23296,77889,0,101185
132518001200000,NW 324,Residential,22204,93027,0,115231
132518001300000,NW 324,Residential,23296,92370,0,115666
132518001400000,APTS NW,Residential,49734,439246,0,488980
132518100100000,NW 324,Residential,23280,78900,0,102180
132518100200000,NW 324,Residential,23296,81211,0,104507
132518100300000,NW 324,Residential,23296,86458,0,109754
132518100400000,NW 324,Residential,22204,86274,0,108478
132518100500000,NW 324,Residential,23296,101216,0,124512
132518100600000,NW 324,Residential,23296,109383,0,132679
132518100700000,NW 324,Residential,22168,91049,0,113217
132518100800000,NW 324,Residential,23296,86216,0,109512
132518100900000,NW 324,Residential,22204,82751,0,104955
132518101000000,NW 324,Residential,23326,81034,0,104360
132518200100000,NW 324,Residential,21810,84025,0,105835
132518200200000,NW 324,Residential,21840,83938,0,105778
132518200300000,NW 324,Residential,21840,123524,0,145364
132518200400000,NW 324,Residential,21840,95216,0,117056
132518200500000,NW 324,Residential,21840,90503,0,112343
132518200600000,NW 324,Residential,21870,89135,0,111005
132518200700000,APTS NW,Residential,31900,288671,0,320571
132520100100000,NW 328,Residential,38146,146670,0,184816
132520100200000,NW 328,Residential,38160,150241,0,188401
132520100300000,NW 328,Residential,36524,159009,0,195533
132520100400000,NW 328,Residential,38178,136367,0,174545
132520100500000,NW 328,Residential,38624,150748,0,189372
132520100600000,NW 328,Residential,33950,159805,0,193755
132520100700000,NW 328,Residential,33950,128500,0,162450
132520100800000,NW 328,Residential,33950,135496,0,169446
132520100900000,NW 328,Residential,33950,148854,0,182804
132520101000000,NW 328,Residential,33950,133327,0,167277
132520101100000,NW 328,Residential,33475,133857,0,167332
132520101200000,NW 328,Residential,33475,135750,0,169225
132520101300000,NW 328,Residential,35671,149538,0,185209
132520101400000,NW 328,Residential,34300,126067,0,160367
132520101500000,NW 328,Residential,31893,127571,0,159464
132520101600000,NW 327,Residential,30233,87035,0,117268
132520101700000,NW 327,Residential,29349,95520,0,124869
132520101800000,NW 327,Residential,29002,95859,0,124861
132520101900000,NW 327,Residential,24000,96000,0,120000
132520102000000,NW 327,Residential,24000,104042,0,128042
132520102100000,NW 327,Residential,24000,96457,0,120457
132520102200000,NW 327,Residential,24000,96070,0,120070
132520102300000,NW 327,Residential,24000,112527,0,136527
132520102400000,NW 328,Residential,27730,151947,0,179677
132520102500000,NW 328,Residential,27440,130431,0,157871
132520102600000,NW 328,Residential,27440,133809,0,161249
132520102700000,NW 328,Residential,27440,128882,0,156322
132520102800000,NW 328,Residential,27160,141708,0,168868
132520200100000,NW 328,Residential,46800,144121,0,190921
132520200200000,NW 328,Residential,36400,134818,0,171218
132520200300000,NW 328,Residential,36400,133544,0,169944
132520200400000,NW 328,Residential,36400,139006,0,175406
132520200500000,NW 328,Residential,36400,139980,0,176380
132520200600000,NW 328,Residential,36400,127110,0,163510
132520200700000,NW 328,Residential,36400,141854,0,178254
132520200800000,NW 328,Residential,36400,126563,0,162963
132520200900000,NW 328,Residential,36400,133582,0,169982
132520201000000,NW 328,Residential,36400,136887,0,173287
132520201100000,NW 328,Residential,36400,136764,0,173164
132520201200000,NW 328,Residential,33800,126696,0,160496
132520201300000,NW 328,Residential,36400,136925,0,173325
132520201400000,NW 328,Residential,36400,134738,0,171138
132520300100000,NW 328,Residential,37102,145696,0,182798
132520300200000,NW 328,Residential,33950,156870,0,190820
132520300300000,NW 328,Residential,33950,168464,0,202414
132520300400000,NW 328,Residential,33950,144783,0,178733
132520300500000,NW 328,Residential,33950,151467,0,185417
132520300600000,NW 328,Residential,33950,156286,0,190236
132520300700000,NW 328,Residential,33950,182730,0,216680
132520300800000,NW 328,Residential,33950,165062,0,199012
132520300900000,NW 328,Residential,33950,143323,0,177273
132520301000000,NW 328,Residential,33950,141620,0,175570
132520301100000,NW 328,Residential,34700,140097,0,174797
132520301200000,NW 328,Residential,33800,146610,0,180410
132520301300000,NW 328,Residential,36050,150994,0,187044
132520301400000,NW 328,Residential,34650,127561,0,162211
132520301500000,NW 328,Residential,37492,138515,0,176007
132520301600000,NW 328,Residential,36400,131515,0,167915
132520301700000,NW 328,Residential,37789,125885,0,163674
132520301800000,NW 328,Residential,35774,145976,0,181750
132520301900000,NW 328,Residential,33668,140118,0,173786
132520302000000,NW 328,Residential,35724,135718,0,171442
132520302100000,NW 328,Residential,31525,148420,0,179945
132520302200000,NW 328,Residential,31525,146722,0,178247
132520302300000,NW 328,Residential,31525,155538,0,187063
132520302400000,NW 328,Residential,31525,146756,0,178281
132520302500000,NW 328,Residential,31525,144512,0,176037
132520302600000,NW 328,Residential,31525,134799,0,166324
132520302700000,NW 328,Residential,31525,162041,0,193566
132520302800000,NW 328,Residential,34920,138510,0,173430
132520400100000,NW 328,Residential,34920,167474,0,202394
132520400200000,NW 328,Residential,31525,125987,0,157512
132520400300000,NW 328,Residential,36075,159815,0,195890
132520400400000,NW 328,Residential,36400,127195,0,163595
132520400500000,NW 328,Residential,35425,137793,0,173218
132520400600000,NW 328,Residential,34450,144435,0,178885
132520400700000,NW 328,Residential,33400,138502,0,171902
132520400800000,NW 328,Residential,41300,134733,0,176033
132520400900000,NW 328,Residential,37867,145753,0,183620
132520401000000,NW 328,Residential,34650,114857,0,149507
132520401100000,NW 328,Residential,34912,126923,0,161835
132520401200000,NW 328,Residential,35981,138163,0,174144
132520401300000,NW 328,Residential,37762,117803,0,155565
132520401400000,NW 328,Residential,39187,148035,0,187222
132520401500000,NW 328,Residential,39900,128559,0,168459
132520401600000,E-15 CITY,Exempt,0,0,0,0
132520401700000,NW 327,Residential,41274,130203,0,171477
132520401800000,NW 327,Residential,40400,88682,0,129082
132520401900000,NW 328,Residential,36075,136753,0,172828
132520402000000,NW 328,Residential,33475,132671,0,166146
132520500100000,NW 328,Residential,42112,127113,0,169225
132520500200000,NW 328,Residential,33150,120091,0,153241
132520500300000,NW 328,Residential,35750,122899,0,158649
132520500400000,NW 328,Residential,37375,114147,0,151522
132520500500000,NW 328,Residential,38675,111862,0,150537
132520500600000,NW 328,Residential,31525,135369,0,166894
132520500700000,NW 328,Residential,31525,128455,0,159980
132520500800000,NW 328,Residential,34920,121917,0,156837
132520500900000,NW 328,Residential,37368,133626,0,170994
132520501000000,NW 328,Residential,37874,141371,0,179245
132520501100000,NW 328,Residential,37047,151069,0,188116
132520501200000,NW 327,Residential,24800,82287,0,107087
132520501300000,NW 327,Residential,24800,82799,0,107599
132520501400000,NW 327,Residential,24800,105240,0,130040
132520501500000,NW 327,Residential,24800,92648,0,117448
132520501600000,NW 327,Residential,24800,95721,0,120521
132520501700000,NW 327,Residential,24800,93061,0,117861
132520501800000,NW 327,Residential,24800,87463,0,112263
132520501900000,NW 327,Residential,24880,119335,0,144215
132520502000000,NW 327,Residential,24800,100746,0,125546
132520502100000,NW 327,Residential,26107,98985,0,125092
132520502200000,NW 327,Residential,34320,93686,0,128006
132520600100000,NW 328,Residential,37102,168452,0,205554
132520600200000,NW 328,Residential,33950,144088,0,178038
132520600300000,NW 328,Residential,39894,117035,0,156929
132520700100000,NW 327,Residential,32680,103512,0,136192
132520700200000,NW 327,Residential,26730,98772,0,125502
132520700300000,NW 327,Residential,26933,93262,0,120195
132520700400000,NW 327,Residential,25200,94395,0,119595
132520700500000,NW 327,Residential,25200,102689,0,127889
132520700600000,NW 327,Residential,25200,88437,0,113637
132520700700000,NW 327,Residential,25200,95872,0,121072
132520700800000,NW 327,Residential,25200,104431,0,129631
132520700900000,NW 327,Residential,25200,92514,0,117714
132520701000000,NW 327,Residential,25200,94383,0,119583
132520701100000,NW 327,Residential,28000,89518,0,117518
132520800100000,NW 327,Residential,24000,77129,0,101129
132520800200000,NW 327,Residential,24000,83174,0,107174
132520800300000,NW 327,Residential,24000,98882,0,122882
132520800400000,NW 327,Residential,24000,78664,0,102664
132520800500000,NW 327,Residential,24000,84494,0,108494
132520800600000,NW 327,Residential,24240,111718,0,135958
132522600100000,NW 328,Residential,36400,148280,0,184680
132522600200000,NW 328,Residential,37331,154137,0,191468
132522600300000,NW 328,Residential,36750,140517,0,177267
132522600400000,NW 328,Residential,37450,118501,0,155951
132522600500000,NW 328,Residential,37800,110704,0,148504
132522600600000,NW 328,Residential,38880,118833,0,157713
132522700100000,NW 328,Residential,40162,163867,0,204029
132522700200000,NW 328,Residential,31824,136483,0,168307
132522700300000,NW 328,Residential,29952,125928,0,155880
132522700400000,NW 328,Residential,37800,152867,0,190667
132522800100000,NW 328,Residential,32000,128704,0,160704
132522800200000,NW 328,Residential,32000,124551,0,156551
132522800300000,NW 328,Residential,28000,114631,0,142631
132522800400000,NW 328,Residential,28000,125693,0,153693
132522800500000,NW 328,Residential,28000,122030,0,150030
132522800600000,NW 328,Residential,28000,140608,0,168608
132522800700000,NW 328,Residential,28000,131492,0,159492
132522800800000,NW 328,Residential,28000,144667,0,172667
132522800900000,NW 328,Residential,28000,119986,0,147986
132522801000000,NW 328,Residential,28000,127416,0,155416
132522801100000,NW 328,Residential,27393,129858,0,157251
132522801200000,NW 328,Residential,27331,122179,0,149510
132522801300000,NW 328,Residential,27160,116616,0,143776
132522801400000,NW 327,Residential,24800,85160,0,109960
132522801500000,NW 327,Residential,24800,101623,0,126423
132522801600000,NW 327,Residential,24800,82162,0,106962
132522801700000,NW 327,Residential,25600,92582,0,118182
132522801800000,NW 327,Residential,26000,92256,0,118256
132522801900000,NW 327,Residential,24400,84257,0,108657
132522802000000,NW 327,Residential,24800,94565,0,119365
132522802100000,NW 327,Residential,24800,101244,0,126044
132522802200000,NW 328,Residential,29280,133108,0,162388
132522802300000,NW 328,Residential,27699,140708,0,168407
132522802400000,NW 328,Residential,29079,117294,0,146373
132522802500000,NW 328,Residential,28000,131851,0,159851
132522802600000,NW 328,Residential,28000,157720,0,185720
132522802700000,NW 328,Residential,28000,126202,0,154202
132522802800000,NW 328,Residential,28000,120956,0,148956
132522802900000,NW 328,Residential,28000,127763,0,155763
132522803000000,NW 328,Residential,28000,133290,0,161290
132522803100000,NW 328,Residential,28000,121446,0,149446
132522803200000,NW 328,Residential,28000,146266,0,174266
132522900100000,NW 328,Residential,32640,139275,0,171915
132522900200000,NW 328,Residential,28560,120450,0,149010
132522900300000,NW 328,Residential,28560,115386,0,143946
132522900400000,NW 328,Residential,28560,115700,0,144260
132522900500000,NW 328,Residential,28560,115367,0,143927
132522900600000,NW 328,Residential,28560,120953,0,149513
132522900700000,NW 328,Residential,28560,127344,0,155904
132522900800000,NW 328,Residential,28560,136926,0,165486
132522900900000,NW 328,Residential,28560,118487,0,147047
132522901000000,NW 328,Residential,28511,121807,0,150318
132522901100000,NW 328,Residential,29155,130342,0,159497
132522901200000,NW 328,Residential,27831,116991,0,144822
132522901300000,NW 327,Residential,26040,121317,0,147357
132522901400000,NW 327,Residential,26040,98154,0,124194
132522901500000,NW 327,Residential,26040,89714,0,115754
132522901600000,NW 327,Residential,26880,96179,0,123059
132523000100000,NW 328,Residential,32550,122326,0,154876
132523000200000,NW 328,Residential,32981,129617,0,162598
132523000300000,NW 328,Residential,43566,121668,0,165234
132523000400000,NW 328,Residential,35340,118096,0,153436
132523000500000,NW 328,Residential,34556,125708,0,160264
132523000600000,NW 328,Residential,34718,118389,0,153107
132523003000000,NW 328,Residential,33950,138337,0,172287
132523100100000,NW 328,Residential,37933,117676,0,155609
132523100200000,NW 328,Residential,40250,117278,0,157528
132523100300000,NW 328,Residential,40250,137921,0,178171
132523100400000,NW 328,Residential,29952,126921,0,156873
132523100500000,NW 328,Residential,29120,121494,0,150614
132523100600000,NW 328,Residential,29120,119734,0,148854
132523100700000,NW 328,Residential,29120,169514,0,198634
132523100800000,NW 328,Residential,29120,133248,0,162368
132523100900000,NW 328,Residential,29120,116362,0,145482
132523101000000,NW 328,Residential,28883,124060,0,152943
132523101100000,NW 328,Residential,27623,154071,0,181694
132523101200000,NW 328,Residential,27477,118377,0,145854
132523101300000,NW 327,Residential,24800,102357,0,127157
132523101400000,NW 327,Residential,24800,97144,0,121944
132523101500000,NW 327,Residential,24000,85168,0,109168
132523101600000,NW 327,Residential,26400,88342,0,114742
132523101700000,NW 327,Residential,26400,86933,0,113333
132523101800000,NW 328,Residential,33570,144494,0,178064
132523101900000,NW 328,Residential,32273,120906,0,153179
132523102000000,NW 328,Residential,33303,123582,0,156885
132523102100000,NW 328,Residential,31525,149532,0,181057
132523102200000,NW 328,Residential,31525,144590,0,176115
132523102300000,NW 328,Residential,31850,160596,0,192446
132523102400000,NW 328,Residential,39558,159462,0,199020
132523102500000,NW 328,Residential,40500,160607,0,201107
132523102600000,NW 328,Residential,37026,140962,0,177988
132523102700000,NW 328,Residential,39069,136663,0,175732
132523102800000,NW 328,Residential,39157,148875,0,188032
132523102900000,NW 328,Residential,37409,127660,0,165069
132523103100000,NW 328,Residential,33950,111050,0,145000
132523103200000,NW 328,Residential,33950,134914,0,168864
132523103300000,NW 328,Residential,39200,154637,0,193837
132523103400000,NW 328,Residential,38850,140850,0,179700
132523103500000,NW 328,Residential,39435,162631,0,202066
132523103600000,NW 328,Residential,35350,147339,0,182689
132523103700000,NW 328,Residential,38227,116344,0,154571
132523103800000,NW 328,Residential,39544,129667,0,169211
132523103900000,NW 328,Residential,37080,121412,0,158492
132523104000000,NW 328,Residential,33738,143992,0,177730
132523104100000,NW 328,Residential,35389,132157,0,167546
132523104200000,NW 328,Residential,37986,123679,0,161665
132523200100000,NW 328,Residential,35941,136270,0,172211
132523200200000,NW 328,Residential,34144,127597,0,161741
132523200300000,NW 328,Residential,31525,162705,0,194230
132523200400000,NW 328,Residential,31525,141114,0,172639
132523200500000,NW 328,Residential,31525,123125,0,154650
132523200600000,NW 328,Residential,31525,123460,0,154985
132523200700000,NW 328,Residential,31525,121527,0,153052
132523200800000,NW 328,Residential,32600,142762,0,175362
132523200900000,NW 328,Residential,37875,135717,0,173592
132523201000000,NW 327,Residential,25600,83027,0,108627
132523201100000,NW 327,Residential,24800,89057,0,113857
132523201200000,NW 327,Residential,24800,84598,0,109398
132523201300000,NW 327,Residential,24800,85037,0,109837
132523201400000,NW 327,Residential,24800,87356,0,112156
132523201500000,NW 327,Residential,24800,90306,0,115106
132523201600000,NW 327,Residential,24800,80046,0,104846
132523201700000,NW 327,Residential,24800,80552,0,105352
132523201800000,NW 327,Residential,24800,81869,0,106669
132523201900000,NW 327,Residential,24800,99619,0,124419
132523300100000,NW 327,Residential,25960,109188,0,135148
132523300200000,NW 327,Residential,25960,85114,0,111074
132523300300000,NW 327,Residential,25960,97184,0,123144
132523300400000,NW 327,Residential,25960,83839,0,109799
132523300500000,NW 327,Residential,24800,91749,0,116549
132523300600000,NW 327,Residential,24800,81880,0,106680
132523300700000,NW 327,Residential,24800,85307,0,110107
132523300800000,NW 327,Residential,24800,79008,0,103808
132523300900000,NW 327,Residential,24800,105242,0,130042
132523301000000,NW 327,Residential,24800,85656,0,110456
132523301100000,NW 327,Residential,24800,82221,0,107021
132523301200000,NW 327,Residential,24800,91849,0,116649
132523301300000,NW 327,Residential,24800,91711,0,116511
132523301400000,NW 327,Residential,26600,103452,0,130052
132523400100000,NW 327,Residential,24000,90094,0,114094
132523400200000,NW 327,Residential,24000,84637,0,108637
132523400300000,NW 327,Residential,24000,88071,0,112071
132523400400000,NW 327,Residential,24000,105495,0,129495
132523400500000,NW 327,Residential,24000,93096,0,117096
132523400600000,NW 327,Residential,29310,82740,0,112050
132525100100000,NW 329,Residential,19740,64044,0,83784
132525100200000,NW 329,Residential,20398,74371,0,94769
132525100300000,NW 329,Residential,21714,71729,0,93443
132525100400000,NW 329,Residential,20398,66940,0,87338
132525100500000,NW 329,Residential,19740,64750,0,84490
132525100600000,NW 329,Residential,20398,78534,0,98932
132525100700000,NW 329,Residential,21714,81543,0,103257
132525100800000,NW 329,Residential,20398,72938,0,93336
132525100900000,NW 329,Residential,19740,70152,0,89892
132525101000000,NW 329,Residential,19170,68351,0,87521
132525101100000,NW 329,Residential,24255,72659,0,96914
132525101200000,NW 329,Residential,24898,94075,0,118973
132525101300000,NW 329,Residential,20946,76909,0,97855
132525101400000,NW 329,Residential,20467,61690,0,82157
132525101500000,NW 329,Residential,21341,66779,0,88120
132525101600000,NW 329,Residential,20398,57130,0,77528
132525101700000,NW 329,Residential,21338,95932,0,117270
132525101800000,NW 329,Residential,20946,69793,0,90739
132525101900000,NW 329,Residential,25856,76300,0,102156
132525102000000,NW 329,Residential,23312,71624,0,94936
132525102100000,NW 329,Residential,24800,66602,0,91402
132525102200000,NW 329,Residential,23061,72861,0,95922
132525102300000,NW 329,Residential,23061,81089,0,104150
132525102400000,NW 329,Residential,22936,80962,0,103898
132525102500000,NW 329,Residential,22936,83845,0,106781
132525102600000,NW 329,Residential,22811,79800,0,102611
132525102700000,NW 329,Residential,22685,71997,0,94682
132525102800000,NW 329,Residential,21763,75449,0,97212
132525200100000,NW 329,Residential,24350,74840,0,99190
132525200200000,NW 329,Residential,26888,79000,0,105888
132525200300000,NW 329,Residential,24218,75163,0,99381
132525200400000,NW 329,Residential,24970,63547,0,88517
132525200500000,NW 329,Residential,25393,90706,0,116099
132525200600000,NW 329,Residential,27843,78619,0,106462
132525200700000,NW 329,Residential,25380,90454,0,115834
132525200800000,NW 329,Residential,26226,66574,0,92800
132525200900000,NW 329,Residential,32314,77985,0,110299
132525201000000,NW 329,Residential,31531,75940,0,107471
132525201100000,NW 329,Residential,32670,84856,0,117526
132525201200000,NW 329,Residential,32076,73258,0,105334
132525201300000,NW 329,Residential,32773,69184,0,101957
132525300100000,NW 329,Residential,20952,67713,0,88665
132525300200000,NW 329,Residential,20398,78565,0,98963
132525300300000,NW 329,Residential,21714,78441,0,100155
132525300400000,NW 329,Residential,20398,73572,0,93970
132525300500000,NW 329,Residential,20398,70362,0,90760
132525300600000,NW 329,Residential,21714,71727,0,93441
132525300700000,NW 329,Residential,20398,66327,0,86725
132525300800000,NW 329,Residential,21714,77986,0,99700
132525300900000,NW 329,Residential,20398,66458,0,86856
132525301000000,NW 329,Residential,21714,78289,0,100003
132525301100000,NW 329,Residential,20398,66977,0,87375
132525301200000,NW 329,Residential,20398,76220,0,96618
132525301300000,NW 329,Residential,22222,77409,0,99631
132525301400000,NW 329,Residential,21233,69972,0,91205
132525301500000,E-15 CITY,Exempt,0,0,0,0
132525301600000,E-15 CITY,Exempt,0,0,0,0
132525400100000,NW 329,Residential,20952,58905,0,79857
132525400200000,NW 329,Residential,20952,66210,0,87162
132525400300000,NW 329,Residential,21714,76312,0,98026
132525400400000,NW 329,Residential,20398,67568,0,87966
132525400500000,NW 329,Residential,19740,65643,0,85383
132525400600000,NW 329,Residential,20398,71839,0,92237
132525400700000,NW 329,Residential,21714,78357,0,100071
132525400800000,NW 329,Residential,20398,80780,0,101178
132525400900000,NW 329,Residential,20398,69092,0,89490
132525401000000,NW 329,Residential,21714,60434,0,82148
132525401100000,NW 329,Residential,20398,65268,0,85666
132525401200000,NW 329,Residential,19740,79088,0,98828
132525401300000,NW 329,Residential,21714,79286,0,101000
132525401400000,NW 329,Residential,22338,81643,0,103981
132525401500000,NW 329,Residential,21883,71182,0,93065
132525401600000,NW 329,Residential,20398,69437,0,89835
132525401700000,NW 329,Residential,19740,74406,0,94146
132525401800000,NW 329,Residential,20398,72606,0,93004
132525401900000,NW 329,Exempt,21714,829,79555,102098
132525402000000,NW 329,Residential,20398,76556,0,96954
132525402100000,NW 329,Residential,20398,74840,0,95238
132525402200000,NW 329,Residential,21714,83758,0,105472
132525402300000,NW 329,Residential,20398,82905,0,103303
132525402400000,NW 329,Residential,19740,62115,0,81855
132525402500000,NW 329,Residential,20398,70055,0,90453
132525402600000,NW 329,Residential,21714,77261,0,98975
132525500100000,NW 329,Residential,19735,67151,0,86886
132525500200000,NW 329,Residential,23333,77032,0,100365
132525500300000,NW 329,Residential,23539,66788,0,90327
132525500400000,NW 329,Residential,22000,63380,0,85380
132525500500000,NW 329,Residential,21896,71964,0,93860
132525500600000,NW 329,Residential,20769,79531,0,100300
132525500700000,NW 329,Residential,22152,65298,0,87450
132525500800000,NW 329,Residential,20160,79874,0,100034
132525500900000,NW 329,Residential,21618,70055,0,91673
132525501000000,NW 329,Residential,21104,68973,0,90077
132525501100000,NW 329,Residential,25693,66566,0,92259
132525501200000,NW 329,Residential,23312,63677,0,86989
132525501300000,NW 329,Residential,24656,66207,0,90863
132525501400000,NW 329,Residential,22403,95706,0,118109
132525501500000,NW 329,Residential,23334,71366,0,94700
132525501600000,NW 329,Residential,22454,77106,0,99560
132525501700000,NW 329,Residential,22906,74433,0,97339
132525501800000,NW 329,Residential,22080,57415,0,79495
132525501900000,NW 329,Residential,22560,70503,0,93063
132525502000000,NW 329,Residential,22560,63688,0,86248
132525502100000,NW 329,Residential,23714,63283,0,86997
132525502200000,NW 329,Residential,23827,67377,0,91204
132525502300000,NW 329,Residential,21957,64678,0,86635
132525502400000,NW 329,Residential,20398,79822,0,100220
132525502500000,NW 329,Residential,19740,64274,0,84014
132525502600000,NW 329,Residential,20398,77975,0,98373
132525502700000,NW 329,Residential,21714,77987,0,99701
132525502800000,NW 329,Residential,20398,68448,0,88846
132525502900000,NW 329,Residential,19740,63310,0,83050
132525503000000,NW 329,Residential,20398,75704,0,96102
132525503100000,NW 329,Residential,21714,76376,0,98090
132525503200000,NW 329,Residential,20398,68640,0,89038
132525503300000,NW 329,Residential,20398,72058,0,92456
132525503400000,NW 329,Residential,20398,81632,0,102030
132525600100000,NW 329,Residential,28272,82339,0,110611
132525600200000,NW 329,Residential,29703,79090,0,108793
132525600300000,NW 329,Residential,25317,74650,0,99967
132525600400000,NW 329,Residential,25587,74692,0,100279
132525600500000,NW 329,Residential,25856,73695,0,99551
132525600600000,NW 329,Residential,23940,65494,0,89434
132525600700000,NW 329,Residential,25587,73445,0,99032
132525600800000,NW 329,Residential,23940,70213,0,94153
132525600900000,NW 329,Residential,25177,78698,0,103875
132525601000000,NW 329,Residential,27072,81646,0,108718
132525601100000,NW 329,Residential,26319,87596,0,113915
132525601200000,NW 329,Residential,24941,70845,0,95786
132525601300000,NW 329,Residential,27867,76552,0,104419
132525601400000,NW 329,Residential,24498,65187,0,89685
132525601500000,NW 329,Residential,23808,69104,0,92912
132525601600000,NW 329,Residential,25958,76560,0,102518
132525601700000,NW 329,Residential,23243,81482,0,104725
132525601800000,NW 329,Exempt,23813,102666,0,126479
132525601900000,NW 329,Residential,25587,79461,0,105048
132525602000000,NW 329,Residential,22819,85297,0,108116
132525602100000,NW 329,Residential,23851,70557,0,94408
132525602200000,NW 329,Residential,25599,77134,0,102733
132525602300000,NW 329,Residential,24105,72620,0,96725
132525602400000,NW 329,Residential,24901,68614,0,93515
132525700100000,NW 329,Residential,29421,87807,0,117228
132525700200000,NW 329,Residential,36708,105029,0,141737
132525700300000,NW 329,Residential,27009,86340,0,113349
132525700400000,NW 329,Residential,27918,81383,0,109301
132525700500000,NW 329,Residential,27072,76100,0,103172
132525700600000,NW 329,Residential,26901,77772,0,104673
132525700700000,NW 329,Residential,24548,95861,0,120409
132525700800000,NW 329,Residential,26195,68827,0,95022
132525700900000,NW 329,Residential,22560,83928,0,106488
132525701000000,NW 329,Residential,23688,97930,0,121618
132525701100000,NW 329,Residential,23312,65770,0,89082
132525701200000,NW 329,Residential,22936,68602,0,91538
132525701300000,NW 329,Residential,24067,73657,0,97724
132525701400000,NW 329,Residential,23238,78436,0,101674
132525701500000,NW 329,Residential,23823,74244,0,98067
132525701600000,NW 329,Residential,23061,93374,0,116435
132525800100000,E-15 CITY,Exempt,0,0,0,0
132525900100000,NW 329,Residential,36981,72862,0,109843
132527600100000,NW 327,Residential,28850,96604,0,125454
132527600200000,NW 327,Residential,26368,97064,0,123432
132527600300000,NW 327,Residential,26368,100464,0,126832
132527600400000,NW 327,Residential,26698,98933,0,125631
132527600500000,NW 327,Residential,26698,99790,0,126488
132527600600000,NW 327,Residential,26698,95518,0,122216
132527600700000,NW 327,Residential,26698,90657,0,117355
132527600800000,NW 327,Residential,26698,94503,0,121201
132527600900000,NW 327,Residential,26438,106216,0,132654
132527601000000,E-15 CITY,Exempt,0,0,0,0
132527601100000,APTS NW,Commercial,19035,0,158400,177435
132527700100000,NW 327,Residential,27650,87911,0,115561
132527700200000,NW 327,Residential,22633,93812,0,116445
132527700300000,NW 327,Residential,24500,105630,0,130130
132527700400000,NW 327,Residential,23800,107140,0,130940
132527700500000,NW 327,Residential,24500,104868,0,129368
132527700600000,NW 327,Residential,24500,108551,0,133051
132527700700000,NW 327,Residential,24500,106336,0,130836
132527700800000,NW 327,Residential,24500,94153,0,118653
132527700900000,NW 327,Residential,24500,99542,0,124042
132527701000000,NW 327,Residential,24500,81147,0,105647
132527800100000,NW 327,Residential,21000,105892,0,126892
132527800200000,NW 327,Residential,21000,91218,0,112218
132527800300000,NW 327,Residential,21000,110289,0,131289
132527800400000,NW 327,Residential,21000,87474,0,108474
132527800500000,NW 327,Residential,21000,82293,0,103293
132527800600000,NW 327,Residential,21000,70805,0,91805
132527900100000,NW 327,Residential,28000,107000,0,135000
132527900200000,NW 327,Residential,24500,91357,0,115857
132527900300000,NW 327,Residential,22643,126147,0,148790
132527900400000,NW 327,Residential,22400,93315,0,115715
132527900500000,NW 327,Residential,21700,106326,0,128026
132527900600000,NW 327,Residential,22400,98624,0,121024
132527900700000,NW 327,Residential,21700,110947,0,132647
132527900800000,NW 327,Residential,22400,111399,0,133799
132527900900000,NW 327,Residential,24238,106149,0,130387
132527901000000,NW 327,Residential,27940,87552,0,115492
132527901100000,NW 327,Residential,25600,88361,0,113961
132527901200000,NW 327,Residential,24800,94373,0,119173
132527901300000,NW 327,Residential,25600,98454,0,124054
132527901400000,NW 327,Residential,24800,96326,0,121126
132527901500000,NW 327,Residential,25600,109215,0,134815
132527901600000,NW 327,Residential,25544,79200,0,104744
132528000100000,NW 327,Residential,24500,87659,0,112159
132528000200000,NW 327,Residential,24500,106719,0,131219
132528000300000,NW 327,Residential,21946,117046,0,138992
132528000400000,NW 327,Residential,22400,98036,0,120436
132528000500000,NW 327,Residential,22400,100232,0,122632
132528000600000,NW 327,Residential,22400,93741,0,116141
132528000700000,NW 327,Residential,22400,105291,0,127691
132528000800000,NW 327,Residential,22400,106855,0,129255
132528000900000,NW 327,Residential,22400,88853,0,111253
132528001000000,NW 327,Residential,22295,99319,0,121614
132528001100000,NW 327,Residential,22505,116693,0,139198
132528001200000,NW 327,Residential,22400,108857,0,131257
132528001300000,NW 327,Residential,22400,108576,0,130976
132528001400000,NW 327,Residential,22400,101703,0,124103
132528001500000,NW 327,Residential,22400,103682,0,126082
132528001600000,NW 327,Residential,22400,90316,0,112716
132528001700000,NW 327,Residential,22400,97829,0,120229
132528001800000,NW 327,Residential,21657,113336,0,134993
132528100100000,NW 327,Residential,24500,98042,0,122542
132528100200000,NW 327,Residential,24500,110984,0,135484
132528100300000,NW 327,Residential,22049,106487,0,128536
132528100400000,NW 327,Residential,22400,108290,0,130690
132528100500000,NW 327,Residential,22400,0,0,22400
132528100600000,NW 327,Residential,22400,110747,0,133147
132528100700000,NW 327,Residential,22400,93154,0,115554
132528100800000,NW 327,Residential,22400,109015,0,131415
132528100900000,NW 327,Residential,24395,92270,0,116665
132528101000000,NW 327,Residential,24605,108014,0,132619
132528101100000,NW 327,Residential,22400,84359,0,106759
132528101200000,NW 327,Residential,22400,110742,0,133142
132528101300000,NW 327,Residential,21700,94056,0,115756
132528101400000,NW 327,Residential,22400,115549,0,137949
132528101500000,NW 327,Residential,22400,94665,0,117065
132528101600000,NW 327,Residential,21818,86344,0,108162
132528200100000,NW 327,Residential,24500,77887,0,102387
132528200200000,NW 327,Residential,24500,92594,0,117094
132528200300000,NW 327,Residential,22327,95460,0,117787
132528200400000,NW 327,Residential,22400,99041,0,121441
132528200500000,NW 327,Residential,22400,117332,0,139732
132528200600000,NW 327,Residential,22400,91354,0,113754
132528200700000,NW 327,Residential,22400,109804,0,132204
132528200800000,NW 327,Residential,22575,112970,0,135545
132528200900000,NW 327,Residential,22575,90915,0,113490
132528201000000,NW 327,Residential,22575,87377,0,109952
132528201100000,NW 327,Residential,22575,85286,0,107861
132528201200000,NW 327,Residential,22610,95456,0,118066
132528201300000,NW 327,Residential,24633,89350,0,113983
132528201400000,NW 327,Residential,22351,88125,0,110476
132528201500000,NW 327,Residential,24633,101101,0,125734
132528201600000,NW 327,Residential,22820,105549,0,128369
132528201700000,NW 327,Residential,22575,97775,0,120350
132528201800000,NW 327,Residential,22575,89731,0,112306
132528201900000,NW 327,Residential,22575,77470,0,100045
132528202000000,NW 327,Residential,22575,93096,0,115671
132528202100000,NW 327,Residential,22400,105069,0,127469
132528202200000,NW 327,Residential,22400,93561,0,115961
132528202300000,NW 327,Residential,22400,100834,0,123234
132528202400000,NW 327,Residential,22400,95941,0,118341
132528202500000,NW 327,Residential,22033,89779,0,111812
132528300100000,NW 327,Residential,24500,98766,0,123266
132528300200000,NW 327,Residential,22474,90415,0,112889
132528300300000,NW 327,Residential,21700,117157,0,138857
132528300400000,NW 327,Residential,22400,104624,0,127024
132528300500000,NW 327,Residential,22400,99121,0,121521
132528300600000,NW 327,Residential,22400,92513,0,114913
132528300700000,NW 327,Residential,22400,112027,0,134427
132528300800000,NW 327,Residential,22400,93428,0,115828
132528300900000,NW 327,Residential,22400,86922,0,109322
132528301000000,NW 327,Residential,22400,89385,0,111785
132528301100000,NW 327,Residential,22400,95870,0,118270
132528301200000,NW 327,Residential,22400,60146,0,82546
132528301300000,NW 327,Residential,24979,73026,0,98005
132528400100000,E-15 CITY,Exempt,0,0,0,0
132528400200000,E-15 CITY,Exempt,0,0,0,0
132528400300000,E-40 CHURCHES,Exempt,437184,0,570333,1007517
132528500100000,E-15 CITY,Exempt,0,0,0,0
132528600100000,NW 327,Residential,22015,114923,0,136938
132528600200000,NW 327,Residential,24448,102072,0,126520
132528600300000,NW 327,Residential,21700,86902,0,108602
132528600400000,NW 327,Residential,21700,89885,0,111585
132528600500000,NW 327,Residential,25514,86795,0,112309
132528600600000,E-15 CITY,Exempt,0,0,0,0
132528700100000,E-15 CITY,Exempt,0,0,0,0
132528700200000,E-15 CITY,Exempt,0,0,0,0
132530100100000,NW 329,Residential,31870,112295,0,144165
132530100200000,NW 329,Residential,57850,108852,0,166702
132530100300000,NW 329,Residential,52350,95802,0,148152
132530100400000,NW 329,Residential,58550,0,0,58550
132530100500000,APTS NW,Commercial,49896,0,400104,450000
132530100600000,NW 329,Residential,33900,181864,0,215764
132530200100000,NW 329,Ag Dwelling,8484,124289,12943,145716
132530200200000,NW 344,Residential,49811,182193,0,232004
132530200300000,NW 344,Residential,46600,270254,0,316854
132530200400000,NW 344,Residential,46354,230508,0,276862
132530200500000,NW 344,Residential,48151,225850,0,274001
132530200600000,NW 344,Residential,46713,283134,0,329847
132530200700000,NW 344,Residential,46084,255402,0,301486
132530200800000,NW 344,Residential,45815,255021,0,300836
132530200900000,NW 344,Residential,45815,229322,0,275137
132530201000000,NW 344,Residential,46609,221120,0,267729
132530201100000,NW 344,Residential,47025,258775,0,305800
132530201200000,NW 344,Residential,50860,229894,0,280754
132530300100000,NW 344,Residential,48706,283677,0,332383
132530300200000,E-15 CITY,Exempt,0,0,0,0
132530300300000,NW 344,Residential,51300,92840,0,144140
132530300500000,NW 344,Residential,44280,253440,0,297720
132530300600000,NW 344,Residential,46632,237311,0,283943
132530300700000,NW 344,Residential,45815,264617,0,310432
132530300800000,NW 344,Residential,45815,256434,0,302249
132530300900000,NW 344,Residential,47669,240945,0,288614
132530400100000,NW 344,Residential,50090,248671,0,298761
132530400200000,NW 344,Residential,45012,215451,0,260463
132530400300000,NW 344,Residential,46329,218893,0,265222
132530400400000,NW 344,Residential,44000,243457,0,287457
132530400500000,NW 344,Residential,47025,250153,0,297178
132530400600000,NW 344,Residential,44000,209835,0,253835
132530400700000,NW 344,Residential,45641,227625,0,273266
132530400800000,NW 344,Residential,46550,272631,0,319181
132530400900000,NW 344,Residential,51937,339726,0,391663
132530401000000,NW 344,Residential,47667,204908,0,252575
132530401200000,NW 344,Residential,48645,235502,0,284147
132530401300000,NW 344,Residential,44550,254155,0,298705
132530401400000,NW 344,Residential,46750,232933,0,279683
132530401500000,NW 344,Residential,46750,242029,0,288779
132530401600000,NW 344,Residential,46750,190634,0,237384
132530401700000,NW 344,Residential,46750,262762,0,309512
132530401800000,NW 344,Residential,46404,216766,0,263170
132530401900000,NW 344,Residential,50935,255901,0,306836
132530402000000,NW 344,Residential,52411,275190,0,327601
132530402100000,NW 344,Residential,50330,250772,0,301102
132530402200000,NW 344,Residential,50879,242558,0,293437
132530402300000,NW 344,Residential,46750,205083,0,251833
132530402400000,NW 344,Residential,46750,228441,0,275191
132530402500000,NW 344,Residential,46750,208286,0,255036
132530402600000,NW 344,Residential,44000,208947,0,252947
132530402700000,NW 344,Residential,46750,215320,0,262070
132530402800000,NW 344,Residential,46750,252468,0,299218
132530402900000,NW 344,Residential,44000,229618,0,273618
132530403000000,NW 344,Residential,46750,260745,0,307495
132530403100000,NW 344,Residential,48369,241277,0,289646
132530403200000,NW 344,Residential,51275,231329,0,282604
132530403300000,NW 344,Residential,53259,241770,0,295029
132530403400000,NW 344,Residential,55566,241078,0,296644
132530403500000,NW 344,Residential,52479,223618,0,276097
132530403600000,NW 344,Residential,51414,195927,0,247341
132532600100000,APTS NW,Commercial,52974,0,1089023,1141997
132532600200000,COMM NW,Commercial,83981,0,208483,292464
132532600300000,COMM NW,Commercial,358560,0,235742,594302
132532600400000,COMM NW,Commercial,175392,0,422458,597850
132532600500000,COMM NW,Commercial,54000,0,45348,99348
132532700100000,NW 329,Residential,26483,59130,0,85613
132532700200000,E-15 CITY,Exempt,0,0,0,0
132532700300000,NW 329,Residential,21301,105403,0,126704
132532700400000,NW 329,Residential,21210,120214,0,141424
132532700500000,NW 329,Residential,21210,120899,0,142109
132532700600000,NW 329,Residential,21489,106665,0,128154
132532700700000,NW 329,Residential,19695,115825,0,135520
132532700800000,NW 329,Residential,19695,118548,0,138243
132532700900000,NW 329,Residential,19695,181122,0,200817
132532701000000,APTS NW,Commercial,26730,0,242763,269493
132532701100000,APTS NW,Commercial,13325,0,239837,253162
132532701200000,COMM NW,Commercial,71515,0,243476,314991
132532701300000,NW 340,Residential,22557,118901,0,141458
132532701400000,NW 340,Residential,21631,120276,0,141907
132532701500000,NW 340,Residential,20854,120408,0,141262
132532701600000,NW 340,Residential,20924,122547,0,143471
132532701700000,NW 340,Residential,19885,147321,0,167206
132532701800000,NW 340,Residential,20272,132435,0,152707
132532701900000,NW 340,Residential,20249,126383,0,146632
132532702000000,NW 340,Residential,21321,132988,0,154309
132532702100000,NW 340,Residential,22792,144219,0,167011
132532702200000,NW 340,Residential,21039,137829,0,158868
132532702300000,NW 340,Residential,19500,136201,0,155701
132532702400000,NW 340,Residential,21725,120833,0,142558
132532702600000,COMM NW,Commercial,136350,0,499325,635675
132532702700000,COMM NW,Commercial,77760,0,215298,293058
132532702800000,COMM NW,Commercial,67392,0,86368,153760
132532702900000,E-46 RELIG PARKING,Exempt,14170,0,0,14170
132532703000000,E-40 CHURCHES,Exempt,188352,0,473281,661633
132532703100000,E-40 CHURCHES,Exempt,36453,0,53997,90450
132532703200000,NW 329,Residential,27233,52585,0,79818
132532703300000,NW 329,Residential,26481,80199,0,106680
132532703400000,NW 329,Residential,26481,85312,0,111793
132532703500000,COMM NW,Commercial,16232,0,61960,78192
132532800100000,NW 329,Residential,20447,105152,0,125599
132532800200000,NW 329,Residential,20370,102174,0,122544
132532800300000,NW 329,Residential,20370,115360,0,135730
132532800400000,NW 329,Residential,20370,110721,0,131091
132532800500000,NW 329,Residential,22484,123423,0,145907
132532800600000,NW 329,Residential,22485,122745,0,145230
132532900100000,NW 329,Residential,11754,110101,0,121855
132532900200000,NW 329,Residential,9693,109738,0,119431
132532900300000,APTS NW,Commercial,19601,0,154733,174334
132532900400000,APTS NW,Commercial,19601,0,154733,174334
132533000100000,COMM NW,Commercial,139968,0,110766,250734
132533000200000,COMM NW,Commercial,45000,0,79591,124591
132533100200000,COMM NW,Commercial,173664,0,167271,340935
132533100300000,COMM NW,Commercial,369792,0,391796,761588
132533100400000,COMM NW,Commercial,135067,0,127739,262806
132533100500000,COMM NW,Commercial,112455,0,132511,244966
132533200400000,COMM NW,Commercial,57132,0,229882,287014
132533200500000,COMM NW,Commercial,51840,0,169728,221568
132533200600000,COMM NW,Commercial,20236,0,122264,142500
132533200700000,COMM NW,Commercial,62208,0,103991,166199
132533200800000,APTS NW,Commercial,42552,0,200794,243346
132533200900000,E-70 CHARITY OTHER,Exempt,28836,0,356600,385436
132535100300000,COMM NW,Commercial,40000,0,0,40000
132535100400000,APTS NW,Commercial,146880,0,2137992,2284872
132535100500000,E-15 CITY,Exempt,0,0,0,0
132535200101000,CONDO 500,Residential,5000,59470,0,64470
132535200101001,CONDO 500,Residential,5000,59470,0,64470
132535200101002,CONDO 500,Residential,5000,59244,0,64244
132535200101003,CONDO 500,Residential,5000,59244,0,64244
132535200101004,CONDO 500,Residential,5000,60328,0,65328
132535200101005,CONDO 500,Residential,5000,60328,0,65328
132535200101006,CONDO 500,Residential,5000,60328,0,65328
132535200101007,CONDO 500,Residential,5000,60328,0,65328
132535200101008,CONDO 500,Residential,5000,60328,0,65328
132535200101009,CONDO 500,Residential,5000,60328,0,65328
132535200101010,CONDO 500,Residential,5000,60328,0,65328
132535200101011,CONDO 500,Residential,5000,60328,0,65328
132535200101012,CONDO 500,Residential,5000,59470,0,64470
132535200101013,CONDO 500,Residential,5000,59470,0,64470
132535200101014,CONDO 500,Residential,5000,59244,0,64244
132535200101015,CONDO 500,Residential,5000,59244,0,64244
132535200101016,CONDO 500,Residential,5000,60328,0,65328
132535200101017,CONDO 500,Residential,5000,60328,0,65328
132535200101018,CONDO 500,Residential,5000,60328,0,65328
132535200101019,CONDO 500,Residential,5000,60328,0,65328
132535200101020,CONDO 500,Residential,5000,60328,0,65328
132535200101021,CONDO 500,Residential,5000,60328,0,65328
132535200101022,CONDO 500,Residential,5000,60328,0,65328
132535200101023,CONDO 500,Residential,5000,60328,0,65328
132535200101024,CONDO 500,Residential,5000,59470,0,64470
132535200101025,CONDO 500,Residential,5000,59470,0,64470
132535200101026,CONDO 500,Residential,5000,59244,0,64244
132535200101027,CONDO 500,Residential,5000,59244,0,64244
132535200101028,CONDO 500,Residential,5000,60328,0,65328
132535200101029,CONDO 500,Residential,5000,60328,0,65328
132535200101030,CONDO 500,Residential,5000,60328,0,65328
132535200101031,CONDO 500,Residential,5000,60328,0,65328
132535200101032,CONDO 500,Residential,5000,60328,0,65328
132535200101033,CONDO 500,Residential,5000,60328,0,65328
132535200101034,CONDO 500,Residential,5000,60328,0,65328
132535200101035,CONDO 500,Residential,5000,60328,0,65328
132535200101036,CONDO 500,Residential,5000,59470,0,64470
132535200101037,CONDO 500,Residential,5000,59470,0,64470
132535200101038,CONDO 500,Residential,5000,59244,0,64244
132535200101039,CONDO 500,Residential,5000,59244,0,64244
132535200101040,CONDO 500,Residential,5000,60328,0,65328
132535200101041,CONDO 500,Residential,5000,60328,0,65328
132535200101042,CONDO 500,Residential,5000,60328,0,65328
132535200101043,CONDO 500,Residential,5000,60328,0,65328
132535200101044,CONDO 500,Residential,5000,60328,0,65328
132535200101045,CONDO 500,Residential,5000,60328,0,65328
132535200101046,CONDO 500,Residential,5000,60328,0,65328
132535200101047,CONDO 500,Residential,5000,60328,0,65328
132535200200000,APTS SW,Commercial,377298,0,3321279,3698577
132535200300000,APTS SW,Commercial,255960,0,768461,1024421
132535200401000,CONDO 500,Residential,4500,33173,0,37673
132535200401001,CONDO 500,Residential,4500,33173,0,37673
132535200401002,CONDO 500,Residential,4500,33173,0,37673
132535200401003,CONDO 500,Residential,4500,46312,0,50812
132535200401004,CONDO 500,Residential,4500,33173,0,37673
132535200401005,CONDO 500,Residential,4500,33173,0,37673
132535200401006,CONDO 500,Residential,4500,33173,0,37673
132535200401007,CONDO 500,Residential,4500,33173,0,37673
132535200401008,CONDO 500,Residential,4500,33173,0,37673
132535200401009,CONDO 500,Residential,4500,33173,0,37673
132535200401010,CONDO 500,Residential,4500,33173,0,37673
132535200401011,CONDO 500,Residential,4500,33173,0,37673
132535200401012,CONDO 500,Residential,4500,33173,0,37673
132535200401013,CONDO 500,Residential,4500,33173,0,37673
132535200401014,CONDO 500,Residential,4500,33173,0,37673
132535200401015,CONDO 500,Residential,4500,33173,0,37673
132535200401016,CONDO 500,Residential,4500,33173,0,37673
132535200401017,CONDO 500,Residential,4500,33173,0,37673
132535200401018,CONDO 500,Residential,4500,46312,0,50812
132535200401019,CONDO 500,Residential,4500,33173,0,37673
132535200401020,CONDO 500,Residential,4500,33173,0,37673
132535200401021,CONDO 500,Residential,4500,33173,0,37673
132535200401022,CONDO 500,Residential,4500,33173,0,37673
132535200401023,CONDO 500,Residential,4500,33173,0,37673
132535200401024,CONDO 500,Residential,4500,33173,0,37673
132535200401025,CONDO 500,Residential,4500,33173,0,37673
132535200401026,CONDO 500,Residential,4500,33173,0,37673
132535200401027,CONDO 500,Residential,4500,33173,0,37673
132535200401028,CONDO 500,Residential,4500,33173,0,37673
132535200401029,CONDO 500,Residential,4500,33173,0,37673
132535200401030,CONDO 500,Residential,4500,33173,0,37673
132535200401031,CONDO 500,Residential,4500,33173,0,37673
132535200401032,CONDO 500,Residential,4500,33173,0,37673
132535200401033,CONDO 500,Residential,4500,46312,0,50812
132535200401034,CONDO 500,Residential,4500,33173,0,37673
132535200401035,CONDO 500,Residential,4500,33173,0,37673
132535200401036,CONDO 500,Residential,4500,33173,0,37673
132535200401037,CONDO 500,Residential,4500,33173,0,37673
132535200401038,CONDO 500,Residential,4500,33173,0,37673
132535200401039,CONDO 500,Residential,4500,33173,0,37673
132535200401040,CONDO 500,Residential,4500,33173,0,37673
132535200401041,CONDO 500,Residential,4500,33173,0,37673
132535200401042,CONDO 500,Residential,4500,33173,0,37673
132535200401043,CONDO 500,Residential,4500,33173,0,37673
132535200401044,CONDO 500,Residential,4500,33173,0,37673
132535200401045,CONDO 500,Residential,4500,33173,0,37673
132535200401046,CONDO 500,Residential,4500,33173,0,37673
132535200401047,CONDO 500,Residential,4500,33173,0,37673
132535200401048,CONDO 500,Residential,4500,46312,0,50812
132535200401049,CONDO 500,Residential,4500,33173,0,37673
132535200401050,CONDO 500,Residential,4500,33173,0,37673
132535200401051,CONDO 500,Residential,4500,33173,0,37673
132535200401052,CONDO 500,Residential,4500,33173,0,37673
132535200401053,CONDO 500,Residential,4500,33173,0,37673
132535200401054,CONDO 500,Residential,4500,33173,0,37673
132535200401055,CONDO 500,Residential,4500,33173,0,37673
132535200401056,CONDO 500,Residential,4500,33173,0,37673
132535200401057,CONDO 500,Residential,4500,33173,0,37673
132535200401058,CONDO 500,Residential,4500,33173,0,37673
132535200401059,CONDO 500,Residential,4500,33173,0,37673
132535200401060,CONDO 500,Residential,4500,33173,0,37673
132535200401061,CONDO 500,Residential,4500,33173,0,37673
132535200401062,CONDO 500,Residential,4500,33173,0,37673
132535200401063,CONDO 500,Residential,4500,46312,0,50812
132535200401064,CONDO 500,Residential,4500,33173,0,37673
132535200401065,CONDO 500,Residential,4500,33173,0,37673
132535200401066,CONDO 500,Residential,4500,33173,0,37673
132535200401067,CONDO 500,Residential,4500,33173,0,37673
132535200401068,CONDO 500,Residential,4500,33173,0,37673
132535200401069,CONDO 500,Residential,4500,33173,0,37673
132535200401070,CONDO 500,Residential,4500,33173,0,37673
132535200401071,CONDO 500,Residential,4500,33173,0,37673
132535200401072,CONDO 500,Residential,4500,33173,0,37673
132535200401073,CONDO 500,Residential,4500,33173,0,37673
132535200401074,CONDO 500,Residential,4500,33173,0,37673
132535200401075,CONDO 500,Residential,4500,33173,0,37673
132535200401076,CONDO 500,Residential,4500,33173,0,37673
132535200401077,CONDO 500,Residential,4500,33173,0,37673
132535200401078,CONDO 500,Residential,4500,46312,0,50812
132535200401079,CONDO 500,Residential,4500,33173,0,37673
132535200401080,CONDO 500,Residential,4500,33173,0,37673
132535200401081,CONDO 500,Residential,4500,33173,0,37673
132535200401082,CONDO 500,Residential,4500,33173,0,37673
132535200401083,CONDO 500,Residential,4500,33173,0,37673
132535200401084,CONDO 500,Residential,4500,33173,0,37673
132535200401085,CONDO 500,Residential,4500,33173,0,37673
132535200401086,CONDO 500,Residential,4500,33173,0,37673
132535200401087,CONDO 500,Residential,4500,33173,0,37673
132535200401088,CONDO 500,Residential,4500,33173,0,37673
132535200401089,CONDO 500,Residential,4500,33173,0,37673
132535200401090,CONDO 500,Residential,4500,33173,0,37673
132535200401091,CONDO 500,Residential,4500,33173,0,37673
132535200401092,CONDO 500,Residential,4500,33173,0,37673
132535200401093,CONDO 500,Residential,4500,46312,0,50812
132535200401094,CONDO 500,Residential,4500,33173,0,37673
132535200401095,CONDO 500,Residential,4500,33173,0,37673
132535200401096,CONDO 500,Residential,4500,33173,0,37673
132535200401097,CONDO 500,Residential,4500,33173,0,37673
132535200401098,CONDO 500,Residential,4500,33173,0,37673
132535200401099,CONDO 500,Residential,4500,33173,0,37673
132535200401100,CONDO 500,Residential,4500,33173,0,37673
132535200401101,CONDO 500,Residential,4500,33173,0,37673
132535200401102,CONDO 500,Residential,4500,33173,0,37673
132535200401103,CONDO 500,Residential,4500,33173,0,37673
132535200401104,CONDO 500,Residential,4500,33173,0,37673
132535200401105,CONDO 500,Residential,4500,33173,0,37673
132535200401106,CONDO 500,Residential,4500,33173,0,37673
132535200401107,CONDO 500,Residential,4500,33173,0,37673
132535200401108,CONDO 500,Residential,4500,46312,0,50812
132535200401109,CONDO 500,Residential,4500,33173,0,37673
132535200401110,CONDO 500,Residential,4500,33173,0,37673
132535200401111,CONDO 500,Residential,4500,33173,0,37673
132535200401112,CONDO 500,Residential,4500,33173,0,37673
132535200401113,CONDO 500,Residential,4500,33173,0,37673
132535200401114,CONDO 500,Residential,4500,33173,0,37673
132535200401115,CONDO 500,Residential,4500,33173,0,37673
132535200401116,CONDO 500,Residential,4500,33173,0,37673
132535200401117,CONDO 500,Residential,4500,33173,0,37673
132535200401118,CONDO 500,Residential,4500,33173,0,37673
132535200401119,CONDO 500,Residential,4500,33173,0,37673
132535200401120,CONDO 500,Residential,4500,33173,0,37673
132535200401121,CONDO 500,Residential,4500,33173,0,37673
132535200401122,CONDO 500,Residential,4500,33173,0,37673
132535200401123,CONDO 500,Residential,4500,46312,0,50812
132535200401124,CONDO 500,Residential,4500,33173,0,37673
132535200401125,CONDO 500,Residential,4500,33173,0,37673
132535200401126,CONDO 500,Residential,4500,33173,0,37673
132535200401127,CONDO 500,Residential,4500,33173,0,37673
132535200401128,CONDO 500,Residential,4500,33173,0,37673
132535200401129,CONDO 500,Residential,4500,33173,0,37673
132535200401130,CONDO 500,Residential,4500,33173,0,37673
132535200401131,CONDO 500,Residential,4500,33173,0,37673
132535200401132,CONDO 500,Residential,4500,33173,0,37673
132535200401133,CONDO 500,Residential,4500,33173,0,37673
132535200401134,CONDO 500,Residential,4500,33173,0,37673
132535200401135,CONDO 500,Residential,4500,33173,0,37673
132535200401136,CONDO 500,Residential,4500,33173,0,37673
132535200401137,CONDO 500,Residential,4500,33173,0,37673
132535200401138,CONDO 500,Residential,4500,46312,0,50812
132535200401139,CONDO 500,Residential,4500,33173,0,37673
132535200401140,CONDO 500,Residential,4500,33173,0,37673
132535200401141,CONDO 500,Residential,4500,33173,0,37673
132535200401142,CONDO 500,Residential,4500,33173,0,37673
132535200401143,CONDO 500,Residential,4500,33173,0,37673
132535200401144,CONDO 500,Residential,4500,33173,0,37673
132535200401145,CONDO 500,Residential,4500,33173,0,37673
132535200401146,CONDO 500,Residential,4500,33173,0,37673
132535200401147,CONDO 500,Residential,4500,33173,0,37673
132535200401148,CONDO 500,Residential,4500,33173,0,37673
132535200401149,CONDO 500,Residential,4500,33173,0,37673
132535200401150,CONDO 500,Residential,4500,33173,0,37673
132535200401151,CONDO 500,Residential,4500,33173,0,37673
132535200401152,CONDO 500,Residential,4500,33173,0,37673
132535200401153,CONDO 500,Residential,4500,46312,0,50812
132535200401154,CONDO 500,Residential,4500,33173,0,37673
132535200401155,CONDO 500,Residential,4500,33173,0,37673
132535200401156,CONDO 500,Residential,4500,33173,0,37673
132535200401157,CONDO 500,Residential,4500,33173,0,37673
132535200401158,CONDO 500,Residential,4500,33173,0,37673
132535200401159,CONDO 500,Residential,4500,33173,0,37673
132535200401160,CONDO 500,Residential,4500,33173,0,37673
132535200401161,CONDO 500,Residential,4500,33173,0,37673
132535200401162,CONDO 500,Residential,4500,33173,0,37673
132535200401163,CONDO 500,Residential,4500,33173,0,37673
132535200401164,CONDO 500,Residential,4500,33173,0,37673
132535200401165,CONDO 500,Residential,4500,33173,0,37673
132535200401166,CONDO 500,Residential,4500,33173,0,37673
132535200401167,CONDO 500,Residential,4500,33173,0,37673
132535200401168,CONDO 500,Residential,4500,46312,0,50812
132535200401169,CONDO 500,Residential,4500,33173,0,37673
132535200401170,CONDO 500,Residential,4500,33173,0,37673
132535200401171,CONDO 500,Residential,4500,33173,0,37673
132535200401172,CONDO 500,Residential,4500,33173,0,37673
132535200401173,CONDO 500,Residential,4500,33173,0,37673
132535200401174,CONDO 500,Residential,4500,33173,0,37673
132535200401175,CONDO 500,Residential,4500,33173,0,37673
132535200401176,CONDO 500,Residential,4500,33173,0,37673
132535200401177,CONDO 500,Residential,4500,33173,0,37673
132535200401178,CONDO 500,Residential,4500,33173,0,37673
132535200401179,CONDO 500,Residential,4500,33173,0,37673
132535200401180,CONDO 500,Residential,4500,33173,0,37673
132535200401181,CONDO 500,Residential,4500,33173,0,37673
132535200401182,CONDO 500,Residential,4500,33173,0,37673
132535200401183,CONDO 500,Residential,4500,46312,0,50812
132535200401184,CONDO 500,Residential,4500,33173,0,37673
132535200401185,CONDO 500,Residential,4500,33173,0,37673
132535200401186,CONDO 500,Residential,4500,33173,0,37673
132535200401187,CONDO 500,Residential,4500,33173,0,37673
132535200401188,CONDO 500,Residential,4500,33173,0,37673
132535200401189,CONDO 500,Residential,4500,33173,0,37673
132535200401190,CONDO 500,Residential,4500,33173,0,37673
132535200401191,CONDO 500,Residential,4500,33173,0,37673
132535200401192,CONDO 500,Residential,4500,33173,0,37673
132535200401193,CONDO 500,Residential,4500,33173,0,37673
132535200401194,CONDO 500,Residential,4500,33173,0,37673
132535200500000,COMM SW,Commercial,383400,0,725517,1108917
132537600101000,CONDO 501,Residential,12000,88335,0,100335
132537600101001,CONDO 501,Residential,12000,88335,0,100335
132537600101002,CONDO 501,Residential,12000,85749,0,97749
132537600101003,CONDO 501,Residential,12000,85749,0,97749
132537600101004,CONDO 501,Residential,11000,73880,0,84880
132537600101005,CONDO 501,Residential,11000,73880,0,84880
132537600101006,CONDO 501,Residential,12000,88335,0,100335
132537600101007,CONDO 501,Residential,12000,88335,0,100335
132537600101008,CONDO 501,Residential,12000,85749,0,97749
132537600101009,CONDO 501,Residential,12000,85749,0,97749
132537600101010,CONDO 501,Residential,11000,73880,0,84880
132537600101011,CONDO 501,Residential,11000,73880,0,84880
132537600101012,CONDO 501,Residential,12000,113187,0,125187
132537600101013,CONDO 501,Residential,12000,109755,0,121755
132537600101014,CONDO 501,Residential,12000,110976,0,122976
132537600101015,CONDO 501,Residential,12000,131940,0,143940
132537600101016,CONDO 501,Residential,12000,113187,0,125187
132537600101017,CONDO 501,Residential,12000,113792,0,125792
132537600101018,CONDO 501,Residential,12000,120499,0,132499
132537600101019,CONDO 501,Residential,12000,130487,0,142487
132537600101020,CONDO 501,Residential,12000,88335,0,100335
132537600101021,CONDO 501,Residential,12000,88335,0,100335
132537600101022,CONDO 501,Residential,12000,85749,0,97749
132537600101023,CONDO 501,Residential,12000,85749,0,97749
132537600101024,CONDO 501,Residential,11000,73880,0,84880
132537600101025,CONDO 501,Residential,11000,73880,0,84880
132537600101026,CONDO 501,Residential,12000,88335,0,100335
132537600101027,CONDO 501,Residential,12000,88335,0,100335
132537600101028,CONDO 501,Residential,12000,85749,0,97749
132537600101029,CONDO 501,Residential,12000,85749,0,97749
132537600101030,CONDO 501,Residential,11000,73880,0,84880
132537600101031,CONDO 501,Residential,11000,73880,0,84880
132537600200000,NW 344,Residential,1646,0,0,1646
132537600300000,NW 344,Residential,2182,0,0,2182
132537700100000,E-15 CITY,Exempt,0,0,0,0
132537700201000,COMM SW,Commercial,36720,0,169004,205724
132537700201001,COMM SW,Commercial,36720,0,169004,205724
132537700201002,COMM SW,Commercial,32400,0,169287,201687
132537700201003,COMM SW,Commercial,36720,0,169004,205724
132537700201004,COMM SW,Commercial,36720,0,169004,205724
132537700300000,APTS SW,Commercial,337500,0,3582570,3920070
132537700401000,CONDO 500,Residential,5000,61447,0,66447
132537700401001,CONDO 500,Residential,5000,61447,0,66447
132537700401002,CONDO 500,Residential,5000,61171,0,66171
132537700401003,CONDO 500,Residential,5000,61171,0,66171
132537700401004,CONDO 500,Residential,5000,62500,0,67500
132537700401005,CONDO 500,Residential,5000,62500,0,67500
132537700401006,CONDO 500,Residential,5000,62500,0,67500
132537700401007,CONDO 500,Residential,5000,62500,0,67500
132537700401008,CONDO 500,Residential,5000,62500,0,67500
132537700401009,CONDO 500,Residential,5000,62500,0,67500
132537700401010,CONDO 500,Residential,5000,62500,0,67500
132537700401011,CONDO 500,Residential,5000,62500,0,67500
132537700401012,CONDO 500,Residential,5000,61485,0,66485
132537700401013,CONDO 500,Residential,5000,61485,0,66485
132537700401014,CONDO 500,Residential,5000,61209,0,66209
132537700401015,CONDO 500,Residential,5000,61209,0,66209
132537700401016,CONDO 500,Residential,5000,62538,0,67538
132537700401017,CONDO 500,Residential,5000,62538,0,67538
132537700401018,CONDO 500,Residential,5000,62538,0,67538
132537700401019,CONDO 500,Residential,5000,62538,0,67538
132537700401020,CONDO 500,Residential,5000,62538,0,67538
132537700401021,CONDO 500,Residential,5000,62538,0,67538
132537700401022,CONDO 500,Residential,5000,62538,0,67538
132537700401023,CONDO 500,Residential,5000,62538,0,67538
132537700401024,CONDO 500,Residential,5000,62089,0,67089
132537700401025,CONDO 500,Residential,5000,62089,0,67089
132537700401026,CONDO 500,Residential,5000,61810,0,66810
132537700401027,CONDO 500,Residential,5000,61810,0,66810
132537700401028,CONDO 500,Residential,5000,63152,0,68152
132537700401029,CONDO 500,Residential,5000,63152,0,68152
132537700401030,CONDO 500,Residential,5000,63152,0,68152
132537700401031,CONDO 500,Residential,5000,63152,0,68152
132537700401032,CONDO 500,Residential,5000,63152,0,68152
132537700401033,CONDO 500,Residential,5000,63152,0,68152
132537700401034,CONDO 500,Residential,5000,63152,0,68152
132537700401035,CONDO 500,Residential,5000,63152,0,68152
132537700401036,CONDO 500,Residential,5000,62089,0,67089
132537700401037,CONDO 500,Residential,5000,62089,0,67089
132537700401038,CONDO 500,Residential,5000,61810,0,66810
132537700401039,CONDO 500,Residential,5000,61810,0,66810
132537700401040,CONDO 500,Residential,5000,63152,0,68152
132537700401041,CONDO 500,Residential,5000,63152,0,68152
132537700401042,CONDO 500,Residential,5000,63152,0,68152
132537700401043,CONDO 500,Residential,5000,63152,0,68152
132537700401044,CONDO 500,Residential,5000,63152,0,68152
132537700401045,CONDO 500,Residential,5000,63152,0,68152
132537700401046,CONDO 500,Residential,5000,63152,0,68152
132537700401047,CONDO 500,Residential,5000,63152,0,68152
132537700401048,CONDO 500,Residential,5000,62089,0,67089
132537700401049,CONDO 500,Residential,5000,62089,0,67089
132537700401050,CONDO 500,Residential,5000,61810,0,66810
132537700401051,CONDO 500,Residential,5000,61810,0,66810
132537700401052,CONDO 500,Residential,5000,63152,0,68152
132537700401053,CONDO 500,Residential,5000,63152,0,68152
132537700401054,CONDO 500,Residential,5000,63152,0,68152
132537700401055,CONDO 500,Residential,5000,63152,0,68152
132537700401056,CONDO 500,Residential,5000,63152,0,68152
132537700401057,CONDO 500,Residential,5000,63152,0,68152
132537700401058,CONDO 500,Residential,5000,63152,0,68152
132537700401059,CONDO 500,Residential,5000,63152,0,68152
132537700401060,CONDO 500,Residential,5000,62089,0,67089
132537700401061,CONDO 500,Residential,5000,62089,0,67089
132537700401062,CONDO 500,Residential,5000,61810,0,66810
132537700401063,CONDO 500,Residential,5000,61810,0,66810
132537700401064,CONDO 500,Residential,5000,63152,0,68152
132537700401065,CONDO 500,Residential,5000,63152,0,68152
132537700401066,CONDO 500,Residential,5000,63152,0,68152
132537700401067,CONDO 500,Residential,5000,63152,0,68152
132537700401068,CONDO 500,Residential,5000,63152,0,68152
132537700401069,CONDO 500,Residential,5000,63152,0,68152
132537700401070,CONDO 500,Residential,5000,63152,0,68152
132537700401071,CONDO 500,Residential,5000,63152,0,68152
132537700401072,CONDO 500,Residential,5000,62128,0,67128
132537700401073,CONDO 500,Residential,5000,62128,0,67128
132537700401074,CONDO 500,Residential,5000,61849,0,66849
132537700401075,CONDO 500,Residential,5000,61849,0,66849
132537700401076,CONDO 500,Residential,5000,63191,0,68191
132537700401077,CONDO 500,Residential,5000,63191,0,68191
132537700401078,CONDO 500,Residential,5000,63191,0,68191
132537700401079,CONDO 500,Residential,5000,63191,0,68191
132537700401080,CONDO 500,Residential,5000,63191,0,68191
132537700401081,CONDO 500,Residential,5000,63191,0,68191
132537700401082,CONDO 500,Residential,5000,63191,0,68191
132537700401083,CONDO 500,Residential,5000,63191,0,68191
132537800100000,COMM SW,Commercial,692650,0,1157350,1850000
132537800200000,COMM SW,Commercial,58607,0,0,58607
132537800300000,COMM SW,Commercial,54470,0,0,54470
132537800400000,COMM SW,Commercial,275832,0,1255234,1531066
132540100100000,NW 335,Residential,23651,114692,0,138343
132540100200000,NW 335,Residential,23560,143922,0,167482
132540100300000,NW 335,Residential,24304,134006,0,158310
132540100400000,NW 335,Residential,25792,127517,0,153309
132540100500000,NW 335,Residential,26288,110221,0,136509
132540100600000,NW 335,Residential,26288,146901,0,173189
132540100700000,NW 335,Residential,26288,97662,0,123950
132540100800000,NW 335,Residential,26288,132120,0,158408
132540100900000,NW 335,Residential,26288,117132,0,143420
132540101000000,NW 335,Residential,26843,123378,0,150221
132540200100000,NW 335,Residential,36634,164480,0,201114
132540200200000,NW 335,Residential,36040,137789,0,173829
132540200300000,NW 335,Residential,28196,111228,0,139424
132540200400000,NW 335,Residential,27348,149188,0,176536
132540200500000,NW 335,Residential,29402,167436,0,196838
132540200600000,NW 335,Residential,31574,105902,0,137476
132540200700000,NW 335,Residential,29680,97669,0,127349
132540300100000,NW 335,Residential,19530,99356,0,118886
132540300200000,NW 335,Residential,29154,95024,0,124178
132540300300000,NW 335,Residential,27864,132721,0,160585
132540300400000,NW 335,Residential,27348,115105,0,142453
132540300500000,NW 335,Residential,27348,111189,0,138537
132540300600000,NW 335,Residential,27348,108949,0,136297
132540300700000,NW 335,Residential,27348,110005,0,137353
132540300800000,NW 335,Residential,27348,85942,0,113290
132540300900000,NW 335,Residential,27348,163891,0,191239
132540301000000,NW 335,Residential,27348,171,0,27519
132540301100000,NW 335,Residential,28620,116309,0,144929
132540301200000,NW 335,Residential,28408,98716,0,127124
132540301300000,NW 335,Residential,28408,112185,0,140593
132540301400000,NW 335,Residential,36930,128414,0,165344
132540301500000,NW 335,Residential,29119,93712,0,122831
132540301600000,NW 335,Residential,25660,92482,0,118142
132540301700000,NW 335,Residential,23808,115719,0,139527
132540301800000,NW 335,Residential,23572,100410,0,123982
132540301900000,NW 335,Residential,23312,98387,0,121699
132540302000000,NW 335,Residential,23312,114709,0,138021
132540302100000,NW 335,Residential,23312,114603,0,137915
132540302200000,NW 335,Residential,23312,93538,0,116850
132540302300000,NW 335,Residential,23312,127720,0,151032
132540302400000,NW 335,Residential,23312,127253,0,150565
132540302500000,NW 335,Residential,23312,112389,0,135701
132540302600000,NW 335,Residential,24064,99999,0,124063
132540302700000,NW 335,Residential,33163,154771,0,187934
132540302800000,NW 335,Residential,23312,109621,0,132933
132540302900000,NW 335,Residential,23312,94771,0,118083
132540303000000,NW 335,Residential,23312,93628,0,116940
132540303100000,NW 335,Residential,24440,122235,0,146675
132540303200000,E-41 RELIG SCHOOLS,Exempt,499554,0,893821,1393375
132540303300000,E-40 CHURCHES,Exempt,979560,0,1805155,2784715
132540303400000,NW 335,Residential,19530,114516,0,134046
132540303500000,NW 335,Residential,19530,114703,0,134233
132542600100000,NW 335,Residential,29680,128425,0,158105
132542600200000,NW 335,Residential,31701,100536,0,132237
132542600300000,NW 335,Residential,31800,109019,0,140819
132542600400000,NW 335,Residential,34238,111205,0,145443
132542600500000,NW 335,Residential,34238,114323,0,148561
132542600600000,NW 335,Residential,27560,129559,0,157119
132542600700000,NW 335,Residential,31048,125484,0,156532
132542600800000,NW 335,Residential,34272,147907,0,182179
132542600900000,NW 335,Residential,31616,105618,0,137234
132542601000000,NW 335,Residential,32936,100089,0,133025
132542601100000,NW 335,Residential,28224,122567,0,150791
132542601200000,NW 335,Residential,25872,122010,0,147882
132542601300000,NW 335,Residential,29792,116505,0,146297
132542601400000,NW 335,Residential,25408,112439,0,137847
132542601500000,NW 335,Residential,25166,106078,0,131244
132542601600000,NW 335,Residential,25733,107593,0,133326
132542601700000,NW 335,Residential,29832,96426,0,126258
132542601800000,NW 335,Residential,25285,139606,0,164891
132542601900000,NW 335,Residential,29610,117250,0,146860
132542602000000,NW 335,Residential,27936,123801,0,151737
132542602100000,NW 335,Residential,29488,112230,0,141718
132542602200000,NW 335,Residential,25560,131860,0,157420
132542602300000,NW 335,Residential,28350,106977,0,135327
132542602400000,NW 335,Residential,32851,137248,0,170099
132542602500000,NW 335,Residential,33987,118021,0,152008
132542602600000,NW 335,Residential,31916,108454,0,140370
132542602700000,NW 335,Residential,27120,142469,0,169589
132542602800000,NW 335,Residential,26400,118346,0,144746
132542602900000,NW 335,Residential,27200,134328,0,161528
132542603000000,NW 335,Residential,26251,133037,0,159288
132542603100000,NW 335,Residential,32486,135347,0,167833
132542603200000,NW 335,Residential,33136,113403,0,146539
132542603300000,NW 335,Residential,31449,152690,0,184139
132542603400000,NW 335,Residential,29557,122682,0,152239
132542603500000,NW 335,Residential,32000,160549,0,192549
132542603600000,NW 335,Residential,32000,135184,0,167184
132542603700000,NW 335,Residential,31600,145029,0,176629
132542603800000,NW 335,Residential,32395,119598,0,151993
132542603900000,Empty,Exempt,0,0,0,0
132542700100000,NW 335,Residential,29530,134153,0,163683
132542700200000,NW 335,Residential,25287,97876,0,123163
132542700300000,NW 335,Residential,25220,139272,0,164492
132542700400000,NW 335,Residential,31040,104444,0,135484
132542700500000,NW 335,Residential,31040,107761,0,138801
132542700600000,NW 335,Residential,32068,98027,0,130095
132542700700000,NW 335,Residential,30997,127063,0,158060
132542700800000,NW 335,Residential,28512,107056,0,135568
132542700900000,NW 335,Residential,31104,137017,0,168121
132542701000000,NW 335,Residential,30672,114300,0,144972
132542701100000,NW 335,Residential,34136,117275,0,151411
132542701200000,NW 335,Residential,28198,122969,0,151167
132542701300000,NW 335,Residential,33440,97514,0,130954
132542701400000,NW 335,Residential,31104,137791,0,168895
132542701500000,NW 335,Residential,32224,104179,0,136403
132542701600000,NW 335,Residential,33696,127870,0,161566
132542701700000,NW 335,Residential,30031,132746,0,162777
132542701800000,NW 335,Residential,30933,116259,0,147192
132542701900000,NW 335,Residential,32013,122941,0,154954
132542702000000,NW 335,Residential,33510,116838,0,150348
132542702100000,NW 335,Residential,28638,128171,0,156809
132542702200000,NW 335,Residential,29154,115467,0,144621
132542702300000,NW 335,Residential,24252,125009,0,149261
132542702400000,NW 335,Residential,26320,132106,0,158426
132542702500000,NW 335,Residential,36816,109139,0,145955
132542702600000,NW 335,Residential,30702,134849,0,165551
132542702700000,NW 335,Residential,37268,210332,0,247600
132542702800000,NW 335,Residential,37576,174190,0,211766
132542702900000,NW 335,Residential,31734,141577,0,173311
132542703000000,NW 335,Residential,28952,117309,0,146261
132542703100000,NW 335,Residential,24252,129254,0,153506
132542703200000,NW 335,Residential,35230,130063,0,165293
132542703300000,NW 335,Residential,24252,105436,0,129688
132542703400000,NW 335,Residential,4940,0,0,4940
132542703500000,NW 335,Residential,1113,0,0,1113
132542703600000,NW 335,Residential,1590,0,0,1590
132542703700000,NW 335,Residential,7482,0,0,7482
132542703800000,NW 335,Residential,8932,0,0,8932
132542703900000,NW 335,Residential,6160,0,0,6160
132542704000000,NW 335,Residential,5160,0,0,5160
132542800100000,NW 335,Residential,33696,132635,0,166331
132542800200000,NW 335,Residential,29466,125061,0,154527
132542800300000,NW 335,Residential,28560,126471,0,155031
132542800400000,NW 335,Residential,30000,151091,0,181091
132542800500000,NW 335,Residential,34320,131914,0,166234
132542800600000,NW 335,Residential,32619,157368,0,189987
132542800700000,NW 335,Residential,32000,145063,0,177063
132542800800000,NW 335,Residential,32000,135748,0,167748
132542800900000,NW 335,Residential,31200,130620,0,161820
132542801000000,NW 335,Residential,32205,127878,0,160083
132542801100000,NW 335,Residential,23715,146042,0,169757
132542801200000,NW 335,Residential,26299,142750,0,169049
132542801300000,NW 335,Residential,28248,282252,0,310500
132542801400000,NW 335,Residential,24840,157231,0,182071
132542801500000,NW 335,Residential,26002,209731,0,235733
132542801600000,NW 335,Residential,22554,125126,0,147680
132542801700000,NW 335,Residential,25024,173133,0,198157
132542801800000,NW 335,Residential,21888,122549,0,144437
132545100100000,NW 335,Residential,24880,220226,0,245106
132545100200000,NW 335,Residential,24880,172394,0,197274
132545100300000,NW 335,Residential,26880,118991,0,145871
132545100400000,NW 335,Residential,26880,130234,0,157114
132545100500000,NW 335,Residential,26880,113938,0,140818
132545100600000,NW 335,Residential,26481,96573,0,123054
132545100700000,NW 335,Residential,26481,101429,0,127910
132545200100000,COMM SW,Commercial,340740,0,3351705,3692445
132545200200000,NW 335,Residential,23212,128699,0,151911
132545200300000,NW 335,Residential,21825,138836,0,160661
132545200400000,NW 335,Residential,21825,84870,0,106695
132545200500000,NW 335,Residential,21825,142015,0,163840
132545200600000,NW 335,Residential,21825,134414,0,156239
132545200700000,NW 335,Residential,22206,147610,0,169816
132545200800000,NW 335,Residential,22127,120491,0,142618
132545200900000,NW 335,Residential,22050,130771,0,152821
132545201000000,NW 335,Residential,22050,103392,0,125442
132545201100000,NW 335,Residential,21644,122254,0,143898
132545201200000,NW 335,Residential,24749,148012,0,172761
132545201300000,NW 335,Residential,23988,156040,0,180028
132545201400000,NW 335,Residential,25102,168235,0,193337
132545201500000,NW 335,Residential,21630,114654,0,136284
132545201600000,NW 335,Residential,22050,144974,0,167024
132545201700000,NW 335,Residential,22050,130557,0,152607
132545201800000,NW 335,Residential,22205,143088,0,165293
132545201900000,COMM SW,Commercial,236250,0,0,236250
132545300100000,NW 335,Residential,25039,111498,0,136537
132545300200000,NW 335,Residential,27440,123001,0,150441
132545300300000,NW 335,Residential,26754,109153,0,135907
132545300400000,NW 335,Residential,27309,114900,0,142209
132545300500000,APTS SW,Commercial,38664,0,458120,496784
132545300600000,APTS SW,Commercial,38556,0,457405,495961
132545400200000,APTS SW,Commercial,50058,0,563993,614051
132545400301000,CONDO 500,Residential,4000,41393,0,45393
132545400301001,CONDO 500,Residential,4000,41393,0,45393
132545400301002,CONDO 500,Residential,4000,42583,0,46583
132545400301003,CONDO 500,Residential,4000,42583,0,46583
132545400301004,CONDO 500,Residential,4000,42583,0,46583
132545400301005,CONDO 500,Residential,4000,42583,0,46583
132545400301006,CONDO 500,Residential,4000,41393,0,45393
132545400301007,CONDO 500,Residential,4000,41393,0,45393
132545400301008,CONDO 500,Residential,4000,43148,0,47148
132545400301009,CONDO 500,Residential,4000,42583,0,46583
132545400301010,CONDO 500,Residential,4000,42583,0,46583
132545400301011,CONDO 500,Residential,4000,42583,0,46583
132545400301012,CONDO 500,Residential,4000,42583,0,46583
132545400301013,CONDO 500,Residential,4000,42583,0,46583
132545400301014,CONDO 500,Residential,4000,42583,0,46583
132545400301015,CONDO 500,Residential,4000,43148,0,47148
132545400301016,CONDO 500,Residential,4000,41393,0,45393
132545400301017,CONDO 500,Residential,4000,41393,0,45393
132545400301018,CONDO 500,Residential,4000,42583,0,46583
132545400301019,CONDO 500,Residential,4000,42583,0,46583
132545400301020,CONDO 500,Residential,4000,42583,0,46583
132545400301021,CONDO 500,Residential,4000,42583,0,46583
132545400301022,CONDO 500,Residential,4000,41393,0,45393
132545400301023,CONDO 500,Residential,4000,41393,0,45393
132545400301024,CONDO 500,Residential,4000,43148,0,47148
132545400301025,CONDO 500,Residential,4000,42583,0,46583
132545400301026,CONDO 500,Residential,4000,42583,0,46583
132545400301027,CONDO 500,Residential,4000,42583,0,46583
132545400301028,CONDO 500,Residential,4000,42583,0,46583
132545400301029,CONDO 500,Residential,4000,42583,0,46583
132545400301030,CONDO 500,Residential,4000,42583,0,46583
132545400301031,CONDO 500,Residential,4000,43148,0,47148
132545500100000,COMM SW,Commercial,413370,0,2917792,3331162
132545500200000,COMM SW,Commercial,261900,0,328849,590749
132545500300000,COMM SW,Commercial,13478,0,0,13478
132545500400000,COMM SW,Commercial,19602,0,0,19602
132545500500000,COMM SW,Commercial,33372,0,39466,72838
132547600100000,NW 335,Residential,21888,115744,0,137632
132547600200000,NW 335,Residential,20160,113961,0,134121
132547600300000,NW 335,Residential,19950,82457,0,102407
132547600400000,NW 335,Residential,18189,107474,0,125663
132547600500000,NW 335,Residential,18189,100105,0,118294
132547600600000,NW 335,Residential,20138,121085,0,141223
132547600700000,NW 335,Residential,21432,128181,0,149613
132547600800000,NW 335,Residential,21705,152850,0,174555
132547600900000,NW 335,Residential,23373,104085,0,127458
132547601000000,NW 335,Residential,23373,93887,0,117260
132547601100000,NW 335,Residential,23373,99919,0,123292
132547601200000,NW 335,Residential,23373,110418,0,133791
132547601300000,NW 335,Residential,23373,125905,0,149278
132547601400000,APTS SW,Commercial,22861,0,125103,147964
132547601500000,APTS SW,Commercial,19596,0,200378,219974
132547601600000,APTS SW,Commercial,20412,0,200754,221166
132547601700000,APTS SW,Commercial,26127,0,255474,281601
132547601800000,COMM SW,Commercial,52542,0,975790,1028332
132547601900000,NW 335,Residential,18360,97174,0,115534
132547602000000,NW 335,Residential,21420,108656,0,130076
132547602100000,NW 335,Residential,21384,118225,0,139609
132547602200000,NW 335,Residential,20460,106289,0,126749
132547602300000,NW 335,Residential,21930,125531,0,147461
132547602400000,NW 335,Residential,20976,82389,0,103365
132547602500000,NW 335,Residential,21627,105666,0,127293
132547602600000,NW 335,Residential,19110,76546,0,95656
132547602700000,NW 335,Residential,20516,115082,0,135598
132547602800000,NW 335,Residential,20370,92737,0,113107
132547602900000,NW 335,Residential,20952,92751,0,113703
132547700100000,NW 335,Exempt,28428,0,156092,184520
132547700200000,NW 335,Residential,24776,140226,0,165002
132547700300000,NW 335,Residential,23280,158826,0,182106
132547700400000,NW 335,Residential,24735,145895,0,170630
132547700500000,NW 335,Residential,23280,163189,0,186469
132547700600000,NW 335,Residential,22116,112800,0,134916
132547700700000,NW 335,Residential,22116,109692,0,131808
132547700800000,NW 335,Residential,24784,113303,0,138087
132547700900000,NW 335,Residential,27160,118415,0,145575
132547701000000,NW 335,Residential,27500,149410,0,176910
132547701100000,NW 335,Residential,27160,108804,0,135964
132547701200000,NW 335,Residential,26481,103190,0,129671
132547701300000,NW 335,Residential,22068,91365,0,113433
132547701400000,NW 335,Residential,28968,115146,0,144114
132547701500000,NW 335,Residential,30450,97077,0,127527
132547800100000,NW 335,Residential,26811,101852,0,128663
132547800200000,NW 335,Exempt,26754,0,140324,167078
132547800300000,NW 335,Residential,25725,96546,0,122271
132547800400000,NW 335,Residential,27783,134641,0,162424
132547800500000,NW 335,Residential,26754,102709,0,129463
132547800600000,NW 335,Residential,26754,98132,0,124886
132547800700000,NW 335,Residential,26754,107171,0,133925
132547800800000,NW 335,Residential,25725,93841,0,119566
132547800900000,APTS SW,Commercial,38556,0,520447,559003
132547801000000,APTS SW,Commercial,38772,0,336228,375000
132547801100000,APTS SW,Commercial,38718,0,336282,375000
132547900101000,COMM SW,Commercial,126360,0,123882,250242
132547900101001,COMM SW,Commercial,126360,0,137438,263798
132547900200000,COMM SW,Commercial,757944,0,2006460,2764404
132547900300000,COMM SW,Commercial,137402,0,201444,338846
132548000100000,APTS SW,Commercial,26946,0,313668,340614
132548000200000,APTS SW,Commercial,75060,0,704940,780000
132548000300000,APTS SW,Commercial,64800,0,535200,600000
132548000400000,COMM SW,Commercial,416448,0,1669311,2085759
132548000500000,APTS SW,Commercial,26838,0,273162,300000
132548000600000,E-15 CITY,Exempt,0,0,0,0
132610100100000,NW 329,Residential,37600,93531,0,131131
132610100200000,NW 329,Residential,31020,90075,0,121095
132610100300000,NW 329,Residential,29610,94829,0,124439
132610100400000,NW 329,Residential,29610,100768,0,130378
132610100500000,NW 329,Residential,29610,102593,0,132203
132610100600000,NW 329,Residential,29610,97643,0,127253
132610100700000,NW 329,Residential,29610,86302,0,115912
132610100800000,NW 329,Residential,29610,82736,0,112346
132610100900000,NW 329,Residential,29610,83190,0,112800
132610101000000,NW 329,Residential,29610,82502,0,112112
132610101100000,NW 329,Residential,29610,100335,0,129945
132610101200000,NW 329,Residential,29610,91555,0,121165
132610101300000,NW 329,Residential,29610,77853,0,107463
132610101400000,NW 329,Residential,29610,96847,0,126457
132610101500000,NW 329,Residential,29610,89927,0,119537
132610101600000,NW 329,Residential,29610,93277,0,122887
132610101700000,NW 329,Residential,33558,93590,0,127148
132610200100000,NW 329,Residential,36000,89269,0,125269
132610200200000,NW 329,Residential,36000,92285,0,128285
132610200300000,NW 329,Residential,30789,80056,0,110845
132610200400000,NW 329,Residential,30240,83996,0,114236
132610200500000,NW 329,Residential,30240,83903,0,114143
132610200600000,NW 329,Residential,30240,101982,0,132222
132610200700000,NW 329,Residential,30240,87847,0,118087
132610200800000,NW 329,Residential,30240,103374,0,133614
132610200900000,NW 329,Residential,30240,83652,0,113892
132610201000000,NW 329,Residential,30240,103227,0,133467
132610201100000,NW 329,Residential,30240,96379,0,126619
132610201200000,NW 329,Residential,30240,99415,0,129655
132610201300000,NW 329,Residential,30240,88416,0,118656
132610201400000,NW 329,Residential,30240,94044,0,124284
132610201500000,NW 329,Residential,29149,85874,0,115023
132610201600000,NW 329,Residential,31040,81510,0,112550
132610201700000,NW 329,Residential,33456,98959,0,132415
132610201800000,NW 329,Residential,31520,95373,0,126893
132610201900000,NW 329,Residential,32430,82330,0,114760
132610202000000,NW 329,Residential,29610,95206,0,124816
132610202100000,NW 329,Residential,30240,83570,0,113810
132610202200000,NW 329,Residential,30240,95118,0,125358
132610202300000,NW 329,Residential,30240,73832,0,104072
132610202400000,NW 329,Residential,30240,95456,0,125696
132610202500000,NW 329,Residential,30240,79445,0,109685
132610202600000,NW 329,Residential,30240,104342,0,134582
132610202700000,NW 329,Residential,30240,85292,0,115532
132610202800000,NW 329,Residential,30240,106299,0,136539
132610202900000,NW 329,Residential,30240,84760,0,115000
132610203000000,NW 329,Residential,30240,84817,0,115057
132610203100000,NW 329,Residential,30240,92258,0,122498
132610203200000,NW 329,Residential,30240,103857,0,134097
132610203300000,NW 329,Residential,30240,91879,0,122119
132610203400000,NW 329,Residential,31059,102164,0,133223
132610300100000,NW 329,Residential,30879,67607,0,98486
132610300200000,NW 329,Residential,30080,84242,0,114322
132610300300000,NW 329,Residential,30879,83525,0,114404
132610300400000,NW 329,Residential,30789,91745,0,122534
132610300500000,NW 329,Residential,30240,86015,0,116255
132610300600000,NW 329,Residential,30240,85292,0,115532
132610300700000,NW 329,Residential,30240,95656,0,125896
132610300800000,NW 329,Residential,30240,88690,0,118930
132610300900000,NW 329,Residential,30240,97379,0,127619
132610301000000,NW 329,Residential,30240,92301,0,122541
132610301100000,NW 329,Residential,30240,88372,0,118612
132610301200000,NW 329,Residential,30240,91551,0,121791
132610301300000,NW 329,Residential,30240,86376,0,116616
132610301400000,NW 329,Residential,30240,94842,0,125082
132610301500000,NW 329,Residential,30240,101234,0,131474
132610301600000,NW 329,Residential,30240,94465,0,124705
132610301700000,NW 329,Residential,33638,94351,0,127989
132610301800000,NW 329,Residential,37128,80104,0,117232
132610301900000,NW 329,Residential,32142,97647,0,129789
132610302000000,NW 329,Residential,30240,86568,0,116808
132610302100000,NW 329,Residential,30240,83673,0,113913
132610302200000,NW 329,Residential,30240,97676,0,127916
132610302300000,NW 329,Residential,30240,89914,0,120154
132610302400000,NW 329,Residential,30240,100360,0,130600
132610302500000,NW 329,Residential,30240,82666,0,112906
132610302600000,NW 329,Residential,30240,87455,0,117695
132610302700000,NW 329,Residential,30240,88974,0,119214
132610302800000,NW 329,Residential,30240,88961,0,119201
132610302900000,NW 329,Residential,30240,90587,0,120827
132610303000000,NW 329,Residential,30240,82993,0,113233
132610303100000,NW 329,Residential,31054,56251,0,87305
132610400100000,NW 329,Residential,33752,104337,0,138089
132610400200000,NW 329,Residential,30080,81012,0,111092
132610400300000,NW 329,Residential,30080,81345,0,111425
132610400400000,NW 329,Residential,30080,93468,0,123548
132610400500000,NW 329,Residential,30080,73032,0,103112
132610400600000,NW 329,Residential,29610,93127,0,122737
132610400700000,NW 329,Residential,29627,71673,0,101300
132610400800000,NW 329,Residential,35250,160860,0,196110
132610400900000,E-15 CITY,Exempt,0,0,0,0
132610401000000,Empty,Exempt,0,0,0,0
132610401100000,NW 329,Residential,33345,88854,0,122199
132610401200000,NW 329,Residential,32800,69500,0,102300
132610401300000,NW 329,Residential,33072,99768,0,132840
132610401400000,NW 329,Residential,32800,90956,0,123756
132610401500000,NW 329,Residential,31983,89983,0,121966
132610401600000,NW 329,Residential,35008,83536,0,118544
132610401700000,NW 329,Residential,29610,84790,0,114400
132610401800000,NW 329,Residential,29610,89922,0,119532
132610401900000,NW 329,Residential,29610,81965,0,111575
132610402000000,NW 329,Residential,29610,85836,0,115446
132610402100000,NW 329,Residential,29610,84250,0,113860
132610402200000,NW 329,Residential,29610,79695,0,109305
132610402300000,NW 329,Residential,29610,98428,0,128038
132610402400000,NW 329,Residential,29610,72850,0,102460
132610402500000,NW 329,Residential,29610,90318,0,119928
132610402600000,NW 329,Residential,29610,80771,0,110381
132610402700000,NW 329,Residential,29610,94446,0,124056
132610402800000,NW 329,Residential,29610,87059,0,116669
132610402900000,NW 329,Residential,28607,92248,0,120855
132610500100000,NW 329,Residential,33840,96085,0,129925
132610600100000,NW 329,Residential,31960,84198,0,116158
132610600200000,NW 329,Residential,27930,81969,0,109899
132610600300000,NW 329,Residential,32500,103384,0,135884
132610700100000,NW 329,Residential,33840,94737,0,128577
132610700200000,NW 329,Residential,30400,88356,0,118756
132610700300000,NW 329,Residential,35456,87274,0,122730
132610700400000,NW 329,Residential,31232,85539,0,116771
132610700500000,NW 329,Residential,29700,84944,0,114644
132610700600000,NW 329,Residential,31936,82794,0,114730
132610800100000,E-40 CHURCHES,Exempt,86400,0,833791,920191
132610900100000,NW 329,Residential,31040,74413,0,105453
132610900200000,NW 329,Residential,31200,87072,0,118272
132610900300000,NW 329,Residential,32099,95300,0,127399
132610900400000,NW 329,Residential,32000,97132,0,129132
132612600100000,NW 329,Residential,32386,122325,0,154711
132612600200000,NW 329,Residential,30720,128210,0,158930
132612600300000,NW 329,Residential,30720,83686,0,114406
132612600400000,NW 329,Residential,30720,125845,0,156565
132612600500000,NW 329,Residential,37120,86984,0,124104
132612600600000,NW 329,Residential,30720,135358,0,166078
132612600700000,NW 329,Residential,6400,0,0,6400
132612600800000,NW 329,Residential,12800,0,0,12800
132612600900000,NW 329,Residential,37120,92105,0,129225
132612601000000,NW 329,Residential,6400,0,0,6400
132612601100000,NW 329,Residential,6400,0,0,6400
132612601200000,NW 329,Residential,6400,0,0,6400
132612601300000,NW 329,Residential,6400,0,0,6400
132612601400000,NW 329,Residential,7500,0,0,7500
132612601500000,NW 329,Residential,32400,89637,0,122037
132612601600000,NW 329,Residential,30720,87002,0,117722
132612601700000,NW 329,Residential,30720,98006,0,128726
132612601800000,NW 329,Residential,30720,84042,0,114762
132612601900000,NW 329,Residential,30720,89606,0,120326
132612602000000,NW 329,Residential,30720,94754,0,125474
132612602100000,NW 329,Residential,30720,98265,0,128985
132612602200000,NW 329,Residential,30720,87579,0,118299
132612602300000,NW 329,Residential,30720,81193,0,111913
132612602400000,NW 329,Residential,30720,82251,0,112971
132612602500000,NW 329,Residential,30720,83791,0,114511
132612602600000,NW 329,Residential,30720,87986,0,118706
132612602700000,NW 329,Residential,32328,100870,0,133198
132612700100000,NW 329,Residential,29981,101363,0,131344
132612700200000,NW 329,Residential,34800,94486,0,129286
132612700300000,NW 329,Residential,6000,0,0,6000
132612700400000,NW 329,Residential,6050,13303,0,19353
132612700500000,NW 329,Residential,28848,118978,0,147826
132612700600000,NW 329,Residential,28800,93495,0,122295
132612700800000,NW 329,Residential,29981,85619,0,115600
132612800100000,NW 329,Residential,32467,85815,0,118282
132612800200000,NW 329,Residential,29100,80806,0,109906
132612800300000,NW 329,Residential,32252,82308,0,114560
132612800400000,NW 329,Residential,30870,73058,0,103928
132612800500000,NW 329,Residential,30080,88624,0,118704
132612800600000,NW 329,Residential,30332,74708,0,105040
132612800700000,NW 329,Residential,30070,96445,0,126515
132612800800000,NW 329,Residential,30393,87840,0,118233
132612800900000,NW 329,Residential,30237,94691,0,124928
132612801000000,NW 329,Residential,30080,82507,0,112587
132612801100000,NW 329,Residential,30400,91875,0,122275
132612801200000,NW 329,Residential,31664,107838,0,139502
132612801300000,NW 329,Residential,31687,92731,0,124418
132612801400000,NW 329,Residential,32013,74499,0,106512
132612801500000,NW 329,Residential,32993,114727,0,147720
132612801600000,NW 329,Residential,31960,99292,0,131252
132612801700000,NW 329,Residential,28200,72802,0,101002
132612801800000,NW 329,Residential,31363,106695,0,138058
132612801900000,NW 329,Residential,30720,72674,0,103394
132612802000000,NW 329,Residential,30720,92810,0,123530
132612802100000,NW 329,Residential,31033,92398,0,123431
132612802200000,NW 329,Residential,31033,90438,0,121471
132612802300000,NW 329,Residential,31360,82556,0,113916
132612802400000,NW 329,Residential,30707,79490,0,110197
132612802500000,NW 329,Residential,30339,85265,0,115604
132612802600000,NW 329,Residential,31020,87953,0,118973
132612900100000,NW 329,Residential,32252,87809,0,120061
132612900200000,NW 329,Residential,29100,78818,0,107918
132612900300000,NW 329,Residential,32483,98373,0,130856
132612900400000,NW 329,Residential,31020,80647,0,111667
132612900500000,NW 329,Residential,30080,86428,0,116508
132612900600000,NW 329,Residential,29930,103288,0,133218
132612900700000,NW 329,Residential,30237,79686,0,109923
132612900800000,NW 329,Residential,30276,82710,0,112986
132612900900000,NW 329,Residential,30260,86174,0,116434
132612901000000,NW 329,Residential,29798,80956,0,110754
132612901100000,NW 329,Residential,30400,100544,0,130944
132612901200000,NW 329,Residential,30408,89427,0,119835
132612901300000,NW 329,Residential,31040,90107,0,121147
132612901400000,NW 329,Residential,31525,86856,0,118381
132612901500000,NW 329,Residential,32495,72505,0,105000
132612901600000,NW 329,Residential,32014,83019,0,115033
132612901700000,NW 329,Residential,28200,84586,0,112786
132612901800000,NW 329,Residential,31960,100936,0,132896
132612901900000,NW 329,Residential,31843,92995,0,124838
132612902000000,NW 329,Residential,32495,84718,0,117213
132612902100000,NW 329,Residential,31687,80763,0,112450
132612902200000,NW 329,Residential,31033,84762,0,115795
132612902300000,NW 329,Residential,31040,88853,0,119893
132612902400000,NW 329,Residential,30720,88712,0,119432
132612902500000,NW 329,Residential,30875,88531,0,119406
132612902600000,NW 329,Residential,30550,94212,0,124762
132612902700000,NW 329,Residential,30550,86824,0,117374
132612902800000,NW 329,Residential,30730,81972,0,112702
132612902900000,NW 329,Residential,30080,82219,0,112299
132612903000000,NW 329,Residential,31020,75079,0,106099
132613000100000,NW 329,Residential,32252,103244,0,135496
132613000200000,NW 329,Residential,29100,74951,0,104051
132613000300000,NW 329,Residential,32483,82381,0,114864
132613000400000,NW 329,Residential,31020,79229,0,110249
132613000500000,NW 329,Residential,30080,74536,0,104616
132613000600000,NW 329,Residential,30080,90456,0,120536
132613000700000,NW 329,Residential,30080,89970,0,120050
132613000800000,NW 329,Residential,30080,84624,0,114704
132613000900000,NW 329,Residential,31200,81156,0,112356
132613001000000,NW 329,Residential,31200,84508,0,115708
132613001100000,NW 329,Residential,31850,83274,0,115124
132613001200000,NW 329,Residential,31213,77106,0,108319
132613001300000,NW 329,Residential,31360,74253,0,105613
132613001400000,NW 329,Residential,31126,89065,0,120191
132613001500000,NW 329,Residential,32621,75329,0,107950
132613001600000,NW 329,Residential,32439,78581,0,111020
132613001700000,NW 329,Residential,28200,76602,0,104802
132613001800000,NW 329,Residential,31906,90345,0,122251
132613001900000,NW 329,Residential,31115,85272,0,116387
132613002000000,NW 329,Residential,31515,91946,0,123461
132613002100000,NW 329,Residential,32340,82660,0,115000
132613002200000,NW 329,Residential,31360,95399,0,126759
132613002300000,NW 329,Residential,31040,85593,0,116633
132613002400000,NW 329,Residential,31525,88393,0,119918
132613002500000,NW 329,Residential,31360,93579,0,124939
132613002600000,NW 329,Residential,31020,77987,0,109007
132613002700000,NW 329,Residential,30237,76805,0,107042
132613002800000,NW 329,Residential,30237,88136,0,118373
132613002900000,NW 329,Residential,30080,81475,0,111555
132613003000000,NW 329,Residential,31020,78302,0,109322
132613100100000,NW 329,Residential,32252,75282,0,107534
132613100200000,NW 329,Residential,29100,86449,0,115549
132613100300000,NW 329,Residential,32367,77150,0,109517
132613100400000,NW 329,Residential,31020,91544,0,122564
132613100500000,NW 329,Residential,30080,84554,0,114634
132613100600000,NW 329,Residential,30080,74809,0,104889
132613100700000,NW 329,Residential,30080,77744,0,107824
132613100800000,NW 329,Residential,30080,89493,0,119573
132613100900000,NW 329,Residential,30080,81419,0,111499
132613101000000,NW 329,Residential,31144,103101,0,134245
132613101100000,NW 329,Residential,30717,69298,0,100015
132613101200000,NW 329,Residential,32670,92215,0,124885
132613101300000,NW 329,Residential,33210,81075,0,114285
132613101400000,NW 329,Residential,32700,95847,0,128547
132613101500000,NW 329,Residential,32917,94105,0,127022
132613101600000,NW 329,Residential,35760,85369,0,121129
132613101700000,NW 329,Residential,32252,89590,0,121842
132613101800000,NW 329,Residential,32240,83295,0,115535
132613101900000,NW 329,Residential,31765,86697,0,118462
132613102000000,NW 329,Residential,35436,95262,0,130698
132613102100000,NW 329,Residential,31687,91133,0,122820
132613102200000,NW 329,Residential,32101,92342,0,124443
132613102300000,NW 329,Residential,31815,80260,0,112075
132613102400000,NW 329,Residential,32175,81897,0,114072
132613102500000,NW 329,Residential,31200,85297,0,116497
132613102600000,NW 329,Residential,30875,78662,0,109537
132613102700000,NW 329,Residential,30512,91077,0,121589
132613102800000,NW 329,Residential,30166,99224,0,129390
132613102900000,NW 329,Residential,30080,80061,0,110141
132613103000000,NW 329,Residential,30080,77082,0,107162
132613103100000,NW 329,Residential,30080,85937,0,116017
132613103200000,NW 329,Residential,31020,77710,0,108730
132613200100000,NW 329,Residential,32737,89342,0,122079
132613200200000,NW 329,Residential,29100,85087,0,114187
132613200300000,NW 329,Residential,32345,90832,0,123177
132613200400000,NW 329,Residential,31350,84007,0,115357
132613200500000,NW 329,Residential,30400,89641,0,120041
132613200600000,NW 329,Residential,30400,86469,0,116869
132613200700000,NW 329,Residential,30400,86028,0,116428
132613200800000,NW 329,Residential,28975,74148,0,103123
132613200900000,NW 329,Residential,28500,91869,0,120369
132613201000000,NW 329,Residential,28714,81934,0,110648
132613201100000,NW 329,Residential,35956,90915,0,126871
132613201200000,NW 329,Residential,31920,62550,0,94470
132613201300000,NW 329,Residential,30560,88996,0,119556
132613201400000,NW 329,Residential,29416,93228,0,122644
132613201500000,NW 329,Residential,30720,89466,0,120186
132613201600000,NW 329,Residential,30720,96591,0,127311
132613201700000,NW 329,Residential,30720,88456,0,119176
132613201800000,NW 329,Residential,30720,88085,0,118805
132613201900000,NW 329,Residential,30720,85662,0,116382
132613202000000,NW 329,Residential,31680,91357,0,123037
132613300100000,NW 329,Residential,35134,92202,0,127336
132613300200000,NW 329,Residential,32617,112000,0,144617
132613300300000,NW 329,Residential,32300,83510,0,115810
132613300400000,NW 329,Residential,32896,84168,0,117064
132613300500000,NW 329,Residential,31350,99729,0,131079
132615100100000,NW 329,Residential,28200,72180,0,100380
132615100200000,NW 329,Residential,31960,83326,0,115286
132615100300000,NW 329,Residential,29100,87549,0,116649
132615100400000,NW 329,Residential,29229,74640,0,103869
132615100500000,NW 329,Residential,29264,55504,0,84768
132615100600000,NW 329,Residential,28576,72624,0,101200
132615100700000,NW 329,Residential,28670,85669,0,114339
132615100800000,NW 329,Residential,28576,88876,0,117452
132615100900000,NW 329,Residential,29344,78118,0,107462
132615101000000,NW 329,Residential,30525,77612,0,108137
132615101100000,NW 329,Residential,31790,76365,0,108155
132615101200000,NW 329,Residential,31547,73089,0,104636
132615101300000,NW 329,Residential,34730,76022,0,110752
132615101400000,NW 329,Residential,28658,85012,0,113670
132615101500000,NW 329,Residential,28816,82086,0,110902
132615101600000,NW 329,Residential,28658,76651,0,105309
132615101700000,NW 329,Residential,33965,83323,0,117288
132615101800000,NW 329,Residential,28900,96467,0,125367
132615101900000,NW 329,Residential,29813,80234,0,110047
132615102000000,NW 329,Residential,28953,66947,0,95900
132615102100000,NW 329,Residential,28380,61620,0,90000
132615102200000,NW 329,Residential,30380,82619,0,112999
132615102300000,NW 329,Residential,31850,83367,0,115217
132615102400000,NW 329,Residential,30870,70526,0,101396
132615200100000,NW 329,Residential,40425,90725,0,131150
132615200200000,NW 329,Residential,40425,97597,0,138022
132615200300000,NW 329,Residential,29844,86548,0,116392
132615200400000,NW 329,Residential,32800,68138,0,100938
132615200500000,NW 329,Residential,27730,70451,0,98181
132615200600000,NW 329,Residential,27714,83131,0,110845
132615200700000,NW 329,Residential,30393,80617,0,111010
132615200800000,NW 329,Residential,33516,83334,0,116850
132615200900000,NW 329,Residential,29700,69252,0,98952
132615201000000,NW 329,Residential,35932,84774,0,120706
132615201100000,NW 329,Residential,33157,83656,0,116813
132615201200000,NW 329,Residential,29700,54950,0,84650
132615201300000,NW 329,Residential,30500,70021,0,100521
132615201400000,NW 329,Residential,30500,79743,0,110243
132615201500000,NW 329,Residential,30053,90644,0,120697
132615201600000,NW 329,Residential,30053,103210,0,133263
132615201700000,NW 329,Residential,31428,78378,0,109806
132615300100000,NW 329,Residential,32980,90652,0,123632
132615300200000,NW 329,Residential,30456,83440,0,113896
132615300300000,NW 329,Residential,28200,69831,0,98031
132615300400000,NW 329,Residential,29100,77773,0,106873
132615300500000,NW 329,Residential,29700,82519,0,112219
132615300600000,NW 329,Residential,29400,87464,0,116864
132615300700000,NW 329,Residential,29100,86418,0,115518
132615300800000,NW 329,Residential,28800,84136,0,112936
132615300900000,NW 329,Residential,29760,92297,0,122057
132615301000000,NW 329,Residential,33696,86754,0,120450
132615301100000,NW 329,Residential,33696,95748,0,129444
132615301200000,NW 329,Residential,29497,86842,0,116339
132615301300000,NW 329,Residential,28000,92613,0,120613
132615301400000,NW 329,Residential,28453,86292,0,114745
132615301500000,NW 329,Residential,29963,76076,0,106039
132615301600000,NW 329,Residential,31200,81326,0,112526
132615301700000,NW 329,Residential,29963,88528,0,118491
132615301800000,NW 329,Residential,30167,83285,0,113452
132615301900000,NW 329,Residential,39616,96941,0,136557
132615302000000,NW 329,Residential,33728,84511,0,118239
132615302100000,NW 329,Residential,31815,87995,0,119810
132615302200000,NW 329,Residential,28667,82737,0,111404
132615302300000,NW 329,Residential,29100,92035,0,121135
132615302400000,NW 329,Residential,30070,102225,0,132295
132615400100000,NW 329,Residential,28513,92636,0,121149
132615400200000,NW 329,Residential,30550,93108,0,123658
132615400300000,NW 329,Residential,30550,105927,0,136477
132615400400000,NW 329,Residential,28200,83237,0,111437
132615400500000,NW 329,Residential,28200,82608,0,110808
132615400600000,NW 329,Residential,28200,91773,0,119973
132615400700000,NW 329,Residential,28200,90681,0,118881
132615400800000,NW 329,Residential,31960,88191,0,120151
132615500100000,NW 329,Residential,32613,80461,0,113074
132615500200000,NW 329,Residential,31845,80022,0,111867
132615500300000,NW 329,Residential,29205,80405,0,109610
132615500400000,NW 329,Residential,30132,84443,0,114575
132615500500000,NW 329,Residential,31373,95383,0,126756
132615500600000,NW 329,Residential,32400,70105,0,102505
132615500700000,NW 329,Residential,32100,76292,0,108392
132615500800000,NW 329,Residential,29750,93736,0,123486
132615500900000,NW 329,Residential,28833,79883,0,108716
132615501000000,NW 329,Residential,27225,87732,0,114957
132615501100000,NW 329,Residential,29400,77326,0,106726
132615501200000,NW 329,Residential,29100,69852,0,98952
132615501300000,NW 329,Residential,28800,82768,0,111568
132615501400000,NW 329,Residential,29600,75722,0,105322
132615501500000,NW 329,Residential,29084,69094,0,98178
132615501600000,NW 329,Residential,29400,76862,0,106262
132615501700000,NW 329,Residential,29400,81413,0,110813
132615501800000,NW 329,Residential,29100,74945,0,104045
132615501900000,NW 329,Residential,29262,83069,0,112331
132615502000000,NW 329,Residential,28960,81304,0,110264
132615502100000,NW 329,Residential,30400,84403,0,114803
132615502200000,NW 329,Residential,33696,69582,0,103278
132615502300000,NW 329,Residential,33725,82065,0,115790
132615502400000,NW 329,Residential,30928,89392,0,120320
132615502500000,NW 329,Residential,29920,83761,0,113681
132615502600000,NW 329,Residential,29760,84165,0,113925
132615502700000,NW 329,Residential,29760,83893,0,113653
132615502800000,NW 329,Residential,29760,92137,0,121897
132615502900000,NW 329,Residential,29280,86848,0,116128
132615503000000,NW 329,Residential,28800,96958,0,125758
132615503100000,NW 329,Residential,29007,83866,0,112873
132615503200000,NW 329,Residential,28200,81625,0,109825
132615503300000,NW 329,Residential,28960,82866,0,111826
132615503400000,NW 329,Residential,29727,89026,0,118753
132615503500000,NW 329,Residential,30167,82442,0,112609
132615503600000,NW 329,Residential,31720,58280,0,90000
132615503700000,NW 329,Residential,37248,76423,0,113671
132615503800000,NW 329,Residential,33269,84265,0,117534
132615503900000,NW 329,Residential,31024,80603,0,111627
132615504000000,NW 329,Residential,29425,95530,0,124955
132615504100000,NW 329,Residential,28500,88086,0,116586
132615504200000,NW 329,Residential,28093,85088,0,113181
132615504300000,NW 329,Residential,28159,84928,0,113087
132615504400000,NW 329,Residential,31720,80899,0,112619
132615504500000,NW 329,Residential,28216,86916,0,115132
132615600100000,E-40 CHURCHES,Exempt,58374,0,820209,878583
132615600200000,NW 329,Exempt,28992,0,89050,118042
132615600300000,NW 329,Residential,29872,77327,0,107199
132615600400000,NW 329,Residential,29440,83827,0,113267
132615600500000,NW 329,Residential,29904,85432,0,115336
132615600600000,NW 329,Residential,30393,96222,0,126615
132615600700000,NW 329,Residential,34042,98019,0,132061
132615600800000,NW 329,Residential,29297,90656,0,119953
132615600900000,NW 329,Residential,35289,112454,0,147743
132615601000000,NW 329,Residential,32529,70948,0,103477
132615601100000,NW 329,Residential,28480,85536,0,114016
132615601200000,NW 329,Residential,28512,80570,0,109082
132615601300000,NW 329,Residential,28480,99906,0,128386
132615601400000,NW 329,Residential,27360,83032,0,110392
132615601500000,NW 329,Residential,28420,82594,0,111014
132615601600000,NW 329,Residential,29073,80927,0,110000
132615700100000,NW 329,Residential,34648,85562,0,120210
132615700200000,NW 329,Residential,29440,99092,0,128532
132615700300000,NW 329,Residential,31960,100133,0,132093
132615700400000,NW 329,Residential,34200,77192,0,111392
132615700500000,NW 329,Residential,33545,92560,0,126105
132615700600000,NW 329,Residential,32505,78041,0,110546
132615700700000,NW 329,Residential,29735,75813,0,105548
132615700800000,NW 329,Residential,30409,83920,0,114329
132615700900000,NW 329,Residential,34317,83507,0,117824
132615701000000,NW 329,Residential,34686,93412,0,128098
132615701100000,NW 329,Residential,32917,90724,0,123641
132615701200000,NW 329,Residential,30232,78127,0,108359
132615701300000,NW 329,Residential,29563,74924,0,104487
132615701400000,NW 329,Residential,30380,81532,0,111912
132615701500000,NW 329,Residential,31000,77359,0,108359
132615800100000,NW 329,Residential,32400,89233,0,121633
132615800200000,NW 329,Residential,28480,84876,0,113356
132615800300000,NW 329,Residential,28800,75009,0,103809
132615800400000,NW 329,Residential,29400,86696,0,116096
132615800500000,NW 329,Residential,30300,76066,0,106366
132615800600000,NW 329,Residential,31200,85563,0,116763
132615800700000,NW 329,Residential,31800,70213,0,102013
132615800800000,NW 329,Residential,31800,86167,0,117967
132615800900000,NW 329,Residential,31200,92956,0,124156
132615801000000,NW 329,Residential,29700,83925,0,113625
132615801100000,NW 329,Residential,28800,91700,0,120500
132615801200000,NW 329,Residential,31960,90326,0,122286
132615900100000,NW 329,Residential,31960,79109,0,111069
132615900200000,NW 329,Residential,28200,96628,0,124828
132615900300000,NW 329,Residential,28200,75706,0,103906
132615900400000,NW 329,Residential,29100,91197,0,120297
132615900500000,NW 329,Residential,31040,86407,0,117447
132615900600000,NW 329,Residential,33231,97132,0,130363
132615900700000,NW 329,Residential,32585,93254,0,125839
132615900800000,NW 329,Residential,29120,86924,0,116044
132617600100000,NW 329,Residential,31680,74893,0,106573
132617600200000,NW 329,Residential,32832,55184,0,88016
132617700100000,NW 329,Residential,31803,76448,0,108251
132617700200000,NW 329,Residential,30550,59263,0,89813
132617700300000,NW 329,Residential,32241,78089,0,110330
132617700400000,NW 329,Residential,33600,80483,0,114083
132617700500000,NW 329,Residential,34200,80790,0,114990
132617700600000,NW 329,Residential,33804,88124,0,121928
132617700700000,NW 329,Residential,31200,74834,0,106034
132617700800000,NW 329,Residential,32522,77474,0,109996
132617700900000,NW 329,Residential,29760,74615,0,104375
132617701000000,NW 329,Residential,32900,85435,0,118335
132617701100000,NW 329,Residential,32900,57356,0,90256
132617701200000,NW 329,Residential,32406,67432,0,99838
132617701300000,NW 329,Residential,31965,66990,0,98955
132617701400000,NW 329,Residential,31587,73208,0,104795
132617701500000,NW 329,Residential,30732,63455,0,94187
132617701600000,NW 329,Residential,32458,80692,0,113150
132617800100000,NW 329,Residential,33804,71445,0,105249
132617800200000,NW 329,Residential,29760,81859,0,111619
132617800300000,NW 329,Residential,28983,71714,0,100697
132617800400000,NW 329,Residential,30522,68279,0,98801
132617800500000,NW 329,Residential,33345,80295,0,113640
132617800600000,NW 329,Residential,34014,65485,0,99499
132617900100000,NW 329,Residential,33543,81353,0,114896
132617900200000,NW 329,Residential,33091,72370,0,105461
132617900300000,NW 329,Residential,34167,68809,0,102976
132617900400000,NW 329,Residential,33320,68641,0,101961
132617900500000,NW 329,Residential,32480,79164,0,111644
132617900600000,NW 329,Residential,31803,94097,0,125900
132617900700000,NW 329,Exempt,31806,0,74269,106075
132618000100000,NW 329,Residential,31960,62676,0,94636
132618000200000,NW 329,Residential,29400,89816,0,119216
132618000300000,NW 329,Residential,30232,86782,0,117014
132618000400000,NW 329,Residential,30543,67523,0,98066
132618000500000,NW 329,Residential,30543,67905,0,98448
132618100100000,NW 329,Residential,29297,84596,0,113893
132618200100000,NW 329,Residential,30550,80976,0,111526
132618200200000,NW 329,Residential,31680,77182,0,108862
132618200300000,NW 329,Residential,30320,88446,0,118766
132618200400000,NW 329,Residential,29767,84123,0,113890
132618200500000,NW 329,Residential,30083,79631,0,109714
132618200600000,NW 329,Residential,32320,75553,0,107873
132618200700000,NW 329,Residential,28960,79242,0,108202
132618200800000,NW 329,Residential,29767,97399,0,127166
132618200900000,NW 329,Residential,29767,80701,0,110468
132618201000000,NW 329,Residential,31983,79250,0,111233
132618201100000,NW 329,Residential,28658,73091,0,101749
132618201200000,NW 329,Residential,29767,60162,0,89929
132618201300000,NW 329,Residential,29767,69872,0,99639
132618201400000,NW 329,Residential,32349,83494,0,115843
132618201500000,NW 329,Residential,30083,77242,0,107325
132618201600000,NW 329,Residential,28658,70753,0,99411
132618201700000,NW 329,Residential,31904,78970,0,110874
132618201800000,NW 329,Residential,32072,134682,0,166754
132618201900000,NW 329,Residential,32640,96936,0,129576
132618202000000,NW 329,Residential,31200,88462,0,119662
132618202100000,NW 329,Residential,31525,94366,0,125891
132618202200000,NW 329,Residential,33142,87591,0,120733
132618202300000,NW 329,Residential,31200,77231,0,108431
132618202400000,NW 329,Residential,31200,76481,0,107681
132618202500000,NW 329,Residential,32495,75224,0,107719
132618202600000,NW 329,Residential,31040,85443,0,116483
132618202700000,NW 329,Residential,30875,57097,0,87972
132618202800000,NW 329,Residential,31983,92934,0,124917
132618202900000,NW 329,Residential,31192,85727,0,116919
132618203000000,NW 329,Residential,30237,78120,0,108357
132618203100000,NW 329,Residential,29936,81636,0,111572
132618203200000,NW 329,Residential,31255,76422,0,107677
132618300100000,NW 329,Residential,29356,70445,0,99801
132618300200000,NW 329,Residential,24269,95128,0,119397
132618300300000,NW 329,Residential,24440,84103,0,108543
132618300400000,NW 329,Residential,27203,86694,0,113897
132618300500000,NW 329,Residential,25218,80534,0,105752
132618300600000,NW 329,Residential,25944,85721,0,111665
132618300700000,NW 329,Residential,26933,81002,0,107935
132618301500000,NW 329,Residential,32821,80092,0,112913
132618301600000,NW 329,Residential,27840,71161,0,99001
132618301700000,NW 329,Residential,27840,79946,0,107786
132618301800000,NW 329,Residential,28810,74972,0,103782
132618301900000,NW 329,Residential,28000,83729,0,111729
132618302000000,NW 329,Residential,29600,85368,0,114968
132618302100000,NW 329,Residential,27920,81725,0,109645
132618302200000,NW 329,Residential,29328,70873,0,100201
132618302300000,NW 329,Residential,30720,86508,0,117228
132618302400000,NW 329,Residential,30880,75123,0,106003
132618302500000,NW 329,Residential,29100,76615,0,105715
132618302600000,NW 329,Residential,29400,82490,0,111890
132618302700000,NW 329,Residential,32705,74262,0,106967
132618302800000,NW 329,Residential,35323,94658,0,129981
132618400100000,NW 329,Residential,31255,62686,0,93941
132618400200000,NW 329,Residential,30064,88585,0,118649
132618400300000,NW 329,Residential,32640,71182,0,103822
132618400400000,NW 329,Residential,31040,68281,0,99321
132618400500000,NW 329,Residential,32640,65047,0,97687
132618400600000,NW 329,Residential,32300,80494,0,112794
132618400700000,NW 329,Residential,32300,85811,0,118111
132618400800000,NW 329,Residential,32640,76451,0,109091
132618400900000,NW 329,Residential,30720,76880,0,107600
132618401000000,NW 329,Residential,31960,72864,0,104824
132618401100000,NW 329,Residential,32458,87038,0,119496
132618401200000,NW 329,Residential,32640,78012,0,110652
132618401300000,NW 329,Residential,32640,82201,0,114841
132618401400000,NW 329,Residential,32256,81727,0,113983
132618500100000,NW 329,Residential,29335,77495,0,106830
132618500200000,NW 329,Residential,26539,81754,0,108293
132618500300000,NW 329,Residential,27495,92869,0,120364
132618500400000,NW 329,Residential,33361,74481,0,107842
132618500500000,NW 329,Residential,31983,73910,0,105893
132618500600000,NW 329,Residential,30855,91578,0,122433
132618500700000,NW 329,Residential,30690,71025,0,101715
132618500800000,NW 329,Residential,33280,56834,0,90114
132618500900000,NW 329,Residential,32591,73139,0,105730
132618501000000,NW 329,Residential,32770,59488,0,92258
132618501100000,NW 329,Residential,32770,86223,0,118993
132618501200000,NW 329,Residential,31973,78723,0,110696
132618501300000,NW 329,Residential,29925,73571,0,103496
132618501400000,NW 329,Residential,30720,70073,0,100793
132618501500000,NW 329,Residential,31883,81479,0,113362
132618501600000,NW 329,Residential,28983,85702,0,114685
132618501700000,NW 329,Residential,30450,90960,0,121410
132618501800000,NW 329,Residential,32480,91568,0,124048
132618501900000,NW 329,Residential,33790,86397,0,120187
132618502000000,NW 329,Residential,32679,88761,0,121440
132618502100000,NW 329,Residential,30870,81756,0,112626
132618502200000,NW 329,Residential,33075,89657,0,122732
132618502300000,NW 329,Residential,33390,83264,0,116654
132618502400000,NW 329,Residential,32130,95134,0,127264
132618502500000,NW 329,Residential,31185,89004,0,120189
132618502600000,NW 329,Residential,30240,83812,0,114052
132618502700000,NW 329,Residential,30240,103699,0,133939
132618502800000,NW 329,Residential,29760,87168,0,116928
132618502900000,NW 329,Residential,33566,95243,0,128809
132618503000000,NW 329,Residential,33830,89257,0,123087
132618503100000,NW 329,Residential,30360,84887,0,115247
132618503200000,NW 329,Residential,32832,83996,0,116828
132618503300000,E-40 CHURCHES,Exempt,41364,0,440130,481494
132618503400000,NW 329,Residential,30294,66625,0,96919
132618503500000,NW 329,Residential,32592,67401,0,99993
132618503600000,NW 329,Residential,34476,60185,0,94661
132618503700000,NW 329,Residential,36586,67772,0,104358
132618600100000,NW 329,Residential,31694,85162,0,116856
132618600200000,NW 329,Residential,29280,78184,0,107464
132618600300000,NW 329,Residential,32980,82088,0,115068
132618600400000,NW 329,Residential,30070,93002,0,123072
132618600500000,NW 329,Residential,30070,88309,0,118379
132618600600000,NW 329,Residential,30070,88128,0,118198
132618600700000,NW 329,Residential,30070,87848,0,117918
132618600800000,NW 329,Residential,31760,94135,0,125895
132618600900000,NW 329,Residential,28670,69142,0,97812
132618601000000,NW 329,Residential,31667,87585,0,119252
132618601100000,NW 329,Residential,30070,89857,0,119927
132618601200000,NW 329,Residential,30070,86647,0,116717
132618601300000,NW 329,Residential,30070,96581,0,126651
132618601400000,NW 329,Residential,30380,94267,0,124647
132618700100000,NW 329,Residential,31648,90215,0,121863
132618700200000,NW 329,Residential,28199,86761,0,114960
132618700300000,NW 329,Residential,29280,85859,0,115139
132618700400000,NW 329,Residential,27840,62160,0,90000
132618700500000,NW 329,Residential,27840,89434,0,117274
132618700600000,NW 329,Residential,27840,69212,0,97052
132618700700000,NW 329,Residential,27840,107672,0,135512
132618700800000,NW 329,Residential,28800,99115,0,127915
132618700900000,NW 329,Residential,27840,93173,0,121013
132618701000000,NW 329,Residential,27840,76991,0,104831
132618701100000,NW 329,Residential,27840,88474,0,116314
132618701200000,NW 329,Residential,27840,84095,0,111935
132618701300000,NW 329,Residential,28800,92415,0,121215
132618701400000,NW 329,Residential,28800,83827,0,112627
132618701500000,NW 329,Residential,31226,95828,0,127054
132620100100000,NW 329,Residential,64960,93986,0,158946
132620100500000,NW 329,Residential,835,0,0,835
132620100600000,NW 329,Residential,36976,148283,0,185259
132620100700000,NW 329,Residential,36976,175846,0,212822
132620100800000,NW 329,Residential,38150,150010,0,188160
132620100900000,NW 329,Residential,37800,142360,0,180160
132620101000000,NW 329,Residential,216,0,0,216
132620101100000,NW 329,Residential,42840,138079,0,180919
132620101200000,NW 329,Residential,413,0,0,413
132620101300000,NW 329,Residential,40680,159292,0,199972
132620101400000,NW 329,Residential,246,0,0,246
132620101500000,NW 329,Residential,50416,0,0,50416
132620101600000,NW 329,Residential,39650,145049,0,184699
132620101700000,NW 329,Residential,34030,158966,0,192996
132620101800000,NW 329,Residential,324,0,0,324
132620101900000,NW 329,Residential,334,0,0,334
132620200100000,NW 329,Residential,33127,81468,0,114595
132620200200000,NW 329,Residential,32500,87787,0,120287
132620200300000,NW 329,Residential,31000,86458,0,117458
132620200400000,NW 329,Residential,31000,78441,0,109441
132620200500000,NW 329,Residential,31000,93241,0,124241
132620200600000,NW 329,Residential,31000,87236,0,118236
132620200700000,NW 329,Residential,31000,73552,0,104552
132620200800000,NW 329,Residential,31000,94556,0,125556
132620200900000,NW 329,Residential,31000,87043,0,118043
132620201000000,NW 329,Residential,33923,91096,0,125019
132620201100000,NW 329,Residential,285,0,0,285
132620201200000,NW 329,Residential,44625,139257,0,183882
132620201300000,NW 329,Residential,295,0,0,295
132620201400000,NW 329,Residential,44625,143642,0,188267
132620201500000,NW 329,Residential,44891,147044,0,191935
132620201600000,NW 329,Residential,44625,170375,0,215000
132620201700000,NW 329,Residential,266,0,0,266
132620201800000,NW 329,Residential,45475,166641,0,212116
132620201900000,NW 329,Residential,60455,8800,0,69255
132620202000000,NW 329,Residential,532,0,0,532
132620202100000,NW 329,Residential,51412,163644,0,215056
132620202200000,NW 329,Residential,40280,11550,0,51830
132620202300000,NW 329,Residential,40810,156548,0,197358
132620202400000,NW 329,Residential,40810,145725,0,186535
132620202500000,NW 329,Residential,256,0,0,256
132622600100000,E-40 CHURCHES,Exempt,561535,0,2989641,3551176
132625100100000,NW 329,Residential,30650,83051,0,113701
132625100300000,NW 329,Residential,33179,101209,0,134388
132625100400000,NW 329,Residential,30000,87028,0,117028
132625100500000,NW 329,Residential,30000,89879,0,119879
132625100600000,NW 329,Residential,27250,108297,0,135547
132625100700000,NW 329,Residential,28750,85451,0,114201
132625100800000,NW 329,Residential,26000,103638,0,129638
132625100900000,NW 329,Residential,30000,93513,0,123513
132625101000000,NW 329,Residential,26000,103180,0,129180
132625200100000,NW 329,Residential,33844,104618,0,138462
132625200200000,NW 329,Residential,31065,215187,0,246252
132625200300000,NW 329,Residential,25800,102282,0,128082
132625200400000,NW 329,Residential,25800,104254,0,130054
132625200500000,NW 329,Residential,25800,93762,0,119562
132625200600000,NW 329,Residential,25800,89708,0,115508
132625200700000,NW 329,Residential,25800,94216,0,120016
132625200800000,NW 329,Residential,25800,95538,0,121338
132625200900000,NW 329,Residential,25800,106618,0,132418
132625201000000,NW 329,Residential,25800,90822,0,116622
132625201100000,NW 329,Residential,25800,91240,0,117040
132625201200000,NW 329,Residential,25800,95568,0,121368
132625201300000,NW 329,Residential,25800,81600,0,107400
132625201400000,NW 329,Residential,25800,86497,0,112297
132625201500000,NW 329,Residential,25800,81494,0,107294
132625201600000,NW 329,Residential,25800,87337,0,113137
132625201700000,NW 329,Residential,25800,90697,0,116497
132625201800000,NW 329,Residential,25800,96978,0,122778
132625201900000,NW 329,Residential,29726,83452,0,113178
132625202000000,NW 329,Residential,29778,81609,0,111387
132625202100000,NW 329,Residential,31500,100652,0,132152
132625202200000,NW 329,Residential,30000,89515,0,119515
132625202300000,NW 329,Residential,31500,108253,0,139753
132625202400000,NW 329,Residential,30000,82791,0,112791
132625202500000,NW 329,Residential,32000,87019,0,119019
132625202600000,NW 329,Residential,30000,101042,0,131042
132625202700000,NW 329,Residential,32400,98440,0,130840
132627600100000,E-15 CITY,Exempt,0,0,0,0
132627600200000,NW 329,Residential,33158,101587,0,134745
132627600300000,NW 329,Residential,30550,88306,0,118856
132627600400000,NW 329,Residential,30550,99988,0,130538
132627600500000,NW 329,Residential,30550,96708,0,127258
132627600600000,NW 329,Residential,30550,107299,0,137849
132627600700000,NW 329,Residential,30550,96506,0,127056
132627700100000,NW 329,Residential,28700,101884,0,130584
132627700200000,NW 329,Residential,29000,83150,0,112150
132627700300000,NW 329,Residential,29000,102159,0,131159
132627700400000,NW 329,Residential,29000,75346,0,104346
132627700500000,NW 329,Residential,30400,99188,0,129588
132627700600000,NW 329,Residential,30000,89012,0,119012
132627700700000,NW 329,Residential,31448,100057,0,131505
132627700800000,NW 329,Residential,30102,97676,0,127778
132627700900000,NW 329,Residential,28200,88020,0,116220
132627701000000,NW 329,Residential,28200,104861,0,133061
132627701100000,NW 329,Residential,28200,82434,0,110634
132627701200000,NW 329,Residential,29337,89018,0,118355
132627701300000,NW 329,Residential,29962,106686,0,136648
132627800100000,NW 329,Residential,36036,97330,0,133366
132627800200000,NW 329,Residential,33165,79726,0,112891
132627800300000,NW 329,Residential,33165,88281,0,121446
132627800400000,NW 329,Residential,33165,76913,0,110078
132627800500000,NW 329,Residential,33165,83282,0,116447
132627800600000,NW 329,Residential,35680,98077,0,133757
132627900100000,NW 329,Residential,33158,102766,0,135924
132627900200000,NW 329,Residential,30080,79106,0,109186
132627900300000,NW 329,Residential,33158,91584,0,124742
132627900400000,NW 329,Residential,31680,86726,0,118406
132627900500000,NW 329,Residential,31680,77970,0,109650
132627900600000,NW 329,Residential,31680,79836,0,111516
132627900700000,NW 329,Residential,31680,100800,0,132480
132627900800000,NW 329,Residential,31680,94835,0,126515
132627900900000,NW 329,Residential,31680,97494,0,129174
132627901000000,NW 329,Residential,31680,94779,0,126459
132627901100000,NW 329,Residential,31680,93764,0,125444
132627901200000,NW 329,Residential,32175,109363,0,141538
132627901300000,NW 329,Residential,31829,91094,0,122923
132627901400000,NW 329,Residential,32373,98942,0,131315
132627901500000,NW 329,Residential,32175,74120,0,106295
132627901600000,NW 329,Residential,31680,89356,0,121036
132627901700000,NW 329,Residential,31680,99929,0,131609
132627901800000,NW 329,Residential,31680,86466,0,118146
132627901900000,NW 329,Residential,31680,92529,0,124209
132627902000000,NW 329,Residential,31680,91069,0,122749
132627902100000,NW 329,Residential,31680,80734,0,112414
132627902200000,NW 329,Residential,31680,88530,0,120210
132627902300000,NW 329,Residential,31680,88625,0,120305
132628000100000,NW 329,Residential,33158,95092,0,128250
132628000200000,NW 329,Residential,30080,97023,0,127103
132628000300000,NW 329,Residential,33158,88595,0,121753
132628000400000,NW 329,Residential,31680,84866,0,116546
132628000500000,NW 329,Residential,31185,105398,0,136583
132628000600000,NW 329,Residential,31185,93491,0,124676
132628000700000,NW 329,Residential,31185,90708,0,121893
132628000800000,NW 329,Residential,31185,92044,0,123229
132628000900000,NW 329,Residential,31185,86401,0,117586
132628001000000,NW 329,Residential,31185,85917,0,117102
132628001100000,NW 329,Residential,31185,77068,0,108253
132628001200000,NW 329,Residential,33165,12144,0,45309
132628001300000,NW 329,Residential,33297,81699,0,114996
132628001400000,NW 329,Residential,32134,85389,0,117523
132628001500000,NW 329,Residential,31507,88042,0,119549
132628001600000,NW 329,Residential,31185,86102,0,117287
132628001700000,NW 329,Residential,31185,87870,0,119055
132628001800000,NW 329,Residential,31185,100404,0,131589
132628001900000,NW 329,Residential,31185,86777,0,117962
132628002000000,NW 329,Residential,31185,86263,0,117448
132628002100000,NW 329,Residential,31185,86636,0,117821
132628002200000,NW 329,Residential,31185,88290,0,119475
132628002300000,NW 329,Residential,31680,84031,0,115711
132628100100000,NW 329,Residential,33158,99482,0,132640
132628100200000,NW 329,Residential,30080,96344,0,126424
132628100300000,NW 329,Residential,33158,109859,0,143017
132628100400000,NW 329,Residential,32126,82839,0,114965
132628100500000,NW 329,Residential,27720,109326,0,137046
132628100600000,NW 329,Residential,29700,107079,0,136779
132628100700000,NW 329,Residential,27720,72560,0,100280
132628100800000,NW 329,Residential,29700,99023,0,128723
132628100900000,NW 329,Residential,28545,90636,0,119181
132628101000000,NW 329,Residential,30855,107593,0,138448
132628101100000,NW 329,Residential,30805,96693,0,127498
132628101200000,NW 329,Residential,33977,103915,0,137892
132628101300000,NW 329,Residential,28070,106716,0,134786
132628101400000,NW 329,Residential,28560,82464,0,111024
132628101500000,NW 329,Residential,32835,92195,0,125030
132628101600000,NW 329,Residential,33165,95009,0,128174
132628101700000,NW 329,Residential,31185,72164,0,103349
132628101800000,NW 329,Residential,31185,97339,0,128524
132628101900000,NW 329,Residential,31185,98967,0,130152
132628102000000,NW 329,Residential,31185,95076,0,126261
132628102100000,NW 329,Residential,31185,88941,0,120126
132628102200000,NW 329,Residential,31185,93857,0,125042
132628102300000,NW 329,Residential,31185,103423,0,134608
132628102400000,NW 329,Residential,31680,93486,0,125166
132628200100000,NW 329,Residential,30699,79828,0,110527
132628200200000,NW 329,Residential,26675,83318,0,109993
132628200300000,NW 329,Residential,26675,83262,0,109937
132628200400000,NW 329,Residential,30489,81075,0,111564
132628200500000,NW 329,Residential,31008,98267,0,129275
132628200600000,NW 329,Residential,27775,96949,0,124724
132628200700000,NW 329,Residential,27775,82408,0,110183
132628200800000,NW 329,Residential,27775,85368,0,113143
132628200900000,NW 329,Residential,30300,91099,0,121399
132628201000000,NW 329,Residential,27775,93568,0,121343
132628201100000,NW 329,Residential,27500,93300,0,120800
132628201200000,NW 329,Residential,30520,95824,0,126344
132628201300000,NW 329,Residential,29260,84715,0,113975
132628201400000,NW 329,Residential,29203,109596,0,138799
132628201500000,NW 329,Residential,29700,87807,0,117507
132628201600000,NW 329,Residential,29627,91360,0,120987
132628201700000,NW 329,Residential,27220,88561,0,115781
132628201800000,NW 329,Residential,30300,94664,0,124964
132628201900000,NW 329,Residential,28280,94283,0,122563
132628202000000,NW 329,Residential,30300,71574,0,101874
132628202100000,NW 329,Residential,28280,84613,0,112893
132628202200000,NW 329,Residential,31361,95758,0,127119
132628300100000,NW 329,Residential,35764,89780,0,125544
132628300200000,NW 329,Residential,33412,94125,0,127537
132628300300000,NW 329,Residential,33145,95661,0,128806
132630100100000,NW 329,Residential,33383,80193,0,113576
132630100200000,NW 329,Residential,32667,79814,0,112481
132630100300000,NW 329,Residential,32440,74482,0,106922
132630100400000,NW 329,Residential,33714,77952,0,111666
132630100500000,NW 329,Residential,35150,99389,0,134539
132630100600000,NW 329,Residential,37145,89135,0,126280
132630100700000,NW 329,Residential,34347,94393,0,128740
132630100800000,NW 329,Residential,27594,97372,0,124966
132630100900000,NW 329,Residential,26112,90834,0,116946
132630101000000,NW 329,Residential,30240,99511,0,129751
132630101100000,NW 329,Residential,29440,102471,0,131911
132630200100000,NW 329,Residential,35482,102571,0,138053
132630200200000,NW 329,Residential,34890,84322,0,119212
132630200300000,NW 329,Residential,31945,92709,0,124654
132630200400000,NW 329,Residential,31603,101074,0,132677
132630200500000,NW 329,Residential,32992,81727,0,114719
132630200600000,NW 329,Residential,27618,93534,0,121152
132630200700000,NW 329,Residential,24832,83569,0,108401
132630200800000,NW 329,Residential,27179,101370,0,128549
132630200900000,NW 329,Residential,33050,92936,0,125986
132630201000000,NW 329,Exempt,33809,0,77690,111499
132630201100000,NW 329,Residential,33516,82861,0,116377
132630201200000,NW 329,Residential,33858,93386,0,127244
132630300100000,NW 329,Residential,32616,100545,0,133161
132630300200000,NW 329,Residential,33530,102766,0,136296
132630300300000,NW 329,Residential,28054,100441,0,128495
132630300400000,NW 329,Residential,25718,101206,0,126924
132630300500000,NW 329,Residential,26313,107919,0,134232
132630300600000,NW 329,Residential,34580,77058,0,111638
132630300700000,NW 329,Residential,31699,75134,0,106833
132630400100000,NW 329,Residential,32524,84476,0,117000
132630500100000,NW 329,Residential,30614,106854,0,137468
132630500200000,NW 329,Residential,27231,80700,0,107931
132630500300000,NW 329,Residential,26928,100255,0,127183
132630500400000,NW 329,Residential,26040,93178,0,119218
132630500500000,NW 329,Residential,27249,95084,0,122333
132630500600000,NW 329,Residential,27363,102400,0,129763
132630500700000,NW 329,Residential,28533,109875,0,138408
132630500800000,NW 329,Residential,37450,103649,0,141099
132630500900000,NW 329,Residential,37100,90976,0,128076
132630501000000,NW 329,Residential,36750,93247,0,129997
132630501100000,NW 329,Residential,37306,107087,0,144393
132630501200000,NW 329,Residential,39462,91691,0,131153
132630600100000,NW 329,Residential,27373,98904,0,126277
132630600200000,NW 329,Residential,26125,101590,0,127715
132630600300000,NW 329,Residential,34791,102405,0,137196
132630600400000,NW 329,Residential,33838,95775,0,129613
132630600500000,NW 329,Residential,34485,90836,0,125321
132630600600000,NW 329,Residential,33330,89728,0,123058
132630600700000,NW 329,Residential,31667,102612,0,134279
132630600800000,NW 329,Residential,32250,100386,0,132636
132630600900000,NW 329,Residential,32250,87906,0,120156
132630601000000,NW 329,Residential,32250,101022,0,133272
132630601100000,NW 329,Residential,32250,87943,0,120193
132630601200000,NW 329,Residential,32450,92458,0,124908
132630601300000,NW 329,Residential,32450,99090,0,131540
132630601400000,NW 329,Residential,32450,89513,0,121963
132630601500000,NW 329,Residential,33660,89587,0,123247
132630601600000,NW 329,Residential,33000,96078,0,129078
132630601700000,NW 329,Residential,33884,91830,0,125714
132630601800000,NW 329,Residential,31500,101063,0,132563
132630601900000,NW 329,Residential,31500,86670,0,118170
132630602000000,NW 329,Residential,33167,87947,0,121114
132630602100000,NW 329,Residential,33167,104085,0,137252
132630700100000,NW 329,Residential,27238,93781,0,121019
132630700200000,NW 329,Residential,24832,80482,0,105314
132630700300000,NW 329,Residential,27238,106660,0,133898
132630700400000,NW 329,Residential,31371,88732,0,120103
132630700500000,NW 329,Residential,31360,92819,0,124179
132630700600000,NW 329,Residential,31325,74457,0,105782
132630700700000,NW 329,Residential,31200,78364,0,109564
132630700800000,NW 329,Residential,32320,105988,0,138308
132630700900000,NW 329,Residential,32320,88015,0,120335
132630701000000,NW 329,Residential,32552,95315,0,127867
132630701100000,NW 329,Residential,30717,88830,0,119547
132630701200000,NW 329,Residential,31801,88041,0,119842
132630701300000,NW 329,Residential,31801,92230,0,124031
132630701400000,NW 329,Residential,31801,78686,0,110487
132630701500000,NW 329,Residential,33075,95368,0,128443
132630701600000,NW 329,Residential,26597,92403,0,119000
132630701700000,NW 329,Residential,28800,79150,0,107950
132630701800000,NW 329,Residential,26413,81643,0,108056
132630701900000,NW 329,Residential,28800,83079,0,111879
132630702000000,NW 329,Residential,29760,85102,0,114862
132630702100000,NW 329,Residential,27645,85120,0,112765
132630702200000,NW 329,Residential,28134,97190,0,125324
132630702300000,NW 329,Residential,29727,81711,0,111438
132630702400000,NW 329,Residential,33516,94955,0,128471
132630702500000,NW 329,Residential,31811,97629,0,129440
132630702600000,NW 329,Residential,31811,81862,0,113673
132630702700000,NW 329,Residential,32139,96974,0,129113
132630702800000,NW 329,Residential,32139,79381,0,111520
132630702900000,NW 329,Residential,32139,91495,0,123634
132630703000000,NW 329,Residential,32139,82003,0,114142
132630800100000,NW 329,Residential,34452,105518,0,139970
132630800200000,NW 329,Residential,27962,90422,0,118384
132630800300000,NW 329,Residential,27373,93990,0,121363
132630800400000,NW 329,Residential,33375,96170,0,129545
132630800500000,NW 329,Residential,33375,110807,0,144182
132630800600000,NW 329,Residential,33660,98899,0,132559
132630800700000,NW 329,Residential,32505,113944,0,146449
132630800800000,NW 329,Residential,31525,95852,0,127377
132630800900000,NW 329,Residential,31446,92748,0,124194
132630801000000,NW 329,Residential,31040,82692,0,113732
132630801100000,NW 329,Residential,31114,105339,0,136453
132630801200000,NW 329,Residential,32340,88732,0,121072
132630801300000,NW 329,Residential,29563,108131,0,137694
132630801400000,NW 329,Residential,29056,88596,0,117652
132630801500000,NW 329,Residential,26513,92626,0,119139
132630801600000,NW 329,Residential,29100,87478,0,116578
132630801700000,NW 329,Residential,26675,77430,0,104105
132630801800000,NW 329,Residential,29100,91691,0,120791
132630801900000,NW 329,Residential,26675,98798,0,125473
132630802000000,NW 329,Residential,29165,90872,0,120037
132630802100000,NW 329,Residential,29035,81688,0,110723
132630802200000,NW 329,Residential,26675,84016,0,110691
132630802300000,NW 329,Residential,29100,120447,0,149547
132630802400000,NW 329,Residential,26675,98186,0,124861
132630802500000,NW 329,Residential,29100,93688,0,122788
132630802600000,NW 329,Residential,29727,87771,0,117498
132630802700000,NW 329,Residential,27416,80152,0,107568
132630802800000,NW 329,Residential,27489,100587,0,128076
132630802900000,NW 329,Residential,27200,81874,0,109074
132630803000000,NW 329,Residential,31520,101461,0,132981
132630803100000,NW 329,Residential,32056,95058,0,127114
132630803200000,NW 329,Residential,31687,81024,0,112711
132630803300000,NW 329,Residential,31848,88521,0,120369
132630803400000,NW 329,Residential,31360,78595,0,109955
132630803500000,NW 329,Residential,31360,89329,0,120689
132630803600000,NW 329,Residential,33333,86772,0,120105
132630803700000,NW 329,Residential,33428,91576,0,125004
132630803800000,NW 329,Residential,33705,86065,0,119770
132630803900000,NW 329,Residential,35768,98660,0,134428
132630804000000,NW 329,Residential,32320,79329,0,111649
132630900100000,NW 329,Residential,29485,107222,0,136707
132630900200000,NW 329,Residential,33745,102333,0,136078
132630900300000,NW 329,Residential,32000,91470,0,123470
132630900400000,NW 329,Residential,32000,96058,0,128058
132630900500000,NW 329,Residential,32000,86388,0,118388
132630900600000,NW 329,Residential,32000,91357,0,123357
132630900700000,NW 329,Residential,32000,82781,0,114781
132631000100000,NW 329,Residential,31040,89216,0,120256
132631000200000,NW 329,Residential,31040,87578,0,118618
132631000300000,NW 329,Residential,31040,92646,0,123686
132631000400000,NW 329,Residential,34408,104707,0,139115
132631000500000,NW 329,Residential,36140,103633,0,139773
132631000600000,NW 329,Residential,36309,85252,0,121561
132631000700000,NW 329,Residential,40145,101852,0,141997
132631000800000,NW 329,Residential,36356,90911,0,127267
132631000900000,NW 329,Residential,35686,106187,0,141873
132631001000000,NW 329,Residential,34952,97409,0,132361
132631001100000,NW 329,Residential,33300,77884,0,111184
132631001200000,NW 329,Residential,34029,97137,0,131166
132631001300000,NW 329,Residential,34300,91921,0,126221
132631001400000,NW 329,Residential,33870,96130,0,130000
132631100100000,NW 329,Residential,33412,99342,0,132754
132631100200000,NW 329,Residential,31360,93645,0,125005
132631100300000,NW 329,Residential,29400,84016,0,113416
132631100400000,NW 329,Residential,31360,93369,0,124729
132631100500000,NW 329,Residential,31360,92077,0,123437
132631100600000,NW 329,Residential,31360,96046,0,127406
132632600100000,NW 329,Residential,34938,102523,0,137461
132632600200000,NW 329,Residential,31040,87231,0,118271
132632600300000,NW 329,Residential,31040,91705,0,122745
132632600400000,NW 329,Residential,35453,96666,0,132119
132632700100000,NW 329,Residential,34042,82353,0,116395
132632700200000,Empty,Exempt,0,0,0,0
132632700300000,E-15 CITY,Exempt,0,0,0,0
132632700400000,NW 329,Residential,33532,93182,0,126714
132632700500000,NW 329,Residential,31500,101872,0,133372
132632700600000,NW 329,Residential,31500,97457,0,128957
132632700700000,NW 329,Residential,31500,97727,0,129227
132632700800000,NW 329,Residential,31500,89922,0,121422
132632700900000,NW 329,Residential,31500,91669,0,123169
132632701000000,NW 329,Residential,31500,92721,0,124221
132632701100000,NW 329,Residential,31500,89078,0,120578
132632800100000,NW 329,Residential,34411,98382,0,132793
132632800200000,NW 332,Residential,44413,196406,0,240819
132632800300000,NW 332,Residential,40375,160571,0,200946
132632800400000,NW 332,Residential,40375,180329,0,220704
132632800500000,NW 332,Residential,40375,221457,0,261832
132632800600000,NW 332,Residential,40375,176015,0,216390
132632800700000,NW 332,Residential,40375,215904,0,256279
132632800800000,NW 332,Residential,44175,181302,0,225477
132632800900000,E-15 CITY,Exempt,0,0,0,0
132632801000000,NW 332,Residential,43529,232166,0,275695
132632801100000,NW 332,Residential,41800,248634,0,290434
132632801200000,NW 332,Residential,41800,244761,0,286561
132632801300000,NW 332,Residential,41800,231242,0,273042
132632801400000,NW 332,Residential,41673,279534,0,321207
132632801500000,NW 332,Residential,61740,70880,0,132620
132632801600000,NW 329,Residential,33609,98915,0,132524
132632801700000,NW 329,Residential,33099,102787,0,135886
132632801800000,NW 329,Residential,30243,93596,0,123839
132632801900000,NW 329,Residential,28050,90901,0,118951
132632802000000,NW 329,Residential,32690,85894,0,118584
132632802100000,NW 329,Residential,32320,85628,0,117948
132632802200000,NW 329,Residential,29795,74981,0,104776
132632802300000,NW 329,Residential,32421,96364,0,128785
132632802400000,NW 329,Residential,30199,85178,0,115377
132632802500000,NW 329,Residential,33553,103917,0,137470
132632802600000,NW 329,Residential,33839,82733,0,116572
132632802700000,NW 329,Residential,31815,82586,0,114401
132632802800000,NW 329,Residential,31815,80715,0,112530
132632802900000,NW 329,Residential,31815,91227,0,123042
132632803000000,NW 329,Residential,31815,88884,0,120699
132632803100000,NW 329,Residential,31815,92466,0,124281
132632803200000,NW 329,Residential,31815,86335,0,118150
132632803300000,NW 329,Residential,31815,96482,0,128297
132632900100000,NW 329,Residential,34144,86444,0,120588
132632900200000,NW 329,Residential,31040,83591,0,114631
132632900300000,NW 329,Residential,34532,84223,0,118755
132633000100000,NW 329,Residential,34047,92016,0,126063
132633000200000,NW 329,Residential,31040,95251,0,126291
132633000300000,NW 329,Residential,33974,95111,0,129085
132633100100000,NW 329,Residential,33221,103235,0,136456
132633100200000,NW 329,Residential,31549,90313,0,121862
132633100300000,NW 329,Residential,31477,75223,0,106700
132633100400000,NW 329,Residential,31477,80896,0,112373
132633100500000,NW 329,Residential,31477,93671,0,125148
132633100600000,NW 329,Residential,31477,83048,0,114525
132633100700000,NW 329,Residential,31477,69339,0,100816
132633100800000,NW 329,Residential,31477,84321,0,115798
132633100900000,NW 329,Residential,31477,109099,0,140576
132633101000000,NW 329,Residential,31477,92958,0,124435
132633101100000,NW 329,Residential,35344,94367,0,129711
132633101200000,NW 329,Residential,33461,92759,0,126220
132633101300000,NW 329,Residential,29100,80762,0,109862
132633101400000,NW 329,Residential,29100,87050,0,116150
132633101500000,NW 329,Residential,26675,93742,0,120417
132633101600000,NW 329,Residential,29100,92766,0,121866
132633101700000,NW 329,Residential,26675,87758,0,114433
132633101800000,NW 329,Residential,29100,86845,0,115945
132633101900000,NW 329,Residential,31283,103321,0,134604
132633102000000,NW 329,Residential,26675,81050,0,107725
132633102100000,NW 329,Residential,31283,80571,0,111854
132633102200000,NW 329,Residential,26594,80562,0,107156
132633102300000,NW 329,Residential,33934,106812,0,140746
132633102400000,NW 329,Residential,28500,92881,0,121381
132633200100000,NW 329,Residential,33067,96302,0,129369
132633200200000,NW 329,Residential,30555,88606,0,119161
132633200300000,NW 329,Residential,35137,96171,0,131308
132633300100000,NW 329,Residential,32475,94361,0,126836
132633300200000,NW 329,Residential,29181,87565,0,116746
132633300300000,NW 329,Residential,26675,78833,0,105508
132633300400000,NW 329,Residential,29100,87094,0,116194
132633300500000,NW 329,Residential,31428,94297,0,125725
132633300600000,NW 329,Residential,30313,87293,0,117606
132633300700000,NW 329,Residential,30313,92006,0,122319
132633300800000,NW 329,Residential,26675,81130,0,107805
132633300900000,NW 329,Residential,29100,96548,0,125648
132633301000000,NW 329,Residential,26675,80374,0,107049
132633301100000,NW 329,Residential,26675,91683,0,118358
132633301200000,NW 329,Residential,30025,102359,0,132384
132633301300000,NW 329,Residential,29475,99965,0,129440
132633301400000,NW 329,Residential,29400,88462,0,117862
132633301500000,NW 329,Residential,29400,97614,0,127014
132633301600000,NW 329,Residential,29400,96094,0,125494
132633301700000,NW 329,Residential,29400,90266,0,119666
132633301800000,NW 329,Residential,29400,94712,0,124112
132633301900000,NW 329,Residential,30257,91889,0,122146
132633302000000,NW 329,Residential,30257,84805,0,115062
132633302100000,NW 329,Residential,29400,96322,0,125722
132633302200000,NW 329,Residential,29400,92298,0,121698
132633302300000,NW 329,Residential,29325,77256,0,106581
132633302400000,NW 329,Residential,34080,92642,0,126722
132633302500000,NW 329,Residential,31500,95574,0,127074
132633400100000,NW 329,Residential,29400,92495,0,121895
132633400200000,NW 329,Residential,31040,92225,0,123265
132633400300000,NW 329,Residential,31040,83857,0,114897
132633400400000,NW 329,Residential,31040,86543,0,117583
132633400500000,NW 329,Residential,26749,82863,0,109612
132633400600000,NW 329,Residential,26675,93261,0,119936
132633400700000,NW 329,Residential,26675,92777,0,119452
132633400800000,NW 329,Residential,26675,79765,0,106440
132633400900000,NW 329,Residential,26675,89175,0,115850
132633401000000,NW 329,Residential,26675,86825,0,113500
132633401100000,NW 329,Residential,26675,91291,0,117966
132633401200000,NW 329,Residential,26675,90442,0,117117
132633401300000,NW 329,Residential,26675,91021,0,117696
132633401400000,NW 329,Residential,26675,99599,0,126274
132633401500000,NW 329,Residential,26675,94413,0,121088
132633401600000,NW 329,Residential,31451,97133,0,128584
132635100100000,NW 329,Residential,26190,98972,0,125162
132635100200000,NW 329,Residential,27936,85146,0,113082
132635100300000,NW 329,Residential,27936,91163,0,119099
132635100400000,NW 329,Residential,27820,91258,0,119078
132635100500000,NW 329,Residential,26123,98975,0,125098
132635100600000,NW 329,Residential,26190,86563,0,112753
132635100700000,NW 329,Residential,26190,84810,0,111000
132635100800000,NW 329,Residential,26190,98061,0,124251
132635100900000,NW 329,Residential,26190,97512,0,123702
132635101000000,NW 329,Residential,26190,114160,0,140350
132635101100000,NW 329,Residential,26190,108172,0,134362
132635101200000,NW 329,Residential,26190,106081,0,132271
132635101300000,NW 329,Residential,26190,101778,0,127968
132635101400000,NW 329,Residential,26190,101622,0,127812
132635101500000,NW 329,Residential,29091,94763,0,123854
132635200100000,NW 329,Residential,33099,91720,0,124819
132635200200000,NW 332,Residential,50639,205855,0,256494
132635200300000,NW 329,Residential,34603,93019,0,127622
132635300100000,NW 329,Residential,26190,83543,0,109733
132635300200000,NW 329,Residential,27936,70790,0,98726
132635300300000,NW 329,Residential,27936,87656,0,115592
132635300400000,NW 329,Residential,27878,81413,0,109291
132635300500000,NW 329,Residential,24074,98160,0,122234
132635300600000,NW 329,Residential,24008,91059,0,115067
132635300700000,NW 329,Residential,24008,90862,0,114870
132635300800000,NW 329,Residential,24008,93826,0,117834
132635300900000,NW 329,Residential,27980,92137,0,120117
132635301000000,NW 329,Residential,27980,91952,0,119932
132635301100000,NW 329,Residential,27980,98264,0,126244
132635301200000,NW 329,Residential,27980,97123,0,125103
132635301300000,NW 329,Residential,27980,100930,0,128910
132635301400000,NW 329,Residential,27980,99143,0,127123
132635301500000,NW 329,Residential,27980,92778,0,120758
132635301600000,NW 329,Residential,27980,91615,0,119595
132635301700000,NW 329,Residential,27980,98099,0,126079
132635301800000,NW 329,Residential,28032,70941,0,98973
132635301900000,NW 329,Residential,35139,125059,0,160198
132635302001000,CONDO 501,Residential,27000,158746,0,185746
132635302101000,CONDO 501,Residential,27000,153295,0,180295
132635302201000,CONDO 501,Residential,27000,156349,0,183349
132635302301000,CONDO 501,Residential,27000,152948,0,179948
132635302401000,CONDO 501,Residential,27000,144115,0,171115
132635302501000,CONDO 501,Residential,27000,129052,0,156052
132635302601000,CONDO 501,Residential,27000,136778,0,163778
132635302701000,CONDO 501,Residential,27000,146176,0,173176
132635302801000,CONDO 501,Residential,27000,147171,0,174171
132635302901000,CONDO 501,Residential,27000,143266,0,170266
132635303001000,CONDO 501,Residential,27000,141572,0,168572
132635303101000,CONDO 501,Residential,27000,137700,0,164700
132635303201000,CONDO 501,Residential,27000,147207,0,174207
132635303301000,CONDO 501,Residential,27000,157349,0,184349
132635303401000,CONDO 501,Residential,27000,142153,0,169153
132635303501000,CONDO 501,Residential,27000,155508,0,182508
132635303601000,CONDO 501,Residential,27000,146546,0,173546
132635303701000,CONDO 501,Residential,27000,144895,0,171895
132635303801000,CONDO 501,Residential,27000,151638,0,178638
132635303901000,CONDO 501,Residential,27000,146273,0,173273
132635304001000,CONDO 501,Residential,27000,152614,0,179614
132635304101000,CONDO 501,Residential,27000,160551,0,187551
132635304201000,CONDO 501,Residential,27000,146497,0,173497
132635304301000,CONDO 501,Residential,27000,152933,0,179933
132635304401000,CONDO 501,Residential,27000,144302,0,171302
132635304501000,CONDO 501,Residential,27000,151282,0,178282
132635304601000,CONDO 501,Residential,27000,146354,0,173354
132635304701000,CONDO 501,Residential,27000,150114,0,177114
132635304801000,CONDO 501,Residential,27000,141967,0,168967
132635304801001,CONDO 501,Residential,27000,144633,0,171633
132635304801002,CONDO 501,Residential,27000,153965,0,180965
132635304801003,CONDO 501,Residential,27000,157231,0,184231
132635304801004,CONDO 501,Residential,27000,152186,0,179186
132635304801005,CONDO 501,Residential,27000,148723,0,175723
132635304901000,CONDO 503,Residential,9000,93003,0,102003
132635304901001,CONDO 503,Residential,7000,85770,0,92770
132635304901002,CONDO 503,Residential,8000,73975,0,81975
132635304901003,CONDO 503,Residential,7000,72988,0,79988
132635305001000,CONDO 503,Residential,9000,99221,0,108221
132635305001001,CONDO 503,Residential,7000,84410,0,91410
132635305001002,CONDO 503,Residential,8000,75365,0,83365
132635305001003,CONDO 503,Residential,7000,74934,0,81934
132635305101000,CONDO 503,Residential,9000,97123,0,106123
132635305101001,CONDO 503,Residential,7000,86554,0,93554
132635305101002,CONDO 503,Residential,8000,73818,0,81818
132635305101003,CONDO 503,Residential,7000,66844,0,73844
132635400101000,CONDO 503,Residential,9000,94708,0,103708
132635400101001,CONDO 503,Residential,7000,87839,0,94839
132635400101002,CONDO 503,Residential,8000,70439,0,78439
132635400101003,CONDO 503,Residential,7000,67363,0,74363
132635400201000,CONDO 503,Residential,9000,89653,0,98653
132635400201001,CONDO 503,Residential,7000,83404,0,90404
132635400201002,CONDO 503,Residential,8000,70439,0,78439
132635400201003,CONDO 503,Residential,7000,66844,0,73844
132635400301000,CONDO 503,Residential,9000,101715,0,110715
132635400301001,CONDO 503,Residential,7000,99006,0,106006
132635400301002,CONDO 503,Residential,8000,83367,0,91367
132635400301003,CONDO 503,Residential,7000,78717,0,85717
132635400401000,CONDO 503,Residential,9000,110244,0,119244
132635400401001,CONDO 503,Residential,7000,90561,0,97561
132635400401002,CONDO 503,Residential,8000,84964,0,92964
132635400401003,CONDO 503,Residential,7000,81333,0,88333
132635400500000,NW 321,Residential,20,0,0,20
132635400501000,CONDO 503,Residential,9000,109090,0,118090
132635400501001,CONDO 503,Residential,7000,98910,0,105910
132635400501002,CONDO 503,Residential,8000,81205,0,89205
132635400501003,CONDO 503,Residential,7000,87252,0,94252
132635500101000,CONDO 503,Residential,9000,110529,0,119529
132635500101001,CONDO 503,Residential,7000,98901,0,105901
132635500101002,CONDO 503,Residential,8000,86580,0,94580
132635500101003,CONDO 503,Residential,7000,84066,0,91066
132635500201000,CONDO 503,Residential,9000,102356,0,111356
132635500201001,CONDO 503,Residential,7000,98102,0,105102
132635500201002,CONDO 503,Residential,8000,81205,0,89205
132635500201003,CONDO 503,Residential,7000,78717,0,85717
132635500301000,CONDO 503,Residential,9000,113450,0,122450
132635500301001,CONDO 503,Residential,7000,91234,0,98234
132635500301002,CONDO 503,Residential,8000,86223,0,94223
132635500301003,CONDO 503,Residential,7000,78717,0,85717
132635500401000,CONDO 503,Residential,9000,111209,0,120209
132635500401001,CONDO 503,Residential,7000,99951,0,106951
132635500401002,CONDO 503,Residential,8000,87131,0,95131
132635500401003,CONDO 503,Residential,7000,87282,0,94282
132635500601000,CONDO 501,Residential,27000,129192,0,156192
132635500701000,CONDO 501,Residential,27000,143348,0,170348
132635500801000,CONDO 501,Residential,27000,147051,0,174051
132635500901000,CONDO 501,Residential,27000,145273,0,172273
132635501001000,CONDO 501,Residential,27000,155111,0,182111
132635501101000,CONDO 501,Residential,27000,141112,0,168112
132635501201000,CONDO 501,Residential,27000,154832,0,181832
132635501301000,CONDO 501,Residential,27000,137144,0,164144
132635501401000,CONDO 501,Residential,27000,154807,0,181807
132635501501000,CONDO 501,Residential,27000,141236,0,168236
132635501601000,CONDO 501,Residential,27000,154175,0,181175
132635501701000,CONDO 501,Residential,27000,150075,0,177075
132635501801000,CONDO 501,Residential,27000,149664,0,176664
132635501901000,CONDO 501,Residential,27000,148147,0,175147
132635502000000,NW 321,Residential,81600,0,0,81600
132635502002000,COMM SW,Commercial,0,0,8442,8442
132635502101000,CONDO 501,Residential,27000,147896,0,174896
132635502201000,CONDO 501,Residential,27000,147668,0,174668
132635502301000,CONDO 501,Residential,27000,144663,0,171663
132635502401000,CONDO 501,Residential,27000,128893,0,155893
132635502501000,CONDO 501,Residential,27000,149529,0,176529
132635502601000,CONDO 501,Residential,27000,148213,0,175213
132635502701000,CONDO 501,Residential,27000,148617,0,175617
132635502801000,CONDO 501,Residential,27000,146401,0,173401
132635502901000,CONDO 501,Residential,27000,147251,0,174251
132635503001000,CONDO 501,Residential,27000,140792,0,167792
132635503101000,CONDO 501,Residential,27000,155964,0,182964
132635503201000,CONDO 501,Residential,27000,147221,0,174221
132637600100000,NW 329,Residential,32000,90377,0,122377
132637600200000,NW 329,Residential,25933,80605,0,106538
132637600300000,NW 329,Residential,30000,98858,0,128858
132637600400000,NW 329,Residential,26000,81760,0,107760
132637600500000,NW 329,Residential,29000,95836,0,124836
132637600600000,NW 329,Residential,29067,93061,0,122128
132637600700000,NW 329,Residential,27552,83706,0,111258
132637600800000,NW 329,Residential,26190,92913,0,119103
132637600900000,NW 329,Residential,26190,90660,0,116850
132637601000000,NW 329,Residential,26190,90260,0,116450
132637601100000,NW 329,Residential,26190,88861,0,115051
132637601200000,NW 329,Residential,26190,84959,0,111149
132637601300000,NW 329,Residential,26190,88453,0,114643
132637601400000,NW 329,Residential,26190,85956,0,112146
132637601500000,NW 329,Residential,26190,89942,0,116132
132637601600000,NW 329,Residential,26190,82308,0,108498
132637601700000,NW 329,Residential,26190,79588,0,105778
132637601800000,NW 329,Residential,27447,86273,0,113720
132637601900000,APTS SW,Commercial,891837,0,5407696,6299533
132637602000000,COMM SW,Commercial,419688,0,281656,701344
132637602002000,COMM SW,Commercial,0,0,4555,4555
132637602100000,COMM SW,Commercial,140873,0,0,140873
132637700100000,NW 329,Residential,30966,88855,0,119821
132637700200000,NW 329,Residential,32191,90784,0,122975
132637700300000,NW 329,Residential,29100,83718,0,112818
132637700400000,NW 329,Residential,29100,100519,0,129619
132637700500000,NW 329,Residential,29100,93942,0,123042
132637700600000,NW 329,Residential,29100,98435,0,127535
132637700700000,NW 329,Residential,29100,79073,0,108173
132637700800000,NW 329,Residential,29100,86045,0,115145
132637700900000,NW 329,Residential,29100,97728,0,126828
132637701000000,NW 329,Residential,29100,96274,0,125374
132637701100000,NW 329,Residential,29100,81403,0,110503
132637701200000,NW 329,Residential,29100,98711,0,127811
132637701300000,NW 329,Residential,32314,100200,0,132514
132637800100000,NW 329,Residential,29569,86102,0,115671
132637800200000,NW 329,Residential,27936,92470,0,120406
132637800300000,NW 329,Residential,26190,91590,0,117780
132637800400000,NW 329,Residential,27936,93443,0,121379
132637800500000,NW 329,Residential,27936,82714,0,110650
132637800600000,NW 329,Residential,27936,99597,0,127533
132637900100000,NW 329,Residential,29516,97959,0,127475
132637900200000,NW 329,Residential,27936,92293,0,120229
132637900300000,NW 329,Residential,26190,82651,0,108841
132637900400000,NW 329,Residential,27936,93446,0,121382
132637900500000,NW 329,Residential,27936,78553,0,106489
132637900600000,NW 329,Residential,27936,79729,0,107665
132637900701000,CONDO 503,Residential,9000,93043,0,102043
132637900701001,CONDO 503,Residential,7000,83680,0,90680
132637900701002,CONDO 503,Residential,8000,73068,0,81068
132637900701003,CONDO 503,Residential,7000,66844,0,73844
132637900801000,CONDO 503,Residential,9000,92804,0,101804
132637900801001,CONDO 503,Residential,7000,82256,0,89256
132637900801002,CONDO 503,Residential,8000,70403,0,78403
132637900801003,CONDO 503,Residential,7000,66844,0,73844
132637900901000,CONDO 503,Residential,9000,92094,0,101094
132637900901001,CONDO 503,Residential,7000,83775,0,90775
132637900901002,CONDO 503,Residential,8000,70439,0,78439
132637900901003,CONDO 503,Residential,7000,66844,0,73844
132637901000000,COMM SW,Commercial,81421,0,184489,265910
132638000101000,CONDO 503,Residential,9000,108113,0,117113
132638000101001,CONDO 503,Residential,7000,96841,0,103841
132638000101002,CONDO 503,Residential,8000,80889,0,88889
132638000101003,CONDO 503,Residential,7000,78455,0,85455
132638000201000,CONDO 503,Residential,9000,108398,0,117398
132638000201001,CONDO 503,Residential,7000,97146,0,104146
132638000201002,CONDO 503,Residential,8000,80889,0,88889
132638000201003,CONDO 503,Residential,7000,82882,0,89882
132638000301000,CONDO 503,Residential,9000,97953,0,106953
132638000301001,CONDO 503,Residential,7000,80791,0,87791
132638000301002,CONDO 503,Residential,8000,73621,0,81621
132638000301003,CONDO 503,Residential,7000,68645,0,75645
132638000401000,CONDO 503,Residential,9000,109378,0,118378
132638000401001,CONDO 503,Residential,7000,97615,0,104615
132638000401002,CONDO 503,Residential,8000,86251,0,94251
132638000401003,CONDO 503,Residential,7000,86374,0,93374
132638000501000,CONDO 503,Residential,9000,109974,0,118974
132638000501001,CONDO 503,Residential,7000,98929,0,105929
132638000501002,CONDO 503,Residential,8000,83940,0,91940
132638000501003,CONDO 503,Residential,7000,78717,0,85717
132640100100000,NW 329,Residential,30293,107924,0,138217
132640100200000,NW 329,Residential,30000,110375,0,140375
132640100300000,NW 329,Residential,30000,120678,0,150678
132640100400000,NW 329,Residential,30000,121765,0,151765
132640100500000,NW 329,Residential,30000,112968,0,142968
132640100600000,NW 329,Residential,30823,110616,0,141439
132640200100000,NW 329,Residential,30526,101150,0,131676
132640200200000,NW 329,Residential,29936,124974,0,154910
132640200300000,NW 329,Residential,31203,113131,0,144334
132640200400000,NW 329,Residential,31255,123866,0,155121
132640200500000,NW 329,Residential,31916,109083,0,140999
132640200600000,NW 329,Residential,31200,115711,0,146911
132640200700000,NW 329,Residential,31200,101996,0,133196
132640200800000,NW 329,Residential,31200,116612,0,147812
132640200900000,NW 329,Residential,30000,103510,0,133510
132640201000000,NW 329,Residential,31200,126937,0,158137
132640201100000,NW 329,Residential,30000,125650,0,155650
132640201200000,NW 329,Residential,30000,121808,0,151808
132640201300000,NW 329,Residential,30000,110500,0,140500
132640201400000,NW 329,Residential,30000,143491,0,173491
132640201500000,NW 329,Residential,31338,129134,0,160472
132640300100000,NW 329,Residential,32727,127741,0,160468
132640300200000,NW 329,Residential,33716,142358,0,176074
132640300300000,NW 329,Residential,31680,119616,0,151296
132640300400000,NW 329,Residential,33359,113286,0,146645
132640300500000,NW 329,Residential,26525,107213,0,133738
132640300600000,NW 329,Residential,25568,99424,0,124992
132640300700000,NW 329,Residential,25703,94186,0,119889
132640300800000,NW 329,Residential,29169,105691,0,134860
132640300900000,NW 329,Residential,35016,155751,0,190767
132640400100000,NW 329,Residential,29777,138332,0,168109
132640400200000,NW 329,Residential,33512,116902,0,150414
132640400300000,NW 329,Residential,32640,104142,0,136782
132640400400000,NW 329,Residential,32640,105447,0,138087
132640400500000,NW 329,Residential,32640,103110,0,135750
132640400600000,NW 329,Residential,31960,108697,0,140657
132640400700000,NW 329,Residential,31960,112879,0,144839
132640400800000,NW 329,Residential,31960,107749,0,139709
132640400900000,NW 329,Residential,32640,115973,0,148613
132640401000000,NW 329,Residential,32640,140149,0,172789
132640401100000,NW 329,Residential,32640,106367,0,139007
132640500100000,NW 329,Residential,30051,99221,0,129272
132640500200000,NW 329,Residential,30378,130570,0,160948
132640500300000,NW 329,Residential,30096,108637,0,138733
132640500400000,NW 329,Residential,30096,122551,0,152647
132640500500000,NW 329,Residential,30096,125534,0,155630
132640500600000,NW 329,Residential,30096,130313,0,160409
132640500700000,NW 329,Residential,30096,131109,0,161205
132640500800000,NW 329,Residential,30096,128093,0,158189
132640500900000,NW 329,Residential,30096,138630,0,168726
132640501000000,NW 329,Residential,30096,127746,0,157842
132640501100000,NW 329,Residential,30096,112592,0,142688
132640501200000,NW 329,Residential,30096,106649,0,136745
132640501300000,NW 329,Residential,30096,112646,0,142742
132640501400000,NW 329,Residential,30096,116034,0,146130
132640501500000,NW 329,Residential,30096,100005,0,130101
132640501600000,NW 329,Residential,30096,125728,0,155824
132640501700000,NW 329,Residential,28512,124817,0,153329
132640501800000,NW 329,Residential,30096,125855,0,155951
132640600100000,NW 329,Residential,30356,134730,0,165086
132640600200000,NW 329,Residential,39167,122737,0,161904
132640600300000,NW 329,Residential,38220,108752,0,146972
132640600400000,NW 329,Residential,35280,123172,0,158452
132640600500000,NW 329,Residential,38220,134040,0,172260
132640600600000,NW 329,Residential,36750,106730,0,143480
132640600700000,NW 329,Residential,37730,96038,0,133768
132640600800000,NW 329,Residential,37240,105668,0,142908
132640600900000,NW 329,Residential,37240,109660,0,146900
132640601000000,NW 329,Residential,37041,86491,0,123532
132640601100000,NW 329,Residential,29792,125254,0,155046
132640601200000,NW 329,Residential,29792,165815,0,195607
132640601300000,NW 329,Residential,29792,133060,0,162852
132640601400000,NW 329,Residential,29792,135338,0,165130
132640601500000,NW 329,Residential,29792,118703,0,148495
132640601600000,NW 329,Residential,29792,114807,0,144599
132640601700000,NW 329,Residential,29792,109222,0,139014
132640601800000,NW 329,Residential,29792,117037,0,146829
132640700100000,NW 329,Residential,30046,115819,0,145865
132640700200000,NW 329,Residential,32393,104482,0,136875
132640700300000,NW 329,Residential,32090,127660,0,159750
132640700400000,NW 329,Residential,29700,143717,0,173417
132640700500000,NW 329,Residential,28423,104413,0,132836
132640700600000,NW 329,Residential,27448,126264,0,153712
132640700700000,NW 329,Residential,27448,110256,0,137704
132640700800000,NW 329,Residential,27448,109052,0,136500
132640700900000,NW 329,Residential,27448,110581,0,138029
132640701000000,NW 329,Residential,27448,131220,0,158668
132640701100000,NW 329,Residential,27448,100157,0,127605
132640701200000,NW 329,Residential,27448,94631,0,122079
132640701300000,NW 329,Residential,27448,118917,0,146365
132640701400000,NW 329,Residential,27448,108529,0,135977
132640701500000,NW 329,Residential,27448,100569,0,128017
132640701600000,NW 329,Residential,28208,102406,0,130614
132640701700000,NW 329,Residential,29184,104822,0,134006
132640701800000,NW 329,Residential,29328,121161,0,150489
132640701901000,CONDO 500,Residential,3800,38926,0,42726
132640701901001,CONDO 500,Residential,3800,38926,0,42726
132640701901002,CONDO 500,Residential,3800,39544,0,43344
132640701901003,CONDO 500,Residential,3800,39544,0,43344
132640701901004,CONDO 500,Residential,3800,39544,0,43344
132640701901005,CONDO 500,Residential,3800,39544,0,43344
132640701901006,CONDO 500,Residential,3800,37682,0,41482
132640701901007,CONDO 500,Residential,3800,38300,0,42100
132640701901008,CONDO 500,Residential,3800,38926,0,42726
132640701901009,CONDO 500,Residential,3800,38926,0,42726
132640701901010,CONDO 500,Residential,3800,38926,0,42726
132640701901011,CONDO 500,Residential,3800,38926,0,42726
132640701901012,CONDO 500,Residential,3800,38300,0,42100
132640701901013,CONDO 500,Residential,3800,37682,0,41482
132640701901014,CONDO 500,Residential,3800,38926,0,42726
132640701901015,CONDO 500,Residential,3800,38926,0,42726
132640701901016,CONDO 500,Residential,3800,38926,0,42726
132640701901017,CONDO 500,Residential,3800,38926,0,42726
132640800100000,APTS SW,Commercial,28593,0,279915,308508
132640800200000,NW 329,Residential,33061,101236,0,134297
132640800300000,NW 329,Residential,26320,105274,0,131594
132640800400000,NW 329,Residential,26320,112807,0,139127
132640800500000,NW 329,Residential,27720,94233,0,121953
132640800600000,NW 329,Residential,29120,97167,0,126287
132640800700000,NW 329,Residential,24700,126677,0,151377
132640800800000,NW 329,Residential,22989,94843,0,117832
132640800900000,NW 329,Residential,22232,100570,0,122802
132640801000000,NW 329,Residential,22344,135986,0,158330
132640801100000,NW 329,Residential,23092,104834,0,127926
132640801200000,NW 329,Residential,21008,131626,0,152634
132640801300000,NW 329,Residential,22230,87770,0,110000
132640801400000,NW 329,Residential,22504,112696,0,135200
132640801500000,NW 329,Residential,22560,109986,0,132546
132640801600000,NW 329,Residential,19176,109491,0,128667
132640801700000,NW 329,Residential,19740,124349,0,144089
132640801800000,APTS SW,Commercial,24895,0,306397,331292
132640900100000,NW 329,Residential,22494,97340,0,119834
132640900200000,NW 329,Residential,21243,141599,0,162842
132640900300000,NW 329,Residential,22116,121970,0,144086
132640900400000,NW 329,Residential,23491,150647,0,174138
132640900500000,NW 329,Residential,29488,114391,0,143879
132640900600000,NW 329,Residential,29488,115976,0,145464
132640900700000,NW 329,Residential,29488,99874,0,129362
132640900800000,NW 329,Residential,29488,105457,0,134945
132640900900000,NW 329,Residential,29184,101580,0,130764
132640901000000,NW 329,Residential,21825,99852,0,121677
132640901100000,NW 329,Residential,22116,116526,0,138642
132640901200000,NW 329,Residential,22896,109351,0,132247
132640901300000,NW 329,Residential,23317,117821,0,141138
132641000100000,NW 329,Residential,22133,115966,0,138099
132641000200000,NW 329,Residential,20593,137423,0,158016
132641000300000,NW 329,Residential,22185,98156,0,120341
132642600100000,NW 329,Residential,35578,99610,0,135188
132642600200000,NW 329,Residential,32126,113432,0,145558
132642600300000,NW 329,Residential,32126,85453,0,117579
132642600400000,NW 329,Residential,32126,103332,0,135458
132642600500000,NW 329,Residential,32126,78981,0,111107
132642600600000,NW 329,Residential,32126,92409,0,124535
132642600700000,NW 329,Residential,32126,92230,0,124356
132642600800000,NW 329,Residential,32126,89079,0,121205
132642600900000,NW 329,Residential,32126,85440,0,117566
132642601000000,NW 329,Residential,32126,80705,0,112831
132642601100000,NW 329,Residential,34158,87940,0,122098
132642700100000,NW 321,Residential,34936,144955,0,179891
132642700200000,NW 321,Residential,33792,147286,0,181078
132642700300000,NW 321,Residential,33792,141080,0,174872
132642700400000,NW 321,Residential,33737,143187,0,176924
132642700500000,NW 321,Residential,37297,147942,0,185239
132642700600000,NW 321,Residential,36808,151966,0,188774
132642700700000,NW 321,Residential,33657,151238,0,184895
132642700800000,NW 321,Residential,33792,124178,0,157970
132642700900000,NW 321,Residential,33792,138113,0,171905
132642701000000,NW 321,Residential,34560,130128,0,164688
132642701100000,NW 321,Residential,36986,121340,0,158326
132642701200000,NW 329,Residential,35932,90340,0,126272
132642701300000,NW 329,Residential,32126,89602,0,121728
132642701400000,NW 329,Residential,32126,92831,0,124957
132642701500000,NW 329,Residential,32126,98012,0,130138
132642701600000,NW 329,Residential,32126,88717,0,120843
132642701700000,NW 329,Residential,32126,81937,0,114063
132642701800000,NW 329,Residential,32126,90000,0,122126
132642701900000,NW 329,Residential,32126,91591,0,123717
132642702000000,NW 329,Residential,32126,86704,0,118830
132642702100000,NW 329,Residential,35067,94960,0,130027
132642702200000,E-15 CITY,Exempt,0,0,0,0
132642800100000,NW 329,Residential,35099,109914,0,145013
132642800200000,NW 329,Residential,31680,92521,0,124201
132642800300000,NW 329,Residential,34745,104995,0,139740
132642800400000,NW 329,Residential,31664,85488,0,117152
132642800500000,NW 329,Residential,31878,92064,0,123942
132642800600000,NW 329,Residential,31878,81414,0,113292
132642800700000,NW 329,Residential,31878,96527,0,128405
132642800800000,NW 329,Residential,31878,83322,0,115200
132642800900000,NW 329,Residential,31878,87995,0,119873
132642801000000,NW 329,Residential,38066,82761,0,120827
132642801100000,NW 329,Residential,27975,96553,0,124528
132642801200000,NW 329,Residential,25344,102986,0,128330
132642801300000,NW 329,Residential,27900,95436,0,123336
132642801400000,NW 329,Residential,33369,109780,0,143149
132642801500000,NW 329,Residential,31878,97816,0,129694
132642801600000,NW 329,Residential,31878,117313,0,149191
132642801700000,NW 329,Residential,31878,96200,0,128078
132642801800000,NW 329,Residential,31878,99574,0,131452
132642801900000,NW 329,Residential,31878,97809,0,129687
132642802000000,NW 329,Residential,32084,114402,0,146486
132642900100000,NW 329,Residential,35099,95075,0,130174
132642900200000,NW 329,Residential,31680,81041,0,112721
132642900300000,NW 329,Residential,34745,74411,0,109156
132642900400000,NW 329,Residential,31664,106903,0,138567
132642900500000,NW 329,Residential,31878,97176,0,129054
132642900600000,NW 329,Residential,31878,96275,0,128153
132642900700000,NW 329,Residential,31878,85361,0,117239
132642900800000,NW 329,Residential,31878,91674,0,123552
132642900900000,NW 329,Residential,31878,82984,0,114862
132642901000000,NW 329,Residential,35165,101939,0,137104
132642901100000,NW 329,Residential,27975,115511,0,143486
132642901200000,NW 329,Residential,25344,96190,0,121534
132642901300000,NW 329,Residential,27900,97199,0,125099
132642901400000,NW 329,Residential,34244,101445,0,135689
132642901500000,NW 329,Residential,31878,91339,0,123217
132642901600000,NW 329,Residential,31878,87800,0,119678
132642901700000,NW 329,Residential,31878,89181,0,121059
132642901800000,NW 329,Residential,31878,79993,0,111871
132642901900000,NW 329,Residential,31878,82965,0,114843
132642902000000,NW 329,Residential,32084,84529,0,116613
132643000100000,NW 329,Residential,27975,116910,0,144885
132643000200000,NW 329,Residential,25344,114797,0,140141
132643000300000,NW 329,Residential,27900,89016,0,116916
132643000400000,NW 329,Residential,31664,122162,0,153826
132643000500000,NW 329,Residential,31779,103764,0,135543
132643000600000,NW 329,Residential,31779,74129,0,105908
132643000700000,NW 329,Residential,31779,99543,0,131322
132643000800000,NW 329,Residential,25423,95491,0,120914
132643000900000,NW 329,Residential,25423,95940,0,121363
132643001000000,NW 329,Residential,25423,95745,0,121168
132643001100000,NW 329,Residential,25423,141001,0,166424
132643100100000,NW 329,Residential,27975,84527,0,112502
132643100200000,NW 329,Residential,25085,95837,0,120922
132643100300000,NW 329,Residential,26721,105911,0,132632
132643100400000,NW 329,Residential,30360,89131,0,119491
132643100500000,NW 329,Residential,31185,92919,0,124104
132643100600000,NW 329,Residential,31185,87211,0,118396
132643100700000,NW 329,Residential,31185,89863,0,121048
132643100800000,NW 329,Residential,32126,79798,0,111924
132643100900000,NW 329,Residential,32126,86873,0,118999
132643101000000,NW 329,Residential,32126,114318,0,146444
132643101100000,NW 329,Residential,32216,107267,0,139483
132643200100000,NW 329,Residential,26817,91579,0,118396
132643200200000,NW 329,Residential,25476,77583,0,103059
132643200300000,NW 329,Residential,26928,93714,0,120642
132643200400000,NW 329,Residential,31977,92500,0,124477
132643200500000,NW 329,Residential,32917,105747,0,138664
132643200600000,NW 329,Residential,27225,93705,0,120930
132643200700000,NW 329,Residential,31680,93534,0,125214
132643200800000,NW 329,Residential,31185,82439,0,113624
132643200900000,NW 329,Residential,31185,85759,0,116944
132643201000000,NW 329,Residential,31185,95075,0,126260
132643201100000,NW 329,Residential,30925,91349,0,122274
132643300100000,NW 329,Residential,28499,112824,0,141323
132643300200000,NW 329,Residential,24779,93379,0,118158
132643300300000,NW 329,Residential,26434,98455,0,124889
132643300400000,NW 329,Residential,34836,92849,0,127685
132643300500000,NW 329,Residential,31680,87333,0,119013
132643300600000,NW 329,Residential,29700,96944,0,126644
132643300700000,NW 329,Residential,27225,91350,0,118575
132643300800000,NW 329,Residential,32917,93745,0,126662
132643300900000,NW 329,Residential,31680,81103,0,112783
132643301000000,NW 329,Residential,31680,87483,0,119163
132643301100000,NW 329,Residential,29700,102000,0,131700
132643301200000,NW 329,Residential,31680,92917,0,124597
132643301300000,NW 329,Residential,33284,79543,0,112827
132643400100000,NW 329,Residential,27751,105189,0,132940
132643400200000,NW 329,Residential,26400,100624,0,127024
132643400300000,NW 329,Residential,32791,92724,0,125515
132643400400000,NW 329,Residential,28280,85631,0,113911
132643400500000,NW 329,Residential,28280,94285,0,122565
132643400600000,NW 329,Residential,30300,83616,0,113916
132643400700000,NW 329,Residential,30300,89036,0,119336
132643400800000,NW 329,Residential,32320,92660,0,124980
132643400900000,NW 329,Residential,30300,93919,0,124219
132645100100000,NW 329,Residential,25423,92815,0,118238
132645100200000,NW 329,Residential,31779,101277,0,133056
132645100300000,NW 329,Residential,31779,103732,0,135511
132645100400000,NW 329,Residential,31779,101468,0,133247
132645100500000,NW 329,Residential,31779,100928,0,132707
132645100600000,NW 329,Residential,31779,74309,0,106088
132645100700000,NW 329,Residential,31779,80708,0,112487
132645100800000,NW 329,Residential,31779,94503,0,126282
132645100900000,NW 329,Residential,31779,98168,0,129947
132645101000000,NW 329,Residential,33315,95206,0,128521
132645101100000,NW 329,Residential,33280,102561,0,135841
132645101200000,NW 329,Residential,35302,101772,0,137074
132645101300000,NW 329,Residential,28467,104138,0,132605
132645101400000,NW 329,Residential,26730,105563,0,132293
132645101500000,NW 329,Residential,25423,96826,0,122249
132645101600000,NW 329,Residential,25423,117249,0,142672
132645101700000,NW 329,Residential,25423,94518,0,119941
132645101800000,NW 329,Residential,25423,94537,0,119960
132645101900000,NW 329,Residential,25423,85762,0,111185
132645102000000,NW 329,Residential,25423,97204,0,122627
132645102100000,NW 329,Residential,25423,111186,0,136609
132645200100000,NW 329,Residential,32126,71859,0,103985
132645200200000,NW 329,Residential,31185,83938,0,115123
132645200300000,NW 329,Residential,31185,90252,0,121437
132645200400000,NW 329,Residential,31185,87227,0,118412
132645200500000,NW 329,Residential,31185,90574,0,121759
132645200600000,NW 329,Residential,31185,79223,0,110408
132645200700000,NW 329,Residential,31185,91436,0,122621
132645200800000,NW 329,Residential,31185,84174,0,115359
132645200900000,NW 329,Residential,31317,86023,0,117340
132645201000000,NW 329,Residential,31139,97687,0,128826
132645201100000,NW 329,Residential,31127,90263,0,121390
132645201200000,NW 329,Residential,30106,89351,0,119457
132645201300000,NW 329,Residential,29600,82217,0,111817
132645201400000,NW 329,Residential,31121,88122,0,119243
132645201500000,NW 329,Residential,34464,111035,0,145499
132645201600000,NW 329,Residential,37158,114280,0,151438
132645201700000,NW 329,Residential,34912,106381,0,141293
132645201800000,NW 329,Residential,34171,105318,0,139489
132645201900000,NW 329,Residential,33412,85264,0,118676
132645202000000,NW 329,Residential,33412,84355,0,117767
132645202100000,NW 329,Residential,32126,98500,0,130626
132645202200000,NW 329,Residential,32126,105229,0,137355
132645202300000,NW 329,Residential,32126,98095,0,130221
132645202400000,NW 329,Residential,32126,94912,0,127038
132645202500000,NW 329,Residential,32126,92494,0,124620
132645300100000,NW 329,Residential,31185,89728,0,120913
132645300200000,NW 329,Residential,29700,100208,0,129908
132645300300000,NW 329,Residential,29700,81030,0,110730
132645300400000,NW 329,Residential,32917,81919,0,114836
132645300500000,NW 329,Residential,32917,107864,0,140781
132645300600000,NW 329,Residential,31680,90622,0,122302
132645300700000,NW 329,Residential,31680,107430,0,139110
132645300800000,NW 329,Residential,31680,79693,0,111373
132645300900000,NW 329,Residential,27225,91744,0,118969
132645301000000,NW 329,Residential,32917,101550,0,134467
132645301100000,NW 329,Residential,32917,91600,0,124517
132645301200000,NW 329,Residential,29700,104863,0,134563
132645301300000,NW 329,Residential,31680,84802,0,116482
132645301400000,NW 329,Residential,33050,95724,0,128774
132645301500000,NW 329,Residential,28043,96212,0,124255
132645301600000,NW 329,Residential,30080,100794,0,130874
132645301700000,NW 329,Residential,31960,93837,0,125797
132645301800000,NW 329,Residential,48600,116285,0,164885
132645301900000,NW 329,Residential,33743,105163,0,138906
132645302000000,NW 329,Residential,31815,100040,0,131855
132645302100000,NW 329,Residential,30545,84572,0,115117
132645302200000,NW 329,Residential,29700,86011,0,115711
132645302300000,NW 329,Residential,29845,76984,0,106829
132645302400000,NW 329,Residential,31081,74710,0,105791
132645302500000,NW 329,Residential,31185,70313,0,101498
132645302600000,NW 329,Residential,31185,75793,0,106978
132645302700000,NW 329,Residential,31185,84850,0,116035
132645302800000,NW 329,Residential,31185,86651,0,117836
132645302900000,NW 329,Residential,31185,79889,0,111074
132645303000000,NW 329,Residential,31185,94787,0,125972
132645400100000,NW 329,Residential,29700,87907,0,117607
132645400200000,NW 329,Residential,29700,84575,0,114275
132645400300000,NW 329,Residential,28710,78415,0,107125
132645400400000,NW 329,Residential,29700,88619,0,118319
132645400500000,NW 329,Residential,32917,86055,0,118972
132645400600000,NW 329,Residential,27225,89930,0,117155
132645400700000,NW 329,Residential,28512,98283,0,126795
132645400800000,NW 329,Residential,28512,91594,0,120106
132645400900000,NW 329,Residential,26730,88611,0,115341
132645401000000,NW 329,Residential,24503,87233,0,111736
132645401100000,NW 329,Residential,29626,92887,0,122513
132645401200000,NW 329,Residential,30395,93973,0,124368
132645401300000,NW 329,Residential,33548,101548,0,135096
132645401400000,NW 329,Residential,27720,84033,0,111753
132645401500000,NW 329,Residential,29700,89904,0,119604
132645401600000,NW 329,Residential,27720,82486,0,110206
132645401700000,NW 329,Residential,27720,101286,0,129006
132645401800000,NW 329,Residential,29700,98026,0,127726
132645401900000,NW 329,Residential,27720,77486,0,105206
132645402000000,NW 329,Residential,27720,85730,0,113450
132645402100000,NW 329,Residential,29700,79649,0,109349
132645402200000,NW 329,Residential,27720,80216,0,107936
132645500100000,NW 329,Residential,28280,89119,0,117399
132645500200000,NW 329,Residential,32320,87888,0,120208
132645500300000,NW 329,Residential,28280,82170,0,110450
132645500400000,NW 329,Residential,30300,80993,0,111293
132645500500000,NW 329,Residential,28560,90704,0,119264
132645500600000,NW 329,Residential,27540,81935,0,109475
132645500700000,NW 329,Residential,25704,84774,0,110478
132645500800000,NW 329,Residential,25704,81785,0,107489
132645500900000,NW 329,Residential,27540,88226,0,115766
132645501000000,NW 329,Residential,25704,85798,0,111502
132645501100000,NW 329,Residential,29179,89190,0,118369
132645600100000,NW 329,Residential,50000,102909,0,152909
132645600200000,E-05 STATE,Exempt,0,0,0,0
132645700100000,NW 329,Residential,29163,88066,0,117229
132645700200000,NW 329,Residential,29140,80457,0,109597
132645700300000,NW 329,Residential,27808,95862,0,123670
132645700400000,NW 329,Residential,29280,84770,0,114050
132645700500000,NW 329,Residential,32473,104764,0,137237
132645700600000,NW 329,Residential,26954,85090,0,112044
132645700700000,NW 329,Residential,26190,95331,0,121521
132645700800000,NW 329,Residential,27936,80584,0,108520
132645700900000,NW 329,Residential,26190,87411,0,113601
132645701000000,NW 329,Residential,27155,95620,0,122775
132645701100000,NW 329,Residential,38563,70326,0,108889
132647600100000,NW 329,Residential,28733,169874,0,198607
132647600200000,NW 329,Residential,20445,115575,0,136020
132647600300000,NW 329,Residential,22185,158986,0,181171
132647600400000,NW 329,Residential,20445,133477,0,153922
132647700100000,NW 329,Residential,22572,129582,0,152154
132647700200000,NW 329,Residential,22275,131642,0,153917
132647700300000,E-40 CHURCHES,Exempt,423576,0,1035420,1458996
132647700400000,NW 329,Residential,29184,120756,0,149940
132647700500000,NW 329,Residential,22275,103230,0,125505
132647700600000,NW 329,Residential,22572,121209,0,143781
132647800101000,CONDO 500,Residential,4500,36473,0,40973
132647800101001,CONDO 500,Residential,4500,36473,0,40973
132647800101002,CONDO 500,Residential,4500,36473,0,40973
132647800101003,CONDO 500,Residential,4500,49477,0,53977
132647800101004,CONDO 500,Residential,4500,36473,0,40973
132647800101005,CONDO 500,Residential,4500,36473,0,40973
132647800101006,CONDO 500,Residential,4500,36473,0,40973
132647800101007,CONDO 500,Residential,4500,36473,0,40973
132647800101008,CONDO 500,Residential,4500,36473,0,40973
132647800101009,CONDO 500,Residential,4500,36473,0,40973
132647800101010,CONDO 500,Residential,4500,36473,0,40973
132647800101011,CONDO 500,Residential,4500,36473,0,40973
132647800101012,CONDO 500,Residential,4500,36473,0,40973
132647800101013,CONDO 500,Residential,4500,36473,0,40973
132647800101014,CONDO 500,Residential,4500,36473,0,40973
132647800101015,CONDO 500,Residential,4500,36473,0,40973
132647800101016,CONDO 500,Residential,4500,36473,0,40973
132647800101017,CONDO 500,Residential,4500,36473,0,40973
132647800101018,CONDO 500,Residential,4500,49477,0,53977
132647800101019,CONDO 500,Residential,4500,36473,0,40973
132647800101020,CONDO 500,Residential,4500,36473,0,40973
132647800101021,CONDO 500,Residential,4500,36473,0,40973
132647800101022,CONDO 500,Residential,4500,36473,0,40973
132647800101023,CONDO 500,Residential,4500,36473,0,40973
132647800101024,CONDO 500,Residential,4500,36473,0,40973
132647800101025,CONDO 500,Residential,4500,36473,0,40973
132647800101026,CONDO 500,Residential,4500,36473,0,40973
132647800101027,CONDO 500,Residential,4500,36473,0,40973
132647800101028,CONDO 500,Residential,4500,36473,0,40973
132647800101029,CONDO 500,Residential,4500,36473,0,40973
132647800101030,CONDO 500,Residential,4500,36473,0,40973
132647800101031,CONDO 500,Residential,4500,36473,0,40973
132647800101032,CONDO 500,Residential,4500,36473,0,40973
132647800101033,CONDO 500,Residential,4500,49477,0,53977
132647800101034,CONDO 500,Residential,4500,36473,0,40973
132647800101035,CONDO 500,Residential,4500,36473,0,40973
132647800101036,CONDO 500,Residential,4500,36473,0,40973
132647800101037,CONDO 500,Residential,4500,36473,0,40973
132647800101038,CONDO 500,Residential,4500,36473,0,40973
132647800101039,CONDO 500,Residential,4500,36473,0,40973
132647800101040,CONDO 500,Residential,4500,36473,0,40973
132647800101041,CONDO 500,Residential,4500,36473,0,40973
132647800101042,CONDO 500,Residential,4500,36473,0,40973
132647800101043,CONDO 500,Residential,4500,36473,0,40973
132647800101044,CONDO 500,Residential,4500,36473,0,40973
132647800101045,CONDO 500,Residential,4500,32835,0,37335
132647800101046,CONDO 500,Residential,4500,32835,0,37335
132647800101047,CONDO 500,Residential,4500,32835,0,37335
132647800101048,CONDO 500,Residential,4500,45839,0,50339
132647800101049,CONDO 500,Residential,4500,32835,0,37335
132647800101050,CONDO 500,Residential,4500,32835,0,37335
132647800101051,CONDO 500,Residential,4500,32835,0,37335
132647800101052,CONDO 500,Residential,4500,32835,0,37335
132647800101053,CONDO 500,Residential,4500,32835,0,37335
132647800101054,CONDO 500,Residential,4500,32835,0,37335
132647800101055,CONDO 500,Residential,4500,32835,0,37335
132647800101056,CONDO 500,Residential,4500,32835,0,37335
132647800101057,CONDO 500,Residential,4500,32835,0,37335
132647800101058,CONDO 500,Residential,4500,32835,0,37335
132647800101059,CONDO 500,Residential,4500,32835,0,37335
132647800101060,CONDO 500,Residential,4500,32835,0,37335
132647800101061,CONDO 500,Residential,4500,32835,0,37335
132647800101062,CONDO 500,Residential,4500,32835,0,37335
132647800101063,CONDO 500,Residential,4500,45839,0,50339
132647800101064,CONDO 500,Residential,4500,32835,0,37335
132647800101065,CONDO 500,Residential,4500,32835,0,37335
132647800101066,CONDO 500,Residential,4500,32835,0,37335
132647800101067,CONDO 500,Residential,4500,32835,0,37335
132647800101068,CONDO 500,Residential,4500,32835,0,37335
132647800101069,CONDO 500,Residential,4500,32835,0,37335
132647800101070,CONDO 500,Residential,4500,32835,0,37335
132647800101071,CONDO 500,Residential,4500,32835,0,37335
132647800101072,CONDO 500,Residential,4500,32835,0,37335
132647800101073,CONDO 500,Residential,4500,32835,0,37335
132647800101074,CONDO 500,Residential,4500,32835,0,37335
132647800101075,CONDO 500,Residential,4500,32835,0,37335
132647800101076,CONDO 500,Residential,4500,32835,0,37335
132647800101077,CONDO 500,Residential,4500,32835,0,37335
132647800101078,CONDO 500,Residential,4500,45839,0,50339
132647800101079,CONDO 500,Residential,4500,32835,0,37335
132647800101080,CONDO 500,Residential,4500,32835,0,37335
132647800101081,CONDO 500,Residential,4500,32835,0,37335
132647800101082,CONDO 500,Residential,4500,32835,0,37335
132647800101083,CONDO 500,Residential,4500,32835,0,37335
132647800101084,CONDO 500,Residential,4500,32835,0,37335
132647800101085,CONDO 500,Residential,4500,32835,0,37335
132647800101086,CONDO 500,Residential,4500,32835,0,37335
132647800101087,CONDO 500,Residential,4500,32835,0,37335
132647800101088,CONDO 500,Residential,4500,32835,0,37335
132647800101089,CONDO 500,Residential,4500,32835,0,37335
132647800201000,CONDO 500,Residential,5000,43266,0,48266
132647800201001,CONDO 500,Residential,5000,43266,0,48266
132647800201002,CONDO 500,Residential,5000,43266,0,48266
132647800201003,CONDO 500,Residential,5000,43266,0,48266
132647800201004,CONDO 500,Residential,5000,43266,0,48266
132647800201005,CONDO 500,Residential,5000,43266,0,48266
132647800201006,CONDO 500,Residential,5000,43266,0,48266
132647800201007,CONDO 500,Residential,5000,43266,0,48266
132647800201008,CONDO 500,Residential,5000,43266,0,48266
132647800201009,CONDO 500,Residential,5000,43266,0,48266
132647800201010,CONDO 500,Residential,5000,43266,0,48266
132647800201011,CONDO 500,Residential,5000,43266,0,48266
132647800201012,CONDO 500,Residential,5000,47233,0,52233
132647800201013,CONDO 500,Residential,5000,47233,0,52233
132647800201014,CONDO 500,Residential,5000,47233,0,52233
132647800201015,CONDO 500,Residential,5000,47233,0,52233
132647800201016,CONDO 500,Residential,5000,43266,0,48266
132647800201017,CONDO 500,Residential,5000,43266,0,48266
132647800201018,CONDO 500,Residential,5000,43266,0,48266
132647800201019,CONDO 500,Residential,5000,43266,0,48266
132647800201020,CONDO 500,Residential,5000,43266,0,48266
132647800201021,CONDO 500,Residential,5000,43266,0,48266
132647800201022,CONDO 500,Residential,5000,43266,0,48266
132647800201023,CONDO 500,Residential,5000,43266,0,48266
132647800201024,CONDO 500,Residential,5000,43266,0,48266
132647800201025,CONDO 500,Residential,5000,43266,0,48266
132647800201026,CONDO 500,Residential,5000,43266,0,48266
132647800201027,CONDO 500,Residential,5000,43266,0,48266
132647800201028,CONDO 500,Residential,5000,43266,0,48266
132647800201029,CONDO 500,Residential,5000,43266,0,48266
132647800201030,CONDO 500,Residential,5000,43266,0,48266
132647800201031,CONDO 500,Residential,5000,43266,0,48266
132647800201032,CONDO 500,Residential,5000,43266,0,48266
132647800201033,CONDO 500,Residential,5000,43266,0,48266
132647800201034,CONDO 500,Residential,5000,43266,0,48266
132647800201035,CONDO 500,Residential,5000,43266,0,48266
132647800201036,CONDO 500,Residential,5000,43266,0,48266
132647800201037,CONDO 500,Residential,5000,43266,0,48266
132647800201038,CONDO 500,Residential,5000,43266,0,48266
132647800201039,CONDO 500,Residential,5000,43266,0,48266
132647800201040,CONDO 500,Residential,5000,47233,0,52233
132647800201041,CONDO 500,Residential,5000,47233,0,52233
132647800201042,CONDO 500,Residential,5000,47233,0,52233
132647800201043,CONDO 500,Residential,5000,47233,0,52233
132647800201044,CONDO 500,Residential,5000,43266,0,48266
132647800201045,CONDO 500,Residential,5000,43266,0,48266
132647800201046,CONDO 500,Residential,5000,43266,0,48266
132647800201047,CONDO 500,Residential,5000,43266,0,48266
132647800201048,CONDO 500,Residential,5000,43266,0,48266
132647800201049,CONDO 500,Residential,5000,43266,0,48266
132647800201050,CONDO 500,Residential,5000,43266,0,48266
132647800201051,CONDO 500,Residential,5000,43266,0,48266
132647800201052,CONDO 500,Residential,5000,47233,0,52233
132647800201053,CONDO 500,Residential,5000,47233,0,52233
132647800201054,CONDO 500,Residential,5000,47233,0,52233
132647800201055,CONDO 500,Residential,5000,47233,0,52233
132647800201056,CONDO 500,Residential,5000,43266,0,48266
132647800201057,CONDO 500,Residential,5000,43266,0,48266
132647800201058,CONDO 500,Residential,5000,43266,0,48266
132647800201059,CONDO 500,Residential,5000,43266,0,48266
132647800201060,CONDO 500,Residential,5000,43266,0,48266
132647800201061,CONDO 500,Residential,5000,43266,0,48266
132647800201062,CONDO 500,Residential,5000,43266,0,48266
132647800201063,CONDO 500,Residential,5000,43266,0,48266
132647800201064,CONDO 500,Residential,5000,43266,0,48266
132647800201065,CONDO 500,Residential,5000,43266,0,48266
132647800201066,CONDO 500,Residential,5000,43266,0,48266
132647800201067,CONDO 500,Residential,5000,43266,0,48266
132647800201068,CONDO 500,Residential,5000,40053,0,45053
132647800201069,CONDO 500,Residential,5000,40053,0,45053
132647800201070,CONDO 500,Residential,5000,40053,0,45053
132647800201071,CONDO 500,Residential,5000,40053,0,45053
132647800201072,CONDO 500,Residential,5000,40053,0,45053
132647800201073,CONDO 500,Residential,5000,40053,0,45053
132647800201074,CONDO 500,Residential,5000,40053,0,45053
132647800201075,CONDO 500,Residential,5000,40053,0,45053
132647800201076,CONDO 500,Residential,5000,40053,0,45053
132647800201077,CONDO 500,Residential,5000,40053,0,45053
132647800201078,CONDO 500,Residential,5000,40053,0,45053
132647800201079,CONDO 500,Residential,5000,40053,0,45053
132647800201080,CONDO 500,Residential,5000,40053,0,45053
132647800201081,CONDO 500,Residential,5000,40053,0,45053
132647800201082,CONDO 500,Residential,5000,40053,0,45053
132647800201083,CONDO 500,Residential,5000,40053,0,45053
132647800201084,CONDO 500,Residential,5000,44020,0,49020
132647800201085,CONDO 500,Residential,5000,44020,0,49020
132647800201086,CONDO 500,Residential,5000,44020,0,49020
132647800201087,CONDO 500,Residential,5000,44020,0,49020
132647800201088,CONDO 500,Residential,5000,44020,0,49020
132647800201089,CONDO 500,Residential,5000,44020,0,49020
132647800201090,CONDO 500,Residential,5000,44020,0,49020
132647800201091,CONDO 500,Residential,5000,44020,0,49020
132647800201092,CONDO 500,Residential,5000,44020,0,49020
132647800201093,CONDO 500,Residential,5000,44020,0,49020
132647800201094,CONDO 500,Residential,5000,44020,0,49020
132647800201095,CONDO 500,Residential,5000,44020,0,49020
132647800300000,COMM SW,Commercial,186300,0,541750,728050
132647800400000,COMM SW,Commercial,84240,0,0,84240
132647800500000,COMM SW,Commercial,83700,0,0,83700
132647800600000,COMM SW,Commercial,85320,0,0,85320
132647800701000,CONDO 500,Residential,4500,33173,0,37673
132647800701001,CONDO 500,Residential,4500,33173,0,37673
132647800701002,CONDO 500,Residential,4500,33173,0,37673
132647800701003,CONDO 500,Residential,4500,46312,0,50812
132647800701004,CONDO 500,Residential,4500,33173,0,37673
132647800701005,CONDO 500,Residential,4500,33173,0,37673
132647800701006,CONDO 500,Residential,4500,33173,0,37673
132647800701007,CONDO 500,Residential,4500,33173,0,37673
132647800701008,CONDO 500,Residential,4500,33173,0,37673
132647800701009,CONDO 500,Residential,4500,33173,0,37673
132647800701010,CONDO 500,Residential,4500,33173,0,37673
132647800701011,CONDO 500,Residential,4500,33173,0,37673
132647800701012,CONDO 500,Residential,4500,33173,0,37673
132647800701013,CONDO 500,Residential,4500,33173,0,37673
132647800701014,CONDO 500,Residential,4500,33173,0,37673
132647800701015,CONDO 500,Residential,4500,33173,0,37673
132647800701016,CONDO 500,Residential,4500,33173,0,37673
132647800701017,CONDO 500,Residential,4500,33173,0,37673
132647800701018,CONDO 500,Residential,4500,46312,0,50812
132647800701019,CONDO 500,Residential,4500,33173,0,37673
132647800701020,CONDO 500,Residential,4500,33173,0,37673
132647800701021,CONDO 500,Residential,4500,33173,0,37673
132647800701022,CONDO 500,Residential,4500,33173,0,37673
132647800701023,CONDO 500,Residential,4500,33173,0,37673
132647800701024,CONDO 500,Residential,4500,33173,0,37673
132647800701025,CONDO 500,Residential,4500,33173,0,37673
132647800701026,CONDO 500,Residential,4500,33173,0,37673
132647800701027,CONDO 500,Residential,4500,33173,0,37673
132647800701028,CONDO 500,Residential,4500,33173,0,37673
132647800701029,CONDO 500,Residential,4500,33173,0,37673
132647800701030,CONDO 500,Residential,4500,33173,0,37673
132647800701031,CONDO 500,Residential,4500,33173,0,37673
132647800701032,CONDO 500,Residential,4500,33173,0,37673
132647800701033,CONDO 500,Residential,4500,46312,0,50812
132647800701034,CONDO 500,Residential,4500,33173,0,37673
132647800701035,CONDO 500,Residential,4500,33173,0,37673
132647800701036,CONDO 500,Residential,4500,33173,0,37673
132647800701037,CONDO 500,Residential,4500,33173,0,37673
132647800701038,CONDO 500,Residential,4500,33173,0,37673
132647800701039,CONDO 500,Residential,4500,33173,0,37673
132647800701040,CONDO 500,Residential,4500,33173,0,37673
132647800701041,CONDO 500,Residential,4500,33173,0,37673
132647800701042,CONDO 500,Residential,4500,33173,0,37673
132647800701043,CONDO 500,Residential,4500,33173,0,37673
132647800701044,CONDO 500,Residential,4500,33173,0,37673
132647800701045,CONDO 500,Residential,4500,33173,0,37673
132647800701046,CONDO 500,Residential,4500,33173,0,37673
132647800701047,CONDO 500,Residential,4500,33173,0,37673
132647800701048,CONDO 500,Residential,4500,46312,0,50812
132647800701049,CONDO 500,Residential,4500,33173,0,37673
132647800701050,CONDO 500,Residential,4500,33173,0,37673
132647800701051,CONDO 500,Residential,4500,33173,0,37673
132647800701052,CONDO 500,Residential,4500,33173,0,37673
132647800701053,CONDO 500,Residential,4500,33173,0,37673
132647800701054,CONDO 500,Residential,4500,33173,0,37673
132647800701055,CONDO 500,Residential,4500,33173,0,37673
132647800701056,CONDO 500,Residential,4500,33173,0,37673
132647800701057,CONDO 500,Residential,4500,33173,0,37673
132647800701058,CONDO 500,Residential,4500,33173,0,37673
132647800701059,CONDO 500,Residential,4500,33173,0,37673
132647800701060,CONDO 500,Residential,4500,33173,0,37673
132647800701061,CONDO 500,Residential,4500,33173,0,37673
132647800701062,CONDO 500,Residential,4500,33173,0,37673
132647800701063,CONDO 500,Residential,4500,46312,0,50812
132647800701064,CONDO 500,Residential,4500,33173,0,37673
132647800701065,CONDO 500,Residential,4500,33173,0,37673
132647800701066,CONDO 500,Residential,4500,33173,0,37673
132647800701067,CONDO 500,Residential,4500,33173,0,37673
132647800701068,CONDO 500,Residential,4500,33173,0,37673
132647800701069,CONDO 500,Residential,4500,33173,0,37673
132647800701070,CONDO 500,Residential,4500,33173,0,37673
132647800701071,CONDO 500,Residential,4500,33173,0,37673
132647800701072,CONDO 500,Residential,4500,33173,0,37673
132647800701073,CONDO 500,Residential,4500,33173,0,37673
132647800701074,CONDO 500,Residential,4500,33173,0,37673
132647800701075,CONDO 500,Residential,4500,33173,0,37673
132647800701076,CONDO 500,Residential,4500,33173,0,37673
132647800701077,CONDO 500,Residential,4500,33173,0,37673
132647800701078,CONDO 500,Residential,4500,46312,0,50812
132647800701079,CONDO 500,Residential,4500,33173,0,37673
132647800701080,CONDO 500,Residential,4500,33173,0,37673
132647800701081,CONDO 500,Residential,4500,33173,0,37673
132647800701082,CONDO 500,Residential,4500,33173,0,37673
132647800701083,CONDO 500,Residential,4500,33173,0,37673
132647800701084,CONDO 500,Residential,4500,33173,0,37673
132647800701085,CONDO 500,Residential,4500,33173,0,37673
132647800701086,CONDO 500,Residential,4500,33173,0,37673
132647800701087,CONDO 500,Residential,4500,33173,0,37673
132647800701088,CONDO 500,Residential,4500,33173,0,37673
132647800701089,CONDO 500,Residential,4500,33173,0,37673
132647800701090,CONDO 500,Residential,4500,33173,0,37673
132647800701091,CONDO 500,Residential,4500,33173,0,37673
132647800701092,CONDO 500,Residential,4500,33173,0,37673
132647800701093,CONDO 500,Residential,4500,46312,0,50812
132647800701094,CONDO 500,Residential,4500,33173,0,37673
132647800701095,CONDO 500,Residential,4500,33173,0,37673
132647800701096,CONDO 500,Residential,4500,33173,0,37673
132647800701097,CONDO 500,Residential,4500,33173,0,37673
132647800701098,CONDO 500,Residential,4500,33173,0,37673
132647800701099,CONDO 500,Residential,4500,33173,0,37673
132647800701100,CONDO 500,Residential,4500,33173,0,37673
132647800701101,CONDO 500,Residential,4500,33173,0,37673
132647800701102,CONDO 500,Residential,4500,33173,0,37673
132647800701103,CONDO 500,Residential,4500,33173,0,37673
132647800701104,CONDO 500,Residential,4500,33173,0,37673
132710100201000,CONDO 501,Residential,20000,207740,0,227740
132710100201001,CONDO 501,Residential,20000,173097,0,193097
132710100301000,CONDO 501,Residential,20000,177575,0,197575
132710100301001,CONDO 501,Residential,20000,0,0,20000
132710100401000,CONDO 501,Residential,20000,0,0,20000
132710100401001,CONDO 501,Residential,20000,0,0,20000
132710100501000,CONDO 501,Residential,20000,188577,0,208577
132710100501001,CONDO 501,Residential,20000,192465,0,212465
132710100601000,CONDO 501,Residential,20000,10500,0,30500
132710100601001,CONDO 501,Residential,20000,0,0,20000
132710100701000,CONDO 501,Residential,20000,209241,0,229241
132710100701001,CONDO 501,Residential,20000,165609,0,185609
132710100801000,CONDO 501,Residential,20000,233781,0,253781
132710100801001,CONDO 501,Residential,20000,225369,0,245369
132710100901000,CONDO 501,Residential,20000,207267,0,227267
132710100901001,CONDO 501,Residential,20000,203923,0,223923
132710101001000,CONDO 501,Residential,20000,179670,0,199670
132710101001001,CONDO 501,Residential,20000,203701,0,223701
132710101101000,CONDO 501,Residential,20000,230690,0,250690
132710101101001,CONDO 501,Residential,20000,205649,0,225649
132710101201000,CONDO 501,Residential,20000,189368,0,209368
132710101201001,CONDO 501,Residential,20000,202449,0,222449
132710101301000,CONDO 501,Residential,20000,177741,0,197741
132710101301001,CONDO 501,Residential,20000,202154,0,222154
132710101401000,CONDO 501,Residential,20000,171839,0,191839
132710101401001,CONDO 501,Residential,20000,219319,0,239319
132710101501000,CONDO 501,Residential,20000,222532,0,242532
132710101501001,CONDO 501,Residential,20000,187539,0,207539
132710101601000,CONDO 501,Residential,20000,222772,0,242772
132710101601001,CONDO 501,Residential,20000,182531,0,202531
132710101701000,CONDO 501,Residential,20000,0,0,20000
132710101701001,CONDO 501,Residential,20000,0,0,20000
132710200101000,CONDO 501,Residential,20000,0,0,20000
132710200101001,CONDO 501,Residential,20000,0,0,20000
132710200201000,CONDO 501,Residential,20000,0,0,20000
132710200201001,CONDO 501,Residential,20000,0,0,20000
132710200301000,CONDO 501,Residential,20000,0,0,20000
132710200301001,CONDO 501,Residential,20000,0,0,20000
132710200401000,CONDO 501,Residential,20000,0,0,20000
132710200401001,CONDO 501,Residential,20000,0,0,20000
132710200501000,CONDO 501,Residential,20000,0,0,20000
132710200501001,CONDO 501,Residential,20000,0,0,20000
132710200601000,CONDO 501,Residential,20000,183600,0,203600
132710200601001,CONDO 501,Residential,20000,180389,0,200389
132710200701000,CONDO 501,Residential,20000,0,0,20000
132710200701001,CONDO 501,Residential,20000,0,0,20000
132710300100000,E-15 CITY,Exempt,0,0,0,0
132710300200000,NW 332,Residential,42218,157409,0,199627
132710300300000,NW 332,Residential,44910,141156,0,186066
132710300400000,NW 332,Residential,39713,206783,0,246496
132710300500000,NW 332,Residential,39890,198646,0,238536
132710300600000,NW 332,Residential,33861,176000,0,209861
132710300700000,NW 332,Residential,40052,202499,0,242551
132710300800000,NW 332,Residential,52725,218133,0,270858
132710300900000,NW 332,Residential,46993,200372,0,247365
132710301000000,NW 332,Residential,32585,176037,0,208622
132710301100000,NW 332,Residential,36100,194822,0,230922
132710301200000,NW 332,Residential,38000,155716,0,193716
132710301300000,NW 332,Residential,31350,200253,0,231603
132710301400000,NW 332,Residential,47011,178121,0,225132
132710301500000,NW 332,Residential,32458,187085,0,219543
132710301600000,NW 332,Residential,32918,166826,0,199744
132710301700000,NW 332,Residential,31037,162836,0,193873
132710301800000,NW 332,Residential,35739,170643,0,206382
132710301900000,NW 332,Residential,32918,162618,0,195536
132710302000000,NW 332,Residential,32918,186536,0,219454
132710302100000,NW 332,Residential,31037,154527,0,185564
132710302200000,NW 332,Residential,6020,0,0,6020
132710302300000,NW 332,Residential,40533,207371,0,247904
132710302400000,NW 332,Residential,44460,179346,0,223806
132710302500000,NW 332,Residential,38380,157749,0,196129
132710302600000,NW 332,Residential,38000,163165,0,201165
132710302700000,NW 332,Residential,7063,0,0,7063
132710400100000,NW 332,Residential,48811,218147,0,266958
132710400200000,NW 332,Residential,36100,195579,0,231679
132710400300000,NW 332,Residential,33250,0,0,33250
132710400400000,NW 332,Residential,39583,182329,0,221912
132710400500000,NW 332,Residential,65304,204313,0,269617
132710400600000,NW 332,Residential,61560,204655,0,266215
132710400700000,E-15 CITY,Exempt,0,0,0,0
132710400800000,NW 332,Residential,49219,201888,0,251107
132710400900000,NW 332,Residential,34722,160762,0,195484
132710401000000,NW 332,Residential,37791,185000,0,222791
132710401100000,NW 332,Residential,31350,165110,0,196460
132710401200000,NW 332,Residential,41258,168883,0,210141
132710401300000,NW 332,Residential,36417,165609,0,202026
132710401400000,NW 332,Residential,6066,0,0,6066
132710401500000,NW 332,Residential,56291,170899,0,227190
132710401600000,NW 332,Residential,5361,0,0,5361
132710401700000,NW 332,Residential,7053,0,0,7053
132710500100000,NW 332,Residential,47500,164329,0,211829
132710500200000,NW 332,Residential,47975,171043,0,219018
132710600100000,NW 332,Residential,45125,197719,0,242844
132710600200000,NW 332,Residential,31350,174415,0,205765
132710600300000,NW 332,Residential,38000,163568,0,201568
132710600400000,NW 332,Residential,30875,223317,0,254192
132710600500000,NW 332,Residential,48171,146888,0,195059
132710600600000,NW 332,Residential,47965,125959,0,173924
132710600700000,NW 332,Residential,33250,150313,0,183563
132710600800000,NW 332,Residential,31350,160776,0,192126
132710600900000,NW 332,Residential,36100,178134,0,214234
132710601000000,NW 332,Residential,45125,163000,0,208125
132712600100000,NW 332,Residential,59000,62633,0,121633
132712600300000,NW 332,Residential,39148,142199,0,181347
132712600400000,NW 332,Residential,30802,144108,0,174910
132712600500000,NW 332,Residential,34447,138917,0,173364
132712600600000,NW 332,Residential,33051,145402,0,178453
132712600800000,NW 332,Residential,37590,158128,0,195718
132712600900000,NW 332,Residential,37590,191550,0,229140
132712601000000,NW 332,Residential,33051,181770,0,214821
132712601100000,NW 332,Residential,34447,180474,0,214921
132712601200000,NW 332,Residential,33671,166303,0,199974
132712601300000,NW 332,Residential,38976,198776,0,237752
132712601400000,NW 332,Residential,38317,152921,0,191238
132712700100000,NW 332,Residential,42959,183194,0,226153
132712700200000,NW 332,Residential,41701,185262,0,226963
132712700300000,NW 332,Residential,43320,200613,0,243933
132712700400000,NW 332,Residential,41670,179120,0,220790
132712700500000,NW 332,Residential,43298,227752,0,271050
132712700600000,NW 332,Residential,43835,142872,0,186707
132712700700000,NW 332,Residential,44403,180031,0,224434
132712700800000,NW 332,Residential,40613,149827,0,190440
132712700900000,NW 332,Residential,41154,159467,0,200621
132712701000000,NW 332,Residential,43862,188718,0,232580
132712701100000,NW 332,Residential,41154,177379,0,218533
132712701200000,NW 332,Residential,31896,178190,0,210086
132712701300000,NW 332,Residential,40294,177475,0,217769
132712701400000,NW 332,Residential,34566,182659,0,217225
132712701500000,NW 332,Residential,35457,236979,0,272436
132712701600000,NW 332,Residential,35369,171901,0,207270
132712701700000,NW 332,Residential,37132,186725,0,223857
132712701800000,E-15 CITY,Exempt,0,0,0,0
132712701900000,NW 332,Residential,33056,262071,0,295127
132712702000000,NW 332,Residential,34980,193676,0,228656
132712702100000,NW 332,Residential,38504,525398,0,563902
132712702200000,NW 332,Residential,38304,265937,0,304241
132712702300000,NW 332,Residential,35346,298190,0,333536
132712702400000,NW 332,Residential,13700,0,0,13700
132712800100000,NW 332,Residential,33051,140725,0,173776
132712800200000,NW 332,Residential,36472,194138,0,230610
132712800300000,NW 332,Residential,37341,172425,0,209766
132712800400000,NW 332,Residential,37628,182249,0,219877
132712800500000,NW 332,Residential,38332,165452,0,203784
132712800600000,NW 332,Residential,37504,186145,0,223649
132712800800000,NW 332,Residential,33051,156268,0,189319
132712800900000,NW 332,Residential,35414,187865,0,223279
132712801000000,NW 332,Residential,39583,173936,0,213519
132712801100000,NW 332,Residential,37428,142200,0,179628
132712801200000,NW 332,Residential,36258,175099,0,211357
132712801300000,NW 332,Residential,41614,171689,0,213303
132712801400000,NW 332,Residential,39520,225477,0,264997
132712801500000,NW 332,Residential,39531,209049,0,248580
132712801600000,NW 332,Residential,38475,142813,0,181288
132712801700000,NW 332,Residential,33725,168153,0,201878
132712801800000,NW 332,Residential,31350,188645,0,219995
132712801900000,NW 332,Residential,35150,169512,0,204662
132712802000000,NW 332,Residential,33725,205275,0,239000
132712802100000,NW 332,Residential,35969,163592,0,199561
132712802200000,NW 332,Residential,38017,197859,0,235876
132712802300000,NW 332,Residential,37049,163178,0,200227
132712802400000,NW 332,Residential,33945,145801,0,179746
132712802500000,NW 332,Residential,35150,146374,0,181524
132712802600000,NW 332,Residential,33725,147285,0,181010
132712802700000,NW 332,Residential,38419,156187,0,194606
132712802800000,NW 332,Residential,34762,198904,0,233666
132712802900000,NW 332,Residential,34710,183713,0,218423
132712803000000,NW 332,Residential,34447,135434,0,169881
132712900100000,NW 332,Residential,37336,184029,0,221365
132712900200000,NW 332,Residential,37928,177474,0,215402
132712900300000,NW 332,Residential,40456,155288,0,195744
132712900400000,NW 332,Residential,35112,145343,0,180455
132712900500000,NW 332,Residential,36614,199700,0,236314
132712900600000,NW 332,Residential,34883,219355,0,254238
132712900700000,NW 332,Residential,35999,147829,0,183828
132712900800000,NW 332,Residential,39124,158665,0,197789
132712900900000,NW 332,Residential,35395,152141,0,187536
132712901000000,NW 332,Residential,38254,168690,0,206944
132712901100000,NW 332,Residential,30576,157185,0,187761
132712901200000,NW 332,Residential,32257,167270,0,199527
132713000100000,NW 332,Residential,38756,148019,0,186775
132713000200000,NW 332,Residential,33393,155631,0,189024
132713000300000,NW 332,Residential,34295,156771,0,191066
132713000400000,NW 332,Residential,32631,185267,0,217898
132713000500000,NW 332,Residential,38350,170083,0,208433
132713000600000,NW 332,Residential,39646,178547,0,218193
132713000700000,NW 332,Residential,34029,174930,0,208959
132713000800000,NW 332,Residential,31350,145360,0,176710
132713000900000,NW 332,Residential,34352,159194,0,193546
132713001000000,NW 332,Residential,35661,155188,0,190849
132713001100000,NW 332,Residential,37814,155202,0,193016
132713001200000,NW 332,Residential,38937,192615,0,231552
132715100100000,NW 331,Residential,28267,136415,0,164682
132715100200000,NW 331,Residential,30245,115252,0,145497
132715100300000,NW 331,Residential,32252,165131,0,197383
132715100400000,NW 332,Residential,37128,170229,0,207357
132715100500000,NW 332,Residential,34224,116661,0,150885
132715100600000,NW 332,Residential,33601,147439,0,181040
132715200100000,NW 332,Residential,33773,222762,0,256535
132715200200000,NW 332,Residential,38914,299830,0,338744
132715200300000,NW 332,Residential,33341,162958,0,196299
132715200400000,NW 332,Residential,32096,159306,0,191402
132715200500000,NW 332,Residential,28651,150316,0,178967
132715200600000,NW 332,Residential,28465,183749,0,212214
132715200700000,NW 332,Residential,31540,165531,0,197071
132715200800000,NW 332,Residential,32111,154105,0,186216
132715200900000,NW 332,Residential,30864,174197,0,205061
132715201000000,NW 332,Residential,28968,156390,0,185358
132715201100000,NW 332,Residential,28560,151245,0,179805
132715201200000,NW 332,Residential,30192,173319,0,203511
132715201300000,NW 332,Residential,31575,171205,0,202780
132715201400000,NW 332,Residential,30659,153165,0,183824
132715201500000,NW 332,Residential,30210,149137,0,179347
132715201600000,NW 332,Residential,31908,163806,0,195714
132715201700000,NW 332,Residential,30370,146592,0,176962
132715201800000,NW 332,Residential,35207,145840,0,181047
132715201900000,NW 332,Residential,28195,156996,0,185191
132715202000000,NW 332,Residential,31728,158630,0,190358
132715202100000,NW 332,Residential,32822,164180,0,197002
132715202200000,NW 332,Residential,32832,149866,0,182698
132715202300000,NW 332,Residential,32812,163043,0,195855
132715202400000,NW 332,Residential,33053,166326,0,199379
132715202500000,NW 332,Residential,34095,147673,0,181768
132715202600000,NW 332,Residential,37360,197654,0,235014
132715202700000,NW 332,Residential,35768,151471,0,187239
132715202800000,NW 332,Residential,34766,142075,0,176841
132715202900000,NW 332,Residential,35224,135990,0,171214
132715203000000,NW 332,Residential,34907,157227,0,192134
132715203100000,NW 332,Residential,33984,142981,0,176965
132715203200000,NW 332,Residential,35743,157868,0,193611
132715300100000,NW 332,Residential,29816,167250,0,197066
132715300200000,NW 332,Residential,27848,155487,0,183335
132715300300000,NW 332,Residential,26400,134583,0,160983
132715300400000,NW 332,Residential,28000,144601,0,172601
132715300500000,NW 332,Residential,32571,166892,0,199463
132715400100000,NW 331,Residential,31376,168092,0,199468
132715400200000,NW 331,Residential,32616,143295,0,175911
132715400300000,NW 332,Residential,32508,132666,0,165174
132715400400000,NW 332,Residential,33647,145990,0,179637
132715400500000,NW 332,Residential,32340,182504,0,214844
132715500100000,NW 332,Residential,30260,180588,0,210848
132715500200000,NW 332,Residential,30974,143011,0,173985
132715500300000,NW 332,Residential,31920,162472,0,194392
132715500400000,NW 332,Residential,31986,133705,0,165691
132715500500000,NW 332,Residential,30235,167871,0,198106
132715500600000,NW 332,Residential,31855,173025,0,204880
132715500700000,NW 332,Residential,32300,137410,0,169710
132715500800000,NW 332,Residential,30000,162768,0,192768
132715500900000,NW 332,Residential,27960,166738,0,194698
132715501000000,NW 332,Residential,29716,174130,0,203846
132715501100000,NW 332,Residential,31874,162932,0,194806
132715501200000,NW 332,Residential,32541,183663,0,216204
132715501300000,NW 332,Residential,29801,169295,0,199096
132715501400000,NW 332,Residential,33477,161891,0,195368
132715501500000,NW 332,Residential,30598,168560,0,199158
132715501600000,NW 332,Residential,28550,144636,0,173186
132715501700000,NW 332,Residential,30386,167082,0,197468
132715501800000,NW 332,Residential,28400,140341,0,168741
132715501900000,NW 332,Residential,30000,143879,0,173879
132715502000000,NW 332,Residential,28400,159126,0,187526
132715502100000,NW 332,Residential,30000,120977,0,150977
132715502200000,NW 332,Residential,32300,173631,0,205931
132715502300000,NW 332,Residential,31572,173540,0,205112
132715502400000,NW 332,Residential,29369,160948,0,190317
132715502500000,NW 332,Residential,28560,149625,0,178185
132715502600000,NW 332,Residential,30651,201876,0,232527
132715502700000,NW 332,Residential,29210,154544,0,183754
132715600100000,NW 332,Residential,32640,183440,0,216080
132715600200000,NW 332,Residential,30672,157121,0,187793
132715600300000,NW 332,Residential,29492,178702,0,208194
132715600400000,NW 332,Residential,30943,192947,0,223890
132715600500000,NW 332,Residential,33523,141013,0,174536
132715700100000,NW 332,Residential,33379,161426,0,194805
132715700200000,NW 332,Residential,29364,177627,0,206991
132715700300000,NW 332,Residential,29766,166078,0,195844
132715700400000,NW 332,Residential,27664,177029,0,204693
132715700500000,NW 332,Residential,27720,157928,0,185648
132715700600000,NW 332,Residential,31339,137654,0,168993
132715700700000,NW 332,Residential,33660,173028,0,206688
132715700800000,NW 332,Residential,34000,170421,0,204421
132715700900000,NW 332,Residential,34710,129408,0,164118
132715701000000,NW 332,Residential,35112,144866,0,179978
132715701100000,NW 332,Residential,37671,207735,0,245406
132715701200000,NW 332,Residential,31633,149160,0,180793
132715701300000,NW 332,Residential,34344,172108,0,206452
132715800100000,NW 332,Residential,35100,151032,0,186132
132715800200000,NW 332,Residential,31416,154433,0,185849
132715800300000,NW 332,Residential,33603,137446,0,171049
132715800400000,NW 332,Residential,33921,137237,0,171158
132715800500000,NW 332,Residential,29455,157451,0,186906
132715800600000,NW 332,Residential,32180,163178,0,195358
132715800700000,NW 332,Residential,34119,167320,0,201439
132715800800000,NW 332,Residential,34075,149905,0,183980
132715800900000,NW 332,Residential,32544,163878,0,196422
132715801000000,NW 332,Residential,33600,185983,0,219583
132715801100000,NW 332,Residential,29648,157074,0,186722
132715801200000,NW 332,Exempt,29600,0,157852,187452
132715801300000,NW 332,Residential,30124,154418,0,184542
132715801400000,NW 332,Residential,34200,162062,0,196262
132715900100000,NW 332,Residential,33987,206863,0,240850
132717600100000,NW 331,Residential,24491,117358,0,141849
132717600200000,NW 331,Residential,26000,113563,0,139563
132717600300000,NW 331,Residential,30400,130969,0,161369
132717600400000,NW 331,Residential,27600,115218,0,142818
132717600500000,NW 331,Residential,28800,128229,0,157029
132717600600000,NW 331,Residential,32800,114767,0,147567
132717600700000,NW 331,Residential,33200,129747,0,162947
132717600800000,NW 331,Residential,30400,129606,0,160006
132717600900000,NW 331,Residential,30400,129364,0,159764
132717601000000,NW 331,Residential,27392,124807,0,152199
132717601100000,NW 331,Residential,31200,109751,0,140951
132717601200000,NW 331,Residential,31200,137376,0,168576
132717601300000,NW 331,Residential,31200,141038,0,172238
132717601400000,NW 331,Residential,31200,128828,0,160028
132717601500000,NW 331,Residential,31200,131326,0,162526
132717601600000,NW 331,Residential,31200,156612,0,187812
132717601700000,NW 331,Residential,32400,146115,0,178515
132717700100000,NW 331,Residential,24654,159382,0,184036
132717700200000,NW 331,Residential,30761,141560,0,172321
132717700300000,NW 331,Residential,26534,125261,0,151795
132717700400000,NW 331,Residential,28829,120809,0,149638
132717700500000,NW 331,Residential,29104,123814,0,152918
132717700600000,NW 331,Residential,28145,150652,0,178797
132717700700000,NW 331,Residential,32533,108881,0,141414
132717700800000,NW 331,Residential,28723,124428,0,153151
132717700900000,NW 331,Residential,28130,132241,0,160371
132717701000000,NW 331,Residential,27103,126294,0,153397
132717701100000,NW 331,Residential,25476,130261,0,155737
132717701200000,NW 331,Residential,28032,150309,0,178341
132717701300000,NW 331,Residential,26220,126553,0,152773
132717701400000,NW 331,Residential,28880,130808,0,159688
132717701500000,NW 331,Residential,25976,150830,0,176806
132717701600000,NW 331,Residential,30135,144696,0,174831
132717800100000,NW 331,Residential,32282,129147,0,161429
132717800200000,NW 331,Residential,25740,126982,0,152722
132717800300000,NW 331,Residential,27444,136751,0,164195
132717800400000,NW 331,Residential,27852,128102,0,155954
132717800500000,NW 331,Residential,24444,162103,0,186547
132717800600000,NW 331,Residential,25856,154972,0,180828
132717800700000,NW 331,Residential,28522,172722,0,201244
132717800800000,NW 331,Residential,26865,134864,0,161729
132717800900000,NW 331,Residential,27740,141700,0,169440
132717801000000,NW 331,Residential,26696,144442,0,171138
132717801100000,NW 331,Residential,28097,133544,0,161641
132717801200000,NW 331,Residential,27720,131848,0,159568
132717801300000,NW 331,Residential,28684,151648,0,180332
132717801400000,NW 331,Residential,27604,155231,0,182835
132717801500000,NW 331,Residential,32060,143829,0,175889
132717801600000,NW 332,Residential,31377,146678,0,178055
132717801700000,NW 331,Residential,33040,156413,0,189453
132717801800000,NW 331,Residential,32000,119252,0,151252
132717801900000,NW 331,Residential,30911,121860,0,152771
132717802000000,NW 331,Residential,26255,134892,0,161147
132717802100000,NW 331,Residential,30496,100224,0,130720
132717802200000,NW 331,Residential,30804,121946,0,152750
132717802300000,NW 331,Residential,29042,155072,0,184114
132717802400000,NW 331,Residential,25344,143048,0,168392
132717802500000,NW 331,Residential,29184,115921,0,145105
132717802600000,NW 331,Residential,25475,128964,0,154439
132717802700000,NW 331,Residential,29617,138688,0,168305
132717802800000,NW 331,Residential,26133,115522,0,141655
132717802900000,NW 331,Residential,32114,125296,0,157410
132717900100000,NW 331,Residential,30661,129834,0,160495
132717900200000,NW 331,Residential,26509,142573,0,169082
132717900300000,NW 331,Residential,26214,131617,0,157831
132717900400000,NW 331,Residential,25394,132891,0,158285
132717900500000,NW 331,Residential,26112,127593,0,153705
132717900600000,NW 331,Residential,26112,128825,0,154937
132717900700000,NW 331,Residential,29998,129790,0,159788
132717900800000,NW 331,Residential,29184,124406,0,153590
132717900900000,NW 331,Residential,29344,121961,0,151305
132717901000000,NW 331,Residential,30921,127970,0,158891
132717901100000,NW 331,Residential,30915,150298,0,181213
132717901200000,NW 331,Residential,31261,126193,0,157454
132717901300000,NW 332,Residential,30874,129052,0,159926
132717901400000,NW 332,Residential,31353,182866,0,214219
132717901500000,NW 332,Residential,31647,115395,0,147042
132717901600000,NW 332,Residential,28000,123876,0,151876
132717901700000,NW 332,Residential,35350,142444,0,177794
132717901800000,NW 331,Residential,32130,115129,0,147259
132717901900000,NW 331,Residential,29093,140336,0,169429
132717902000000,NW 331,Residential,30400,126691,0,157091
132717902100000,NW 331,Residential,33790,130020,0,163810
132717902200000,NW 331,Residential,32915,124675,0,157590
132717902300000,NW 331,Residential,29855,140643,0,170498
132717902400000,NW 331,Residential,25030,123553,0,148583
132717902500000,NW 331,Residential,30264,131865,0,162129
132717902600000,NW 331,Residential,30580,142205,0,172785
132717902700000,NW 331,Residential,28215,119870,0,148085
132717902800000,NW 331,Residential,31920,157304,0,189224
132717902900000,NW 331,Residential,30716,121001,0,151717
132717903000000,NW 331,Residential,29365,129151,0,158516
132717903100000,NW 331,Residential,29766,130811,0,160577
132717903200000,NW 331,Residential,26125,121682,0,147807
132717903300000,NW 331,Residential,30217,141463,0,171680
132717903400000,NW 331,Residential,31731,116709,0,148440
132717903500000,NW 331,Residential,30289,130015,0,160304
132717903600000,NW 331,Residential,30818,105988,0,136806
132717903700000,NW 331,Residential,31471,111540,0,143011
132717903800000,NW 331,Residential,29400,134207,0,163607
132717903900000,NW 331,Residential,31104,158485,0,189589
132717904000000,NW 331,Residential,28800,123351,0,152151
132717904100000,NW 331,Residential,30720,131627,0,162347
132717904200000,NW 331,Residential,25344,106203,0,131547
132717904300000,NW 331,Residential,25763,124320,0,150083
132718000100000,NW 332,Residential,33170,149976,0,183146
132718000200000,NW 332,Residential,28840,167387,0,196227
132718000300000,NW 332,Residential,35073,144457,0,179530
132718100100000,NW 331,Residential,30229,130098,0,160327
132718100200000,NW 331,Residential,24768,134776,0,159544
132718100300000,NW 331,Residential,25856,126578,0,152434
132718100400000,NW 331,Residential,29754,142833,0,172587
132718100500000,NW 331,Residential,24576,120661,0,145237
132718100600000,NW 331,Residential,23000,97864,0,120864
132718100700000,NW 331,Residential,29142,129821,0,158963
132718100800000,NW 331,Residential,28684,117666,0,146350
132718100900000,NW 331,Residential,30709,123441,0,154150
132718101000000,NW 331,Residential,25075,147921,0,172996
132718101100000,NW 331,Residential,29720,127707,0,157427
132718200100000,NW 331,Residential,31680,119298,0,150978
132718200200000,NW 331,Residential,30336,155466,0,185802
132718200300000,NW 331,Residential,31284,106865,0,138149
132718200400000,NW 331,Residential,31108,118758,0,149866
132718200500000,NW 331,Residential,32096,114689,0,146785
132718200600000,NW 332,Residential,35605,127030,0,162635
132718200700000,NW 332,Residential,37719,166134,0,203853
132718200800000,NW 332,Residential,34997,172512,0,207509
132720100200000,NW 332,Residential,30020,183339,0,213359
132720200100000,NW 332,Residential,37214,196000,0,233214
132720200200000,NW 332,Residential,29785,177044,0,206829
132720200300000,NW 332,Residential,30601,163358,0,193959
132725100200000,NW 332,Ag Land,20989,0,0,20989
132725200100000,NW 332,Residential,39900,268481,0,308381
132725200200000,NW 332,Residential,39900,329149,0,369049
132725200300000,NW 332,Residential,39900,329623,0,369523
132725200400000,NW 332,Residential,39900,163361,0,203261
132725200500000,NW 332,Residential,39900,292506,0,332406
132725200600000,NW 332,Residential,39900,290575,0,330475
132725200700000,NW 332,Residential,38000,307451,0,345451
132725200800000,NW 332,Residential,42433,216970,0,259403
132725200900000,NW 332,Residential,52693,247586,0,300279
132725201000000,NW 332,Residential,850,0,0,850
132725300100000,NW 332,Residential,450,0,0,450
132725300200000,NW 332,Residential,48577,324547,0,373124
132725300300000,NW 332,Residential,43106,265237,0,308343
132725300400000,NW 332,Residential,100,0,0,100
132725400100000,NW 332,Residential,38760,285580,0,324340
132725400200000,NW 332,Residential,38760,207343,0,246103
132725400300000,NW 332,Residential,35853,205426,0,241279
132725400400000,NW 332,Residential,35853,8160,0,44013
132725400500000,NW 332,Residential,38760,8160,0,46920
132725400600000,NW 332,Residential,33915,167696,0,201611
132725400700000,NW 332,Residential,38760,220521,0,259281
132725400800000,NW 332,Residential,34561,0,0,34561
132725400900000,NW 332,Residential,38651,0,0,38651
132725401000000,NW 332,Residential,39026,196207,0,235233
132725401100000,NW 332,Residential,47175,205052,0,252227
132725500100000,NW 332,Residential,650,0,0,650
132725500200000,E-15 CITY,Exempt,0,0,0,0
132725500300000,NW 332,Residential,2150,0,0,2150
132725500400000,NW 332,Residential,41396,363304,0,404700
132725500500000,NW 332,Residential,50944,365989,0,416933
132725500600000,NW 332,Residential,41119,287145,0,328264
132725500700000,NW 332,Residential,43912,255906,0,299818
132727600100000,NW 332,Residential,32000,176807,0,208807
132727600200000,NW 332,Residential,32000,184673,0,216673
132727600300000,NW 332,Residential,32000,153387,0,185387
132727600400000,NW 332,Residential,32000,209359,0,241359
132727600500000,NW 332,Residential,32280,199356,0,231636
132727700100000,NW 332,Residential,36044,164696,0,200740
132727700200000,NW 332,Residential,30000,172322,0,202322
132727700300000,NW 332,Residential,30000,165450,0,195450
132727700500000,NW 332,Residential,30000,142889,0,172889
132727700600000,NW 332,Residential,30000,173869,0,203869
132727700700000,NW 332,Residential,36044,218663,0,254707
132727800100000,NW 332,Residential,34272,192788,0,227060
132727800200000,NW 332,Residential,35402,190461,0,225863
132727800300000,NW 332,Residential,36512,172619,0,209131
132727900100000,NW 332,Residential,36044,163738,0,199782
132727900200000,NW 332,Residential,30000,174683,0,204683
132727900300000,NW 332,Residential,30000,163093,0,193093
132727900400000,NW 332,Residential,30235,157233,0,187468
132727900500000,NW 332,Residential,30001,172422,0,202423
132727900600000,NW 332,Residential,33467,185882,0,219349
132727900700000,NW 332,Residential,42475,207894,0,250369
132727900800000,NW 332,Residential,42750,204888,0,247638
132727900900000,NW 332,Residential,42750,202934,0,245684
132727901000000,NW 332,Residential,38000,237146,0,275146
132727901100000,NW 332,Residential,39900,251563,0,291463
132727901200000,NW 332,Residential,38950,223457,0,262407
132727901300000,NW 332,Residential,40176,248693,0,288869
132727901400000,NW 332,Residential,38000,304518,0,342518
132727901500000,NW 332,Residential,38000,236149,0,274149
132727901600000,NW 332,Residential,38000,10710,0,48710
132728000100000,NW 332,Residential,30289,170964,0,201253
132728000200000,NW 332,Residential,30626,170105,0,200731
132728000300000,NW 332,Residential,27894,173803,0,201697
132728000400000,NW 332,Residential,30706,186589,0,217295
132728000500000,NW 332,Residential,30601,175895,0,206496
132728000600000,NW 332,Residential,30338,164552,0,194890
132728000700000,NW 332,Residential,32027,166375,0,198402
132728000800000,NW 332,Residential,29255,170211,0,199466
132728000900000,NW 332,Residential,32576,180867,0,213443
132728001000000,NW 332,Residential,30305,163734,0,194039
132728001100000,NW 332,Residential,30033,164091,0,194124
132728001200000,NW 332,Residential,30815,174759,0,205574
132728001300000,NW 332,Residential,33104,170864,0,203968
132728001400000,NW 332,Residential,38760,250202,0,288962
132728001500000,NW 332,Residential,38760,187454,0,226214
132728001600000,NW 332,Residential,55718,430279,0,485997
132728001700000,NW 332,Residential,42152,268670,0,310822
132728001800000,NW 332,Residential,40698,211117,0,251815
132728001900000,NW 332,Residential,41509,299949,0,341458
132728002000000,NW 332,Residential,34533,323926,0,358459
132728002100000,NW 332,Residential,32640,185665,0,218305
132728002200000,NW 332,Residential,34272,253270,0,287542
132728002300000,NW 332,Residential,35904,214562,0,250466
132728002400000,NW 332,Residential,35904,220687,0,256591
132728002500000,NW 332,Residential,35904,262417,0,298321
132728002600000,NW 332,Residential,35643,188697,0,224340
132728002700000,NW 332,Residential,40800,281374,0,322174
132728100100000,NW 332,Residential,32157,161186,0,193343
132728100200000,NW 332,Residential,32886,205485,0,238371
132728100300000,NW 332,Residential,29584,135952,0,165536
132728100400000,NW 332,Residential,31312,169305,0,200617
132728100500000,NW 332,Residential,31173,198838,0,230011
132728100600000,NW 332,Residential,31680,178303,0,209983
132728100800000,NW 332,Residential,34353,170270,0,204623
132728100900000,NW 332,Residential,34109,228005,0,262114
132728101000000,NW 332,Residential,34109,182652,0,216761
132728101100000,NW 332,Residential,34109,188213,0,222322
132728101200000,NW 332,Residential,32558,251444,0,284002
132728101300000,NW 332,Residential,32640,159403,0,192043
132728101400000,NW 332,Residential,34015,0,0,34015
132728200100000,NW 332,Residential,45866,190075,0,235941
132740100100000,NW 331,Residential,34030,0,0,34030
132740100200000,NW 331,Residential,31200,113009,0,144209
132740100300000,NW 331,Residential,31241,122442,0,153683
132740100400000,NW 331,Residential,32211,129204,0,161415
132740100500000,NW 331,Residential,27064,154196,0,181260
132740100600000,NW 331,Residential,26505,124043,0,150548
132740100700000,NW 331,Residential,30400,143946,0,174346
132740100800000,NW 331,Residential,32105,149050,0,181155
132740100900000,NW 331,Residential,35708,128425,0,164133
132740101000000,NW 331,Residential,34784,142623,0,177407
132740101100000,NW 331,Residential,29116,138956,0,168072
132740101200000,NW 331,Residential,34272,143043,0,177315
132740101300000,NW 331,Residential,31072,155204,0,186276
132740101400000,NW 331,Residential,37962,141237,0,179199
132740101500000,NW 331,Residential,36680,144905,0,181585
132740101600000,NW 332,Residential,32850,175011,0,207861
132740101700000,NW 332,Residential,33334,185516,0,218850
132740101800000,NW 332,Residential,30704,172300,0,203004
132740101900000,NW 332,Residential,30704,217873,0,248577
132740102000000,NW 332,Residential,32400,190477,0,222877
132740102100000,NW 332,Residential,33197,200168,0,233365
132740102200000,NW 332,Residential,30704,169721,0,200425
132740102300000,NW 332,Residential,32724,206321,0,239045
132740102400000,NW 332,Residential,30704,162429,0,193133
132740102500000,NW 332,Residential,33048,186725,0,219773
132740102600000,NW 332,Residential,33600,159817,0,193417
132740102700000,NW 332,Residential,32685,167014,0,199699
132740102800000,NW 332,Residential,32685,186206,0,218891
132740102900000,NW 332,Residential,31949,162033,0,193982
132740103000000,NW 332,Residential,33048,193550,0,226598
132740103100000,NW 332,Residential,33048,184225,0,217273
132740103200000,NW 332,Residential,30688,178118,0,208806
132740103400000,E-64 YMCA,Exempt,585090,0,1877400,2462490
132740103500000,E-15 CITY,Exempt,0,0,0,0
132740200100000,NW 332,Residential,32980,188325,0,221305
132740200200000,NW 332,Residential,31680,170218,0,201898
132740200300000,NW 332,Residential,35134,159536,0,194670
132740300100000,NW 332,Residential,32980,201221,0,234201
132740300200000,NW 332,Residential,32476,177412,0,209888
132740300300000,NW 332,Residential,9059,0,0,9059
132740300400000,NW 332,Residential,31666,165861,0,197527
132740300500000,NW 332,Residential,32980,201200,0,234180
132740300600000,NW 332,Residential,31680,176092,0,207772
132740400100000,NW 332,Residential,32335,222593,0,254928
132740400200000,NW 332,Residential,29066,158696,0,187762
132740400300000,NW 332,Residential,31902,185704,0,217606
132740400400000,NW 332,Residential,1426,0,0,1426
132740400500000,NW 332,Residential,3627,0,0,3627
132740400600000,NW 332,Residential,31600,178740,0,210340
132740400700000,NW 332,Residential,30553,160811,0,191364
132740400800000,NW 332,Residential,31360,175172,0,206532
132740400900000,NW 332,Residential,33209,184429,0,217638
132740401000000,NW 332,Residential,31530,161761,0,193291
132740500100000,NW 332,Residential,31957,178134,0,210091
132740500200000,NW 332,Residential,32000,160903,0,192903
132740500300000,NW 332,Residential,28044,170286,0,198330
132740500400000,NW 332,Residential,30541,163547,0,194088
132740500500000,NW 332,Residential,30984,205591,0,236575
132740500600000,NW 332,Residential,1227,0,0,1227
132742600100000,NW 332,Residential,34484,163221,0,197705
132742600200000,NW 332,Residential,31984,184287,0,216271
132742600300000,NW 332,Residential,31991,166748,0,198739
132742600400000,NW 332,Residential,31088,187820,0,218908
132742600500000,NW 332,Residential,32640,177984,0,210624
132742600600000,NW 332,Residential,31008,182439,0,213447
132742600700000,NW 332,Residential,32640,200478,0,233118
132742600800000,NW 332,Residential,31008,178802,0,209810
132742600900000,NW 332,Residential,31008,210332,0,241340
132742601000000,NW 332,Residential,32640,200626,0,233266
132742601100000,NW 332,Residential,31008,158281,0,189289
132742601200000,NW 332,Residential,33452,155234,0,188686
132742601300000,NW 332,Residential,33003,173964,0,206967
132742601400000,NW 332,Residential,31063,153606,0,184669
132742601500000,NW 332,Residential,33170,187024,0,220194
132742700100000,E-15 CITY,Exempt,0,0,0,0
132742700200000,NW 332,Residential,45475,227041,0,272516
132742700300000,NW 332,Residential,40626,176579,0,217205
132742700400000,NW 332,Residential,40459,182291,0,222750
132742700500000,NW 332,Residential,41895,181781,0,223676
132742700600000,NW 332,Residential,41097,155403,0,196500
132742700700000,NW 332,Residential,47701,162631,0,210332
132742700800000,NW 332,Residential,44640,191082,0,235722
132742700900000,NW 338,Residential,56100,169218,0,225318
132742701000000,NW 338,Residential,52800,178079,0,230879
132742701100000,NW 338,Residential,56100,181973,0,238073
132742701200000,NW 338,Residential,52800,188618,0,241418
132742701300000,NW 338,Residential,56100,246544,0,302644
132742701400000,NW 338,Residential,52800,197916,0,250716
132742701500000,NW 338,Residential,56100,189548,0,245648
132742800100000,NW 332,Residential,32115,158223,0,190338
132742800200000,NW 332,Residential,31385,158498,0,189883
132742800300000,NW 332,Residential,32377,207712,0,240089
132742800400000,NW 332,Residential,32300,195816,0,228116
132742800500000,NW 332,Residential,30000,162627,0,192627
132742800600000,NW 332,Residential,31920,218915,0,250835
132742800700000,NW 332,Residential,30400,164186,0,194586
132742800800000,NW 332,Residential,32000,185236,0,217236
132742800900000,NW 332,Residential,32000,182487,0,214487
132742801000000,NW 332,Residential,30400,186176,0,216576
132742801100000,NW 332,Residential,33525,201699,0,235224
132742801200000,NW 332,Residential,43481,191650,0,235131
132742801300000,NW 332,Residential,38634,174648,0,213282
132742801400000,NW 332,Residential,37558,186023,0,223581
132742801500000,NW 332,Residential,42666,165372,0,208038
132742801600000,NW 332,Residential,53222,211967,0,265189
132742801700000,NW 332,Residential,33769,240173,0,273942
132742801800000,NW 332,Residential,31172,163696,0,194868
132742801900000,NW 332,Residential,32000,184034,0,216034
132742802000000,NW 332,Residential,31200,185089,0,216289
132742802100000,NW 332,Residential,32000,192519,0,224519
132742802200000,NW 332,Residential,32000,155379,0,187379
132742802300000,NW 332,Residential,31920,211260,0,243180
132742802400000,NW 332,Residential,30400,140941,0,171341
132742802500000,NW 332,Residential,31034,172962,0,203996
132742802600000,NW 332,Residential,30483,191969,0,222452
132742802700000,NW 332,Residential,32879,181214,0,214093
132742900100000,NW 332,Residential,31467,173627,0,205094
132742900200000,NW 332,Residential,33397,205891,0,239288
132742900300000,NW 332,Residential,30612,166504,0,197116
132742900400000,NW 332,Residential,31920,177561,0,209481
132742900500000,NW 332,Residential,28800,163831,0,192631
132742900600000,NW 332,Residential,32000,201783,0,233783
132742900700000,NW 332,Residential,30400,175744,0,206144
132742900800000,NW 332,Residential,31600,155904,0,187504
132742900900000,NW 332,Residential,35054,186494,0,221548
132742901000000,NW 332,Residential,35378,200938,0,236316
132742901100000,NW 338,Residential,56101,181885,0,237986
132742901200000,NW 332,Residential,373,0,0,373
132743000100000,NW 332,Residential,51096,178843,0,229939
132743000200000,NW 332,Residential,46200,191999,0,238199
132743000300000,NW 332,Residential,51520,189723,0,241243
132743000400000,NW 338,Residential,51720,146145,0,197865
132743000500000,NW 338,Residential,49500,143159,0,192659
132743000600000,NW 338,Residential,53295,203832,0,257127
132743000700000,NW 338,Residential,52800,198939,0,251739
132743000800000,NW 338,Residential,49500,164588,0,214088
132743000900000,NW 338,Residential,53295,217670,0,270965
132743001000000,NW 338,Residential,52800,183426,0,236226
132743001100000,NW 338,Residential,49950,172086,0,222036
132743001200000,NW 338,Residential,49950,158510,0,208460
132743001300000,NW 338,Residential,53147,203628,0,256775
132743001400000,NW 338,Residential,53280,225870,0,279150
132743001500000,NW 338,Residential,49284,179035,0,228319
132743001600000,NW 338,Residential,53280,195109,0,248389
132743001700000,NW 338,Residential,49284,174254,0,223538
132743100100000,NW 338,Residential,55773,227366,0,283139
132743100200000,NW 338,Residential,53922,200309,0,254231
132743100300000,NW 338,Residential,54120,229262,0,283382
132743100400000,NW 338,Residential,53295,275783,0,329078
132743100500000,NW 338,Residential,53295,223254,0,276549
132745100200000,NW 338,Residential,52668,278035,0,330703
132745100300000,NW 332,Residential,54032,211076,0,265108
132745200100000,NW 338,Residential,49950,170172,0,220122
132745200200000,NW 338,Residential,52800,202240,0,255040
132745200500000,NW 332,Residential,50215,228876,0,279091
132745200600000,NW 332,Residential,50526,216757,0,267283
132745300100000,NW 338,Residential,53288,176907,0,230195
132745300300000,NW 332,Residential,140,0,0,140
132745300400000,NW 332,Residential,50021,212533,0,262554
132745400100000,NW 332,Residential,48600,233988,0,282588
132745400200000,NW 332,Residential,48000,188812,0,236812
132745400300000,NW 332,Residential,42000,170748,0,212748
132745400400000,NW 332,Residential,48000,254500,0,302500
132745400500000,NW 332,Residential,42000,165918,0,207918
132745400600000,NW 332,Residential,48000,210983,0,258983
132745400700000,NW 332,Residential,46200,173773,0,219973
132745400800000,NW 332,Residential,46800,170759,0,217559
132745400900000,NW 332,Residential,48000,188083,0,236083
132745401000000,NW 332,Residential,49208,185674,0,234882
132745500100000,NW 332,Residential,50722,222915,0,273637
132745500200000,NW 332,Residential,49086,203217,0,252303
132745500300000,NW 332,Residential,39996,176649,0,216645
132745500400000,NW 332,Residential,48480,223077,0,271557
132745500500000,NW 332,Residential,48480,224315,0,272795
132745500600000,NW 332,Residential,48480,195275,0,243755
132745500700000,NW 332,Residential,39996,158833,0,198829
132745500800000,NW 332,Residential,42420,185718,0,228138
132745500900000,NW 332,Residential,48480,209506,0,257986
132745501000000,NW 332,Residential,48501,162710,0,211211
132745501100000,NW 332,Residential,48363,290196,0,338559
132745501200000,NW 332,Residential,48165,287157,0,335322
132745501300000,NW 332,Residential,46200,192386,0,238586
132745501400000,NW 332,Residential,50100,211019,0,261119
132745501500000,NW 332,Residential,50400,210563,0,260963
132745501600000,NW 332,Residential,48000,197245,0,245245
132745501700000,NW 332,Residential,49020,212277,0,261297
132745501800000,NW 332,Residential,48600,201776,0,250376
132745600100000,NW 332,Residential,50838,166300,0,217138
132745600200000,NW 332,Residential,46800,142475,0,189275
132745600300000,NW 332,Residential,51642,177292,0,228934
132745600400000,NW 332,Residential,49498,162853,0,212351
132745600500000,NW 332,Residential,50616,183639,0,234255
132745600600000,NW 332,Residential,44601,151574,0,196175
132745600700000,NW 332,Residential,50223,170510,0,220733
132745600800000,NW 332,Residential,49457,213637,0,263094
132745700100000,NW 332,Residential,50787,253659,0,304446
132745700200000,NW 332,Residential,45144,187342,0,232486
132745700300000,NW 332,Residential,49896,190093,0,239989
132745700400000,NW 332,Residential,46629,158209,0,204838
132745700500000,NW 332,Residential,50193,269306,0,319499
132745700600000,NW 332,Residential,47520,165587,0,213107
132745700700000,NW 332,Residential,47520,266131,0,313651
132745700800000,NW 332,Residential,48632,206865,0,255497
132747600100000,NW 332,Residential,36720,0,0,36720
132747600200000,NW 332,Residential,34560,0,0,34560
132747600300000,NW 332,Residential,34685,0,0,34685
132747600400000,NW 332,Residential,33653,0,0,33653
132747600500000,NW 332,Residential,32585,0,0,32585
132747600600000,NW 332,Residential,32320,235088,0,267408
132747600700000,NW 332,Residential,31507,194722,0,226229
132747600800000,NW 332,Residential,30400,190078,0,220478
132747600900000,NW 332,Residential,31599,167375,0,198974
132747601000000,NW 332,Residential,33314,200252,0,233566
132747700100000,NW 332,Residential,32014,151526,0,183540
132747700200000,NW 332,Residential,30785,194468,0,225253
132747700300000,NW 332,Residential,29299,145895,0,175194
132747700400000,NW 332,Residential,32845,152214,0,185059
132747800100000,NW 332,Residential,34272,0,0,34272
132747800200000,NW 332,Residential,31855,0,0,31855
132747800300000,NW 332,Residential,33419,0,0,33419
132747800400000,NW 332,Residential,35021,0,0,35021
132747800500000,NW 332,Residential,33004,0,0,33004
132747800600000,NW 332,Residential,33040,0,0,33040
132747800700000,NW 332,Residential,33920,184601,0,218521
132747800800000,NW 332,Residential,31108,167185,0,198293
132747800900000,NW 332,Residential,34668,182392,0,217060
132747801000000,NW 332,Residential,33835,156013,0,189848
132747801100000,NW 332,Residential,31708,173570,0,205278
132747801200000,NW 332,Residential,32640,155635,0,188275
132747801300000,COMM SW,Commercial,431676,0,1043416,1475092
132747801400000,NW 332,Residential,31008,167973,0,198981
132747801500000,NW 332,Residential,33275,206773,0,240048
132747801700000,NW 332,Residential,36704,187005,0,223709
132747801800000,NW 332,Residential,33279,184198,0,217477
132747801900000,NW 332,Residential,32640,184279,0,216919
132747802000000,NW 332,Residential,31008,144018,0,175026
132747802100000,NW 332,Residential,32558,184011,0,216569
132747802200000,NW 332,Residential,31008,144764,0,175772
132747802300000,NW 332,Residential,28429,185005,0,213434
132747802400000,NW 332,Residential,35345,165444,0,200789
132747802500000,NW 332,Residential,36335,206319,0,242654
132747802600000,NW 332,Residential,30096,177150,0,207246
132747802700000,NW 332,Residential,31680,208926,0,240606
132747802800000,NW 332,Residential,36130,218525,0,254655
132747802900000,NW 332,Residential,33922,187867,0,221789
132747803000000,NW 332,Residential,32467,169210,0,201677
132747803100000,NW 332,Residential,32205,189632,0,221837
132747803200000,NW 332,Residential,30879,192785,0,223664
132747803300000,NW 332,Residential,31343,177295,0,208638
132747803400000,NW 332,Residential,33213,167727,0,200940
132747803500000,NW 332,Residential,33523,158504,0,192027
132747803600000,NW 332,Residential,29322,141905,0,171227
132747803700000,NW 332,Residential,30492,208006,0,238498
132747803800000,NW 332,Residential,29753,195000,0,224753
132747803900000,NW 332,Residential,30347,167886,0,198233
132747804000000,NW 332,Residential,31020,174794,0,205814
132747804100000,NW 332,Residential,32413,205598,0,238011
132747804200000,COMM SW,Commercial,304560,0,575598,880158
132747804300000,NW 332,Residential,42500,106135,0,148635
132747900100000,NW 332,Residential,34053,162163,0,196216
132747900200000,NW 332,Residential,32267,177183,0,209450
132747900300000,NW 332,Residential,33333,146667,0,180000
132747900400000,NW 332,Residential,32459,148031,0,180490
132747900500000,NW 332,Residential,35016,204014,0,239030
132747900600000,NW 332,Residential,31825,180755,0,212580
132747900700000,NW 332,Residential,30096,219479,0,249575
132747900800000,NW 332,Residential,30096,147942,0,178038
132747900900000,NW 332,Residential,29792,182867,0,212659
132747901000000,NW 332,Residential,31954,142556,0,174510
132747901100000,NW 332,Residential,30324,151084,0,181408
133410100100000,COMM SW,Commercial,316354,0,179162,495516
133430100100000,SW 432,Ag Land,51957,0,0,51957
133440100100000,SW 432,Ag Land,50734,0,0,50734
133440100200000,SW 432,Residential,99000,142569,0,241569
133442600100000,SW 432,Ag Land,55234,0,0,55234
133445100100000,SW 432,Ag Land,24086,0,0,24086
133447600100000,SW 432,Ag Land,34992,0,0,34992
133447600200000,Empty,Other,0,0,0,0
133510100100000,E-40 CHURCHES,Exempt,292032,0,354105,646137
133510100200000,COMM SW,Commercial,129924,0,0,129924
133510100300000,COMM SW,Commercial,294624,0,719918,1014542
133510100400000,COMM SW,Commercial,295272,0,435823,731095
133510100500000,INDUSTRIAL,Industrial,206400,0,1148482,1354882
133510100600000,COMM SW,Commercial,207900,0,345053,552953
133510100700000,E-70 CHARITY OTHER,Exempt,93312,0,351819,445131
133510200100000,COMM SW,Commercial,172368,0,901111,1073479
133510200200000,COMM SW,Commercial,114696,0,492144,606840
133510200300000,COMM SW,Commercial,114696,0,298169,412865
133510200400000,COMM SW,Commercial,114696,0,271486,386182
133510200500000,COMM SW,Commercial,141161,0,129814,270975
133510200600000,COMM SW,Commercial,153792,0,0,153792
133510200700000,COMM SW,Commercial,115344,0,0,115344
133510200800000,COMM SW,Commercial,122472,0,0,122472
133510200900000,COMM SW,Commercial,160704,0,46829,207533
133512600100000,COMM SW,Commercial,232200,0,329966,562166
133512600200000,CONVERSIONS,Commercial,54000,0,123345,177345
133512600300000,SW 407,Residential,48000,114866,0,162866
133512600400000,COMM SW,Commercial,54000,0,167834,221834
133512600500000,INDUSTRIAL,Industrial,355005,0,995257,1350262
133512600700000,COMM SW,Commercial,351216,0,250561,601777
133512600800000,SW 407,Ag Land,17035,0,0,17035
133512600900000,INDUSTRIAL,Industrial,19500,0,0,19500
133512601000000,COMM SW,Commercial,166752,0,192991,359743
133512601100000,COMM SW,Commercial,97686,0,0,97686
133512601200000,COMM SW,Commercial,187488,0,89235,276723
133512601300000,COMM SW,Commercial,67910,0,157537,225447
133515100100000,SW 407,Ag Land,50460,0,0,50460
133515100300000,COMM SW,Commercial,225504,0,165145,390649
133515100400000,SW 407,Residential,60250,104464,0,164714
133517600100000,E-15 CITY,Exempt,0,0,0,0
133517600200000,SW 407,Ag Land,11512,0,0,11512
133517600300000,COMM SW,Commercial,174528,0,137249,311777
133517600400000,SW 407,Residential,54000,75196,0,129196
133517600500000,COMM SW,Commercial,245052,0,321021,566073
133517600600000,Empty,Other,0,0,0,0
133520100100000,COMM SW,Commercial,217193,0,249234,466427
133520100200000,COMM SW,Commercial,137214,0,170453,307667
133520100300000,COMM SW,Commercial,10352,0,2677,13029
133520200100000,COMM SW,Commercial,91003,0,267337,358340
133520200200000,COMM SW,Commercial,90153,0,49600,139753
133520200300000,COMM SW,Commercial,225990,0,224010,450000
133520200400000,COMM SW,Commercial,30715,0,136263,166978
133520200500000,COMM SW,Commercial,274752,0,109392,384144
133520200600000,COMM SW,Commercial,48924,0,25440,74364
133520200700000,COMM SW,Commercial,151926,0,226147,378073
133520200800000,E-40 CHURCHES,Exempt,86400,0,164850,251250
133522600100000,COMM SW,Commercial,184356,0,220631,404987
133522600200000,NW 332,Residential,54650,124030,0,178680
133522600300000,NW 332,Residential,26892,0,0,26892
133522600400000,E-40 CHURCHES,Exempt,743580,0,4362993,5106573
133527600100000,SW 407,Ag Land,25752,0,0,25752
133527600200000,COMM SW,Commercial,1896480,0,483740,2380220
133530100100000,COMM SW,Commercial,3123576,0,2049117,5172693
133530100103000,COMM SW,Commercial,0,0,5651,5651
133530100103001,COMM SW,Commercial,0,0,4744,4744
133530100103002,COMM SW,Commercial,0,0,4942,4942
133530100103003,COMM SW,Commercial,0,0,7413,7413
133530100103004,COMM SW,Commercial,0,0,6968,6968
133530100103005,COMM SW,Commercial,0,0,6425,6425
133530100103006,COMM SW,Commercial,0,0,6425,6425
133530100103007,COMM SW,Commercial,0,0,4892,4892
133530100103008,COMM SW,Commercial,0,0,6425,6425
133530100103009,COMM SW,Commercial,0,0,5782,5782
133530100103010,COMM SW,Commercial,0,0,6571,6571
133530100103011,COMM SW,Commercial,0,0,6571,6571
133530100103012,COMM SW,Commercial,0,0,6571,6571
133530100103013,COMM SW,Commercial,0,0,7227,7227
133530100103014,COMM SW,Commercial,0,0,6571,6571
133530100103015,COMM SW,Commercial,0,0,7885,7885
133530100103016,COMM SW,Commercial,0,0,5914,5914
133530100103017,COMM SW,Commercial,0,0,7388,7388
133530100103018,COMM SW,Commercial,0,0,5115,5115
133530100103019,COMM SW,Commercial,0,0,7234,7234
133530100103020,COMM SW,Commercial,0,0,7388,7388
133530100103021,COMM SW,Commercial,0,0,6045,6045
133530100103022,COMM SW,Commercial,0,0,5115,5115
133530100103023,COMM SW,Commercial,0,0,4650,4650
133530100103024,COMM SW,Commercial,0,0,6045,6045
133530100103025,COMM SW,Commercial,0,0,6510,6510
133530100103026,COMM SW,Commercial,0,0,5115,5115
133530100103027,COMM SW,Commercial,0,0,5115,5115
133530100103028,COMM SW,Commercial,0,0,4960,4960
133530100103029,COMM SW,Commercial,0,0,7602,7602
133530100103030,COMM SW,Commercial,0,0,5807,5807
133530100103031,COMM SW,Commercial,0,0,5226,5226
133530100103032,COMM SW,Commercial,0,0,7549,7549
133530100103033,COMM SW,Commercial,0,0,5226,5226
133530100103034,COMM SW,Commercial,0,0,6968,6968
133530100103035,COMM SW,Commercial,0,0,4989,4989
133530100103036,COMM SW,Commercial,0,0,7155,7155
133530100103037,COMM SW,Commercial,0,0,5696,5696
133530100103038,COMM SW,Commercial,0,0,5337,5337
133530100103039,COMM SW,Commercial,0,0,7265,7265
133530100103040,COMM SW,Commercial,0,0,7265,7265
133530100103041,COMM SW,Commercial,0,0,6604,6604
133530100103042,COMM SW,Commercial,0,0,5449,5449
133530100103043,COMM SW,Commercial,0,0,5063,5063
133530100103044,COMM SW,Commercial,0,0,5944,5944
133530100103045,COMM SW,Commercial,0,0,7265,7265
133530100103046,COMM SW,Commercial,0,0,8586,8586
133530100103047,COMM SW,Commercial,0,0,5283,5283
133530100103048,COMM SW,Commercial,0,0,7155,7155
133530100103049,COMM SW,Commercial,0,0,6604,6604
133530100103050,COMM SW,Commercial,0,0,9081,9081
133530100103051,COMM SW,Commercial,0,0,5944,5944
133530100103052,COMM SW,Commercial,0,0,6439,6439
133530100103053,COMM SW,Commercial,0,0,7710,7710
133530100103054,COMM SW,Commercial,0,0,6604,6604
133530100103056,COMM SW,Commercial,0,0,5045,5045
133530100103057,COMM SW,Commercial,0,0,7134,7134
133530100103058,COMM SW,Commercial,0,0,7262,7262
133530100103059,COMM SW,Commercial,0,0,7313,7313
133530100103061,COMM SW,Commercial,0,0,7262,7262
133530100103062,COMM SW,Commercial,0,0,6778,6778
133530100103063,COMM SW,Commercial,0,0,5045,5045
133530100103064,COMM SW,Commercial,0,0,7491,7491
133530100103065,COMM SW,Commercial,0,0,5962,5962
133530100103066,COMM SW,Commercial,0,0,6294,6294
133530100103067,COMM SW,Commercial,0,0,5045,5045
133530100103068,COMM SW,Commercial,0,0,6604,6604
133530100103069,COMM SW,Commercial,0,0,8916,8916
133530100103070,COMM SW,Commercial,0,0,7925,7925
133530100103072,COMM SW,Commercial,0,0,6604,6604
133530100103073,COMM SW,Commercial,0,0,5751,5751
133530100103074,COMM SW,Commercial,0,0,9411,9411
133530100103075,COMM SW,Commercial,0,0,7265,7265
133530100103076,COMM SW,Commercial,0,0,5504,5504
133530100103077,COMM SW,Commercial,0,0,7265,7265
133530100103078,COMM SW,Commercial,0,0,11228,11228
133530100103079,COMM SW,Commercial,0,0,4413,4413
133530100103080,COMM SW,Commercial,0,0,9206,9206
133530100103082,COMM SW,Commercial,0,0,6604,6604
133530100103083,COMM SW,Commercial,0,0,4238,4238
133530100103084,COMM SW,Commercial,0,0,8286,8286
133530100103085,COMM SW,Commercial,0,0,6604,6604
133530100103086,COMM SW,Commercial,0,0,7436,7436
133530100103087,COMM SW,Commercial,0,0,7667,7667
133530100103088,COMM SW,Commercial,0,0,8049,8049
133530100103089,COMM SW,Commercial,0,0,4843,4843
133530100103091,COMM SW,Commercial,0,0,760,760
133530100103092,COMM SW,Commercial,0,0,8586,8586
133532600100000,COMM SW,Commercial,537475,0,370403,907878
133532600103000,COMM SW,Commercial,0,0,8586,8586
133532600103001,COMM SW,Commercial,0,0,5944,5944
133532600103002,COMM SW,Commercial,0,0,8256,8256
133532600103003,COMM SW,Commercial,0,0,7705,7705
133532600103004,COMM SW,Commercial,0,0,6274,6274
133532600103005,COMM SW,Commercial,0,0,7870,7870
133532600103006,COMM SW,Commercial,0,0,7155,7155
133532600103007,COMM SW,Commercial,0,0,5504,5504
133532600103022,COMM SW,Commercial,0,0,5884,5884
133532600103068,COMM SW,Commercial,0,0,7155,7155
133532600300000,SW 432,Residential,122550,0,0,122550
133535100200000,SW 432,Residential,28000,0,0,28000
133535100300000,SW 432,Residential,28000,0,0,28000
133535100400000,SW 432,Residential,28000,152872,0,180872
133535100500000,SW 432,Residential,28000,131981,0,159981
133535100600000,SW 432,Residential,28000,112885,0,140885
133535100700000,SW 432,Residential,28000,114289,0,142289
133535100800000,SW 432,Residential,28000,115280,0,143280
133535100900000,SW 432,Residential,28516,112756,0,141272
133535101000000,SW 432,Residential,39574,0,0,39574
133535101100000,SW 432,Residential,44087,114435,0,158522
133535200100000,SW 432,Residential,28900,233875,0,262775
133535200200000,SW 432,Residential,28900,108590,0,137490
133535200300000,SW 432,Residential,30410,173873,0,204283
133535200400000,SW 407,Residential,92840,0,0,92840
133535200500000,SW 432,Residential,41707,0,0,41707
133535200600000,SW 432,Residential,43056,175322,0,218378
133535200700000,SW 432,Residential,28000,0,0,28000
133535200800000,SW 432,Residential,28000,136127,0,164127
133535200900000,SW 432,Residential,28000,156300,0,184300
133535201000000,SW 432,Residential,28000,166560,0,194560
133535201100000,SW 432,Residential,28000,182805,0,210805
133535300100000,SW 432,Residential,28000,114430,0,142430
133535300200000,SW 432,Residential,28000,133685,0,161685
133535300300000,SW 432,Residential,29915,112936,0,142851
133535400100000,SW 432,Residential,28000,0,0,28000
133535400200000,SW 432,Residential,28000,0,0,28000
133535400300000,SW 432,Residential,28000,0,0,28000
133535400400000,SW 432,Residential,28000,121648,0,149648
133535400500000,SW 432,Residential,28000,0,0,28000
133535400600000,SW 432,Residential,31079,132861,0,163940
133535400700000,SW 432,Residential,34687,112691,0,147378
133535400800000,SW 432,Residential,35046,126246,0,161292
133535400900000,SW 432,Residential,38080,0,0,38080
133535401000000,SW 432,Residential,28000,149137,0,177137
133535401100000,SW 432,Residential,28000,142612,0,170612
133535401200000,SW 432,Residential,28000,115692,0,143692
133535401300000,SW 432,Residential,28000,0,0,28000
133535500100000,SW 432,Residential,28000,156438,0,184438
133535500200000,SW 432,Residential,28000,136532,0,164532
133535500300000,SW 432,Residential,28000,0,0,28000
133535500400000,SW 432,Residential,28000,0,0,28000
133535500500000,SW 432,Residential,28000,0,0,28000
133535500600000,SW 432,Residential,29733,0,0,29733
133535500700000,SW 432,Residential,28280,0,0,28280
133535500800000,SW 432,Residential,37333,4500,0,41833
133535500900000,SW 432,Residential,47173,113698,0,160871
133535501000000,SW 432,Residential,46020,167636,0,213656
133535501100000,SW 432,Residential,41616,134173,0,175789
133537600100000,SW 407,Ag Land,59072,0,0,59072
133540100100000,SW 407,Ag Land,51469,0,1528,52997
133540100102000,SW 407,Residential,0,13127,0,13127
133545100100000,SW 407,Ag Land,52910,0,1509,54419
133545100200000,SW 407,Residential,74400,136884,0,211284
133547600100000,SW 407,Ag Land,50335,0,0,50335
133610100100000,COMM SW,Commercial,259524,0,232221,491745
133610100200000,COMM SW,Commercial,599400,0,250600,850000
133610100300000,E-70 CHARITY OTHER,Exempt,122715,0,19316,142031
133610100302000,COMM SW,Commercial,0,0,10925,10925
133610100400000,E-70 CHARITY OTHER,Exempt,296568,0,1083271,1379839
133610100500000,COMM SW,Commercial,258417,0,330883,589300
133610100600000,COMM SW,Commercial,33614,0,0,33614
133610100700000,COMM SW,Commercial,33502,0,454,33956
133610100800000,E-70 CHARITY OTHER,Exempt,67003,0,258641,325644
133610100900000,COMM SW,Commercial,83430,0,185338,268768
133610101000000,COMM SW,Commercial,116122,0,231305,347427
133610101100000,COMM SW,Commercial,226152,0,136319,362471
133610200100000,COMM SW,Commercial,191808,0,19767,211575
133610200300000,SW 407,Ag Land,10746,0,0,10746
133610200400000,COMM SW,Commercial,631800,0,849636,1481436
133610200500000,COMM SW,Commercial,115776,0,56886,172662
133610200600000,COMM SW,Commercial,38880,0,61048,99928
133610200700000,COMM SW,Commercial,265248,0,576194,841442
133610200800000,COMM SW,Commercial,11059,0,0,11059
133612600100000,COMM SW,Commercial,187650,0,245131,432781
133612600200000,INDUSTRIAL,Industrial,145000,0,564080,709080
133612600300000,COMM SW,Commercial,184950,0,682050,867000
133612600400000,COMM SW,Commercial,395280,0,226044,621324
133612600500000,COMM SW,Commercial,372060,0,201291,573351
133612600502000,COMM SW,Commercial,0,0,51933,51933
133612600600000,SW 407,Residential,50750,100652,0,151402
133612700100000,SW 407,Ag Land,22478,0,0,22478
133615100200000,COMM SW,Commercial,121478,0,305678,427156
133615100400000,APTS SW,Commercial,15953,0,155067,171020
133615100500000,APTS SW,Commercial,15901,0,143565,159466
133615100600000,APTS SW,Commercial,15901,0,151748,167649
133615100700000,APTS SW,Commercial,15901,0,106776,122677
133615100800000,APTS SW,Commercial,15848,0,106776,122624
133615100900000,APTS SW,Commercial,15795,0,114486,130281
133615101000000,APTS SW,Commercial,15795,0,113347,129142
133615101800000,APTS SW,Commercial,15396,0,123473,138869
133615102100000,APTS SW,Commercial,15396,0,117855,133251
133615102200000,APTS SW,Commercial,15396,0,124850,140246
133615102300000,APTS SW,Commercial,15396,0,124685,140081
133615102400000,APTS SW,Commercial,15396,0,116641,132037
133615102700000,COMM SW,Commercial,257850,0,242150,500000
133615102800000,COMM SW,Commercial,162000,0,683172,845172
133615102901000,CONDO 500,Residential,4000,43241,0,47241
133615102901001,CONDO 500,Residential,4000,43241,0,47241
133615102901002,CONDO 500,Residential,4000,43241,0,47241
133615102901003,CONDO 500,Residential,4000,43241,0,47241
133615102901004,CONDO 500,Residential,4000,30087,0,34087
133615102901005,CONDO 500,Residential,4000,30087,0,34087
133615102901006,CONDO 500,Residential,4000,30087,0,34087
133615102901007,CONDO 500,Residential,4000,30087,0,34087
133615102901008,CONDO 500,Residential,4000,30087,0,34087
133615102901009,CONDO 500,Residential,4000,30087,0,34087
133615102901010,CONDO 500,Residential,4000,30087,0,34087
133615102901011,CONDO 500,Residential,4000,30087,0,34087
133615102901012,CONDO 500,Residential,4000,30087,0,34087
133615102901013,CONDO 500,Residential,4000,30087,0,34087
133615102901014,CONDO 500,Residential,4000,30087,0,34087
133615102901015,CONDO 500,Residential,4000,30087,0,34087
133615102901016,CONDO 500,Residential,4000,30087,0,34087
133615102901017,CONDO 500,Residential,4000,30087,0,34087
133615102901018,CONDO 500,Residential,4000,30087,0,34087
133615102901019,CONDO 500,Residential,4000,30087,0,34087
133615102901020,CONDO 500,Residential,4000,30087,0,34087
133615102901021,CONDO 500,Residential,4000,30087,0,34087
133615102901022,CONDO 500,Residential,4000,30087,0,34087
133615102901023,CONDO 500,Residential,4000,30087,0,34087
133615102901024,CONDO 500,Residential,4000,30087,0,34087
133615102901025,CONDO 500,Residential,4000,30087,0,34087
133615102901026,CONDO 500,Residential,4000,30087,0,34087
133615102901027,CONDO 500,Residential,4000,30087,0,34087
133615102901028,CONDO 500,Residential,4000,37016,0,41016
133615102901029,CONDO 500,Residential,4000,37016,0,41016
133615102901030,CONDO 500,Residential,4000,37016,0,41016
133615102901031,CONDO 500,Residential,4000,37016,0,41016
133615102901032,CONDO 500,Residential,4000,37016,0,41016
133615102901033,CONDO 500,Residential,4000,37016,0,41016
133615102901034,CONDO 500,Residential,4000,37016,0,41016
133615102901035,CONDO 500,Residential,4000,37016,0,41016
133615102901036,CONDO 500,Residential,4000,37016,0,41016
133615102901037,CONDO 500,Residential,4000,37016,0,41016
133615102901038,CONDO 500,Residential,4000,37016,0,41016
133615102901039,CONDO 500,Residential,4000,37016,0,41016
133615102901040,CONDO 500,Residential,4000,37016,0,41016
133615102901041,CONDO 500,Residential,4000,37016,0,41016
133615102901042,CONDO 500,Residential,4000,37016,0,41016
133615102901043,CONDO 500,Residential,4000,37016,0,41016
133615102901044,CONDO 500,Residential,4000,37016,0,41016
133615102901045,CONDO 500,Residential,4000,37016,0,41016
133615102901046,CONDO 500,Residential,4000,37016,0,41016
133615102901047,CONDO 500,Residential,4000,37016,0,41016
133615102901048,CONDO 500,Residential,4000,37016,0,41016
133615102901049,CONDO 500,Residential,4000,37016,0,41016
133615102901050,CONDO 500,Residential,4000,37016,0,41016
133615102901051,CONDO 500,Residential,4000,37016,0,41016
133615102901052,CONDO 500,Residential,4000,37016,0,41016
133615102901053,CONDO 500,Residential,4000,37016,0,41016
133615102901054,CONDO 500,Residential,4000,37016,0,41016
133615102901055,CONDO 500,Residential,4000,37016,0,41016
133615102901056,CONDO 500,Residential,4000,37016,0,41016
133615102901057,CONDO 500,Residential,4000,37016,0,41016
133615102901058,CONDO 500,Residential,4000,37016,0,41016
133615102901059,CONDO 500,Residential,4000,37016,0,41016
133615102901060,CONDO 500,Residential,4000,37016,0,41016
133615102901061,CONDO 500,Residential,4000,37016,0,41016
133615102901062,CONDO 500,Residential,4000,37016,0,41016
133615102901063,CONDO 500,Residential,4000,37016,0,41016
133615102901064,CONDO 500,Residential,4000,37016,0,41016
133615102901065,CONDO 500,Residential,4000,37016,0,41016
133615102901066,CONDO 500,Residential,4000,37016,0,41016
133615102901067,CONDO 500,Residential,4000,37016,0,41016
133615102901068,CONDO 500,Residential,4000,37016,0,41016
133615102901069,CONDO 500,Residential,4000,37016,0,41016
133615102901070,CONDO 500,Residential,4000,37016,0,41016
133615102901071,CONDO 500,Residential,4000,37016,0,41016
133615102901072,CONDO 500,Residential,4000,37016,0,41016
133615102901073,CONDO 500,Residential,4000,37016,0,41016
133615102901074,CONDO 500,Residential,4000,37016,0,41016
133615102901075,CONDO 500,Residential,4000,37016,0,41016
133615102901076,CONDO 500,Residential,4000,37016,0,41016
133615102901077,CONDO 500,Residential,4000,37016,0,41016
133615102901078,CONDO 500,Residential,4000,37016,0,41016
133615102901079,CONDO 500,Residential,4000,37016,0,41016
133615102901080,CONDO 500,Residential,4000,37016,0,41016
133615102901081,CONDO 500,Residential,4000,37016,0,41016
133615102901082,CONDO 500,Residential,4000,37016,0,41016
133615102901083,CONDO 500,Residential,4000,37016,0,41016
133615102901084,CONDO 500,Residential,4000,37016,0,41016
133615102901085,CONDO 500,Residential,4000,37016,0,41016
133615102901086,CONDO 500,Residential,4000,37016,0,41016
133615102901087,CONDO 500,Residential,4000,37016,0,41016
133615102901088,CONDO 500,Residential,4000,37016,0,41016
133615102901089,CONDO 500,Residential,4000,37016,0,41016
133615102901090,CONDO 500,Residential,4000,37016,0,41016
133615102901091,CONDO 500,Residential,4000,37016,0,41016
133615102901092,CONDO 500,Residential,4000,30087,0,34087
133615102901093,CONDO 500,Residential,4000,30087,0,34087
133615102901094,CONDO 500,Residential,4000,30087,0,34087
133615102901095,CONDO 500,Residential,4000,29022,0,33022
133615102901096,CONDO 500,Residential,4000,29022,0,33022
133615102901097,CONDO 500,Residential,4000,29022,0,33022
133615102901098,CONDO 500,Residential,4000,29022,0,33022
133615102901099,CONDO 500,Residential,4000,29022,0,33022
133615102901100,CONDO 500,Residential,4000,29022,0,33022
133615102901101,CONDO 500,Residential,4000,29022,0,33022
133615102901102,CONDO 500,Residential,4000,29022,0,33022
133615102901103,CONDO 500,Residential,4000,29022,0,33022
133615102901104,CONDO 500,Residential,4000,29022,0,33022
133615102901105,CONDO 500,Residential,4000,29022,0,33022
133615102901106,CONDO 500,Residential,4000,29022,0,33022
133615102901107,CONDO 500,Residential,4000,29022,0,33022
133615102901108,CONDO 500,Residential,4000,29022,0,33022
133615102901109,CONDO 500,Residential,4000,29022,0,33022
133615102901110,CONDO 500,Residential,4000,29022,0,33022
133615102901111,CONDO 500,Residential,4000,29022,0,33022
133615102901112,CONDO 500,Residential,4000,29022,0,33022
133615102901113,CONDO 500,Residential,4000,29022,0,33022
133615102901114,CONDO 500,Residential,4000,29022,0,33022
133615102901115,CONDO 500,Residential,4000,29022,0,33022
133615102901116,CONDO 500,Residential,4000,29022,0,33022
133615102901117,CONDO 500,Residential,4000,29022,0,33022
133615102901118,CONDO 500,Residential,4000,29022,0,33022
133615102901119,CONDO 500,Residential,4000,29022,0,33022
133615102901120,CONDO 500,Residential,4000,29022,0,33022
133615102901121,CONDO 500,Residential,4000,29022,0,33022
133615102901122,CONDO 500,Residential,4000,29022,0,33022
133615102901123,CONDO 500,Residential,4000,29022,0,33022
133615103001000,CONDO 500,Residential,4000,42176,0,46176
133615103001001,CONDO 500,Residential,4000,42176,0,46176
133615103001002,CONDO 500,Residential,4000,42176,0,46176
133615103001003,CONDO 500,Residential,4000,42176,0,46176
133615103001004,CONDO 500,Residential,4000,42176,0,46176
133615103001005,CONDO 500,Residential,4000,42176,0,46176
133615103001006,CONDO 500,Residential,4000,42176,0,46176
133615103001007,CONDO 500,Residential,4000,42176,0,46176
133615103101000,CONDO 500,Residential,4000,42625,0,46625
133615103101001,CONDO 500,Residential,4000,42625,0,46625
133615103101002,CONDO 500,Residential,4000,42625,0,46625
133615103101003,CONDO 500,Residential,4000,42625,0,46625
133615103201000,CONDO 500,Residential,4000,42625,0,46625
133615103201001,CONDO 500,Residential,4000,42625,0,46625
133615103201002,CONDO 500,Residential,4000,42625,0,46625
133615103201003,CONDO 500,Residential,4000,42625,0,46625
133615103301000,CONDO 500,Residential,4000,41727,0,45727
133615103301001,CONDO 500,Residential,4000,41727,0,45727
133615103301002,CONDO 500,Residential,4000,41727,0,45727
133615103301003,CONDO 500,Residential,4000,41727,0,45727
133615103401000,CONDO 500,Residential,4000,52379,0,56379
133615103401001,CONDO 500,Residential,4000,52379,0,56379
133615103401002,CONDO 500,Residential,4000,52379,0,56379
133615103401003,CONDO 500,Residential,4000,52379,0,56379
133615103501000,CONDO 505,Residential,4000,52379,0,56379
133615103501001,CONDO 500,Residential,4000,52379,0,56379
133615103501002,CONDO 500,Residential,4000,52379,0,56379
133615103501003,CONDO 500,Residential,4000,52379,0,56379
133615103601000,CONDO 500,Residential,4000,41727,0,45727
133615103601001,CONDO 500,Residential,4000,41727,0,45727
133615103601002,CONDO 500,Residential,4000,41727,0,45727
133615103601003,CONDO 500,Residential,4000,41727,0,45727
133615103701000,CONDO 500,Residential,4000,42176,0,46176
133615103701001,CONDO 500,Residential,4000,42176,0,46176
133615103701002,CONDO 500,Residential,4000,42176,0,46176
133615103701003,CONDO 500,Residential,4000,42176,0,46176
133615103801000,CONDO 500,Residential,4000,42176,0,46176
133615103801001,CONDO 500,Residential,4000,42176,0,46176
133615103801002,CONDO 500,Residential,4000,42176,0,46176
133615103801003,CONDO 500,Residential,4000,42176,0,46176
133615103901000,CONDO 500,Residential,4000,41727,0,45727
133615103901001,CONDO 500,Residential,4000,41727,0,45727
133615103901002,CONDO 500,Residential,4000,41727,0,45727
133615103901003,CONDO 500,Residential,4000,41727,0,45727
133615104001000,CONDO 500,Residential,4000,42625,0,46625
133615104001001,CONDO 500,Residential,4000,42625,0,46625
133615104001002,CONDO 500,Residential,4000,42625,0,46625
133615104001003,CONDO 500,Residential,4000,42625,0,46625
133615104001004,CONDO 500,Residential,4000,42625,0,46625
133615104001005,CONDO 500,Residential,4000,42625,0,46625
133615104001006,CONDO 500,Residential,4000,42625,0,46625
133615104001007,CONDO 500,Residential,4000,42625,0,46625
133615104001008,CONDO 500,Residential,4000,42625,0,46625
133615104001009,CONDO 500,Residential,4000,42625,0,46625
133615104001010,CONDO 500,Residential,4000,42625,0,46625
133615104001011,CONDO 500,Residential,4000,42625,0,46625
133615104001012,CONDO 500,Residential,4000,42625,0,46625
133615104001013,CONDO 500,Residential,4000,42625,0,46625
133615104001014,CONDO 500,Residential,4000,42625,0,46625
133615104001015,CONDO 500,Residential,4000,42625,0,46625
133615104001016,CONDO 500,Residential,4000,42625,0,46625
133615104001017,CONDO 500,Residential,4000,42625,0,46625
133615104001018,CONDO 500,Residential,4000,42625,0,46625
133615104001019,CONDO 500,Residential,4000,42625,0,46625
133615104001020,CONDO 500,Residential,4000,42625,0,46625
133615104001021,CONDO 500,Residential,4000,42625,0,46625
133615104001022,CONDO 500,Residential,4000,42625,0,46625
133615104001023,CONDO 500,Residential,4000,42625,0,46625
133615104001024,CONDO 500,Residential,4000,42625,0,46625
133615104001025,CONDO 500,Residential,4000,42625,0,46625
133615104001026,CONDO 500,Residential,4000,42625,0,46625
133615104001027,CONDO 500,Residential,4000,42625,0,46625
133615104001028,CONDO 500,Residential,4000,42625,0,46625
133615104001029,CONDO 500,Residential,4000,42625,0,46625
133615104001030,CONDO 500,Residential,4000,42625,0,46625
133615104001031,CONDO 500,Residential,4000,42625,0,46625
133615104001032,CONDO 500,Residential,4000,42625,0,46625
133615104001033,CONDO 500,Residential,4000,42625,0,46625
133615104001034,CONDO 500,Residential,4000,42625,0,46625
133615104001035,CONDO 500,Residential,4000,42625,0,46625
133615104001036,CONDO 500,Residential,4000,42625,0,46625
133615104001037,CONDO 500,Residential,4000,42625,0,46625
133615104001038,CONDO 500,Residential,4000,42625,0,46625
133615104001039,CONDO 500,Residential,4000,42625,0,46625
133615104001040,CONDO 500,Residential,4000,42625,0,46625
133615104001041,CONDO 500,Residential,4000,42625,0,46625
133615104001042,CONDO 500,Residential,4000,42625,0,46625
133615104001043,CONDO 500,Residential,4000,42625,0,46625
133615104001044,CONDO 500,Residential,4000,42625,0,46625
133615104001045,CONDO 500,Residential,4000,42625,0,46625
133615104001046,CONDO 500,Residential,4000,42625,0,46625
133615104001047,CONDO 500,Residential,4000,42625,0,46625
133615104001048,CONDO 500,Residential,4000,42625,0,46625
133615104001049,CONDO 500,Residential,4000,42625,0,46625
133615104001050,CONDO 500,Residential,4000,42625,0,46625
133615104001051,CONDO 500,Residential,4000,42625,0,46625
133615104001052,CONDO 500,Residential,4000,42625,0,46625
133615104001053,CONDO 500,Residential,4000,42625,0,46625
133615104001054,CONDO 500,Residential,4000,42625,0,46625
133615104001055,CONDO 500,Residential,4000,42625,0,46625
133615104001056,CONDO 500,Residential,4000,42625,0,46625
133615104001057,CONDO 500,Residential,4000,42625,0,46625
133615104001058,CONDO 500,Residential,4000,42625,0,46625
133615104001059,CONDO 500,Residential,4000,42625,0,46625
133615104001060,CONDO 500,Residential,4000,42625,0,46625
133615104001061,CONDO 500,Residential,4000,42625,0,46625
133615104001062,CONDO 500,Residential,4000,42625,0,46625
133615104001063,CONDO 500,Residential,4000,42625,0,46625
133615104001064,CONDO 500,Residential,4000,42625,0,46625
133615104001065,CONDO 500,Residential,4000,42625,0,46625
133615104001066,CONDO 500,Residential,4000,42625,0,46625
133615104001067,CONDO 500,Residential,4000,42625,0,46625
133615104001068,CONDO 500,Residential,4000,42625,0,46625
133615104001069,CONDO 500,Residential,4000,42625,0,46625
133615104001070,CONDO 500,Residential,4000,42625,0,46625
133615104001071,CONDO 500,Residential,4000,42625,0,46625
133615104001072,CONDO 500,Residential,4000,42625,0,46625
133615104001073,CONDO 500,Residential,4000,42625,0,46625
133615104001074,CONDO 500,Residential,4000,42625,0,46625
133615104001075,CONDO 500,Residential,4000,42625,0,46625
133615200200000,COMM SW,Commercial,121770,0,366511,488281
133615200300000,COMM SW,Commercial,121770,0,355951,477721
133615200401000,COMM SW,Commercial,16200,0,53800,70000
133615200401001,COMM SW,Commercial,16200,0,53800,70000
133615200401002,COMM SW,Commercial,16200,0,53800,70000
133615200401003,COMM SW,Commercial,16200,0,53800,70000
133615200401004,COMM SW,Commercial,14580,0,68743,83323
133615200401005,COMM SW,Commercial,14580,0,50420,65000
133615200401006,COMM SW,Commercial,14580,0,50420,65000
133615200401007,COMM SW,Commercial,14580,0,50420,65000
133615200500000,COMM SW,Commercial,147571,0,434414,581985
133615200600000,E-40 CHURCHES,Exempt,243540,0,574659,818199
133615200800000,COMM SW,Commercial,76982,0,190689,267671
133615201001000,CONDO 500,Residential,4000,31121,0,35121
133615201001001,CONDO 500,Residential,4000,31121,0,35121
133615201001002,CONDO 500,Residential,4000,31121,0,35121
133615201001003,CONDO 500,Residential,4000,31121,0,35121
133615201001004,CONDO 500,Residential,4000,31121,0,35121
133615201001005,CONDO 500,Residential,4000,31121,0,35121
133615201001006,CONDO 500,Residential,4000,31121,0,35121
133615201001007,CONDO 500,Residential,4000,31121,0,35121
133615201001008,CONDO 500,Residential,4000,31121,0,35121
133615201001009,CONDO 500,Residential,4000,31121,0,35121
133615201001010,CONDO 500,Residential,4000,31121,0,35121
133615201001011,CONDO 500,Residential,4000,31121,0,35121
133615201001012,CONDO 500,Residential,4000,31121,0,35121
133615201001013,CONDO 500,Residential,4000,31121,0,35121
133615201001014,CONDO 500,Residential,4000,31121,0,35121
133615201001015,CONDO 500,Residential,4000,31121,0,35121
133615201101000,CONDO 500,Residential,4000,30931,0,34931
133615201101001,CONDO 500,Residential,4000,30931,0,34931
133615201101002,CONDO 500,Residential,4000,30931,0,34931
133615201101003,CONDO 500,Residential,4000,30931,0,34931
133615201101004,CONDO 500,Residential,4000,30931,0,34931
133615201101005,CONDO 500,Residential,4000,30931,0,34931
133615201101006,CONDO 500,Residential,4000,30931,0,34931
133615201101007,CONDO 500,Residential,4000,30931,0,34931
133615201101008,CONDO 505,Residential,4000,57069,0,61069
133615201101009,CONDO 500,Residential,4000,57069,0,61069
133615201101010,CONDO 500,Residential,4000,57069,0,61069
133615201101011,CONDO 500,Residential,4000,57069,0,61069
133615300801000,CONDO 500,Residential,4000,35951,0,39951
133615300801001,CONDO 500,Residential,4000,35951,0,39951
133615300801002,CONDO 500,Residential,4000,35951,0,39951
133615300801003,CONDO 500,Residential,4000,35951,0,39951
133615300801004,CONDO 500,Residential,4000,35951,0,39951
133615300801005,CONDO 500,Residential,4000,35951,0,39951
133615300801006,CONDO 500,Residential,4000,35951,0,39951
133615300801007,CONDO 500,Residential,4000,35951,0,39951
133615300801008,CONDO 500,Residential,4000,35951,0,39951
133615300801009,CONDO 500,Residential,4000,35951,0,39951
133615300801010,CONDO 500,Residential,4000,35951,0,39951
133615300801011,CONDO 500,Residential,4000,35951,0,39951
133615300801012,CONDO 500,Residential,4000,35951,0,39951
133615300801013,CONDO 500,Residential,4000,35951,0,39951
133615300801014,CONDO 500,Residential,4000,35951,0,39951
133615300801015,CONDO 500,Residential,4000,35951,0,39951
133615300801016,CONDO 500,Residential,4000,38050,0,42050
133615300801017,CONDO 500,Residential,4000,38050,0,42050
133615300801018,CONDO 500,Residential,4000,38050,0,42050
133615300801019,CONDO 500,Residential,4000,38050,0,42050
133615300801020,CONDO 500,Residential,4000,38050,0,42050
133615300801021,CONDO 500,Residential,4000,38050,0,42050
133615300801022,CONDO 500,Residential,4000,38050,0,42050
133615300801023,CONDO 500,Residential,4000,38050,0,42050
133615300801024,CONDO 500,Residential,4000,30811,0,34811
133615300801025,CONDO 500,Residential,4000,30811,0,34811
133615300801026,CONDO 500,Residential,4000,30811,0,34811
133615300801027,CONDO 500,Residential,4000,30811,0,34811
133615300801028,CONDO 500,Residential,4000,30811,0,34811
133615300801029,CONDO 500,Residential,4000,30811,0,34811
133615300801030,CONDO 500,Residential,4000,30811,0,34811
133615300801031,CONDO 500,Residential,4000,30811,0,34811
133615300801032,CONDO 500,Residential,4000,35951,0,39951
133615300801033,CONDO 500,Residential,4000,35951,0,39951
133615300801034,CONDO 500,Residential,4000,35951,0,39951
133615300801035,CONDO 500,Residential,4000,35951,0,39951
133615300801036,CONDO 500,Residential,4000,35951,0,39951
133615300801037,CONDO 500,Residential,4000,35951,0,39951
133615300801038,CONDO 500,Residential,4000,35951,0,39951
133615300801039,CONDO 500,Residential,4000,35951,0,39951
133615300801040,CONDO 500,Residential,4000,35951,0,39951
133615300801041,CONDO 500,Residential,4000,35951,0,39951
133615300801042,CONDO 500,Residential,4000,35951,0,39951
133615300801043,CONDO 500,Residential,4000,35951,0,39951
133615300801044,CONDO 500,Residential,4000,35951,0,39951
133615300801045,CONDO 500,Residential,4000,35951,0,39951
133615300801046,CONDO 500,Residential,4000,35951,0,39951
133615300801047,CONDO 500,Residential,4000,35951,0,39951
133615300801048,CONDO 500,Residential,4000,35951,0,39951
133615300801049,CONDO 500,Residential,4000,35951,0,39951
133615300801050,CONDO 500,Residential,4000,35951,0,39951
133615300801051,CONDO 500,Residential,4000,35951,0,39951
133615300801052,CONDO 500,Residential,4000,35951,0,39951
133615300801053,CONDO 500,Residential,4000,35951,0,39951
133615300801054,CONDO 500,Residential,4000,35951,0,39951
133615300801055,CONDO 500,Residential,4000,35951,0,39951
133615300901000,CONDO 500,Residential,4000,35951,0,39951
133615300901001,CONDO 500,Residential,4000,35951,0,39951
133615300901002,CONDO 500,Residential,4000,35951,0,39951
133615300901003,CONDO 500,Residential,4000,35951,0,39951
133615300901004,CONDO 500,Residential,4000,35951,0,39951
133615300901005,CONDO 500,Residential,4000,35951,0,39951
133615300901006,CONDO 500,Residential,4000,35951,0,39951
133615300901007,CONDO 500,Residential,4000,35951,0,39951
133615300901008,CONDO 500,Residential,4000,35951,0,39951
133615300901009,CONDO 500,Residential,4000,35951,0,39951
133615300901010,CONDO 500,Residential,4000,35951,0,39951
133615300901011,CONDO 500,Residential,4000,35951,0,39951
133615300901012,CONDO 500,Residential,4000,35951,0,39951
133615300901013,CONDO 500,Residential,4000,35951,0,39951
133615300901014,CONDO 500,Residential,4000,35951,0,39951
133615300901015,CONDO 500,Residential,4000,35951,0,39951
133615300901016,CONDO 500,Residential,4000,35951,0,39951
133615300901017,CONDO 500,Residential,4000,35951,0,39951
133615300901018,CONDO 500,Residential,4000,35951,0,39951
133615300901019,CONDO 500,Residential,4000,35951,0,39951
133615300901020,CONDO 500,Residential,4000,35951,0,39951
133615300901021,CONDO 500,Residential,4000,35951,0,39951
133615300901022,CONDO 500,Residential,4000,35951,0,39951
133615300901023,CONDO 500,Residential,4000,35951,0,39951
133615301001000,CONDO 500,Residential,4000,35951,0,39951
133615301001001,CONDO 500,Residential,4000,35951,0,39951
133615301001002,CONDO 500,Residential,4000,35951,0,39951
133615301001003,CONDO 500,Residential,4000,35951,0,39951
133615301001004,CONDO 500,Residential,4000,35951,0,39951
133615301001005,CONDO 500,Residential,4000,35951,0,39951
133615301001006,CONDO 500,Residential,4000,35951,0,39951
133615301001007,CONDO 500,Residential,4000,35951,0,39951
133615301001008,CONDO 500,Residential,4000,35951,0,39951
133615301001009,CONDO 500,Residential,4000,35951,0,39951
133615301001010,CONDO 500,Residential,4000,35951,0,39951
133615301001011,CONDO 500,Residential,4000,35951,0,39951
133615301001012,CONDO 500,Residential,4000,35951,0,39951
133615301001013,CONDO 500,Residential,4000,35951,0,39951
133615301001014,CONDO 500,Residential,4000,35951,0,39951
133615301001015,CONDO 500,Residential,4000,35951,0,39951
133615301001016,CONDO 500,Residential,4000,35951,0,39951
133615301001017,CONDO 500,Residential,4000,35951,0,39951
133615301001018,CONDO 500,Residential,4000,35951,0,39951
133615301001019,CONDO 500,Residential,4000,35951,0,39951
133615301001020,CONDO 500,Residential,4000,35951,0,39951
133615301001021,CONDO 500,Residential,4000,35951,0,39951
133615301001022,CONDO 500,Residential,4000,35951,0,39951
133615301001023,CONDO 500,Residential,4000,35951,0,39951
133615301101000,CONDO 500,Residential,4000,35951,0,39951
133615301101001,CONDO 500,Residential,4000,35951,0,39951
133615301101002,CONDO 500,Residential,4000,35951,0,39951
133615301101003,CONDO 500,Residential,4000,35951,0,39951
133615301101004,CONDO 500,Residential,4000,35951,0,39951
133615301101005,CONDO 500,Residential,4000,35951,0,39951
133615301101006,CONDO 500,Residential,4000,35951,0,39951
133615301101007,CONDO 500,Residential,4000,35951,0,39951
133615301101008,CONDO 500,Residential,4000,35951,0,39951
133615301101009,CONDO 500,Residential,4000,35951,0,39951
133615301101010,CONDO 500,Residential,4000,35951,0,39951
133615301101011,CONDO 500,Residential,4000,35951,0,39951
133615301101012,CONDO 500,Residential,4000,35951,0,39951
133615301101013,CONDO 500,Residential,4000,35951,0,39951
133615301101014,CONDO 500,Residential,4000,35951,0,39951
133615301101015,CONDO 500,Residential,4000,35951,0,39951
133615301101016,CONDO 500,Residential,4000,35951,0,39951
133615301101017,CONDO 500,Residential,4000,35951,0,39951
133615301101018,CONDO 500,Residential,4000,35951,0,39951
133615301101019,CONDO 500,Residential,4000,35951,0,39951
133615301101020,CONDO 500,Residential,4000,35951,0,39951
133615301101021,CONDO 500,Residential,4000,35951,0,39951
133615301101022,CONDO 500,Residential,4000,35951,0,39951
133615301101023,CONDO 500,Residential,4000,35951,0,39951
133615301201000,CONDO 500,Residential,4000,35951,0,39951
133615301201001,CONDO 500,Residential,4000,35951,0,39951
133615301201002,CONDO 500,Residential,4000,35951,0,39951
133615301201003,CONDO 500,Residential,4000,35951,0,39951
133615301201004,CONDO 500,Residential,4000,35951,0,39951
133615301201005,CONDO 500,Residential,4000,35951,0,39951
133615301201006,CONDO 500,Residential,4000,35951,0,39951
133615301201007,CONDO 500,Residential,4000,35951,0,39951
133615301201008,CONDO 500,Residential,4000,35951,0,39951
133615301201009,CONDO 500,Residential,4000,35951,0,39951
133615301201010,CONDO 500,Residential,4000,35951,0,39951
133615301201011,CONDO 500,Residential,4000,35951,0,39951
133615301201012,CONDO 500,Residential,4000,35951,0,39951
133615301201013,CONDO 500,Residential,4000,35951,0,39951
133615301201014,CONDO 500,Residential,4000,35951,0,39951
133615301201015,CONDO 500,Residential,4000,35951,0,39951
133615301201016,CONDO 500,Residential,4000,35951,0,39951
133615301201017,CONDO 500,Residential,4000,35951,0,39951
133615301201018,CONDO 500,Residential,4000,35951,0,39951
133615301201019,CONDO 500,Residential,4000,35951,0,39951
133615301201020,CONDO 500,Residential,4000,35951,0,39951
133615301201021,CONDO 500,Residential,4000,35951,0,39951
133615301201022,CONDO 500,Residential,4000,35951,0,39951
133615301201023,CONDO 500,Residential,4000,35951,0,39951
133615301301000,CONDO 500,Residential,4000,38050,0,42050
133615301301001,CONDO 500,Residential,4000,38050,0,42050
133615301301002,CONDO 500,Residential,4000,38050,0,42050
133615301301003,CONDO 500,Residential,4000,38050,0,42050
133615301301004,CONDO 500,Residential,4000,38050,0,42050
133615301301005,CONDO 500,Residential,4000,38050,0,42050
133615301301006,CONDO 500,Residential,4000,38050,0,42050
133615301301007,CONDO 500,Residential,4000,38050,0,42050
133615301301008,CONDO 500,Residential,4000,35951,0,39951
133615301301009,CONDO 500,Residential,4000,35951,0,39951
133615301301010,CONDO 500,Residential,4000,35951,0,39951
133615301301011,CONDO 500,Residential,4000,35951,0,39951
133615301301012,CONDO 500,Residential,4000,35951,0,39951
133615301301013,CONDO 500,Residential,4000,35951,0,39951
133615301301014,CONDO 500,Residential,4000,35951,0,39951
133615301301015,CONDO 500,Residential,4000,35951,0,39951
133615301301016,CONDO 500,Residential,4000,35951,0,39951
133615301301017,CONDO 500,Residential,4000,35951,0,39951
133615301301018,CONDO 500,Residential,4000,35951,0,39951
133615301301019,CONDO 500,Residential,4000,35951,0,39951
133615301301020,CONDO 500,Residential,4000,35951,0,39951
133615301301021,CONDO 500,Residential,4000,35951,0,39951
133615301301022,CONDO 500,Residential,4000,35951,0,39951
133615301301023,CONDO 500,Residential,4000,35951,0,39951
133615301501000,CONDO 500,Residential,4000,35951,0,39951
133615301501001,CONDO 500,Residential,4000,35951,0,39951
133615301501002,CONDO 500,Residential,4000,35951,0,39951
133615301501003,CONDO 500,Residential,4000,35951,0,39951
133615301501004,CONDO 500,Residential,4000,35951,0,39951
133615301501005,CONDO 500,Residential,4000,35951,0,39951
133615301501006,CONDO 500,Residential,4000,35951,0,39951
133615301501007,CONDO 500,Residential,4000,35951,0,39951
133615301501008,CONDO 500,Residential,4000,35951,0,39951
133615301501009,CONDO 500,Residential,4000,35951,0,39951
133615301501010,CONDO 500,Residential,4000,35951,0,39951
133615301501011,CONDO 500,Residential,4000,35951,0,39951
133615301501012,CONDO 500,Residential,4000,35951,0,39951
133615301501013,CONDO 500,Residential,4000,35951,0,39951
133615301501014,CONDO 500,Residential,4000,35951,0,39951
133615301501015,CONDO 500,Residential,4000,35951,0,39951
133615301501016,CONDO 500,Residential,4000,35951,0,39951
133615301501017,CONDO 500,Residential,4000,35951,0,39951
133615301501018,CONDO 500,Residential,4000,35951,0,39951
133615301501019,CONDO 500,Residential,4000,35951,0,39951
133615301501020,CONDO 500,Residential,4000,35951,0,39951
133615301501021,CONDO 500,Residential,4000,35951,0,39951
133615301501022,CONDO 500,Residential,4000,35951,0,39951
133615301501023,CONDO 500,Residential,4000,35951,0,39951
133617600200000,COMM SW,Commercial,1263708,0,8153030,9416738
133617600400000,COMM SW,Commercial,274428,0,465993,740421
133617600500000,COMM SW,Commercial,450360,0,963442,1413802
133617600700000,COMM SW,Commercial,298728,0,467425,766153
133617600800000,COMM SW,Commercial,1739,0,0,1739
133617600900000,COMM SW,Commercial,263412,0,473650,737062
133617700200000,E-66 GOODWILL IND,Exempt,275832,0,633337,909169
133617700300000,COMM SW,Commercial,345492,0,783278,1128770
133617700400000,COMM SW,Commercial,268650,0,698692,967342
133617700500000,COMM SW,Commercial,122580,0,253692,376272
133620100100000,COMM SW,Commercial,790992,0,1373601,2164593
133620100200000,COMM SW,Commercial,222264,0,65418,287682
133620200100000,COMM SW,Commercial,229824,0,322950,552774
133620200200000,COMM SW,Commercial,141178,0,296811,437989
133620200300000,COMM SW,Commercial,329130,0,6566991,6896121
133620200400000,E-01 FEDERAL,Exempt,0,0,0,0
133622600100000,COMM SW,Commercial,404784,0,0,404784
133622600200000,COMM SW,Commercial,162000,0,7000,169000
133622700200000,COMM SW,Commercial,369144,0,5664691,6033835
133622700300000,COMM SW,Commercial,156153,0,0,156153
133625100200000,COMM SW,Commercial,378054,0,143105,521159
133625100300000,COMM SW,Commercial,544150,0,0,544150
133627600200000,COMM SW,Commercial,251046,0,3667584,3918630
133627600301000,COMM SW,Commercial,19440,0,122880,142320
133627600301001,COMM SW,Commercial,19440,0,122880,142320
133627600301002,COMM SW,Commercial,19440,0,122880,142320
133627600301003,COMM SW,Commercial,19440,0,122880,142320
133627600301004,COMM SW,Commercial,19440,0,122880,142320
133627600301005,COMM SW,Commercial,19440,0,122880,142320
133627600301006,COMM SW,Commercial,19440,0,122880,142320
133627600301007,COMM SW,Commercial,19440,0,122880,142320
133627600301008,COMM SW,Commercial,19440,0,122880,142320
133627600301009,COMM SW,Commercial,19440,0,122880,142320
133627600301010,COMM SW,Commercial,19440,0,122880,142320
133627600301011,COMM SW,Commercial,19440,0,122880,142320
133627600400000,INDUSTRIAL,Industrial,243400,0,2216561,2459961
133627600500000,COMM SW,Commercial,255744,0,218718,474462
133627600600000,COMM SW,Commercial,234954,0,0,234954
133627600700000,COMM SW,Commercial,559440,0,0,559440
133627600800000,COMM SW,Commercial,446256,0,488744,935000
133627600900000,COMM SW,Commercial,247104,0,2712223,2959327
133630100100000,COMM SW,Commercial,254610,0,324945,579555
133630100200000,SW 407,Ag Land,38552,0,0,38552
133632600100000,COMM SW,Commercial,4398678,0,2893139,7291817
133632600103000,COMM SW,Commercial,0,0,6955,6955
133632600103001,COMM SW,Commercial,0,0,5782,5782
133632600103002,COMM SW,Commercial,0,0,5437,5437
133632600103003,COMM SW,Commercial,0,0,7278,7278
133632600103005,COMM SW,Commercial,0,0,6717,6717
133632600103006,COMM SW,Commercial,0,0,8526,8526
133632600103007,COMM SW,Commercial,0,0,6604,6604
133632600103008,COMM SW,Commercial,0,0,8710,8710
133632600103009,COMM SW,Commercial,0,0,6604,6604
133632600103010,COMM SW,Commercial,0,0,6604,6604
133632600103011,COMM SW,Commercial,0,0,5283,5283
133632600103012,COMM SW,Commercial,0,0,8586,8586
133632600103013,COMM SW,Commercial,0,0,6604,6604
133632600103014,COMM SW,Commercial,0,0,4843,4843
133632600103015,COMM SW,Commercial,0,0,5283,5283
133632600103016,COMM SW,Commercial,0,0,6054,6054
133632600103017,COMM SW,Commercial,0,0,3852,3852
133632600103018,COMM SW,Commercial,0,0,10017,10017
133632600103019,COMM SW,Commercial,0,0,8171,8171
133632600103020,Empty,Commercial,0,0,7681,7681
133632600103021,COMM SW,Commercial,0,0,9370,9370
133632600103022,COMM SW,Commercial,0,0,7925,7925
133632600103023,COMM SW,Commercial,0,0,7265,7265
133632600103024,COMM SW,Commercial,0,0,11503,11503
133632600103025,COMM SW,Commercial,0,0,6742,6742
133637600100000,COMM SW,Commercial,672300,0,826592,1498892
133637600200000,COMM SW,Commercial,27540,0,0,27540
133637700200000,SW 407,Ag Land,6504,0,0,6504
133640100100000,COMM SW,Commercial,345000,0,0,345000
133640100200000,COMM SW,Commercial,34555,0,96445,131000
133640100300000,COMM SW,Commercial,96978,0,94022,191000
133640100400000,COMM SW,Commercial,257772,0,225228,483000
133640100500000,COMM SW,Commercial,1002336,0,602766,1605102
133640100600000,COMM SW,Commercial,622832,0,2718190,3341022
133640100700000,COMM SW,Commercial,50350,0,387313,437663
133640200400000,SW 420,Residential,30240,89298,0,119538
133640200500000,SW 420,Residential,30240,86576,0,116816
133640200600000,SW 420,Residential,30422,81406,0,111828
133640200700000,COMM SW,Commercial,194835,0,0,194835
133642600100000,COMM SW,Commercial,279072,0,1064028,1343100
133642600200000,COMM SW,Commercial,80572,0,244355,324927
133642600300000,COMM SW,Commercial,505440,0,894413,1399853
133642700100000,COMM SW,Commercial,1056186,0,1765548,2821734
133642700102000,COMM SW,Commercial,0,0,55736,55736
133642700200000,COMM SW,Commercial,99360,0,299106,398466
133642700300000,COMM SW,Commercial,218700,0,373620,592320
133642700400000,COMM SW,Commercial,145800,0,487202,633002
133642700500000,COMM SW,Commercial,248832,0,2184,251016
133642700600000,COMM SW,Commercial,1069416,0,2599935,3669351
133642700700000,COMM SW,Commercial,264298,0,266109,530407
133645100100000,COMM SW,Commercial,767520,0,62480,830000
133645100200000,COMM SW,Commercial,90000,0,0,90000
133645200100000,COMM SW,Commercial,235030,0,632574,867604
133645200102000,COMM SW,Commercial,0,0,51200,51200
133645300100000,COMM SW,Commercial,1596726,0,5993555,7590281
133647600200000,COMM SW,Commercial,836573,0,6315507,7152080
133647600300000,COMM SW,Commercial,415221,0,939233,1354454
133647600400000,COMM SW,Commercial,1026540,0,2047487,3074027
133647600500000,COMM SW,Commercial,340616,0,67263,407879
133647600600000,COMM SW,Commercial,27798,0,6389,34187
133647600700000,COMM SW,Commercial,922404,0,1497083,2419487
133647600800000,COMM SW,Commercial,579960,0,1283227,1863187
140132600200000,COMM SE,Commercial,498312,0,680689,1179001
140132600300000,APTS SE,Commercial,15057,0,157669,172726
140132600400000,APTS SE,Commercial,17803,0,155393,173196
140132600501000,CONDO 500,Residential,5000,48746,0,53746
140132600501001,CONDO 500,Residential,5000,50383,0,55383
140132600501002,CONDO 500,Residential,5000,48532,0,53532
140132600501003,CONDO 500,Residential,5000,50597,0,55597
140132600501004,CONDO 500,Residential,5000,50597,0,55597
140132600501005,CONDO 500,Residential,5000,48532,0,53532
140132600501006,CONDO 500,Residential,5000,53025,0,58025
140132600501007,CONDO 500,Residential,5000,52734,0,57734
140132600501008,CONDO 500,Residential,5000,50597,0,55597
140132600501009,CONDO 500,Residential,5000,48532,0,53532
140132600501010,CONDO 500,Residential,5000,50383,0,55383
140132600501011,CONDO 500,Residential,5000,48176,0,53176
140132600600000,APTS SE,Commercial,15576,0,159438,175014
140132600700000,APTS SE,Commercial,18309,0,196992,215301
140132600800000,APTS SE,Commercial,16359,0,167872,184231
140132600900000,APTS SE,Commercial,14211,0,157173,171384
140132601100000,NE 115,Residential,8800,0,0,8800
140132700300000,COMM SE,Commercial,469800,0,1095406,1565206
140132700401009,COMM SE,Commercial,124200,0,499698,623898
140132700401010,COMM SE,Commercial,58320,0,255110,313430
140132700401011,COMM SE,Commercial,163000,0,865278,1028278
140132700401012,COMM SE,Commercial,69660,0,107056,176716
140132700401013,COMM SE,Commercial,493560,0,3033559,3527119
140132700401014,COMM SE,Commercial,122040,0,390534,512574
140132700501000,CONDO 500,Residential,5000,42298,0,47298
140132700501001,CONDO 500,Residential,5000,42298,0,47298
140132700501002,CONDO 500,Residential,5000,38946,0,43946
140132700501003,CONDO 500,Residential,5000,39465,0,44465
140132700501004,CONDO 500,Residential,5000,38946,0,43946
140132700501005,CONDO 500,Residential,5000,39465,0,44465
140132700501006,CONDO 500,Residential,5000,42298,0,47298
140132700501007,CONDO 500,Residential,5000,42298,0,47298
140132700501008,CONDO 500,Residential,5000,39465,0,44465
140132700501009,CONDO 500,Residential,5000,38946,0,43946
140132700501010,CONDO 500,Residential,5000,39465,0,44465
140132700501011,CONDO 500,Residential,5000,38946,0,43946
140132700601000,CONDO 500,Residential,5000,42683,0,47683
140132700601001,CONDO 500,Residential,5000,42683,0,47683
140132700601002,CONDO 500,Residential,5000,40007,0,45007
140132700601003,CONDO 500,Residential,5000,40007,0,45007
140132700601004,CONDO 500,Residential,5000,40007,0,45007
140132700601005,CONDO 500,Residential,5000,40007,0,45007
140132700700000,APTS SE,Commercial,52866,0,488791,541657
140132700800000,APTS SE,Commercial,52920,0,488791,541711
140132700900000,COMM SE,Commercial,1953,0,0,1953
140132701300000,COMM SE,Commercial,56700,0,16928,73628
140132800101000,CONDO 501,Residential,9000,97868,0,106868
140132800101001,CONDO 501,Residential,9000,97868,0,106868
140132800101002,CONDO 501,Residential,9000,97408,0,106408
140132800101003,CONDO 501,Residential,9000,94000,0,103000
140132800101004,CONDO 501,Residential,9000,97245,0,106245
140132800101005,CONDO 501,Residential,9000,94860,0,103860
140132800101006,CONDO 501,Residential,9000,98364,0,107364
140132800101007,CONDO 501,Residential,9000,98807,0,107807
140132800101008,CONDO 501,Residential,9000,94036,0,103036
140132800101009,CONDO 501,Residential,9000,98368,0,107368
140132800101010,CONDO 501,Residential,9000,94096,0,103096
140132800101011,CONDO 501,Residential,9000,100658,0,109658
140132800101012,CONDO 501,Residential,9000,98822,0,107822
140132800101013,CONDO 501,Residential,9000,98890,0,107890
140132800101014,CONDO 501,Residential,9000,98909,0,107909
140132800101015,CONDO 501,Residential,9000,98865,0,107865
140132800101016,CONDO 501,Residential,9000,94119,0,103119
140132800101017,CONDO 501,Residential,9000,94692,0,103692
140132800101018,CONDO 501,Residential,9000,98454,0,107454
140132800101019,CONDO 501,Residential,9000,98261,0,107261
140132800101020,CONDO 501,Residential,9000,99709,0,108709
140132800101021,CONDO 501,Residential,9000,99676,0,108676
140132800101022,CONDO 501,Residential,9000,94233,0,103233
140132800101023,CONDO 501,Residential,9000,95503,0,104503
140132900101000,CONDO 500,Residential,5000,64979,0,69979
140132900101001,CONDO 500,Residential,5000,62611,0,67611
140132900101002,CONDO 500,Residential,5000,62611,0,67611
140132900101003,CONDO 500,Residential,5000,62611,0,67611
140132900101004,CONDO 500,Residential,5000,62611,0,67611
140132900101005,CONDO 500,Residential,5000,63071,0,68071
140132900101006,CONDO 500,Residential,5000,58696,0,63696
140132900101007,CONDO 500,Residential,5000,56565,0,61565
140132900101008,CONDO 500,Residential,5000,56565,0,61565
140132900101009,CONDO 500,Residential,5000,56565,0,61565
140132900101010,CONDO 500,Residential,5000,56979,0,61979
140132900101011,CONDO 500,Residential,5000,56565,0,61565
140132900101012,CONDO 500,Residential,200,3067,0,3267
140132900101013,CONDO 500,Residential,200,3067,0,3267
140132900101014,CONDO 500,Residential,200,3067,0,3267
140132900101015,CONDO 500,Residential,200,3067,0,3267
140132900101016,CONDO 500,Residential,200,3067,0,3267
140132900101017,CONDO 500,Residential,200,3067,0,3267
140132900101018,CONDO 500,Residential,200,3067,0,3267
140132900101019,CONDO 500,Residential,200,3067,0,3267
140132900101020,CONDO 500,Residential,200,3067,0,3267
140132900101021,CONDO 500,Residential,200,3067,0,3267
140132900101022,CONDO 500,Residential,200,3067,0,3267
140132900101023,CONDO 500,Residential,200,3067,0,3267
140132900201000,CONDO 500,Residential,5000,37708,0,42708
140132900201001,CONDO 500,Residential,5000,37708,0,42708
140132900201002,CONDO 500,Residential,5000,37708,0,42708
140132900201003,CONDO 500,Residential,5000,37708,0,42708
140132900201004,CONDO 500,Residential,5000,47251,0,52251
140132900201005,CONDO 500,Residential,5000,34782,0,39782
140132900201006,CONDO 500,Residential,5000,34192,0,39192
140132900201007,CONDO 500,Residential,5000,37708,0,42708
140132900201008,CONDO 500,Residential,5000,34656,0,39656
140132900201009,CONDO 500,Residential,5000,34656,0,39656
140132900201010,CONDO 500,Residential,5000,34656,0,39656
140132900201011,CONDO 500,Residential,5000,31730,0,36730
140132900201012,CONDO 500,Residential,5000,31141,0,36141
140132900201013,CONDO 500,Residential,5000,31730,0,36730
140132900201014,CONDO 500,Residential,5000,31141,0,36141
140135100101003,CONDO 500,Residential,5000,48318,0,53318
140135100101004,CONDO 500,Residential,5000,49726,0,54726
140135100101005,CONDO 500,Residential,5000,48318,0,53318
140135100101006,CONDO 500,Residential,5000,48532,0,53532
140135100101007,CONDO 500,Residential,5000,50597,0,55597
140135100101008,CONDO 500,Residential,5000,50597,0,55597
140135100101009,CONDO 500,Residential,5000,49940,0,54940
140135100101010,CONDO 500,Residential,5000,50597,0,55597
140135100101011,CONDO 500,Residential,5000,50597,0,55597
140135100101012,CONDO 500,Residential,5000,48366,0,53366
140135100101013,CONDO 500,Residential,5000,49726,0,54726
140135100101014,CONDO 500,Residential,5000,48318,0,53318
140135100101015,CONDO 500,Residential,5000,48532,0,53532
140135100101016,CONDO 500,Residential,5000,50597,0,55597
140135100101017,CONDO 500,Residential,5000,50597,0,55597
140135100101018,CONDO 500,Residential,5000,49940,0,54940
140135100101019,CONDO 500,Residential,5000,50597,0,55597
140135100101020,CONDO 500,Residential,5000,50597,0,55597
140135100101021,CONDO 500,Residential,0,22967,0,22967
140135100201000,CONDO 500,Residential,5000,60818,0,65818
140135100201001,CONDO 500,Residential,5000,60818,0,65818
140135100201002,CONDO 500,Residential,5000,61063,0,66063
140135100201003,CONDO 500,Residential,5000,61063,0,66063
140135100201004,CONDO 500,Residential,5000,61994,0,66994
140135100201005,CONDO 500,Residential,5000,61994,0,66994
140135100201006,CONDO 500,Residential,5000,61994,0,66994
140135100201007,CONDO 500,Residential,5000,61994,0,66994
140135100201008,CONDO 500,Residential,5000,61994,0,66994
140135100201009,CONDO 500,Residential,5000,61994,0,66994
140135100201010,CONDO 500,Residential,5000,61994,0,66994
140135100201011,CONDO 500,Residential,5000,61994,0,66994
140135100201012,CONDO 500,Residential,5000,60248,0,65248
140135100201013,CONDO 500,Residential,5000,60248,0,65248
140135100201014,CONDO 500,Residential,5000,60490,0,65490
140135100201015,CONDO 500,Residential,5000,60490,0,65490
140135100201016,CONDO 500,Residential,5000,61411,0,66411
140135100201017,CONDO 500,Residential,5000,61411,0,66411
140135100201018,CONDO 500,Residential,5000,61411,0,66411
140135100201019,CONDO 500,Residential,5000,61411,0,66411
140135100201020,CONDO 500,Residential,5000,61411,0,66411
140135100201021,CONDO 500,Residential,5000,61411,0,66411
140135100201022,CONDO 500,Residential,5000,61411,0,66411
140135100201023,CONDO 500,Residential,5000,61411,0,66411
140135100201024,CONDO 500,Residential,5000,60204,0,65204
140135100201025,CONDO 500,Residential,5000,60204,0,65204
140135100201026,CONDO 500,Residential,5000,60446,0,65446
140135100201027,CONDO 500,Residential,5000,60446,0,65446
140135100201028,CONDO 500,Residential,5000,61367,0,66367
140135100201029,CONDO 500,Residential,5000,61367,0,66367
140135100201030,CONDO 500,Residential,5000,61367,0,66367
140135100201031,CONDO 500,Residential,5000,61367,0,66367
140135100201032,CONDO 500,Residential,5000,61367,0,66367
140135100201033,CONDO 500,Residential,5000,61367,0,66367
140135100201034,CONDO 500,Residential,5000,61367,0,66367
140135100201035,CONDO 500,Residential,5000,61367,0,66367
140135100201036,CONDO 500,Residential,5000,55921,0,60921
140135100201037,CONDO 500,Residential,5000,60204,0,65204
140135100201038,CONDO 500,Residential,5000,56163,0,61163
140135100201039,CONDO 500,Residential,5000,60446,0,65446
140135100201040,CONDO 500,Residential,5000,61367,0,66367
140135100201041,CONDO 500,Residential,5000,61367,0,66367
140135100201042,CONDO 500,Residential,5000,61367,0,66367
140135100201043,CONDO 500,Residential,5000,61367,0,66367
140135100201044,CONDO 500,Residential,5000,61367,0,66367
140135100201045,CONDO 500,Residential,5000,61367,0,66367
140135100201046,CONDO 500,Residential,5000,61367,0,66367
140135100201047,CONDO 500,Residential,5000,61367,0,66367
140135100201048,CONDO 500,Residential,5000,60159,0,65159
140135100201049,CONDO 500,Residential,5000,60159,0,65159
140135100201050,CONDO 500,Residential,5000,60401,0,65401
140135100201051,CONDO 500,Residential,5000,60401,0,65401
140135100201052,CONDO 500,Residential,5000,61322,0,66322
140135100201053,CONDO 500,Residential,5000,61322,0,66322
140135100201054,CONDO 500,Residential,5000,61322,0,66322
140135100201055,CONDO 500,Residential,5000,61322,0,66322
140135100201056,CONDO 500,Residential,5000,61322,0,66322
140135100201057,CONDO 500,Residential,5000,61322,0,66322
140135100201058,CONDO 500,Residential,5000,61322,0,66322
140135100201059,CONDO 500,Residential,5000,57084,0,62084
140135100201060,CONDO 500,Residential,5000,60159,0,65159
140135100201061,CONDO 500,Residential,5000,60159,0,65159
140135100201062,CONDO 500,Residential,5000,60401,0,65401
140135100201063,CONDO 500,Residential,5000,60401,0,65401
140135100201064,CONDO 500,Residential,5000,61322,0,66322
140135100201065,CONDO 500,Residential,5000,61322,0,66322
140135100201066,CONDO 500,Residential,5000,61322,0,66322
140135100201067,CONDO 500,Residential,5000,61322,0,66322
140135100201068,CONDO 500,Residential,5000,61322,0,66322
140135100201069,CONDO 500,Residential,5000,61322,0,66322
140135100201070,CONDO 500,Residential,5000,61322,0,66322
140135100201071,CONDO 500,Residential,5000,61322,0,66322
140135100201072,CONDO 500,Residential,5000,60159,0,65159
140135100201073,CONDO 500,Residential,5000,60159,0,65159
140135100201074,CONDO 500,Residential,5000,60401,0,65401
140135100201075,CONDO 500,Residential,5000,60401,0,65401
140135100201076,CONDO 500,Residential,5000,61322,0,66322
140135100201077,CONDO 500,Residential,5000,61322,0,66322
140135100201078,CONDO 500,Residential,5000,61322,0,66322
140135100201079,CONDO 500,Residential,5000,61322,0,66322
140135100201080,CONDO 500,Residential,5000,61322,0,66322
140135100201081,CONDO 500,Residential,5000,61322,0,66322
140135100201082,CONDO 500,Residential,5000,61322,0,66322
140135100201083,CONDO 500,Residential,5000,61322,0,66322
140135100201084,CONDO 500,Residential,5000,60159,0,65159
140135100201085,CONDO 500,Residential,5000,60159,0,65159
140135100201086,CONDO 500,Residential,5000,60401,0,65401
140135100201087,CONDO 500,Residential,5000,60401,0,65401
140135100201088,CONDO 500,Residential,5000,61322,0,66322
140135100201089,CONDO 500,Residential,5000,61322,0,66322
140135100201090,CONDO 500,Residential,5000,61322,0,66322
140135100201091,CONDO 500,Residential,5000,61322,0,66322
140135100201092,CONDO 500,Residential,5000,61322,0,66322
140135100201093,CONDO 500,Residential,5000,61322,0,66322
140135100201094,CONDO 500,Residential,5000,61322,0,66322
140135100201095,CONDO 500,Residential,5000,61322,0,66322
140135100201096,CONDO 500,Residential,5000,60159,0,65159
140135100201097,CONDO 500,Residential,5000,60159,0,65159
140135100201098,CONDO 500,Residential,5000,60401,0,65401
140135100201099,CONDO 500,Residential,5000,60401,0,65401
140135100201100,CONDO 500,Residential,5000,61322,0,66322
140135100201101,CONDO 500,Residential,5000,61322,0,66322
140135100201102,CONDO 500,Residential,5000,61322,0,66322
140135100201103,CONDO 500,Residential,5000,61322,0,66322
140135100201104,CONDO 500,Residential,5000,61322,0,66322
140135100201105,CONDO 500,Residential,5000,61322,0,66322
140135100201106,CONDO 500,Residential,5000,61322,0,66322
140135100201107,CONDO 500,Residential,5000,61322,0,66322
140135200101000,CONDO 500,Residential,5000,62611,0,67611
140135200101001,CONDO 500,Residential,5000,62611,0,67611
140135200101002,CONDO 500,Residential,5000,62611,0,67611
140135200101003,CONDO 500,Residential,5000,62611,0,67611
140135200101004,CONDO 500,Residential,5000,62611,0,67611
140135200101005,CONDO 500,Residential,5000,62611,0,67611
140135200101006,CONDO 500,Residential,5000,62611,0,67611
140135200101007,CONDO 500,Residential,5000,62611,0,67611
140135200101008,CONDO 500,Residential,5000,56565,0,61565
140135200101009,CONDO 500,Residential,5000,56565,0,61565
140135200101010,CONDO 500,Residential,5000,56565,0,61565
140135200101011,CONDO 500,Residential,5000,56565,0,61565
140135200101012,CONDO 500,Residential,5000,56979,0,61979
140135200101013,CONDO 500,Residential,5000,56565,0,61565
140135200101014,CONDO 500,Residential,5000,56565,0,61565
140135200101015,CONDO 500,Residential,5000,56565,0,61565
140135200101016,CONDO 500,Residential,200,3026,0,3226
140135200101017,CONDO 500,Residential,200,3026,0,3226
140135200101018,CONDO 500,Residential,200,3026,0,3226
140135200101019,CONDO 500,Residential,200,3026,0,3226
140135200101020,CONDO 500,Residential,200,3026,0,3226
140135200101021,CONDO 500,Residential,200,1952,0,2152
140135200101022,CONDO 500,Residential,200,3026,0,3226
140135200101023,CONDO 500,Residential,200,3026,0,3226
140135200101024,CONDO 500,Residential,200,3026,0,3226
140135200101025,CONDO 500,Residential,200,3026,0,3226
140135200101026,CONDO 500,Residential,200,3026,0,3226
140135200101027,CONDO 500,Residential,200,3026,0,3226
140135200101028,CONDO 500,Residential,200,3026,0,3226
140135200101029,CONDO 500,Residential,200,3026,0,3226
140135200101030,CONDO 500,Residential,200,3026,0,3226
140135200101031,CONDO 500,Residential,200,3026,0,3226
140135200101032,CONDO 500,Residential,200,3026,0,3226
140135200101033,CONDO 500,Residential,200,3026,0,3226
140135200101034,CONDO 500,Residential,200,3026,0,3226
140135200101035,CONDO 500,Residential,200,3026,0,3226
140135200101036,CONDO 500,Residential,200,3026,0,3226
140135200101037,CONDO 500,Residential,200,3026,0,3226
140135200101038,CONDO 500,Residential,200,3026,0,3226
140135200101039,CONDO 500,Residential,200,3026,0,3226
140135200101040,CONDO 500,Residential,200,3026,0,3226
140135200101041,CONDO 500,Residential,200,3026,0,3226
140135200101042,CONDO 500,Residential,200,3026,0,3226
140135200101043,CONDO 500,Residential,200,3026,0,3226
140135200101044,CONDO 500,Residential,200,3026,0,3226
140135200101045,CONDO 500,Residential,200,3026,0,3226
140135200201000,CONDO 500,Residential,5000,61883,0,66883
140135200201001,CONDO 500,Residential,5000,61883,0,66883
140135200201002,CONDO 500,Residential,5000,62337,0,67337
140135200201003,CONDO 500,Residential,5000,61883,0,66883
140135200201004,CONDO 500,Residential,5000,61492,0,66492
140135200201005,CONDO 500,Residential,5000,61883,0,66883
140135200201006,CONDO 500,Residential,5000,61883,0,66883
140135200201007,CONDO 500,Residential,5000,61883,0,66883
140135200201008,CONDO 500,Residential,5000,55907,0,60907
140135200201009,CONDO 500,Residential,5000,55907,0,60907
140135200201010,CONDO 500,Residential,5000,56317,0,61317
140135200201011,CONDO 500,Residential,5000,55556,0,60556
140135200201012,CONDO 500,Residential,5000,55907,0,60907
140135200201013,CONDO 500,Residential,5000,55907,0,60907
140135200201014,CONDO 500,Residential,5000,55907,0,60907
140135200201015,CONDO 500,Residential,5000,55907,0,60907
140135200201016,CONDO 500,Residential,200,2984,0,3184
140135200201017,CONDO 500,Residential,200,2984,0,3184
140135200201018,CONDO 500,Residential,200,2984,0,3184
140135200201019,CONDO 500,Residential,200,1952,0,2152
140135200201020,CONDO 500,Residential,200,2984,0,3184
140135200201021,CONDO 500,Residential,200,2984,0,3184
140135200201022,CONDO 500,Residential,200,2984,0,3184
140135200201023,CONDO 500,Residential,200,2984,0,3184
140135200201024,CONDO 500,Residential,200,2984,0,3184
140135200201025,CONDO 500,Residential,200,2984,0,3184
140135300101000,CONDO 500,Residential,7000,83877,0,90877
140135300101001,CONDO 500,Residential,7000,79647,0,86647
140135300101002,CONDO 500,Residential,7000,84705,0,91705
140135300101003,CONDO 500,Residential,7000,83877,0,90877
140135300101004,CONDO 500,Residential,7000,73279,0,80279
140135300101005,CONDO 500,Residential,7000,73355,0,80355
140135300101006,CONDO 500,Residential,7000,76234,0,83234
140135300101007,CONDO 500,Residential,7000,73279,0,80279
140135300201000,CONDO 500,Residential,7000,91681,0,98681
140135300201001,CONDO 500,Residential,6000,84982,0,90982
140135300201002,CONDO 500,Residential,6000,85215,0,91215
140135300201003,CONDO 500,Residential,6000,85952,0,91952
140135300201004,CONDO 500,Residential,7000,83127,0,90127
140135300201005,CONDO 500,Residential,6000,73233,0,79233
140135300201006,CONDO 500,Residential,6000,76693,0,82693
140135300201007,CONDO 500,Residential,6000,73075,0,79075
140135300301000,CONDO 500,Residential,7000,91883,0,98883
140135300301001,CONDO 500,Residential,6000,76992,0,82992
140135300301002,CONDO 500,Residential,6000,80527,0,86527
140135300301003,CONDO 500,Residential,6000,81081,0,87081
140135300301004,CONDO 500,Residential,7000,76897,0,83897
140135300301005,CONDO 500,Residential,6000,70781,0,76781
140135300301006,CONDO 500,Residential,6000,69663,0,75663
140135300301007,CONDO 500,Residential,6000,73614,0,79614
140135300401000,CONDO 500,Residential,7000,82438,0,89438
140135300401001,CONDO 500,Residential,7000,81621,0,88621
140135300401002,CONDO 500,Residential,7000,81220,0,88220
140135300401003,CONDO 500,Residential,7000,81836,0,88836
140135300401004,CONDO 500,Residential,7000,73887,0,80887
140135300401005,CONDO 500,Residential,7000,74589,0,81589
140135300401006,CONDO 500,Residential,7000,74027,0,81027
140135300401007,CONDO 500,Residential,7000,73887,0,80887
140135300601000,CONDO 500,Residential,6000,89658,0,95658
140135300601001,CONDO 500,Residential,6000,87228,0,93228
140135300601002,CONDO 500,Residential,6000,92746,0,98746
140135300601003,CONDO 500,Residential,6000,89016,0,95016
140135300601004,CONDO 500,Residential,6000,79870,0,85870
140135300601005,CONDO 500,Residential,6000,81061,0,87061
140135300601006,CONDO 500,Residential,6000,81031,0,87031
140135300601007,CONDO 500,Residential,6000,80942,0,86942
140135300701000,CONDO 500,Residential,7000,87181,0,94181
140135300701001,CONDO 500,Residential,7000,86079,0,93079
140135300701002,CONDO 500,Residential,7000,81887,0,88887
140135300701003,CONDO 500,Residential,7000,78697,0,85697
140135300701004,CONDO 500,Residential,7000,81740,0,88740
140135300701005,CONDO 500,Residential,7000,78417,0,85417
140135300701006,CONDO 500,Residential,7000,78019,0,85019
140135300701007,CONDO 500,Residential,7000,81740,0,88740
140135301001000,CONDO 501,Residential,7000,91691,0,98691
140135301001001,CONDO 500,Residential,7000,85451,0,92451
140135301001002,CONDO 500,Residential,7000,86196,0,93196
140135301001003,CONDO 500,Residential,7000,92419,0,99419
140135301001004,CONDO 500,Residential,7000,78708,0,85708
140135301001005,CONDO 500,Residential,7000,81519,0,88519
140135301001006,CONDO 500,Residential,7000,78019,0,85019
140135301001007,CONDO 500,Residential,7000,79929,0,86929
140135301101000,CONDO 500,Residential,7000,86352,0,93352
140135301101001,CONDO 500,Residential,7000,84553,0,91553
140135301101002,CONDO 500,Residential,7000,84641,0,91641
140135301101003,CONDO 500,Residential,7000,89239,0,96239
140135301101004,CONDO 500,Residential,7000,78439,0,85439
140135301101005,CONDO 500,Residential,7000,77591,0,84591
140135301101006,CONDO 500,Residential,7000,68041,0,75041
140135301101007,CONDO 500,Residential,7000,80879,0,87879
140135301201000,CONDO 500,Residential,7000,83232,0,90232
140135301201001,CONDO 500,Residential,7000,88907,0,95907
140135301201002,CONDO 500,Residential,7000,83809,0,90809
140135301201003,CONDO 500,Residential,7000,88995,0,95995
140135301201004,CONDO 500,Residential,7000,79324,0,86324
140135301201005,CONDO 500,Residential,7000,80112,0,87112
140135301201006,CONDO 500,Residential,7000,80661,0,87661
140135301201007,CONDO 500,Residential,7000,76971,0,83971
140135301301000,CONDO 500,Residential,7000,82000,0,89000
140135301301001,CONDO 500,Residential,7000,81417,0,88417
140135301301002,CONDO 500,Residential,14000,119028,0,133028
140135301301003,CONDO 500,Residential,7000,77635,0,84635
140135301301004,CONDO 500,Residential,7000,78956,0,85956
140135301301005,CONDO 500,Residential,7000,74483,0,81483
140135301301006,CONDO 500,Residential,7000,78184,0,85184
140135301501000,CONDO 500,Residential,7000,88576,0,95576
140135301501001,CONDO 500,Residential,7000,87288,0,94288
140135301501002,CONDO 500,Residential,7000,88143,0,95143
140135301501003,CONDO 500,Residential,7000,88576,0,95576
140135301501004,CONDO 500,Residential,7000,78480,0,85480
140135301501005,CONDO 500,Residential,7000,76149,0,83149
140135301501006,CONDO 500,Residential,7000,75767,0,82767
140135301501007,CONDO 500,Residential,7000,78480,0,85480
140135301601000,CONDO 500,Residential,7000,87102,0,94102
140135301601001,CONDO 500,Residential,7000,82547,0,89547
140135301601002,CONDO 500,Residential,7000,82026,0,89026
140135301601003,CONDO 500,Residential,7000,82736,0,89736
140135301601004,CONDO 500,Residential,7000,77635,0,84635
140135301601005,CONDO 500,Residential,7000,75330,0,82330
140135301601006,CONDO 500,Residential,7000,78398,0,85398
140135301601007,CONDO 500,Residential,7000,74699,0,81699
140135301701000,CONDO 500,Residential,7000,82736,0,89736
140135301701001,CONDO 500,Residential,7000,81938,0,88938
140135301701002,CONDO 500,Residential,7000,82026,0,89026
140135301701003,CONDO 500,Residential,7000,87015,0,94015
140135301701004,CONDO 500,Residential,7000,77635,0,84635
140135301701005,CONDO 500,Residential,7000,75330,0,82330
140135301701006,CONDO 500,Residential,7000,74840,0,81840
140135301701007,CONDO 500,Residential,7000,74699,0,81699
140135301801000,CONDO 500,Residential,5000,64979,0,69979
140135301801001,CONDO 500,Residential,5000,65439,0,70439
140135301801002,CONDO 500,Residential,5000,64979,0,69979
140135301801003,CONDO 500,Residential,5000,64979,0,69979
140135301801004,CONDO 500,Residential,5000,62611,0,67611
140135301801005,CONDO 500,Residential,5000,64979,0,69979
140135301801006,CONDO 500,Residential,5000,63071,0,68071
140135301801007,CONDO 500,Residential,5000,65154,0,70154
140135301801008,CONDO 500,Residential,5000,56565,0,61565
140135301801009,CONDO 500,Residential,5000,58696,0,63696
140135301801010,CONDO 500,Residential,5000,59110,0,64110
140135301801011,CONDO 500,Residential,5000,58696,0,63696
140135301801012,CONDO 500,Residential,5000,56979,0,61979
140135301801013,CONDO 500,Residential,5000,56565,0,61565
140135301801014,CONDO 500,Residential,5000,58341,0,63341
140135301801015,CONDO 500,Residential,5000,58696,0,63696
140135301801016,CONDO 500,Residential,200,3067,0,3267
140135301801017,CONDO 500,Residential,200,3067,0,3267
140135301801018,CONDO 500,Residential,200,3067,0,3267
140135301801019,CONDO 500,Residential,200,3067,0,3267
140135301801020,CONDO 500,Residential,200,3067,0,3267
140135301801021,CONDO 500,Residential,200,3067,0,3267
140135301801022,CONDO 500,Residential,200,3067,0,3267
140135301801023,CONDO 500,Residential,200,3067,0,3267
140135301801024,CONDO 500,Residential,200,3067,0,3267
140135301801025,CONDO 500,Residential,200,3067,0,3267
140135301801026,CONDO 500,Residential,200,3067,0,3267
140135301801027,CONDO 500,Residential,200,3067,0,3267
140135301801028,CONDO 500,Residential,200,3067,0,3267
140135301801029,CONDO 500,Residential,200,3067,0,3267
140135301801030,CONDO 500,Residential,200,3067,0,3267
140135301801031,CONDO 500,Residential,200,3067,0,3267
140135301801032,CONDO 500,Residential,200,3067,0,3267
140135301801033,CONDO 500,Residential,200,3067,0,3267
140135301801034,CONDO 500,Residential,200,3067,0,3267
140135301801035,CONDO 500,Residential,200,3067,0,3267
140135301801036,CONDO 500,Residential,200,3067,0,3267
140135301801037,CONDO 500,Residential,200,3067,0,3267
140135301801038,CONDO 500,Residential,200,3067,0,3267
140135301801039,CONDO 500,Residential,200,3067,0,3267
140135301901000,CONDO 500,Residential,5000,62611,0,67611
140135301901001,CONDO 500,Residential,5000,62676,0,67676
140135301901002,CONDO 500,Residential,5000,63071,0,68071
140135301901003,CONDO 500,Residential,5000,62611,0,67611
140135301901004,CONDO 500,Residential,5000,62611,0,67611
140135301901005,CONDO 500,Residential,5000,65439,0,70439
140135301901006,CONDO 500,Residential,5000,58755,0,63755
140135301901007,CONDO 500,Residential,5000,56565,0,61565
140135301901008,CONDO 500,Residential,5000,59629,0,64629
140135301901009,CONDO 500,Residential,5000,56565,0,61565
140135301901010,CONDO 500,Residential,5000,56565,0,61565
140135301901011,CONDO 500,Residential,5000,58696,0,63696
140135301901012,CONDO 500,Residential,200,3067,0,3267
140135301901013,CONDO 500,Residential,200,3067,0,3267
140135301901014,CONDO 500,Residential,200,3067,0,3267
140135301901015,CONDO 500,Residential,200,3067,0,3267
140135301901016,CONDO 500,Residential,200,3067,0,3267
140135301901017,CONDO 500,Residential,200,3067,0,3267
140135301901018,CONDO 500,Residential,200,3067,0,3267
140135301901019,CONDO 500,Residential,200,3067,0,3267
140135301901020,CONDO 500,Residential,200,3067,0,3267
140135301901021,CONDO 500,Residential,200,3067,0,3267
140135301901022,CONDO 500,Residential,200,3067,0,3267
140135301901023,CONDO 500,Residential,200,3067,0,3267
140135301901024,CONDO 500,Residential,200,3067,0,3267
140135301901025,CONDO 500,Residential,200,3067,0,3267
140135301901026,CONDO 500,Residential,200,3067,0,3267
140135301901027,CONDO 500,Residential,200,3067,0,3267
140135301901028,CONDO 500,Residential,200,3067,0,3267
140135301901029,CONDO 500,Residential,200,3067,0,3267
140135301901030,CONDO 500,Residential,200,3067,0,3267
140135301901031,CONDO 500,Residential,200,3067,0,3267
140135302001000,CONDO 501,Residential,9000,135445,0,144445
140135302001001,CONDO 501,Residential,9000,133367,0,142367
140135302001002,CONDO 501,Residential,9000,138722,0,147722
140135302001003,CONDO 501,Residential,9000,135683,0,144683
140135302001004,CONDO 501,Residential,9000,131274,0,140274
140135302001005,CONDO 501,Residential,9000,132147,0,141147
140135501401000,CONDO 500,Residential,7000,87961,0,94961
140135501401001,CONDO 500,Residential,7000,87200,0,94200
140135501401002,CONDO 500,Residential,7000,83532,0,90532
140135501401003,CONDO 500,Residential,7000,83635,0,90635
140135501401004,CONDO 500,Residential,7000,78005,0,85005
140135501401005,CONDO 500,Residential,7000,76149,0,83149
140135501401006,CONDO 500,Residential,7000,75653,0,82653
140135501401007,CONDO 500,Residential,7000,76152,0,83152
140215100700000,COMM NE,Commercial,348300,0,426975,775275
140215100800000,COMM NE,Commercial,92880,0,8760,101640
140215200200000,COMM NE,Commercial,1244808,0,2766356,4011164
140215200300000,COMM NE,Commercial,272160,0,361315,633475
140215200400000,COMM NE,Commercial,266004,0,360045,626049
140220100100000,Empty,Other,0,0,0,0
140220100200000,NE 115,Residential,6340,9788,0,16128
140220100300000,NE 115,Residential,2440,0,0,2440
140220100400000,NE 115,Residential,8980,0,0,8980
140220200100000,NE 115,Residential,42050,41464,0,83514
140220200200000,COMM NE,Commercial,44955,0,46558,91513
140220200300000,NE 115,Residential,41875,101970,0,143845
140220200400000,COMM NE,Commercial,790020,0,628842,1418862
140220200500000,COMM NE,Commercial,266184,0,173816,440000
140220200600000,COMM NE,Commercial,385290,0,715020,1100310
140220200700000,COMM NE,Commercial,102400,0,81067,183467
140220200702000,COMM NE,Commercial,0,0,10303,10303
140220200800000,COMM NE,Commercial,138996,0,191182,330178
140220200900000,COMM NE,Commercial,27796,0,8145,35941
140220201000000,NE 115,Residential,28600,110109,0,138709
140220300600000,COMM NE,Commercial,63156,0,240115,303271
140220300700000,COMM NE,Commercial,43765,0,262493,306258
140220300800000,E-70 CHARITY OTHER,Exempt,63557,0,169586,233143
140220300900000,COMM NE,Commercial,32999,0,166757,199756
140220301000000,COMM NE,Commercial,112196,0,412804,525000
140220301100000,COMM NE,Commercial,70864,0,157514,228378
140220301200000,COMM NE,Commercial,66760,0,194038,260798
140220301300000,COMM NE,Commercial,56579,0,184167,240746
140220400300000,APTS NE,Commercial,118692,0,1591052,1709744
140220400400000,APTS NE,Commercial,91962,0,1193355,1285317
140220400500000,APTS NE,Commercial,75924,0,1223287,1299211
140222600200000,NE 164,Residential,28000,249595,0,277595
140222600300000,NE 164,Residential,28000,182953,0,210953
140222600400000,NE 164,Residential,30154,218876,0,249030
140222600500000,NE 164,Residential,31540,207200,0,238740
140222600600000,NE 164,Residential,57098,362992,0,420090
140222700100000,NE 164,Residential,28280,193807,0,222087
140222700200000,NE 164,Residential,28280,171329,0,199609
140222700300000,NE 164,Residential,28560,145311,0,173871
140222700400000,NE 164,Residential,31616,220795,0,252411
140222700500000,NE 164,Residential,30754,179714,0,210468
140222700600000,NE 164,Residential,28000,253131,0,281131
140222700700000,NE 164,Residential,28000,190062,0,218062
140222700800000,NE 164,Residential,28000,190812,0,218812
140222700900000,NE 164,Residential,28000,197163,0,225163
140222701000000,NE 164,Residential,29900,169731,0,199631
140222701100000,COMM NE,Commercial,140357,0,0,140357
140222701300000,NE 164,Residential,52692,287292,0,339984
140222701400000,NE 164,Residential,45900,243812,0,289712
140222701500000,NE 164,Residential,45450,177195,0,222645
140222701600000,COMM NE,Commercial,18079,0,0,18079
140222701700000,Empty,Other,0,0,0,0
140222701800000,Empty,Other,0,0,0,0
140222800100000,COMM NE,Commercial,435240,0,900399,1335639
140222800200000,COMM NE,Commercial,627750,0,527622,1155372
140222800202000,COMM NE,Commercial,0,0,45975,45975
140222800300000,COMM NE,Commercial,258120,0,789788,1047908
140222800400000,COMM NE,Commercial,443880,0,1104256,1548136
140222800600000,COMM NE,Commercial,204120,0,293330,497450
140222800700000,COMM NE,Commercial,106920,0,29624,136544
140222800800000,COMM NE,Commercial,194400,0,96764,291164
140222900100000,Empty,Other,0,0,0,0
140223000100000,NE 164,Residential,55932,334349,0,390281
140225100100000,INDUSTRIAL,Industrial,1213436,0,15922822,17136258
140225100200000,INDUSTRIAL,Industrial,16650,0,461677,478327
140225100300000,COMM NE,Commercial,845640,0,1104360,1950000
140227600100000,COMM NE,Commercial,116931,0,408069,525000
140227600200000,COMM NE,Commercial,111791,0,413209,525000
140227600400000,APTS NE,Commercial,119016,0,484769,603785
140227600500000,COMM NE,Commercial,86265,0,200875,287140
140227600700000,COMM NE,Commercial,247050,0,486726,733776
140227600800000,COMM NE,Commercial,522288,0,388005,910293
140227600900000,COMM NE,Commercial,967680,0,907000,1874680
140227601000000,COMM NE,Commercial,208073,0,410122,618195
140227601100000,COMM NE,Commercial,761400,0,439831,1201231
140227601200000,COMM NE,Commercial,105300,0,194700,300000
140227601300000,COMM NE,Commercial,78393,0,221607,300000
140227601400000,COMM NE,Commercial,83451,0,216549,300000
140227601500000,COMM NE,Commercial,317682,0,367217,684899
140227601600000,COMM NE,Commercial,113827,0,661173,775000
140227601700000,COMM NE,Commercial,111791,0,413209,525000
140227601900000,COMM NE,Commercial,172071,0,427929,600000
140227602000000,COMM NE,Commercial,342252,0,549528,891780
140227602100000,COMM NE,Commercial,108000,0,0,108000
140227700100000,COMM NE,Commercial,665,0,0,665
140227700200000,COMM NE,Commercial,90720,0,92728,183448
140227700300000,E-40 CHURCHES,Exempt,381294,0,3837748,4219042
140227700400000,COMM NE,Commercial,219915,0,4038,223953
140227700500000,COMM NE,Commercial,219915,0,381916,601831
140227700600000,COMM NE,Commercial,382113,0,605187,987300
140227700800000,COMM NE,Commercial,563587,0,438815,1002402
140227700900000,COMM NE,Commercial,15120,0,2436,17556
140227701800000,COMM NE,Commercial,22,0,0,22
140230100100000,COMM NE,Commercial,874800,0,675200,1550000
140230100200000,COMM NE,Commercial,891000,0,1036864,1927864
140230100300000,COMM NE,Commercial,537840,0,237603,775443
140230100400000,COMM NE,Commercial,466560,0,362730,829290
140230100500000,COMM NE,Commercial,688824,0,449234,1138058
140230100600000,COMM NE,Commercial,1102,0,2333,3435
140230100700000,COMM NE,Commercial,626616,0,617586,1244202
140230100800000,COMM NE,Commercial,509760,0,572689,1082449
140230100900000,COMM NE,Commercial,1509300,0,5443341,6952641
140230101100000,COMM NE,Commercial,1215702,0,305066,1520768
140230101200000,COMM NE,Commercial,357696,0,2190762,2548458
140230101300000,COMM NE,Commercial,4774,0,1000,5774
140230101400000,COMM NE,Commercial,262116,0,871012,1133128
140232600100000,COMM NE,Commercial,1069200,0,680800,1750000
140232600200000,COMM NE,Commercial,500580,0,649420,1150000
140232600300000,COMM NE,Commercial,362880,0,539618,902498
140232600400000,NE 117,Residential,33000,76743,0,109743
140232600500000,NE 117,Residential,33000,75225,0,108225
140232600600000,NE 117,Residential,33000,83150,0,116150
140232600700000,NE 117,Residential,33000,86893,0,119893
140232600800000,NE 117,Residential,33000,63145,0,96145
140232600900000,NE 117,Residential,36040,85184,0,121224
140232601000000,NE 117,Residential,36000,55940,0,91940
140232601100000,NE 117,Residential,36000,144830,0,180830
140232601200000,NE 117,Residential,36000,80832,0,116832
140232601300000,NE 117,Residential,35000,81690,0,116690
140232601400000,NE 117,Residential,47500,95457,0,142957
140232601500000,NE 117,Residential,46250,87154,0,133404
140232601600000,NE 117,Residential,46755,112682,0,159437
140232601700000,COMM NE,Commercial,682981,0,331082,1014063
140232601800000,COMM NE,Commercial,102870,0,1058130,1161000
140232601900000,COMM NE,Commercial,117288,0,808147,925435
140232602000000,COMM NE,Commercial,1375920,0,3224080,4600000
140232602100000,COMM NE,Commercial,6273,0,0,6273
140235100100000,E-35 CEMETARY ASSN,Exempt,3371436,0,1723535,5094971
140237600100000,COMM NE,Commercial,22680,0,2765,25445
140237600200000,COMM NE,Commercial,18295,0,377194,395489
140237600300000,COMM NE,Commercial,52051,0,1327417,1379468
140237600400000,COMM NE,Commercial,343764,0,244246,588010
140237700100000,COMM SE,Commercial,146146,0,176197,322343
140237700200000,COMM NE,Commercial,315252,0,5651,320903
140237700300000,COMM SE,Commercial,298080,0,286987,585067
140237700400000,COMM SE,Commercial,326160,0,342398,668558
140237700500000,COMM SE,Commercial,100980,0,173465,274445
140237700600000,COMM SE,Commercial,126984,0,113025,240009
140237700700000,NE 115,Residential,17727,88228,0,105955
140237700800000,NE 115,Residential,20248,51270,0,71518
140237700900000,APTS SE,Commercial,55944,0,921570,977514
140237701200000,NE 115,Residential,2064,0,0,2064
140240100300000,COMM NE,Commercial,1520640,0,1371234,2891874
140240100400000,COMM NE,Commercial,383400,0,303103,686503
140240100500000,COMM NE,Commercial,274284,0,228222,502506
140240100502000,COMM NE,Commercial,0,0,51200,51200
140240100600000,COMM NE,Commercial,246717,0,376614,623331
140240101200000,COMM NE,Commercial,536047,0,757761,1293808
140240101300000,COMM NE,Commercial,1694520,0,2446964,4141484
140240200100000,COMM NE,Commercial,777600,0,976349,1753949
140240200200000,COMM NE,Commercial,1878660,0,1731212,3609872
140240200300000,COMM NE,Commercial,229262,0,468817,698079
140240200400000,COMM NE,Commercial,167832,0,166822,334654
140240200402000,COMM NE,Commercial,0,0,10581,10581
140240300400000,COMM SE,Commercial,445770,0,114230,560000
140240301600000,COMM SE,Commercial,440640,0,984069,1424709
140240301700000,COMM SE,Commercial,225504,0,303522,529026
140240400200000,COMM SE,Commercial,630720,0,1564506,2195226
140240400400000,COMM SE,Commercial,1137240,0,1274734,2411974
140240400500000,COMM SE,Commercial,359640,0,466960,826600
140242600100000,COMM NE,Commercial,1615140,0,3732802,5347942
140242600200000,COMM NE,Commercial,511920,0,568404,1080324
140242600300000,COMM NE,Commercial,2750220,0,26413011,29163231
140245100100000,COMM SE,Commercial,477792,0,586197,1063989
140245100200000,COMM SE,Commercial,144993,0,255007,400000
140245100300000,COMM SE,Commercial,1803060,0,4059446,5862506
140245100500000,COMM SE,Commercial,636012,0,1163988,1800000
140245100600000,COMM SE,Commercial,210816,0,280586,491402
140245100700000,COMM SE,Commercial,210816,0,274968,485784
140245100800000,COMM SE,Commercial,87615,0,179657,267272
140245100900000,COMM SE,Commercial,139536,0,102238,241774
140245101000000,NE 115,Residential,10420,0,0,10420
140245101100000,NE 115,Residential,10000,0,0,10000
140245101200000,COMM SE,Commercial,34776,0,27240,62016
140245200100000,COMM NE,Commercial,108000,0,298545,406545
140245200200000,COMM NE,Commercial,410400,0,355015,765415
140245200300000,COMM NE,Commercial,196020,0,447947,643967
140245200400000,E-35 CEMETARY ASSN,Exempt,22680,0,162401,185081
140245300400000,APTS SE,Commercial,17388,0,308157,325545
140245300500000,NE 115,Residential,30912,167493,0,198405
140245300600000,NE 115,Residential,15572,76863,0,92435
140245300700000,NE 115,Residential,2986,0,0,2986
140245300800000,NE 115,Residential,111,0,0,111
140245300900000,NE 115,Residential,3993,0,0,3993
140247600900000,NE 115,Residential,237800,0,0,237800
140247601000000,COMM SE,Commercial,929556,0,2058387,2987943
140247601300000,COMM SE,Commercial,1459620,0,4354374,5813994
140247601400000,COMM SE,Commercial,1330020,0,3992660,5322680
140310100100000,NE 110,Residential,19708,81442,0,101150
140310100200000,NE 110,Residential,19176,118988,0,138164
140310100300000,NE 110,Residential,19176,136139,0,155315
140310100400000,NE 110,Residential,19176,143573,0,162749
140310100500000,NE 110,Residential,19176,114205,0,133381
140310100600000,NE 110,Residential,19176,148823,0,167999
140310100700000,NE 110,Residential,22997,132017,0,155014
140310100800000,NE 110,Residential,24190,131655,0,155845
140310200100000,NE 110,Residential,18430,134393,0,152823
140310200200000,NE 110,Residential,21257,143833,0,165090
140310300101000,CONDO 500,Residential,5000,65832,0,70832
140310300101001,CONDO 500,Residential,5000,65351,0,70351
140310300101002,CONDO 500,Residential,5000,65832,0,70832
140310300101003,CONDO 500,Residential,5000,65832,0,70832
140310300101004,CONDO 500,Residential,5000,68463,0,73463
140310300101005,CONDO 500,Residential,5000,65351,0,70351
140310300101006,CONDO 500,Residential,5000,65420,0,70420
140310300101007,CONDO 500,Residential,5000,65351,0,70351
140310300101008,CONDO 500,Residential,5000,66082,0,71082
140310300101009,CONDO 500,Residential,5000,65601,0,70601
140310300101010,CONDO 500,Residential,5000,65601,0,70601
140310300101011,CONDO 500,Residential,5000,65601,0,70601
140310300101012,CONDO 500,Residential,5000,65601,0,70601
140310300101013,CONDO 500,Residential,5000,66082,0,71082
140310300101014,CONDO 500,Residential,5000,65601,0,70601
140310300101015,CONDO 500,Residential,5000,65601,0,70601
140310300101016,CONDO 500,Residential,200,2860,0,3060
140310300101017,CONDO 500,Residential,200,2860,0,3060
140310300101018,CONDO 500,Residential,200,2860,0,3060
140310300101019,CONDO 500,Residential,200,2860,0,3060
140310300101020,CONDO 500,Residential,200,2860,0,3060
140310300101021,CONDO 500,Residential,200,2860,0,3060
140310300101022,CONDO 500,Residential,200,2860,0,3060
140310300101023,CONDO 500,Residential,200,2860,0,3060
140310300101024,CONDO 500,Residential,200,2860,0,3060
140310300101025,CONDO 500,Residential,200,2860,0,3060
140310300101026,CONDO 500,Residential,200,2860,0,3060
140310300101027,CONDO 500,Residential,200,2860,0,3060
140310300101028,CONDO 500,Residential,200,2860,0,3060
140310300101029,CONDO 500,Residential,200,2860,0,3060
140310300101030,CONDO 500,Residential,200,2860,0,3060
140310300101031,CONDO 500,Residential,200,2860,0,3060
140310300101032,CONDO 500,Residential,200,2860,0,3060
140310300201000,CONDO 500,Residential,5000,65832,0,70832
140310300201001,CONDO 500,Residential,5000,65351,0,70351
140310300201002,CONDO 500,Residential,5000,65351,0,70351
140310300201003,CONDO 500,Residential,5000,65351,0,70351
140310300201004,CONDO 500,Residential,5000,65832,0,70832
140310300201005,CONDO 500,Residential,5000,65351,0,70351
140310300201006,CONDO 500,Residential,5000,65351,0,70351
140310300201007,CONDO 500,Residential,5000,65832,0,70832
140310300201008,CONDO 500,Residential,5000,65601,0,70601
140310300201009,CONDO 500,Residential,5000,65601,0,70601
140310300201010,CONDO 500,Residential,5000,65601,0,70601
140310300201011,CONDO 500,Residential,5000,66082,0,71082
140310300201012,CONDO 500,Residential,5000,66082,0,71082
140310300201013,CONDO 500,Residential,5000,66082,0,71082
140310300201014,CONDO 500,Residential,5000,65601,0,70601
140310300201015,CONDO 500,Residential,5000,66082,0,71082
140310300201016,CONDO 500,Residential,200,2860,0,3060
140310300201017,CONDO 500,Residential,200,2860,0,3060
140310300201018,CONDO 500,Residential,200,2860,0,3060
140310300201019,CONDO 500,Residential,200,2860,0,3060
140310300201020,CONDO 500,Residential,200,2860,0,3060
140310300201021,CONDO 500,Residential,200,2860,0,3060
140310300201022,CONDO 500,Residential,200,2860,0,3060
140310300201023,CONDO 500,Residential,200,2860,0,3060
140310300201024,CONDO 500,Residential,200,2860,0,3060
140310300201025,CONDO 500,Residential,200,2860,0,3060
140310300201026,CONDO 500,Residential,200,2860,0,3060
140310300201027,CONDO 500,Residential,200,2860,0,3060
140310300201028,CONDO 500,Residential,200,2860,0,3060
140310300201029,CONDO 500,Residential,200,2860,0,3060
140310300201030,CONDO 500,Residential,200,2860,0,3060
140310300201031,CONDO 500,Residential,200,2860,0,3060
140310300201032,CONDO 500,Residential,200,2860,0,3060
140310300300000,APTS NE,Residential,13365,133115,0,146480
140310300401000,CONDO 500,Residential,5000,66615,0,71615
140310300401001,CONDO 500,Residential,5000,65712,0,70712
140310300401002,CONDO 500,Residential,5000,66129,0,71129
140310300401003,CONDO 500,Residential,5000,66129,0,71129
140310300401004,CONDO 500,Residential,5000,66129,0,71129
140310300401005,CONDO 500,Residential,5000,66615,0,71615
140310300401006,CONDO 500,Residential,5000,66382,0,71382
140310300401007,CONDO 500,Residential,5000,66382,0,71382
140310300401008,CONDO 500,Residential,5000,66382,0,71382
140310300401009,CONDO 500,Residential,5000,66382,0,71382
140310300401010,CONDO 500,Residential,5000,66382,0,71382
140310300401011,CONDO 500,Residential,5000,66382,0,71382
140310300401012,CONDO 500,Residential,200,2984,0,3184
140310300401013,CONDO 500,Residential,200,2984,0,3184
140310300401014,CONDO 500,Residential,200,2984,0,3184
140310300401015,CONDO 500,Residential,200,2984,0,3184
140310300401016,CONDO 500,Residential,200,2984,0,3184
140310300401017,CONDO 500,Residential,200,2984,0,3184
140310300401018,CONDO 500,Residential,200,2984,0,3184
140310300401019,CONDO 500,Residential,200,2984,0,3184
140310300401020,CONDO 500,Residential,200,2984,0,3184
140310300401021,CONDO 500,Residential,200,2984,0,3184
140310300401022,CONDO 500,Residential,200,2984,0,3184
140310300401023,CONDO 500,Residential,200,2984,0,3184
140310300401024,CONDO 500,Residential,200,2984,0,3184
140310300401025,CONDO 500,Residential,200,2984,0,3184
140310300401026,CONDO 500,Residential,200,2984,0,3184
140310300401027,CONDO 500,Residential,200,2984,0,3184
140310300401028,CONDO 500,Residential,200,2984,0,3184
140310300401029,CONDO 500,Residential,200,2984,0,3184
140310300401030,CONDO 500,Residential,200,2984,0,3184
140310300401031,CONDO 500,Residential,200,2984,0,3184
140310300401032,CONDO 500,Residential,200,2984,0,3184
140310300401033,CONDO 500,Residential,200,2984,0,3184
140310300401034,CONDO 500,Residential,200,2984,0,3184
140310300401035,CONDO 500,Residential,200,2984,0,3184
140310300401036,CONDO 500,Residential,200,2984,0,3184
140310300401037,CONDO 500,Residential,200,2984,0,3184
140310300401038,CONDO 500,Residential,200,2984,0,3184
140310300401039,CONDO 500,Residential,200,2984,0,3184
140310300501000,CONDO 500,Residential,5000,65351,0,70351
140310300501001,CONDO 500,Residential,5000,64939,0,69939
140310300501002,CONDO 500,Residential,5000,65351,0,70351
140310300501003,CONDO 500,Residential,5000,65832,0,70832
140310300501004,CONDO 500,Residential,5000,65351,0,70351
140310300501005,CONDO 500,Residential,5000,65351,0,70351
140310300501006,CONDO 500,Residential,5000,65351,0,70351
140310300501007,CONDO 500,Residential,5000,65351,0,70351
140310300501008,CONDO 500,Residential,5000,65601,0,70601
140310300501009,CONDO 500,Residential,5000,65601,0,70601
140310300501010,CONDO 500,Residential,5000,65601,0,70601
140310300501011,CONDO 500,Residential,5000,65601,0,70601
140310300501012,CONDO 500,Residential,5000,65601,0,70601
140310300501013,CONDO 500,Residential,5000,65601,0,70601
140310300501014,CONDO 500,Residential,5000,65601,0,70601
140310300501015,CONDO 500,Residential,5000,65601,0,70601
140310300501016,CONDO 500,Residential,200,2902,0,3102
140310300501017,CONDO 500,Residential,200,2902,0,3102
140310300501018,CONDO 500,Residential,200,2902,0,3102
140310300501019,CONDO 500,Residential,200,2902,0,3102
140310300501020,CONDO 500,Residential,200,2902,0,3102
140310300501021,CONDO 500,Residential,200,2902,0,3102
140310300501022,CONDO 500,Residential,200,2902,0,3102
140310300501023,CONDO 500,Residential,200,2902,0,3102
140310300501024,CONDO 500,Residential,200,2902,0,3102
140310300501025,CONDO 500,Residential,200,2902,0,3102
140310300501026,CONDO 500,Residential,200,2902,0,3102
140310300501027,CONDO 500,Residential,200,2902,0,3102
140310300600000,APTS NE,Commercial,16098,0,142116,158214
140310300800000,CONDO 501,Residential,405000,0,0,405000
140310300801000,CONDO 501,Residential,15000,182802,0,197802
140310300801001,CONDO 501,Residential,15000,154775,0,169775
140310300801002,CONDO 501,Residential,15000,141787,0,156787
140310300801003,CONDO 501,Residential,15000,166794,0,181794
140310300801004,CONDO 501,Residential,15000,166794,0,181794
140310300801005,CONDO 501,Residential,15000,141826,0,156826
140310300801006,CONDO 501,Residential,15000,154814,0,169814
140310300801007,CONDO 501,Residential,15000,166794,0,181794
140310300801008,CONDO 501,Residential,15000,209814,0,224814
140310300801009,CONDO 501,Residential,15000,202840,0,217840
140310300801010,CONDO 501,Residential,15000,125969,0,140969
140310300801011,CONDO 501,Residential,15000,135969,0,150969
140310300801012,CONDO 501,Residential,15000,227906,0,242906
140310300801013,CONDO 501,Residential,15000,198379,0,213379
140310300801014,CONDO 501,Residential,15000,169083,0,184083
140310300801015,CONDO 501,Residential,15000,157606,0,172606
140310300801016,CONDO 501,Residential,15000,137935,0,152935
140310300801017,CONDO 501,Residential,15000,126868,0,141868
140310300900000,E-40 CHURCHES,Exempt,691200,0,1028562,1719762
140310400400000,COMM NE,Commercial,285120,0,671518,956638
140310400500000,COMM NE,Commercial,411480,0,665826,1077306
140310400600000,COMM NE,Commercial,302,0,0,302
140310400700000,COMM NE,Commercial,268920,0,987252,1256172
140310400801000,CONDO 501,Residential,15000,175000,0,190000
140310400801001,CONDO 501,Residential,15000,248963,0,263963
140312600100000,NE 110,Residential,23901,125572,0,149473
140312600200000,NE 110,Residential,21632,107432,0,129064
140312600300000,NE 110,Residential,21632,117091,0,138723
140312600400000,NE 110,Residential,21632,127506,0,149138
140312600500000,NE 110,Residential,21632,113501,0,135133
140312600600000,NE 110,Residential,21777,127067,0,148844
140312600700000,NE 110,Residential,23478,100721,0,124199
140312700100000,NE 110,Residential,23296,93442,0,116738
140312700200000,NE 110,Residential,20800,102515,0,123315
140312800100000,NE 110,Residential,26141,92561,0,118702
140312800200000,NE 110,Residential,22057,113754,0,135811
140312800300000,NE 110,Residential,21168,96229,0,117397
140312800400000,NE 110,Residential,21168,114951,0,136119
140312800500000,NE 110,Residential,21168,128219,0,149387
140312800600000,NE 110,Residential,21509,126024,0,147533
140312800700000,NE 110,Residential,22661,97762,0,120423
140312800800000,NE 110,Residential,22661,42258,0,64919
140312800900000,NE 110,Residential,22482,99472,0,121954
140312801000000,NE 110,Residential,22251,84458,0,106709
140312801100000,NE 110,Residential,21470,104227,0,125697
140312801200000,NE 110,Residential,21470,88365,0,109835
140312801300000,NE 110,Residential,21660,92206,0,113866
140312801400000,NE 110,Residential,22156,106015,0,128171
140312801500000,NE 110,Residential,22321,95693,0,118014
140312801600000,NE 110,Residential,25200,134265,0,159465
140312900100000,NE 110,Residential,22440,99789,0,122229
140312900200000,NE 110,Residential,20800,89687,0,110487
140312900300000,NE 110,Residential,22348,90545,0,112893
140312900400000,NE 110,Residential,22176,111792,0,133968
140312900500000,NE 110,Residential,22440,97166,0,119606
140313000100000,COMM NE,Commercial,135125,0,163760,298885
140313000200000,COMM NE,Commercial,269892,0,267216,537108
140313000202000,COMM NE,Commercial,0,0,45975,45975
140313000300000,COMM NE,Commercial,720360,0,988206,1708566
140315100100000,INDUSTRIAL,Industrial,2364700,0,16740009,19104709
140317600100000,COMM NE,Commercial,151632,0,1209,152841
140320100100000,NE 111,Residential,20000,87909,0,107909
140320200200000,COMM NE,Commercial,1110780,0,7308971,8419751
140320200300000,COMM NE,Commercial,702216,0,2337130,3039346
140320200400000,COMM NE,Commercial,459000,0,747396,1206396
140320300100000,NE 111,Residential,20000,97753,0,117753
140320300200000,NE 111,Residential,440,0,0,440
140320300300000,NE 111,Residential,21400,87303,0,108703
140320400100000,E-15 CITY,Exempt,0,0,0,0
140320400200000,COMM NE,Commercial,471960,0,281733,753693
140320400300000,COMM NE,Commercial,630720,0,327547,958267
140320400302000,COMM NE,Commercial,0,0,26161,26161
140320500100000,COMM NE,Commercial,310824,0,2889176,3200000
140320500200000,COMM NE,Commercial,22378,0,38826,61204
140320500300000,COMM NE,Commercial,371088,0,1235195,1606283
140320500400000,COMM NE,Commercial,34425,0,0,34425
140322600100000,COMM NE,Commercial,107055,0,142529,249584
140322600200000,COMM NE,Commercial,34992,0,0,34992
140322600300000,COMM NE,Commercial,133920,0,0,133920
140322600400000,COMM NE,Commercial,133920,0,360131,494051
140322600500000,COMM NE,Commercial,109080,0,11739,120819
140322600600000,COMM NE,Commercial,228960,0,544090,773050
140322600701000,COMM NE,Commercial,90720,0,359874,450594
140322600701001,COMM NE,Commercial,25920,0,91080,117000
140322600701002,COMM NE,Commercial,25920,0,113425,139345
140322600701003,COMM NE,Commercial,25920,0,113425,139345
140322600701004,COMM NE,Commercial,25920,0,113425,139345
140322600800000,COMM NE,Commercial,302400,0,594977,897377
140322700100000,COMM NE,Commercial,299160,0,671263,970423
140322700200000,COMM NE,Commercial,430272,0,1093765,1524037
140322700300000,COMM NE,Commercial,691740,0,1032343,1724083
140322700400000,COMM NE,Commercial,281880,0,345388,627268
140322700500000,COMM NE,Commercial,297000,0,609169,906169
140322800200000,E-66 GOODWILL IND,Exempt,836730,0,1495502,2332232
140322800300000,COMM NE,Commercial,245932,0,317859,563791
140322800400000,Empty,Other,0,0,0,0
140322800500000,COMM NE,Commercial,1254960,0,4248830,5503790
140322800600000,COMM NE,Commercial,216000,0,1134864,1350864
140325100100000,COMM NE,Commercial,388098,0,3340157,3728255
140325100300000,COMM NE,Commercial,241920,0,1930580,2172500
140325100400000,COMM NE,Commercial,728730,0,6076244,6804974
140325100500000,COMM NE,Commercial,443880,0,1494358,1938238
140325100600000,COMM NE,Commercial,49950,0,0,49950
140325100700000,COMM NE,Commercial,644490,0,4689298,5333788
140325100800000,COMM NE,Commercial,216000,0,761901,977901
140325200100000,COMM NE,Commercial,152928,0,456445,609373
140325200200000,COMM NE,Commercial,238464,0,483526,721990
140325200300000,COMM NE,Commercial,247104,0,476873,723977
140325200400000,COMM NE,Commercial,524880,0,779312,1304192
140325200500000,COMM NE,Commercial,547884,0,1952116,2500000
140325300100000,COMM NE,Commercial,319680,0,297880,617560
140325300200000,COMM NE,Commercial,95472,0,304669,400141
140325300300000,COMM NE,Commercial,288684,0,427765,716449
140325300400000,COMM NE,Commercial,123822,0,177793,301615
140325300402000,COMM NE,Commercial,0,0,43838,43838
140325300500000,COMM NE,Commercial,114394,0,529954,644348
140327600100000,COMM NE,Commercial,360126,0,1237274,1597400
140327600200000,INDUSTRIAL,Industrial,343600,0,1178405,1522005
140327600300000,COMM NE,Commercial,400032,0,167604,567636
140327600400000,COMM NE,Commercial,387072,0,0,387072
140327600500000,COMM NE,Commercial,366336,0,3496249,3862585
140327600700000,COMM NE,Commercial,338688,0,2700060,3038748
140327600800000,COMM NE,Commercial,177600,0,58312,235912
140327700100000,COMM NE,Commercial,202500,0,861730,1064230
140327700200000,INDUSTRIAL,Industrial,938050,0,4243189,5181239
140327700300000,COMM NE,Commercial,882360,0,8793106,9675466
140327700400000,COMM NE,Commercial,115020,0,16695,131715
140327700500000,COMM NE,Commercial,110769,0,338765,449534
140327700502000,COMM NE,Commercial,0,0,54044,54044
140330100100000,Empty,Exempt,0,0,0,0
140330100200000,E-15 CITY,Exempt,0,0,0,0
140332600100000,E-15 CITY,Exempt,0,0,0,0
140337600100000,E-76 EDU CLASS BLDG,Exempt,149310,0,166802,316112
140337600200000,NE 117,Residential,33739,72119,0,105858
140337600300000,NE 117,Residential,32010,82067,0,114077
140337600400000,NE 117,Residential,32010,68747,0,100757
140337600500000,NE 117,Residential,32010,66530,0,98540
140337600600000,NE 117,Residential,32010,76715,0,108725
140337600700000,NE 117,Residential,32010,75225,0,107235
140337600800000,NE 117,Residential,32010,91437,0,123447
140337600900000,NE 117,Residential,32010,80927,0,112937
140337601000000,NE 117,Residential,36596,82340,0,118936
140337700100000,NE 117,Residential,34629,62785,0,97414
140337700200000,NE 117,Residential,33756,71036,0,104792
140337700300000,NE 117,Residential,33756,55476,0,89232
140337700400000,NE 117,Residential,33756,74419,0,108175
140337700500000,NE 117,Residential,33756,77774,0,111530
140337700600000,NE 117,Residential,33756,78256,0,112012
140337700700000,NE 117,Residential,32010,77672,0,109682
140337700800000,NE 117,Residential,32010,75519,0,107529
140337700900000,NE 117,Residential,32010,70079,0,102089
140337701000000,NE 117,Residential,38070,87245,0,125315
140337800100000,NE 117,Residential,36434,99094,0,135528
140337800200000,NE 117,Residential,35264,70266,0,105530
140337800300000,NE 117,Residential,33456,52956,0,86412
140337800400000,NE 117,Residential,32100,56169,0,88269
140337800500000,NE 117,Residential,32700,51006,0,83706
140337800600000,NE 117,Residential,32100,51969,0,84069
140337800700000,NE 117,Residential,31200,60112,0,91312
140337800800000,NE 117,Residential,30888,57611,0,88499
140337800900000,NE 117,Residential,32010,63809,0,95819
140337801000000,NE 117,Residential,33174,54604,0,87778
140337801100000,NE 117,Residential,32126,76996,0,109122
140337801200000,NE 117,Residential,33756,64942,0,98698
140337801300000,NE 117,Residential,32010,81116,0,113126
140337801400000,NE 117,Residential,32010,64669,0,96679
140337801500000,NE 117,Residential,32010,68604,0,100614
140337801600000,NE 117,Residential,32010,84214,0,116224
140337801700000,NE 117,Residential,32010,71232,0,103242
140337801800000,NE 117,Residential,32708,80286,0,112994
140337801900000,NE 117,Residential,33756,74327,0,108083
140337802000000,NE 117,Residential,33756,72184,0,105940
140337802100000,NE 117,Residential,33756,78300,0,112056
140337802200000,NE 117,Residential,36289,83723,0,120012
140337802300000,NE 117,Residential,34066,74929,0,108995
140337802400000,NE 117,Residential,37810,79277,0,117087
140337802500000,NE 117,Residential,33756,78327,0,112083
140337802600000,NE 117,Residential,33756,88563,0,122319
140337802700000,NE 117,Residential,33756,89171,0,122927
140337802800000,NE 117,Residential,32708,75287,0,107995
140337802900000,NE 117,Residential,32010,81158,0,113168
140337803000000,NE 117,Residential,32010,82058,0,114068
140337803100000,NE 117,Residential,32010,56007,0,88017
140337803200000,NE 117,Residential,32010,60471,0,92481
140337803300000,NE 117,Residential,32010,72548,0,104558
140337803400000,NE 117,Residential,32534,77737,0,110271
140337803500000,NE 117,Residential,32010,77189,0,109199
140337803600000,NE 117,Residential,32010,75199,0,107209
140337803700000,NE 117,Residential,33908,81067,0,114975
140337803800000,NE 117,Residential,34094,49153,0,83247
140337803900000,NE 117,Residential,35853,70800,0,106653
140337804000000,NE 117,Residential,35937,85818,0,121755
140337804100000,NE 117,Residential,34382,88529,0,122911
140337804200000,NE 117,Residential,34382,74122,0,108504
140337804300000,NE 117,Residential,33060,88905,0,121965
140337804400000,NE 117,Residential,33408,79546,0,112954
140337900100000,NE 117,Residential,34642,72140,0,106782
140337900200000,NE 117,Residential,34920,67004,0,101924
140337900300000,NE 117,Residential,34920,71401,0,106321
140337900400000,NE 117,Residential,34920,70018,0,104938
140337900500000,NE 117,Residential,34920,90559,0,125479
140337900600000,NE 117,Residential,33756,81688,0,115444
140337900700000,NE 117,Residential,33756,82351,0,116107
140337900800000,NE 117,Residential,33756,58876,0,92632
140337900900000,NE 117,Residential,36064,72520,0,108584
140337901000000,NE 117,Residential,34400,79295,0,113695
140337901100000,NE 117,Residential,36960,54904,0,91864
140337901200000,NE 117,Residential,34832,55366,0,90198
140337901300000,NE 117,Residential,33199,60225,0,93424
140337901400000,NE 117,Residential,38160,53282,0,91442
140337901500000,NE 117,Residential,38160,69012,0,107172
140337901600000,NE 117,Residential,38160,79409,0,117569
140337901700000,NE 117,Residential,38160,70515,0,108675
140337901800000,NE 117,Residential,38160,93346,0,131506
140337901900000,NE 117,Residential,38160,73139,0,111299
140337902000000,E-40 CHURCHES,Commercial,97065,0,147614,244679
140337902100000,COMM NE,Commercial,380808,0,2636464,3017272
140337902200000,COMM NE,Commercial,367362,0,1332638,1700000
140337902300000,COMM NE,Commercial,21546,0,54015,75561
140337902400000,COMM NE,Commercial,153900,0,205096,358996
140337902500000,COMM NE,Commercial,135324,0,421294,556618
140338000100000,NE 117,Residential,35455,80068,0,115523
140338000200000,NE 117,Residential,34150,66043,0,100193
140338000300000,NE 117,Residential,32832,72039,0,104871
140338000400000,NE 117,Residential,32010,78412,0,110422
140338000500000,NE 117,Residential,32010,72903,0,104913
140338000600000,NE 117,Residential,31777,77735,0,109512
140338000700000,NE 117,Residential,31777,70151,0,101928
140338000800000,NE 117,Residential,31777,66784,0,98561
140338000900000,NE 117,Residential,31777,67602,0,99379
140338001000000,NE 117,Residential,31777,68840,0,100617
140338001100000,NE 117,Residential,31777,52713,0,84490
140338001200000,NE 117,Residential,31777,71236,0,103013
140338001300000,NE 117,Residential,31777,77701,0,109478
140338001400000,NE 117,Residential,31777,80485,0,112262
140338001500000,NE 117,Residential,36289,71560,0,107849
140338001600000,NE 117,Residential,34066,68980,0,103046
140338001700000,NE 117,Residential,37810,73292,0,111102
140338001800000,NE 117,Residential,31777,71087,0,102864
140338001900000,NE 117,Residential,31777,74593,0,106370
140338002000000,NE 117,Residential,31777,75980,0,107757
140338002100000,NE 117,Residential,31777,88018,0,119795
140338002200000,NE 117,Residential,31777,66277,0,98054
140338002300000,NE 117,Residential,31777,83401,0,115178
140338002400000,NE 117,Residential,31777,67142,0,98919
140338002500000,NE 117,Residential,31777,69607,0,101384
140338002600000,NE 117,Residential,31777,85664,0,117441
140338002700000,NE 117,Residential,32010,91943,0,123953
140338002800000,NE 117,Residential,32010,72621,0,104631
140338002900000,NE 117,Residential,32623,74867,0,107490
140338003000000,NE 117,Residential,32771,69162,0,101933
140338100100000,E-70 CHARITY OTHER,Exempt,75233,0,0,75233
140338100200000,COMM NE,Commercial,10935,0,141588,152523
140338100300000,E-68 FRATERNAL ORG,Exempt,34830,0,63383,98213
140340100100000,COMM NE,Commercial,1002510,0,1069812,2072322
140340200100000,NE 117,Residential,35316,78753,0,114069
140340200200000,NE 117,Residential,36660,103933,0,140593
140340200300000,NE 117,Residential,28200,87537,0,115737
140340200400000,NE 117,Residential,28200,83151,0,111351
140340200500000,NE 117,Residential,28200,71327,0,99527
140340200600000,NE 117,Residential,28200,69381,0,97581
140340200700000,NE 117,Residential,28200,81724,0,109924
140340200800000,NE 117,Residential,28200,73746,0,101946
140340200900000,NE 117,Residential,28200,86501,0,114701
140340201000000,NE 117,Residential,33109,85768,0,118877
140340201100000,NE 117,Residential,33691,79929,0,113620
140340201200000,NE 117,Residential,28592,100840,0,129432
140340201300000,NE 117,Residential,28500,80668,0,109168
140340201400000,NE 117,Residential,33014,76166,0,109180
140340201500000,NE 117,Residential,33250,108049,0,141299
140340201600000,NE 117,Residential,26675,74175,0,100850
140340201700000,NE 117,Residential,26675,74583,0,101258
140340201800000,NE 117,Residential,28251,73422,0,101673
140340201900000,NE 117,Residential,25200,68105,0,93305
140340202000000,NE 117,Residential,26149,88785,0,114934
140340202100000,NE 117,Residential,27160,77176,0,104336
140340202200000,NE 117,Residential,27160,66615,0,93775
140340202300000,NE 117,Residential,27160,79655,0,106815
140340202400000,NE 117,Residential,27160,73894,0,101054
140340202500000,NE 117,Residential,18634,0,0,18634
140340202600000,NE 117,Residential,23674,95810,0,119484
140340202700000,NE 117,Residential,29414,76213,0,105627
140340202800000,NE 117,Residential,30720,72311,0,103031
140340202900000,NE 117,Residential,31680,76907,0,108587
140340203000000,NE 117,Residential,31680,75481,0,107161
140340203100000,NE 117,Residential,31680,76222,0,107902
140340203200000,NE 117,Residential,31680,80258,0,111938
140340300100000,NE 117,Residential,35079,81843,0,116922
140340300200000,NE 117,Residential,36425,62136,0,98561
140340300300000,NE 117,Residential,28200,78676,0,106876
140340300400000,NE 117,Residential,28200,74541,0,102741
140340300500000,NE 117,Residential,28200,82844,0,111044
140340300600000,NE 117,Residential,28200,78557,0,106757
140340300700000,NE 117,Residential,28200,74711,0,102911
140340300800000,NE 117,Residential,28200,70121,0,98321
140340300900000,NE 117,Residential,28200,71958,0,100158
140340301000000,NE 117,Residential,30300,82415,0,112715
140340301100000,NE 117,Residential,33950,80804,0,114754
140340301200000,NE 117,Residential,33777,89618,0,123395
140340301300000,NE 117,Residential,34083,84942,0,119025
140340301400000,NE 117,Residential,31680,81198,0,112878
140340301500000,NE 117,Residential,31680,70842,0,102522
140340301600000,NE 117,Residential,31680,76731,0,108411
140340301700000,NE 117,Residential,31680,73386,0,105066
140340301800000,NE 117,Residential,31680,79637,0,111317
140340301900000,NE 117,Residential,31680,73968,0,105648
140340302000000,NE 117,Residential,31680,81205,0,112885
140340400100000,COMM NE,Commercial,118368,0,265502,383870
140340400200000,NE 116,Residential,43600,95475,0,139075
140340400300000,NE 116,Residential,43600,58977,0,102577
140340400400000,NE 116,Residential,43600,74434,0,118034
140340400500000,NE 116,Residential,43600,60929,0,104529
140340400600000,NE 116,Residential,46750,91773,0,138523
140340400700000,NE 116,Residential,50667,95483,0,146150
140340400800000,NE 116,Exempt,54267,0,77984,132251
140340400900000,NE 116,Residential,50850,90521,0,141371
140340401000000,NE 116,Residential,53820,101618,0,155438
140340401100000,NE 116,Residential,46816,89334,0,136150
140340401200000,NE 116,Residential,47500,87950,0,135450
140340401300000,NE 116,Residential,49000,80355,0,129355
140340401400000,NE 116,Residential,58753,95175,0,153928
140340500100000,E-40 CHURCHES,Exempt,64800,0,157103,221903
140340500200000,NE 116,Residential,43600,85620,0,129220
140340500300000,NE 116,Residential,43600,70810,0,114410
140340500400000,NE 116,Residential,43600,84340,0,127940
140340500500000,NE 116,Residential,43600,66292,0,109892
140340500600000,NE 116,Residential,43600,72938,0,116538
140340500700000,NE 116,Residential,56689,99808,0,156497
140340500800000,NE 116,Residential,54500,112413,0,166913
140340500900000,NE 116,Residential,54500,115107,0,169607
140340501000000,NE 116,Residential,54500,108369,0,162869
140340501100000,NE 116,Residential,54500,84595,0,139095
140340501200000,NE 116,Residential,54500,117945,0,172445
140340600100000,NE 116,Residential,62863,72880,0,135743
140340600200000,NE 116,Residential,65300,117331,0,182631
140340600300000,NE 116,Residential,53500,149698,0,203198
140340600400000,NE 116,Residential,69550,109609,0,179159
140342600100000,NE 117,Residential,39592,88704,0,128296
140342600200000,NE 117,Residential,25872,61675,0,87547
140342600300000,NE 117,Residential,23760,85142,0,108902
140342600400000,NE 117,Residential,36660,66467,0,103127
140342600500000,NE 117,Residential,32902,76440,0,109342
140342600600000,NE 117,Residential,35568,60985,0,96553
140342600700000,NE 117,Residential,37624,96173,0,133797
140342600800000,NE 117,Residential,32495,74223,0,106718
140342600900000,NE 117,Residential,34000,82328,0,116328
140342601000000,NE 117,Residential,33000,75374,0,108374
140342601100000,NE 117,Residential,35705,75176,0,110881
140342601200000,NE 117,Residential,30500,75545,0,106045
140342601300000,NE 117,Residential,31763,73897,0,105660
140342601400000,NE 117,Residential,31110,90332,0,121442
140342601500000,NE 117,Residential,30195,81211,0,111406
140342700100000,E-40 CHURCHES,Exempt,703080,0,286107,989187
140342700200000,NE 117,Residential,38880,97003,0,135883
140342700300000,NE 117,Residential,34560,73893,0,108453
140342700400000,NE 117,Residential,39168,73695,0,112863
140342700500000,NE 117,Residential,30333,72361,0,102694
140342700600000,NE 117,Residential,29890,70315,0,100205
140342700700000,NE 117,Residential,29617,72281,0,101898
140342700800000,NE 117,Residential,29585,84742,0,114327
140342700900000,NE 117,Residential,30195,77268,0,107463
140342701000000,NE 117,Residential,31142,75973,0,107115
140342701100000,NE 117,Residential,29813,72943,0,102756
140342701200000,NE 117,Residential,31565,67525,0,99090
140342701300000,NE 117,Residential,30625,103011,0,133636
140342701400000,NE 117,Residential,36975,80513,0,117488
140342701500000,NE 117,Residential,32177,62162,0,94339
140342701600000,NE 117,Residential,33453,59059,0,92512
140342701700000,NE 117,Residential,36416,70473,0,106889
140342800100000,NE 117,Residential,36978,78287,0,115265
140342800200000,NE 117,Residential,34920,70763,0,105683
140342800300000,NE 117,Residential,34920,69119,0,104039
140342800400000,NE 117,Residential,34920,68709,0,103629
140342800500000,NE 117,Residential,34920,86973,0,121893
140342800600000,NE 117,Residential,34920,79419,0,114339
140342800700000,NE 117,Residential,34920,73244,0,108164
140342800800000,NE 117,Residential,37248,85143,0,122391
140342900100000,NE 117,Residential,35720,78304,0,114024
140342900200000,NE 117,Residential,33170,88031,0,121201
140342900300000,NE 117,Residential,33790,76688,0,110478
140342900400000,NE 117,Residential,34467,69555,0,104022
140342900500000,NE 117,Residential,33170,65238,0,98408
140342900600000,NE 117,Residential,32067,71343,0,103410
140342900700000,NE 117,Residential,30667,62831,0,93498
140342900800000,NE 117,Residential,30360,62589,0,92949
140342900900000,NE 117,Residential,29585,57464,0,87049
140342901000000,NE 117,Residential,29520,62589,0,92109
140342901100000,NE 117,Residential,29407,70823,0,100230
140342901200000,NE 117,Residential,29423,68810,0,98233
140342901300000,NE 117,Residential,29423,64990,0,94413
140342901400000,NE 117,Residential,29423,69138,0,98561
140342901500000,NE 117,Residential,29423,65791,0,95214
140342901600000,NE 117,Residential,29423,64205,0,93628
140342901700000,NE 117,Residential,29682,64899,0,94581
140342901800000,NE 117,Residential,39168,75026,0,114194
140342901900000,NE 117,Residential,34560,82956,0,117516
140342902000000,NE 117,Residential,39168,93486,0,132654
140342902100000,NE 117,Residential,27095,65210,0,92305
140342902200000,NE 117,Residential,29585,65780,0,95365
140342902300000,NE 117,Residential,30070,76387,0,106457
140342902400000,NE 117,Residential,30070,78963,0,109033
140342902500000,NE 117,Residential,30070,77255,0,107325
140342902600000,NE 117,Residential,29908,56136,0,86044
140342902700000,NE 117,Residential,29908,69680,0,99588
140342902800000,NE 117,Residential,30543,73246,0,103789
140342902900000,NE 117,Residential,30855,105973,0,136828
140342903000000,NE 117,Residential,31815,77072,0,108887
140342903100000,NE 117,Residential,33567,71240,0,104807
140342903200000,NE 117,Residential,34517,117165,0,151682
140342903300000,NE 117,Residential,34418,98250,0,132668
140342903400000,NE 117,Residential,35720,79535,0,115255
140342903500000,NE 117,Residential,26950,73209,0,100159
140342903600000,NE 117,Residential,28875,66412,0,95287
140342903700000,NE 117,Residential,28875,66291,0,95166
140342903800000,NE 117,Residential,31033,54065,0,85098
140342903900000,NE 117,Residential,35530,73958,0,109488
140342904000000,NE 117,Residential,28500,76646,0,105146
140343000100000,NE 117,Residential,31768,62180,0,93948
140343000200000,NE 117,Residential,26675,71258,0,97933
140343000300000,NE 117,Residential,26675,72438,0,99113
140343000400000,NE 117,Residential,26675,72049,0,98724
140343000500000,NE 117,Residential,29100,70028,0,99128
140343000600000,NE 117,Residential,29100,70945,0,100045
140343000700000,NE 117,Residential,29100,92313,0,121413
140343000800000,NE 117,Residential,29100,75641,0,104741
140343000900000,NE 117,Residential,29100,72237,0,101337
140343001000000,NE 117,Residential,29100,66867,0,95967
140343001100000,NE 117,Residential,29100,69916,0,99016
140343001200000,NE 117,Residential,29100,78767,0,107867
140343001300000,NE 117,Residential,29100,69051,0,98151
140343001400000,NE 117,Residential,47580,58971,0,106551
140343001500000,NE 117,Residential,27691,67983,0,95674
140343001600000,NE 117,Residential,33479,74134,0,107613
140343001700000,NE 117,Residential,28258,63708,0,91966
140343001800000,NE 117,Residential,15750,0,0,15750
140343001900000,NE 117,Residential,34106,101883,0,135989
140343100100000,NE 117,Residential,35720,66172,0,101892
140343100200000,NE 117,Residential,30393,72295,0,102688
140343100300000,NE 117,Residential,29423,76422,0,105845
140343100400000,NE 117,Residential,30393,78044,0,108437
140343100500000,NE 117,Residential,30393,82521,0,112914
140343100600000,NE 117,Residential,30393,69126,0,99519
140343100700000,NE 117,Residential,30393,77483,0,107876
140343100800000,NE 117,Residential,30393,85311,0,115704
140343100900000,NE 117,Residential,30393,80910,0,111303
140343101000000,NE 117,Residential,30393,67315,0,97708
140343101100000,NE 117,Residential,30393,82646,0,113039
140343101200000,NE 117,Residential,31881,81230,0,113111
140343101300000,NE 117,Residential,39168,73699,0,112867
140343101400000,NE 117,Residential,34560,71245,0,105805
140343101500000,NE 117,Residential,39168,89795,0,128963
140343101600000,NE 117,Residential,27742,73414,0,101156
140343101700000,NE 117,Residential,31033,67409,0,98442
140343101800000,NE 117,Residential,27930,61297,0,89227
140343101900000,NE 117,Residential,28583,84282,0,112865
140343102000000,NE 117,Residential,27930,88366,0,116296
140343102100000,NE 117,Residential,28583,94571,0,123154
140343102200000,NE 117,Residential,27930,76585,0,104515
140343102300000,NE 117,Residential,31033,85384,0,116417
140343102400000,NE 117,Residential,29400,75418,0,104818
140343102500000,NE 117,Residential,35794,81523,0,117317
140343102600000,NE 117,Residential,28200,79304,0,107504
140343200100000,NE 117,Residential,37248,78075,0,115323
140343200200000,NE 117,Residential,34338,88854,0,123192
140343200300000,NE 117,Residential,34338,81295,0,115633
140343200400000,NE 117,Residential,34338,88308,0,122646
140343200500000,NE 117,Residential,34338,78081,0,112419
140343200600000,NE 117,Residential,34338,76768,0,111106
140343200700000,NE 117,Residential,34338,92090,0,126428
140343200800000,NE 117,Residential,34338,71252,0,105590
140343200900000,NE 117,Residential,34804,82726,0,117530
140343201000000,NE 117,Residential,33745,78700,0,112445
140343300100000,NE 117,Residential,31906,76302,0,108208
140343300200000,NE 117,Residential,28453,71314,0,99767
140343300300000,NE 117,Residential,28130,80791,0,108921
140343300400000,NE 117,Residential,27968,86716,0,114684
140343300500000,NE 117,Residential,27968,75869,0,103837
140343300600000,NE 117,Residential,27968,77615,0,105583
140343300700000,NE 117,Residential,27968,77094,0,105062
140343300800000,NE 117,Residential,27322,67935,0,95257
140343300900000,NE 117,Residential,36864,83475,0,120339
140343301000000,NE 117,Residential,34560,105140,0,139700
140343301100000,NE 117,Residential,36864,79528,0,116392
140343301200000,NE 117,Residential,35114,69342,0,104456
140343301300000,NE 117,Residential,36860,81831,0,118691
140343301400000,NE 117,Residential,37597,61796,0,99393
140343301500000,NE 117,Residential,37781,73513,0,111294
140343301600000,NE 117,Residential,37631,63396,0,101027
140343301700000,NE 117,Residential,28200,75999,0,104199
140343400100000,NE 117,Residential,36230,83649,0,119879
140343400200000,NE 117,Residential,38080,82407,0,120487
140343400300000,NE 117,Residential,37300,93700,0,131000
140343400400000,NE 117,Residential,37149,89029,0,126178
140345100100000,NE 117,Residential,32939,70381,0,103320
140345100200000,NE 117,Residential,31837,54101,0,85938
140345100300000,NE 117,Residential,38220,63048,0,101268
140345100400000,NE 117,Residential,35362,76630,0,111992
140345100500000,NE 117,Residential,37653,77137,0,114790
140345100600000,NE 117,Residential,31040,79026,0,110066
140345200100000,NE 117,Residential,30080,94319,0,124399
140345200200000,NE 117,Residential,34920,74852,0,109772
140345200300000,NE 117,Residential,34920,73015,0,107935
140345200400000,NE 117,Residential,34920,70351,0,105271
140345200500000,NE 117,Residential,34920,82800,0,117720
140345200600000,NE 117,Residential,34920,82967,0,117887
140345200700000,NE 117,Residential,34920,63539,0,98459
140345200800000,NE 117,Residential,34920,76485,0,111405
140345200900000,NE 117,Residential,34920,76181,0,111101
140345201000000,NE 117,Residential,34920,79041,0,113961
140345201100000,NE 117,Residential,34920,75651,0,110571
140345201200000,NE 117,Residential,34920,83099,0,118019
140345201300000,NE 117,Residential,34920,94095,0,129015
140345201400000,NE 117,Residential,34920,89018,0,123938
140345201500000,NE 117,Residential,30080,78200,0,108280
140345201600000,NE 117,Residential,22560,77225,0,99785
140345300100000,NE 117,Residential,24064,75454,0,99518
140345300200000,NE 117,Residential,32010,66404,0,98414
140345300300000,NE 117,Residential,32010,66770,0,98780
140345300400000,NE 117,Residential,32010,68376,0,100386
140345300500000,NE 117,Residential,32010,69984,0,101994
140345300600000,NE 117,Residential,32010,74784,0,106794
140345300700000,NE 117,Residential,32010,72306,0,104316
140345300800000,NE 117,Residential,32010,94205,0,126215
140345300900000,NE 117,Residential,32010,75059,0,107069
140345301000000,NE 117,Residential,32010,60884,0,92894
140345301100000,NE 117,Residential,32010,80427,0,112437
140345301200000,NE 117,Residential,32010,76964,0,108974
140345301300000,NE 117,Residential,32010,79758,0,111768
140345301400000,NE 117,Residential,32010,61048,0,93058
140345301500000,NE 117,Residential,32010,69745,0,101755
140345301600000,NE 117,Residential,32010,72976,0,104986
140345301700000,NE 117,Residential,32010,72364,0,104374
140345301800000,NE 117,Residential,24064,58570,0,82634
140345301900000,NE 117,Residential,22560,68771,0,91331
140345400100000,NE 117,Residential,37440,72156,0,109596
140345400200000,NE 117,Residential,32100,53681,0,85781
140345400300000,NE 117,Residential,32400,50762,0,83162
140345400400000,NE 117,Residential,32400,67717,0,100117
140345400500000,NE 117,Residential,32123,51686,0,83809
140345400600000,NE 117,Residential,36622,71683,0,108305
140345400700000,NE 117,Residential,34160,60177,0,94337
140345500100000,NE 117,Residential,44070,76419,0,120489
140345500200000,NE 117,Exempt,47514,0,92418,139932
140345500300000,E-40 CHURCHES,Exempt,172800,0,71091,243891
140345500400000,NE 117,Residential,44840,127183,0,172023
140345500500000,NE 117,Residential,23185,74623,0,97808
140345500600000,NE 117,Residential,25355,29464,0,54819
140345500700000,NE 117,Residential,32906,96090,0,128996
140345500800000,NE 117,Residential,34425,78550,0,112975
140345500900000,NE 117,Residential,31945,82995,0,114940
140345501000000,NE 117,Residential,31200,76256,0,107456
140345501100000,NE 117,Residential,31200,106888,0,138088
140345501200000,NE 117,Residential,31320,92675,0,123995
140345501300000,NE 117,Residential,31200,82752,0,113952
140345501400000,NE 117,Residential,31200,86822,0,118022
140345501500000,NE 117,Residential,31200,101556,0,132756
140345501600000,NE 117,Residential,31200,109515,0,140715
140345501700000,NE 117,Residential,31200,52773,0,83973
140345501800000,NE 117,Residential,30368,63779,0,94147
140345501900000,NE 117,Residential,42700,86963,0,129663
140345502000000,NE 117,Residential,6092,737,0,6829
140345502100000,NE 117,Residential,36400,73943,0,110343
140345502200000,NE 117,Residential,6234,0,0,6234
140345502300000,NE 117,Residential,36811,75430,0,112241
140345502400000,NE 117,Residential,42253,88182,0,130435
140345502500000,NE 117,Residential,5450,0,0,5450
140345502600000,NE 117,Residential,36400,120749,0,157149
140345502700000,NE 117,Residential,36400,93874,0,130274
140345502800000,NE 117,Residential,36400,137907,0,174307
140345502900000,NE 117,Residential,36052,136001,0,172053
140345600100000,NE 117,Residential,35109,46667,0,81776
140345600200000,NE 117,Residential,33300,78010,0,111310
140345600300000,NE 117,Residential,31280,65035,0,96315
140345600400000,NE 117,Residential,38562,151728,0,190290
140345600500000,NE 117,Residential,36604,77769,0,114373
140345600600000,APTS NE,Commercial,226800,0,2073200,2300000
140345600700000,NE 117,Residential,45900,98864,0,144764
140345600800000,NE 117,Residential,41111,111695,0,152806
140345600900000,NE 117,Residential,42281,109711,0,151992
140345601000000,NE 117,Residential,42281,70072,0,112353
140345601100000,NE 117,Residential,23000,90318,0,113318
140345601200000,NE 117,Residential,38360,106875,0,145235
140345601300000,NE 117,Residential,44240,87440,0,131680
140345601400000,NE 117,Residential,38164,89792,0,127956
140345700100000,NE 117,Residential,48589,76000,0,124589
140345700200000,NE 117,Residential,31200,88557,0,119757
140345700300000,NE 117,Residential,31200,87017,0,118217
140345700400000,NE 117,Residential,31200,64167,0,95367
140345700500000,NE 117,Residential,31200,63817,0,95017
140345700600000,NE 117,Residential,31200,73217,0,104417
140345700700000,NE 117,Residential,31200,95232,0,126432
140345700800000,NE 117,Residential,31200,80304,0,111504
140345700900000,NE 117,Residential,31200,102537,0,133737
140345701000000,NE 117,Residential,30403,76207,0,106610
140345701100000,NE 116,Residential,24250,47446,0,71696
140345701200000,NE 116,Residential,33984,83725,0,117709
140345701300000,NE 116,Residential,46500,86208,0,132708
140345701400000,NE 116,Residential,46500,80483,0,126983
140345701500000,NE 116,Residential,46500,104202,0,150702
140345701600000,NE 116,Residential,52161,101167,0,153328
140345701700000,NE 116,Residential,50000,99972,0,149972
140345701800000,NE 116,Residential,50000,60030,0,110030
140345800100000,NE 116,Residential,46000,81927,0,127927
140345800200000,NE 116,Residential,46000,78747,0,124747
140345800300000,NE 116,Residential,46000,89214,0,135214
140345800400000,NE 116,Residential,41630,84802,0,126432
140347600100000,NE 116,Residential,53500,97117,0,150617
140347600200000,NE 116,Residential,53500,130788,0,184288
140347600300000,NE 116,Residential,53500,101500,0,155000
140347600400000,NE 116,Residential,53500,92598,0,146098
140347700100000,NE 116,Residential,74439,171171,0,245610
140347700200000,NE 116,Residential,66342,158068,0,224410
140347700300000,NE 116,Residential,53500,131158,0,184658
140347700400000,NE 116,Residential,53500,115551,0,169051
140347700500000,NE 116,Residential,53500,82471,0,135971
140347700600000,NE 116,Residential,54092,87755,0,141847
140347700700000,NE 116,Residential,55120,90612,0,145732
140347700800000,NE 116,Residential,53500,92640,0,146140
140347700900000,NE 116,Residential,53500,73351,0,126851
140347701000000,NE 116,Residential,53500,73417,0,126917
140347701100000,NE 116,Residential,53500,76500,0,130000
140347800100000,NE 116,Residential,54500,104721,0,159221
140347800200000,NE 116,Residential,58840,90235,0,149075
140347800300000,NE 116,Residential,57770,124766,0,182536
140347800400000,NE 116,Residential,58044,86895,0,144939
140347900100000,NE 116,Residential,53500,91470,0,144970
140347900200000,NE 116,Residential,53500,105067,0,158567
140347900300000,NE 116,Residential,53500,94113,0,147613
140347900400000,NE 116,Residential,48671,117091,0,165762
140347900500000,NE 116,Residential,50690,111579,0,162269
140347900600000,NE 116,Residential,56316,219179,0,275495
140347900700000,NE 116,Residential,49683,108202,0,157885
140347900800000,NE 116,Residential,56214,85242,0,141456
140347900900000,NE 116,Residential,50661,94574,0,145235
140347901000000,NE 116,Residential,53500,64482,0,117982
140347901100000,NE 116,Residential,53500,83815,0,137315
140347901200000,NE 116,Residential,53500,104808,0,158308
140347901300000,NE 116,Residential,53500,95850,0,149350
140347901400000,NE 116,Residential,55708,72178,0,127886
140347901500000,NE 116,Residential,52384,95175,0,147559
140347901600000,NE 116,Residential,53500,79891,0,133391
140347901700000,NE 116,Residential,53500,82000,0,135500
140347901800000,NE 116,Residential,53500,64710,0,118210
140347901900000,NE 116,Residential,42800,60759,0,103559
140348000100000,NE 116,Residential,59920,93675,0,153595
140348000200000,NE 116,Residential,44110,70058,0,114168
140348000300000,NE 116,Residential,54000,97609,0,151609
140348000400000,NE 116,Residential,54000,70243,0,124243
140348000500000,NE 116,Residential,54000,116509,0,170509
140348000600000,NE 116,Residential,55256,79984,0,135240
140348000700000,NE 116,Residential,56469,144085,0,200554
140348000800000,NE 116,Residential,53500,89243,0,142743
140348000900000,NE 116,Residential,53500,85514,0,139014
140348001000000,NE 116,Residential,53500,140938,0,194438
140348001100000,NE 116,Residential,53500,64154,0,117654
140348001200000,NE 116,Residential,55708,83712,0,139420
140348001300000,NE 116,Residential,56136,85369,0,141505
140348001400000,NE 116,Residential,50503,87175,0,137678
140348001500000,NE 116,Residential,57427,101603,0,159030
140348001600000,NE 116,Residential,52725,94815,0,147540
140348001700000,NE 116,Residential,52517,130559,0,183076
140348001800000,NE 116,Residential,54000,85256,0,139256
140348100100000,NE 116,Residential,54604,76227,0,130831
140348100200000,NE 116,Residential,53500,70265,0,123765
140348100300000,NE 116,Residential,53500,87797,0,141297
140348100400000,NE 116,Residential,53500,93215,0,146715
140348100500000,NE 116,Residential,53500,71145,0,124645
140348100600000,NE 116,Residential,51765,67794,0,119559
140348200100000,NE 116,Residential,54604,72606,0,127210
140348200200000,NE 116,Residential,53500,46505,0,100005
140348200300000,NE 116,Residential,53500,91302,0,144802
140348200400000,NE 116,Residential,53500,87760,0,141260
140348200500000,NE 116,Residential,53500,63676,0,117176
140348200600000,NE 116,Residential,57290,97273,0,154563
140410100200000,COMM NE,Commercial,701514,0,359324,1060838
140410100300000,Empty,Other,0,0,0,0
140410100400000,COMM NE,Commercial,418500,0,262665,681165
140410100500000,INDUSTRIAL,Industrial,287200,0,1621015,1908215
140410100600000,COMM NE,Commercial,453600,0,321705,775305
140410100800000,Empty,Commercial,351648,0,1684782,2036430
140410200100000,COMM NE,Commercial,961049,0,2801990,3763039
140410200200000,INDUSTRIAL,Industrial,570580,0,4043834,4614414
140412600100000,Empty,Other,0,0,0,0
140412600200000,COMM NE,Commercial,145508,0,222549,368057
140412600300000,COMM NE,Commercial,103615,0,188922,292537
140412600400000,COMM NE,Commercial,128226,0,112200,240426
140412600500000,COMM NE,Commercial,180900,0,148585,329485
140412600502000,COMM NE,Commercial,0,0,57631,57631
140412600600000,COMM NE,Commercial,5962,0,12165,18127
140412600700000,COMM NE,Commercial,97200,0,233680,330880
140412600800000,COMM NE,Commercial,77517,0,8814,86331
140412600900000,COMM NE,Commercial,75294,0,151035,226329
140412601000000,COMM NE,Commercial,7760,0,17328,25088
140412601100000,COMM NE,Commercial,93150,0,383369,476519
140412601200000,COMM NE,Commercial,157950,0,544431,702381
140412601300000,COMM NE,Commercial,60000,0,0,60000
140412601400000,COMM NE,Commercial,288900,0,253027,541927
140412602500000,COMM NE,Commercial,4212,0,0,4212
140412900100000,COMM NE,Commercial,491062,0,616614,1107676
140412900200000,COMM NE,Commercial,188592,0,4226,192818
140412900300000,COMM NE,Commercial,22,0,0,22
140413000100000,COMM NE,Commercial,280800,0,93860,374660
140413000300000,COMM NE,Commercial,198450,0,397404,595854
140413000400000,COMM NE,Commercial,114345,0,160426,274771
140413000500000,COMM NE,Commercial,120285,0,369436,489721
140413000600000,COMM NE,Commercial,22,0,0,22
140413000700000,COMM NE,Commercial,22,0,0,22
140413000800000,COMM NE,Commercial,865494,0,2369075,3234569
140413100100000,COMM NE,Commercial,315900,0,433490,749390
140413100200000,COMM NE,Commercial,137970,0,152510,290480
140413100300000,COMM NE,Commercial,340200,0,431735,771935
140413100400000,COMM NE,Commercial,253800,0,254565,508365
140413100402000,COMM NE,Commercial,0,0,58658,58658
140413100500000,COMM NE,Commercial,226800,0,263903,490703
140413100600000,COMM NE,Commercial,102624,0,136921,239545
140413100602000,COMM NE,Commercial,0,0,28258,28258
140413100700000,COMM NE,Commercial,86158,0,143584,229742
140413100800000,COMM NE,Commercial,30793,0,0,30793
140413101100000,COMM NE,Commercial,240300,0,1008275,1248575
140413101200000,COMM NE,Commercial,22,0,0,22
140415100100000,COMM NE,Commercial,41796,0,0,41796
140415100300000,Empty,Other,0,0,0,0
140415100302000,COMM NE,Commercial,0,0,16089,16089
140415200100000,COMM NE,Commercial,935820,0,2838614,3774434
140415200200000,COMM NE,Commercial,433350,0,522039,955389
140415200301000,COMM NE,Commercial,68310,0,194620,262930
140415200301001,COMM NE,Commercial,68310,0,207131,275441
140415200301002,COMM NE,Commercial,133650,0,234248,367898
140415200400000,COMM NE,Commercial,305251,0,336816,642067
140415300100000,NE 111,Residential,47875,186065,0,233940
140415300200000,COMM NE,Commercial,783540,0,3018972,3802512
140415300300000,COMM NE,Commercial,183600,0,509760,693360
140417600100000,COMM NE,Commercial,131760,0,350593,482353
140417600200000,COMM NE,Commercial,60480,0,391132,451612
140417600300000,COMM NE,Commercial,227448,0,14256,241704
140417600400000,COMM NE,Commercial,938520,0,3246601,4185121
140417600500000,E-15 CITY,Commercial,629100,0,10070,639170
140417600600000,COMM NE,Commercial,395280,0,376314,771594
140417600700000,COMM NE,Commercial,113416,0,91683,205099
140417600800000,COMM NE,Commercial,281232,0,437657,718889
140417601000000,COMM NE,Commercial,13608,0,21228,34836
140417700100000,COMM NE,Commercial,766260,0,789210,1555470
140417700200000,COMM NE,Commercial,238950,0,317524,556474
140417700300000,COMM NE,Commercial,49410,0,0,49410
140417700400000,COMM NE,Commercial,219780,0,368863,588643
140417800100000,INDUSTRIAL,Industrial,573750,0,1574770,2148520
140417800200000,NE 111,Residential,47550,153870,0,201420
140420500100000,COMM NE,Commercial,515160,0,1076670,1591830
140420500200000,COMM NE,Commercial,1788,0,17397,19185
140420500300000,APTS NE,Commercial,18144,0,285980,304124
140420500400000,APTS NE,Commercial,18090,0,280506,298596
140420500500000,APTS NE,Commercial,29088,0,373321,402409
140420500601000,CONDO 500,Residential,5000,52469,0,57469
140420500601001,CONDO 500,Residential,5000,48300,0,53300
140420500601002,CONDO 500,Residential,5000,52469,0,57469
140420500601003,CONDO 500,Residential,5000,48300,0,53300
140420500601004,CONDO 500,Residential,5000,52469,0,57469
140420500601005,CONDO 500,Residential,5000,48300,0,53300
140420500700000,APTS NE,Residential,24057,285584,0,309641
140420500800000,APTS NE,Commercial,24084,0,284160,308244
140420500900000,APTS NE,Commercial,403920,0,3917036,4320956
140420501000000,COMM NE,Commercial,40203,0,70898,111101
140420501100000,COMM NE,Commercial,52596,0,107999,160595
140420501200000,COMM NE,Commercial,112104,0,92332,204436
140420501300000,COMM NE,Commercial,122024,0,136280,258304
140420501400000,COMM NE,Commercial,197640,0,215981,413621
140420501500000,COMM NE,Commercial,124805,0,164350,289155
140420600100000,APTS NE,Commercial,34265,0,353490,387755
140420600200000,COMM NE,Commercial,52488,0,151614,204102
140423100100000,COMM NE,Commercial,491400,0,995663,1487063
140423100200000,COMM NE,Commercial,307800,0,355509,663309
140423100300000,COMM NE,Commercial,183600,0,476177,659777
140423100400000,INDUSTRIAL,Industrial,312400,0,1101033,1413433
140423100500000,COMM NE,Commercial,147150,0,634475,781625
140423100600000,Empty,Other,0,0,0,0
140423200100000,COMM NE,Commercial,142144,0,236736,378880
140423200200000,COMM NE,Commercial,95863,0,72711,168574
140423200300000,COMM NE,Commercial,265075,0,531064,796139
140425100100000,E-15 CITY,Exempt,0,0,0,0
140425200100000,E-15 CITY,Exempt,0,0,0,0
140427600300000,COMM NE,Commercial,271296,0,212028,483324
140427600400000,COMM NE,Commercial,292680,0,507320,800000
140427600500000,INDUSTRIAL,Industrial,206250,0,514197,720447
140427600600000,COMM NE,Commercial,339012,0,671711,1010723
140427600700000,COMM NE,Commercial,210600,0,648254,858854
140427600800000,COMM NE,Commercial,86659,0,144868,231527
140427600900000,COMM NE,Commercial,97675,0,372280,469955
140427601000000,COMM NE,Commercial,432,0,3694,4126
140427601200000,Empty,Other,0,0,0,0
140427601300000,COMM NE,Commercial,141264,0,277180,418444
140427601400000,COMM NE,Commercial,315900,0,399427,715327
140427700100000,COMM NE,Commercial,308826,0,704053,1012879
140427700200000,COMM NE,Commercial,51840,0,194135,245975
140427700300000,NE 112,Residential,24300,50323,0,74623
140427700400000,NE 112,Residential,10000,32868,0,42868
140427700500000,NE 112,Residential,24525,59933,0,84458
140427700600000,NE 112,Residential,30150,49266,0,79416
140427700700000,NE 112,Residential,18057,58342,0,76399
140427700800000,NE 112,Residential,18300,51103,0,69403
140427700900000,NE 112,Residential,31350,55418,0,86768
140427701000000,NE 112,Residential,19680,76724,0,96404
140427701100000,Empty,Other,0,0,0,0
140427800100000,E-40 CHURCHES,Exempt,91109,0,104905,196014
140427800200000,NE 112,Residential,20750,63364,0,84114
140427800300000,NE 112,Residential,19920,42715,0,62635
140427800400000,NE 112,Residential,20140,54117,0,74257
140427800500000,NE 112,Residential,18880,29158,0,48038
140427800600000,NE 112,Residential,18880,21416,0,40296
140427800700000,COMM NE,Commercial,359032,0,105220,464252
140430100300000,COMM NE,Commercial,93015,0,189701,282716
140430100400000,COMM NE,Commercial,49572,0,68824,118396
140430100500000,COMM NE,Commercial,154440,0,755560,910000
140430100600000,COMM NE,Commercial,57953,0,213943,271896
140430100700000,COMM NE,Commercial,174150,0,114366,288516
140430100800000,COMM NE,Commercial,472500,0,1233578,1706078
140430100900000,COMM NE,Commercial,200340,0,202949,403289
140430101000000,COMM NE,Commercial,511515,0,637980,1149495
140430101100000,COMM NE,Commercial,50220,0,178999,229219
140430101200000,E-15 CITY,Exempt,0,0,0,0
140430101300000,Empty,Other,0,0,0,0
140430101400000,E-15 CITY,Exempt,0,0,0,0
140430200100000,NE 120,Residential,30252,126597,0,156849
140430200200000,NE 120,Residential,28000,137194,0,165194
140430300100000,NE 120,Residential,32340,148738,0,181078
140430300200000,NE 120,Residential,33280,145471,0,178751
140432600100000,NE 120,Residential,30219,128365,0,158584
140432600200000,NE 120,Residential,28785,114292,0,143077
140432600300000,NE 120,Residential,29169,121181,0,150350
140432600400000,NE 120,Residential,32435,106751,0,139186
140432600500000,NE 120,Residential,33602,100109,0,133711
140432600600000,NE 120,Residential,32311,151895,0,184206
140432600700000,NE 120,Residential,32689,147150,0,179839
140432601000000,NE 120,Residential,30600,152820,0,183420
140432601100000,NE 120,Residential,2106,0,0,2106
140432601200000,NE 120,Residential,29700,126936,0,156636
140432601300000,NE 120,Residential,30528,118446,0,148974
140432601400000,NE 120,Residential,33048,155784,0,188832
140432601500000,NE 120,Residential,32000,187048,0,219048
140432601600000,NE 120,Residential,30000,141865,0,171865
140432601700000,NE 120,Residential,30000,148903,0,178903
140432601800000,NE 120,Residential,30607,117693,0,148300
140432601900000,NE 120,Residential,33507,144275,0,177782
140432602000000,NE 120,Residential,33566,138027,0,171593
140432602100000,NE 120,Residential,33152,134164,0,167316
140432602200000,NE 120,Residential,32000,158534,0,190534
140432700100000,NE 120,Residential,30756,146991,0,177747
140432700200000,NE 120,Residential,32000,145529,0,177529
140432700300000,NE 120,Residential,30000,148881,0,178881
140432700400000,NE 120,Residential,28000,139758,0,167758
140432700500000,NE 120,Residential,32000,175299,0,207299
140432700600000,NE 120,Residential,34469,166945,0,201414
140432700700000,NE 120,Residential,34800,132214,0,167014
140432700800000,NE 120,Residential,33213,115251,0,148464
140432700900000,NE 120,Residential,37332,189227,0,226559
140432701000000,NE 120,Residential,32420,146608,0,179028
140432701100000,NE 120,Residential,31820,136549,0,168369
140432701200000,NE 120,Residential,31220,147082,0,178302
140432701300000,NE 120,Residential,32340,133430,0,165770
140432701400000,NE 120,Residential,31700,136186,0,167886
140432701500000,NE 120,Residential,705,0,0,705
140432701600000,NE 120,Residential,33545,206187,0,239732
140432701700000,NE 120,Residential,38907,158504,0,197411
140432701800000,NE 120,Residential,28712,131707,0,160419
140432701900000,NE 120,Residential,32340,106111,0,138451
140432702000000,NE 120,Residential,26800,139164,0,165964
140432702100000,NE 120,Residential,28916,173540,0,202456
140432702200000,NE 120,Residential,26520,120856,0,147376
140432702300000,NE 120,Residential,26395,133092,0,159487
140432702400000,NE 120,Residential,28119,119919,0,148038
140432702500000,NE 120,Residential,33512,140308,0,173820
140432702600000,NE 120,Residential,27318,137836,0,165154
140432702700000,NE 120,Residential,28560,131190,0,159750
140432702800000,NE 120,Residential,28560,147131,0,175691
140432702900000,NE 120,Residential,29620,146392,0,176012
140432703000000,NE 120,Residential,33454,135022,0,168476
140432703100000,NE 120,Residential,35148,132924,0,168072
140432703200000,NE 120,Residential,34854,137545,0,172399
140432703300000,NE 120,Residential,31902,123262,0,155164
140432703400000,NE 120,Residential,28560,123507,0,152067
140432703500000,NE 120,Residential,28560,125889,0,154449
140432703600000,NE 120,Residential,26928,131395,0,158323
140432703700000,NE 120,Residential,28215,115899,0,144114
140432703800000,NE 120,Residential,30241,135032,0,165273
140432703900000,NE 120,Residential,27160,94030,0,121190
140432704000000,NE 120,Residential,27160,96253,0,123413
140432704100000,NE 120,Residential,27160,123053,0,150213
140432704200000,NE 120,Residential,27611,95246,0,122857
140432800100000,NE 120,Residential,30492,126712,0,157204
140432800200000,NE 120,Residential,29333,115412,0,144745
140432800300000,NE 120,Residential,29851,122903,0,152754
140432800400000,NE 120,Residential,26000,90022,0,116022
140432800500000,NE 120,Residential,26000,101322,0,127322
140432800600000,NE 120,Residential,26000,99388,0,125388
140432800700000,NE 120,Residential,26000,116768,0,142768
140432800800000,NE 120,Residential,26252,110546,0,136798
140432900100000,NE 120,Residential,33048,138044,0,171092
140432900200000,NE 120,Residential,32640,147501,0,180141
140432900300000,NE 120,Residential,30300,173012,0,203312
140432900400000,NE 120,Residential,32320,120082,0,152402
140432900500000,NE 120,Residential,28000,112038,0,140038
140432900600000,NE 120,Residential,32667,0,0,32667
140432900800000,NE 120,Residential,28274,11025,0,39299
140432900900000,NE 120,Residential,30138,125340,0,155478
140435100100000,NE 121,Residential,30901,93290,0,124191
140435100200000,NE 121,Residential,32130,88593,0,120723
140435100300000,NE 121,Residential,32485,89339,0,121824
140435100400000,NE 121,Residential,32314,101531,0,133845
140435100500000,NE 121,Residential,31217,116348,0,147565
140435100600000,NE 121,Residential,34807,86622,0,121429
140435100700000,NE 121,Residential,32512,91113,0,123625
140435100800000,NE 121,Residential,32237,88767,0,121004
140435100900000,NE 121,Residential,32340,106168,0,138508
140435101000000,NE 121,Residential,31084,86865,0,117949
140435101100000,NE 121,Residential,30186,87985,0,118171
140435101200000,NE 121,Residential,29788,115504,0,145292
140435101300000,NE 121,Residential,30233,74579,0,104812
140435200100000,NE 121,Residential,31479,90280,0,121759
140435200200000,NE 121,Residential,32000,137582,0,169582
140435200300000,NE 121,Residential,30000,109632,0,139632
140435200400000,NE 121,Residential,32000,111026,0,143026
140435200500000,NE 121,Residential,31851,135649,0,167500
140435200600000,NE 121,Residential,30000,122654,0,152654
140435200700000,NE 121,Residential,30559,131551,0,162110
140435300100000,NE 121,Residential,30503,120721,0,151224
140435300200000,NE 121,Residential,30000,131183,0,161183
140435300300000,NE 121,Residential,31708,116919,0,148627
140435300400000,NE 121,Residential,32776,117260,0,150036
140435300500000,NE 121,Residential,33557,120721,0,154278
140435300600000,NE 121,Residential,31913,93448,0,125361
140435300700000,NE 121,Residential,32320,90990,0,123310
140435300800000,NE 121,Residential,31924,128062,0,159986
140435300900000,NE 121,Residential,30133,97808,0,127941
140435301000000,NE 121,Residential,32695,103098,0,135793
140435301100000,Empty,Exempt,0,0,0,0
140435400100000,NE 121,Residential,28800,102569,0,131369
140435400200000,NE 121,Residential,32732,108449,0,141181
140435400300000,NE 121,Residential,36223,116789,0,153012
140435400400000,NE 121,Residential,34634,120621,0,155255
140435400500000,NE 121,Residential,37856,153036,0,190892
140435400600000,NE 121,Residential,33818,104203,0,138021
140435400700000,NE 121,Residential,35360,138139,0,173499
140435400800000,NE 121,Residential,32694,107619,0,140313
140435400900000,NE 121,Residential,29388,85648,0,115036
140435401000000,NE 121,Residential,30420,67768,0,98188
140435401100000,NE 121,Residential,29484,84646,0,114130
140435401200000,NE 121,Residential,30420,90037,0,120457
140435401300000,NE 121,Residential,29016,85576,0,114592
140435401400000,NE 121,Residential,30186,91216,0,121402
140435401500000,NE 121,Residential,31625,87295,0,118920
140435401600000,NE 121,Residential,32341,93644,0,125985
140435401700000,NE 121,Residential,31327,82199,0,113526
140435401800000,NE 121,Residential,31936,95236,0,127172
140435401900000,NE 121,Residential,32076,110438,0,142514
140435500100000,NE 121,Residential,29198,112939,0,142137
140435500200000,NE 121,Residential,30240,96425,0,126665
140435500300000,NE 121,Residential,30600,97976,0,128576
140435500400000,NE 121,Residential,30300,91446,0,121746
140435500500000,NE 121,Residential,30346,0,0,30346
140435500600000,NE 121,Residential,38942,157700,0,196642
140435500700000,NE 121,Residential,28179,99153,0,127332
140435500800000,NE 121,Residential,31229,129176,0,160405
140435500900000,NE 121,Residential,32051,107693,0,139744
140435501000000,NE 121,Residential,32130,134247,0,166377
140435501100000,NE 121,Residential,33024,140426,0,173450
140435501200000,NE 121,Residential,34238,124796,0,159034
140435501300000,NE 121,Residential,30600,104659,0,135259
140435501400000,NE 121,Residential,30569,103409,0,133978
140435600100000,NE 121,Residential,32527,105146,0,137673
140435600200000,NE 121,Residential,31920,114541,0,146461
140435600300000,NE 121,Residential,29497,134043,0,163540
140435600400000,NE 121,Residential,32320,110184,0,142504
140435600500000,NE 121,Residential,32320,121391,0,153711
140435600600000,NE 121,Residential,32320,108962,0,141282
140435600700000,NE 121,Residential,32320,150092,0,182412
140435600800000,NE 121,Residential,30866,121642,0,152508
140435600900000,NE 121,Residential,32320,131206,0,163526
140435601000000,NE 121,Residential,31373,138436,0,169809
140435601100000,NE 121,Residential,32227,143984,0,176211
140435601200000,NE 121,Residential,32000,78342,0,110342
140435601300000,NE 121,Residential,31520,113277,0,144797
140435601400000,NE 121,Residential,32320,100821,0,133141
140435601500000,NE 121,Residential,32360,105289,0,137649
140435601600000,NE 121,Residential,32724,100431,0,133155
140435601700000,NE 121,Residential,33997,117291,0,151288
140435700100000,NE 121,Residential,28800,108012,0,136812
140435700200000,NE 121,Residential,28077,93914,0,121991
140435700300000,NE 121,Residential,26520,83301,0,109821
140435700400000,NE 121,Residential,28560,76196,0,104756
140435700500000,NE 121,Residential,29338,85862,0,115200
140435700600000,NE 121,Residential,31104,78875,0,109979
140435700700000,NE 121,Residential,32628,111965,0,144593
140435700800000,NE 121,Residential,24990,81750,0,106740
140435700900000,NE 121,Residential,24990,70886,0,95876
140435701000000,NE 121,Residential,24549,77018,0,101567
140435701100000,NE 121,Residential,26460,106693,0,133153
140437600100000,COMM NE,Commercial,470880,0,2229120,2700000
140437600300000,COMM NE,Commercial,27852,0,9693,37545
140437600400000,Empty,Other,0,0,0,0
140437600500000,E-15 CITY,Exempt,0,0,0,0
140437601000000,APTS NE,Commercial,24787,0,175213,200000
140437700100000,NE 121,Residential,35475,130416,0,165891
140437700200000,NE 121,Residential,30240,158715,0,188955
140437700300000,NE 121,Residential,17113,97512,0,114625
140437700400000,NE 121,Residential,11040,83392,0,94432
140437700500000,NE 121,Residential,10848,98510,0,109358
140437700600000,NE 121,Residential,16218,97924,0,114142
140437700701000,CONDO 501,Residential,10000,139611,0,149611
140437700701001,CONDO 501,Residential,10000,147639,0,157639
140437700701002,CONDO 501,Residential,10000,134120,0,144120
140437700701003,CONDO 501,Residential,11000,129872,0,140872
140437700701004,CONDO 501,Residential,12000,161988,0,173988
140437700801000,CONDO 501,Residential,10000,115913,0,125913
140437700801001,CONDO 501,Residential,13000,101407,0,114407
140437700801002,CONDO 501,Residential,13000,101407,0,114407
140437700801003,CONDO 501,Residential,10000,133355,0,143355
140437700901000,CONDO 501,Residential,10000,111809,0,121809
140437700901001,CONDO 501,Residential,13000,100863,0,113863
140437700901002,CONDO 501,Residential,13000,110122,0,123122
140437700901003,CONDO 501,Residential,10000,135907,0,145907
140437701101000,CONDO 501,Residential,10000,111167,0,121167
140437701101001,CONDO 501,Residential,13000,101624,0,114624
140437701101002,CONDO 501,Residential,13000,102867,0,115867
140437701101003,CONDO 501,Residential,10000,112513,0,122513
140437701101004,CONDO 501,Residential,10000,135132,0,145132
140437701101005,CONDO 501,Residential,13000,101624,0,114624
140437701101006,CONDO 501,Residential,13000,104627,0,117627
140437701101007,CONDO 501,Residential,10000,115155,0,125155
140437701200000,NE 121,Residential,43306,222558,0,265864
140437701300000,NE 121,Residential,39168,210382,0,249550
140437701400000,NE 121,Residential,32000,150241,0,182241
140437701500000,NE 121,Residential,30000,165186,0,195186
140437701600000,NE 121,Residential,32000,164950,0,196950
140437701700000,NE 121,Residential,21000,145297,0,166297
140437701800000,NE 121,Residential,30000,147954,0,177954
140437701900000,NE 121,Residential,32912,194095,0,227007
140437702000000,NE 121,Residential,28560,63594,0,92154
140437702100000,NE 121,Residential,25200,59136,0,84336
140437702200000,NE 121,Residential,24903,81909,0,106812
140437702300000,NE 121,Residential,26185,89939,0,116124
140437702400000,NE 121,Residential,26552,116016,0,142568
140437702500000,NE 121,Residential,27562,102102,0,129664
140437702600000,NE 121,Residential,27930,103207,0,131137
140437702700000,NE 121,Residential,26460,99981,0,126441
140437702800000,NE 121,Residential,26460,109010,0,135470
140437702900000,NE 121,Residential,26185,105011,0,131196
140437703000000,NE 121,Residential,26185,83442,0,109627
140437703100000,NE 121,Residential,25436,68584,0,94020
140437800100000,NE 121,Residential,31492,121754,0,153246
140437800200000,NE 121,Residential,32640,131407,0,164047
140437800300000,NE 121,Residential,32640,146363,0,179003
140437800400000,NE 121,Residential,34680,148662,0,183342
140437800500000,NE 121,Residential,32640,132139,0,164779
140437800600000,NE 121,Residential,30600,132134,0,162734
140437800700000,NE 121,Residential,31144,163752,0,194896
140437800800000,NE 121,Residential,34088,179823,0,213911
140437800900000,NE 121,Residential,31122,114215,0,145337
140437801000000,NE 121,Residential,30420,94791,0,125211
140437801100000,NE 121,Residential,30233,103653,0,133886
140437801200000,NE 121,Residential,30233,82918,0,113151
140437801300000,NE 121,Residential,31255,87782,0,119037
140437801400000,NE 121,Residential,40747,176860,0,217607
140437801500000,NE 121,Residential,30000,159427,0,189427
140437801600000,NE 121,Residential,34200,191450,0,225650
140437801700000,NE 121,Residential,32716,154655,0,187371
140437801800000,NE 121,Residential,33354,153653,0,187007
140437801900000,NE 121,Residential,34290,155982,0,190272
140440100100000,E-40 CHURCHES,Exempt,1042200,0,5036589,6078789
140440100400000,NE 118,Residential,34880,134258,0,169138
140440100500000,NE 118,Residential,32427,77613,0,110040
140440100700000,NE 118,Residential,30495,52224,0,82719
140440100800000,NE 118,Residential,33197,83309,0,116506
140440100900000,NE 118,Residential,31200,74992,0,106192
140440101000000,NE 118,Residential,31200,90715,0,121915
140440101100000,NE 118,Residential,31200,74746,0,105946
140440101200000,NE 118,Residential,31200,82555,0,113755
140440101300000,NE 118,Residential,32205,102272,0,134477
140440101400000,NE 118,Residential,31200,79197,0,110397
140440101500000,NE 118,Residential,31200,100543,0,131743
140440101600000,NE 118,Residential,31200,88790,0,119990
140440101700000,NE 118,Residential,31200,82780,0,113980
140440101800000,NE 118,Residential,31200,80790,0,111990
140440101900000,NE 118,Residential,31200,89326,0,120526
140440102000000,NE 118,Residential,31200,82287,0,113487
140440102100000,NE 118,Residential,31200,77086,0,108286
140440102200000,NE 118,Residential,31200,101814,0,133014
140440102300000,NE 118,Residential,31200,97110,0,128310
140440102400000,NE 118,Residential,31200,90156,0,121356
140440102500000,NE 118,Residential,31200,90113,0,121313
140440102600000,NE 118,Exempt,34424,0,112287,146711
140440102700000,NE 118,Residential,31240,60587,0,91827
140440102800000,NE 118,Residential,52964,157736,0,210700
140440200100000,NE 118,Residential,33484,97779,0,131263
140440200200000,NE 118,Residential,31200,75138,0,106338
140440200300000,NE 118,Residential,31200,72963,0,104163
140440200400000,NE 118,Residential,31200,70539,0,101739
140440200500000,NE 118,Residential,31200,74766,0,105966
140440200600000,NE 118,Residential,31200,66847,0,98047
140440200700000,NE 118,Residential,31200,109736,0,140936
140440200800000,NE 118,Residential,31200,83199,0,114399
140440200900000,NE 118,Residential,31200,72914,0,104114
140440201000000,NE 118,Residential,31200,81845,0,113045
140440201100000,NE 118,Residential,31200,84200,0,115400
140440201200000,NE 118,Residential,31200,82665,0,113865
140440201300000,NE 118,Residential,31200,107574,0,138774
140440201400000,NE 118,Residential,31200,80033,0,111233
140440201500000,NE 118,Residential,31200,82790,0,113990
140440201600000,NE 118,Residential,31593,70646,0,102239
140440201700000,NE 118,Residential,31200,69007,0,100207
140440201800000,NE 118,Residential,31200,80859,0,112059
140440201900000,NE 118,Residential,26750,61376,0,88126
140440202000000,NE 118,Residential,34507,102875,0,137382
140440202100000,NE 118,Residential,33186,104513,0,137699
140440202200000,NE 118,Residential,32460,90848,0,123308
140440202300000,NE 118,Residential,32040,87522,0,119562
140440202400000,NE 118,Residential,31000,88841,0,119841
140440202500000,NE 118,Residential,32400,98809,0,131209
140440202600000,NE 118,Residential,30000,82457,0,112457
140440202700000,NE 118,Residential,32300,73605,0,105905
140440202800000,NE 118,Residential,31000,64846,0,95846
140440202900000,NE 118,Residential,30000,88614,0,118614
140440203000000,NE 118,Residential,31000,83959,0,114959
140440203100000,NE 118,Residential,33858,71640,0,105498
140440203200000,NE 118,Residential,34708,77868,0,112576
140440203300000,NE 118,Residential,35062,102578,0,137640
140440203400000,NE 118,Residential,33088,86213,0,119301
140440203500000,NE 118,Residential,32709,70059,0,102768
140440203600000,NE 118,Residential,34501,120526,0,155027
140440203700000,NE 118,Residential,50500,110427,0,160927
140440203900000,NE 118,Residential,30150,92155,0,122305
140440204000000,NE 118,Residential,29324,91881,0,121205
140440204100000,NE 118,Residential,27540,87204,0,114744
140440204200000,NE 118,Residential,27540,89953,0,117493
140440204300000,NE 118,Residential,27540,87475,0,115015
140440204400000,NE 118,Residential,25239,93179,0,118418
140440300100000,NE 118,Residential,27575,105622,0,133197
140440300200000,NE 118,Residential,28152,90038,0,118190
140440300300000,NE 118,Residential,34331,108120,0,142451
140440300400000,NE 118,Residential,32100,86843,0,118943
140440400100000,NE 118,Residential,34026,101175,0,135201
140440400200000,NE 118,Residential,32635,101784,0,134419
140440400300000,NE 118,Residential,32100,72198,0,104298
140440400400000,NE 118,Residential,34240,81143,0,115383
140440400500000,NE 118,Residential,29960,91482,0,121442
140440400600000,NE 118,Residential,31800,89378,0,121178
140440400700000,NE 118,Residential,30532,84582,0,115114
140440600100000,COMM NE,Commercial,388800,0,400502,789302
140440600200000,COMM NE,Commercial,541350,0,2655258,3196608
140440600300000,COMM NE,Commercial,492480,0,912169,1404649
140442700100000,NE 118,Residential,38985,0,0,38985
140442700200000,COMM NE,Commercial,768960,0,591040,1360000
140442700300000,COMM NE,Commercial,768960,0,1329996,2098956
140442700400000,E-40 CHURCHES,Exempt,171396,0,4373921,4545317
140442700600000,NE 118,Residential,41040,76147,0,117187
140442700700000,NE 118,Residential,50669,70913,0,121582
140442700800000,NE 118,Residential,36223,85152,0,121375
140442700900000,NE 118,Residential,50535,88185,0,138720
140445100100000,NE 118,Residential,34906,85733,0,120639
140445100200000,NE 118,Residential,34122,70878,0,105000
140445100300000,NE 118,Residential,34122,76325,0,110447
140445100400000,NE 118,Residential,31020,84449,0,115469
140445100500000,NE 118,Residential,31020,81844,0,112864
140445100600000,NE 118,Residential,31020,69478,0,100498
140445100700000,NE 118,Residential,31020,85148,0,116168
140445100800000,NE 118,Residential,31020,74926,0,105946
140445100900000,NE 118,Residential,31020,74188,0,105208
140445101000000,NE 118,Residential,31020,69194,0,100214
140445101100000,NE 118,Residential,31020,73148,0,104168
140445101200000,NE 118,Residential,31020,77693,0,108713
140445101300000,NE 118,Residential,31020,79493,0,110513
140445101400000,NE 118,Residential,31020,85926,0,116946
140445101500000,NE 118,Residential,36652,87095,0,123747
140445101600000,NE 118,Residential,36241,83316,0,119557
140445101700000,NE 118,Residential,36920,95382,0,132302
140445101800000,NE 118,Residential,36052,81128,0,117180
140445101900000,NE 118,Residential,41580,103134,0,144714
140445200100000,NE 118,Residential,34849,99396,0,134245
140445200200000,NE 118,Residential,31026,94448,0,125474
140445200300000,NE 118,Residential,31155,107412,0,138567
140445200400000,NE 118,Residential,31155,104192,0,135347
140445200500000,NE 118,Residential,31929,91645,0,123574
140445200600000,NE 118,Residential,33683,83918,0,117601
140445200700000,NE 118,Residential,32340,86453,0,118793
140445200800000,NE 118,Residential,30300,78157,0,108457
140445200900000,NE 118,Residential,30255,81922,0,112177
140445201000000,NE 118,Residential,30600,75672,0,106272
140445201100000,NE 118,Residential,30600,65401,0,96001
140445201200000,NE 118,Residential,30600,82633,0,113233
140445201300000,NE 118,Residential,30600,72978,0,103578
140445201400000,NE 118,Residential,30600,69589,0,100189
140445201500000,NE 118,Residential,28913,74964,0,103877
140445201600000,NE 118,Residential,28800,74373,0,103173
140445201700000,NE 118,Residential,36121,73182,0,109303
140445201800000,NE 118,Residential,35693,74735,0,110428
140445201900000,NE 118,Residential,33660,71247,0,104907
140445202000000,NE 118,Residential,33660,73006,0,106666
140445202100000,NE 118,Residential,33660,68927,0,102587
140445202200000,NE 118,Residential,33660,85789,0,119449
140445202300000,NE 118,Residential,33660,113731,0,147391
140445202400000,NE 118,Residential,33000,97463,0,130463
140445202500000,NE 118,Residential,31680,71447,0,103127
140445202600000,NE 118,Residential,33088,84585,0,117673
140445202700000,NE 118,Residential,33067,71668,0,104735
140445202800000,NE 118,Residential,31020,69608,0,100628
140445202900000,NE 118,Residential,34639,87462,0,122101
140445203000000,NE 118,Residential,34639,81234,0,115873
140445300100000,NE 118,Residential,31639,81058,0,112697
140445300200000,NE 118,Residential,31960,98949,0,130909
140445300300000,NE 118,Residential,31960,70992,0,102952
140445300400000,NE 118,Residential,31161,103970,0,135131
140445400100000,NE 118,Residential,38157,73423,0,111580
140445400200000,NE 118,Residential,41400,63770,0,105170
140445400400000,COMM NE,Commercial,413100,0,512491,925591
140445400500000,NE 118,Residential,33900,98775,0,132675
140445400700000,NE 118,Residential,42234,117079,0,159313
140445400800000,E-40 CHURCHES,Exempt,648000,0,432403,1080403
140445400900000,COMM NE,Commercial,99478,0,0,99478
140445401000000,COMM NE,Commercial,68850,0,565,69415
140445401100000,COMM NE,Commercial,54043,0,43483,97526
140445401200000,COMM NE,Commercial,52877,0,41906,94783
140445401300000,NE 118,Residential,30600,0,0,30600
140445401400000,NE 118,Residential,28200,86635,0,114835
140445401500000,NE 118,Residential,29550,76237,0,105787
140445401600000,NE 118,Residential,26765,102635,0,129400
140445401700000,NE 118,Residential,28050,69398,0,97448
140445401800000,NE 118,Residential,27775,74920,0,102695
140445401900000,NE 118,Residential,27775,71757,0,99532
140445402000000,NE 118,Residential,30750,48050,0,78800
140445500100000,COMM NE,Commercial,78300,0,10161,88461
140445500200000,COMM NE,Commercial,45900,0,13000,58900
140445500300000,COMM NE,Commercial,480600,0,494806,975406
140445500400000,COMM NE,Commercial,265410,0,878737,1144147
140445600100000,COMM NE,Commercial,52693,0,223325,276018
140445600200000,NE 118,Residential,29974,53152,0,83126
140445700100000,NE 118,Residential,34550,79714,0,114264
140445700200000,NE 118,Residential,28581,63236,0,91817
140445700300000,COMM NE,Commercial,166504,0,60515,227019
140445700400000,COMM NE,Commercial,349920,0,296748,646668
140445700500000,NE 118,Residential,29343,73309,0,102652
140445700600000,NE 118,Residential,29343,74040,0,103383
140445800100000,COMM NE,Commercial,460080,0,1536951,1997031
140445800200000,COMM NE,Commercial,40038,0,8840,48878
140445800400000,COMM NE,Commercial,138132,0,41510,179642
140445800500000,COMM NE,Commercial,146340,0,193753,340093
140445800600000,COMM NE,Commercial,83430,0,2631,86061
140445800700000,COMM NE,Commercial,141991,0,70570,212561
140445800800000,COMM NE,Commercial,165794,0,63122,228916
140445800900000,E-15 CITY,Exempt,0,0,0,0
140445801000000,COMM NE,Commercial,143100,0,246271,389371
140447600100000,NE 118,Residential,25081,51333,0,76414
140447600200000,NE 118,Residential,26420,66031,0,92451
140447600300000,NE 118,Residential,25380,56105,0,81485
140447600400000,NE 118,Residential,25380,51485,0,76865
140447600500000,NE 118,Residential,25380,54629,0,80009
140447600600000,NE 118,Residential,25380,54129,0,79509
140447600700000,NE 118,Residential,25380,57233,0,82613
140447600800000,NE 118,Residential,25380,57516,0,82896
140447600900000,NE 118,Residential,25380,55639,0,81019
140447601000000,NE 118,Residential,25380,53499,0,78879
140447601100000,NE 118,Residential,25380,65232,0,90612
140447601200000,NE 118,Residential,25380,59655,0,85035
140447601300000,NE 118,Residential,25380,53200,0,78580
140447601400000,NE 118,Residential,25380,51633,0,77013
140447601500000,NE 118,Residential,25380,51771,0,77151
140447601600000,NE 118,Residential,25380,51877,0,77257
140447601700000,NE 118,Residential,25380,54312,0,79692
140447601800000,NE 118,Residential,25380,54866,0,80246
140447601900000,NE 118,Residential,25380,53914,0,79294
140447602000000,NE 118,Residential,25380,49952,0,75332
140447602100000,NE 118,Residential,28354,55057,0,83411
140447602200000,NE 118,Residential,28452,78122,0,106574
140447602300000,NE 118,Residential,25380,51704,0,77084
140447602400000,NE 118,Residential,25380,53692,0,79072
140447602500000,NE 118,Residential,25380,58602,0,83982
140447602600000,NE 118,Residential,25380,52595,0,77975
140447602700000,NE 118,Residential,25380,67593,0,92973
140447602800000,NE 118,Residential,25380,53656,0,79036
140447602900000,NE 118,Residential,25380,47356,0,72736
140447603000000,NE 118,Residential,25380,59624,0,85004
140447603100000,NE 118,Residential,25380,52519,0,77899
140447603200000,NE 118,Residential,25380,54104,0,79484
140447603300000,NE 118,Residential,25380,49409,0,74789
140447603400000,NE 118,Residential,25380,51938,0,77318
140447603500000,NE 118,Residential,25380,68905,0,94285
140447603600000,NE 118,Residential,25380,53634,0,79014
140447603700000,NE 118,Residential,25380,55373,0,80753
140447603800000,NE 118,Residential,25380,57133,0,82513
140447603900000,NE 118,Residential,25380,60684,0,86064
140447604000000,NE 118,Residential,25380,65195,0,90575
140447700100000,NE 118,Residential,27069,55813,0,82882
140447700200000,NE 118,Residential,26183,77533,0,103716
140447700300000,NE 118,Residential,25650,57463,0,83113
140447700400000,NE 118,Residential,25650,47954,0,73604
140447700500000,NE 118,Residential,31009,74894,0,105903
140447700600000,NE 118,Residential,25650,82869,0,108519
140447700700000,NE 118,Residential,25650,55522,0,81172
140447700800000,NE 118,Residential,25650,51577,0,77227
140447700900000,NE 118,Residential,25650,57310,0,82960
140447701000000,NE 118,Residential,25650,64077,0,89727
140447701100000,NE 118,Residential,25650,56351,0,82001
140447701200000,NE 118,Residential,25650,54854,0,80504
140447701300000,NE 118,Residential,25650,58599,0,84249
140447701400000,NE 118,Residential,25650,73156,0,98806
140447701500000,NE 118,Residential,25650,57400,0,83050
140447701600000,NE 118,Residential,25650,55991,0,81641
140447701700000,NE 118,Residential,25650,62732,0,88382
140447701800000,NE 118,Residential,25650,51878,0,77528
140447701900000,NE 118,Residential,25650,61199,0,86849
140447702000000,NE 118,Residential,25650,61619,0,87269
140447702100000,NE 118,Residential,26745,81213,0,107958
140447702200000,NE 118,Residential,27667,54760,0,82427
140447702300000,NE 118,Residential,25650,56208,0,81858
140447702400000,NE 118,Residential,25650,52158,0,77808
140447702500000,NE 118,Residential,25650,55292,0,80942
140447702600000,NE 118,Residential,25650,50739,0,76389
140447702700000,NE 118,Residential,25650,46753,0,72403
140447702800000,NE 118,Residential,25650,57262,0,82912
140447702900000,NE 118,Residential,25650,59074,0,84724
140447703000000,NE 118,Residential,25650,43155,0,68805
140447703100000,NE 118,Residential,25650,49790,0,75440
140447703200000,NE 118,Residential,25650,59688,0,85338
140447703300000,NE 118,Residential,25650,50307,0,75957
140447703400000,NE 118,Residential,25650,53365,0,79015
140447703500000,NE 118,Residential,25650,53817,0,79467
140447703600000,NE 118,Residential,25650,53682,0,79332
140447703700000,NE 118,Residential,25650,59556,0,85206
140447703800000,NE 118,Residential,25650,53583,0,79233
140447703900000,NE 118,Residential,26933,54543,0,81476
140447704000000,NE 118,Residential,26505,62315,0,88820
140447800100000,NE 118,Residential,26065,75604,0,101669
140447800200000,NE 118,Residential,37615,82385,0,120000
140447800300000,NE 118,Residential,36408,89928,0,126336
140447800400000,NE 118,Residential,34892,69122,0,104014
140447800500000,NE 118,Residential,34320,72930,0,107250
140447800600000,NE 118,Residential,34530,81007,0,115537
140447800700000,NE 118,Residential,32010,87413,0,119423
140447800800000,E-15 CITY,Exempt,0,0,0,0
140447800900000,NE 118,Residential,34320,80749,0,115069
140447801000000,E-15 CITY,Exempt,0,0,0,0
140447801100000,APTS NE,Commercial,22791,0,124646,147437
140447801200000,NE 118,Residential,25000,0,0,25000
140447801300000,COMM NE,Commercial,152064,0,622332,774396
140447801400000,NE 118,Residential,26734,79604,0,106338
140447801500000,NE 118,Residential,25380,44422,0,69802
140447801600000,NE 118,Residential,25380,61943,0,87323
140447801700000,NE 118,Residential,25380,60722,0,86102
140447801800000,NE 118,Residential,25380,74018,0,99398
140447801900000,NE 118,Residential,25380,56736,0,82116
140447802000000,NE 118,Residential,25380,56902,0,82282
140447802100000,NE 118,Residential,25380,46898,0,72278
140447802200000,NE 118,Residential,25380,54460,0,79840
140447802300000,NE 118,Residential,25380,56416,0,81796
140447802400000,NE 118,Residential,25380,53904,0,79284
140447802500000,NE 118,Residential,25380,49586,0,74966
140447802600000,NE 118,Residential,25380,56500,0,81880
140447802700000,NE 118,Residential,25380,59189,0,84569
140447802800000,E-15 CITY,Exempt,0,0,0,0
140447802900000,NE 118,Residential,26720,78961,0,105681
140447803000000,NE 118,Residential,25380,53570,0,78950
140447803100000,NE 118,Residential,25380,75950,0,101330
140447803200000,NE 118,Residential,25380,68414,0,93794
140447900100000,NE 118,Residential,28600,97468,0,126068
140447900200000,NE 118,Residential,37847,82148,0,119995
140447900300000,NE 118,Residential,34892,75151,0,110043
140447900400000,NE 118,Residential,34892,83804,0,118696
140447900500000,NE 118,Residential,34892,81236,0,116128
140447900600000,NE 118,Residential,34892,129909,0,164801
140447900700000,NE 118,Residential,34892,74741,0,109633
140447900800000,NE 118,Residential,34892,72868,0,107760
140447900900000,NE 118,Residential,34892,79679,0,114571
140447901000000,NE 118,Residential,34892,86459,0,121351
140447901100000,NE 118,Residential,34892,83014,0,117906
140447901201000,COMM NE,Commercial,26460,0,84783,111243
140447901201001,COMM NE,Commercial,26460,0,84783,111243
140447901201002,COMM NE,Commercial,26460,0,84783,111243
140447901201003,COMM NE,Commercial,26460,0,85526,111986
140447901201004,COMM NE,Commercial,34020,0,106488,140508
140447901201005,COMM NE,Commercial,34020,0,106488,140508
140447901201006,COMM NE,Commercial,139860,0,272770,412630
140447901301000,COMM NE,Commercial,26460,0,84532,110992
140447901301001,COMM NE,Commercial,26460,0,83798,110258
140447901301002,COMM NE,Commercial,26460,0,84783,111243
140447901301003,COMM NE,Commercial,26460,0,84783,111243
140447901400000,E-40 CHURCHES,Exempt,369360,0,204004,573364
140447901401000,COMM NE,Commercial,26460,0,81663,108123
140447901401001,COMM NE,Commercial,26460,0,85770,112230
140447901401002,COMM NE,Commercial,26460,0,86642,113102
140447901401003,COMM NE,Commercial,26460,0,87394,113854
140447901500000,APTS NE,Commercial,30261,0,142562,172823
140447901600000,APTS NE,Commercial,15757,0,178914,194671
140447902000000,APTS NE,Commercial,52488,0,717565,770053
140447902100000,APTS NE,Commercial,13122,0,123582,136704
140447902200000,APTS NE,Commercial,17378,0,182463,199841
140448000100000,NE 118,Residential,37480,79268,0,116748
140448000200000,NE 118,Residential,34892,74806,0,109698
140448000300000,NE 118,Residential,34892,91016,0,125908
140448000400000,NE 118,Residential,34892,82807,0,117699
140448000500000,NE 118,Residential,36036,85004,0,121040
140448000600000,NE 118,Residential,33748,85512,0,119260
140448000700000,NE 118,Residential,34892,79126,0,114018
140448000800000,NE 118,Residential,34320,89683,0,124003
140448000900000,NE 118,Residential,29172,60944,0,90116
140448001000000,NE 118,Residential,35510,87616,0,123126
140448001100000,NE 118,Residential,19800,0,0,19800
140510600100000,COMM NE,Commercial,178848,0,238817,417665
140510600200000,COMM NE,Commercial,145152,0,16808,161960
140510600300000,COMM NE,Commercial,148191,0,255784,403975
140510600400000,COMM NE,Commercial,294300,0,230662,524962
140510600501000,COMM NE,Commercial,44280,0,79139,123419
140510600501001,COMM NE,Commercial,30240,0,54909,85149
140510600501002,COMM NE,Commercial,35640,0,64637,100277
140510600501003,COMM NE,Commercial,27540,0,50045,77585
140510600501004,COMM NE,Commercial,35640,0,64637,100277
140510600501005,COMM NE,Commercial,30240,0,54909,85149
140510600501006,COMM NE,Commercial,35640,0,64637,100277
140510600501007,COMM NE,Commercial,30240,0,54909,85149
140510600501008,COMM NE,Commercial,35640,0,64637,100277
140510600501009,COMM NE,Commercial,30240,0,54909,85149
140510600501010,COMM NE,Commercial,35640,0,64637,100277
140510600501011,COMM NE,Commercial,32940,0,59773,92713
140510600501012,COMM NE,Commercial,35640,0,64637,100277
140510600501013,COMM NE,Commercial,30240,0,54909,85149
140510600501014,COMM NE,Commercial,35640,0,67493,103133
140510600501015,COMM NE,Commercial,30240,0,55546,85786
140510600501016,COMM NE,Commercial,35640,0,65389,101029
140510600501017,COMM NE,Commercial,30240,0,54909,85149
140510600501018,COMM NE,Commercial,35640,0,65389,101029
140510600501019,COMM NE,Commercial,30240,0,54909,85149
140510600501020,COMM NE,Commercial,37800,0,65736,103536
140510600501021,COMM NE,Commercial,28080,0,51666,79746
140510600501022,COMM NE,Commercial,32940,0,59773,92713
140510600501023,COMM NE,Commercial,28620,0,52008,80628
140510600501024,COMM NE,Commercial,37260,0,67540,104800
140510600600000,COMM NE,Commercial,590882,0,501905,1092787
140510600700000,COMM NE,Commercial,346157,0,99825,445982
140510600900000,COMM NE,Commercial,579015,0,686693,1265708
140510601000000,COMM NE,Commercial,63102,0,69930,133032
140510601100000,COMM NE,Commercial,672578,0,419376,1091954
140510601200000,COMM NE,Commercial,268489,0,400292,668781
140510601300000,COMM NE,Commercial,243355,0,359432,602787
140512900100000,COMM NE,Commercial,298690,0,456978,755668
140512900200000,COMM NE,Commercial,246695,0,334640,581335
140512900300000,COMM NE,Commercial,323330,0,455732,779062
140512900400000,COMM NE,Commercial,348743,0,461317,810060
140512900500000,COMM NE,Commercial,670647,0,2104888,2775535
140512900900000,COMM NE,Commercial,548705,0,979663,1528368
140512901200000,COMM NE,Commercial,1087659,0,5556325,6643984
140512901300000,COMM NE,Commercial,1688,0,0,1688
140515100300000,COMM NE,Commercial,45842,0,2165,48007
140515100400000,E-40 CHURCHES,Exempt,997002,0,6424132,7421134
140517600300000,COMM NE,Commercial,227961,0,821560,1049521
140517600400000,COMM NE,Commercial,270000,0,465934,735934
140517600500000,COMM NE,Commercial,217259,0,619202,836461
140517600600000,COMM NE,Commercial,128752,0,0,128752
140517600700000,COMM NE,Commercial,101239,0,377431,478670
140517600800000,COMM NE,Commercial,132676,0,0,132676
140517600900000,COMM NE,Commercial,965286,0,3709406,4674692
140517601000000,COMM NE,Commercial,1145858,0,5142144,6288002
140517601100000,COMM NE,Commercial,273567,0,895291,1168858
140517601200000,COMM NE,Commercial,170983,0,0,170983
140520800100000,NE 111,Residential,740,0,0,740
140520800200000,APTS NE,Commercial,105840,0,184183,290023
140520800300000,NE 168,Residential,60000,143581,0,203581
140520800400000,APTS NE,Exempt,73440,0,654665,728105
140520800500000,E-73 LOW RENT HOUSE,Exempt,29527,0,238657,268184
140520900101000,CONDO 500,Residential,5000,41435,0,46435
140520900101001,CONDO 500,Residential,5000,41435,0,46435
140520900101002,CONDO 500,Residential,5000,41435,0,46435
140520900101003,CONDO 500,Residential,5000,41435,0,46435
140520900101004,CONDO 500,Residential,5000,41351,0,46351
140520900101005,CONDO 500,Residential,5000,41351,0,46351
140520900101006,CONDO 500,Residential,5000,41351,0,46351
140520900101007,CONDO 500,Residential,5000,41351,0,46351
140520900201000,CONDO 500,Residential,5000,41435,0,46435
140520900201001,CONDO 500,Residential,5000,41435,0,46435
140520900201002,CONDO 500,Residential,5000,41435,0,46435
140520900201003,CONDO 500,Residential,5000,41435,0,46435
140520900201004,CONDO 500,Residential,5000,41351,0,46351
140520900201005,CONDO 500,Residential,5000,41351,0,46351
140520900201006,CONDO 500,Residential,5000,41351,0,46351
140520900201007,CONDO 500,Residential,5000,41351,0,46351
140520900301000,CONDO 500,Residential,5000,44499,0,49499
140520900301001,CONDO 500,Residential,5000,44499,0,49499
140520900301002,CONDO 500,Residential,5000,44499,0,49499
140520900301003,CONDO 500,Residential,5000,44499,0,49499
140520900301004,CONDO 500,Residential,5000,44415,0,49415
140520900301005,CONDO 500,Residential,5000,44415,0,49415
140520900301006,CONDO 500,Residential,5000,44415,0,49415
140520900301007,CONDO 500,Residential,5000,44415,0,49415
140520900401000,CONDO 500,Residential,5000,44499,0,49499
140520900401001,CONDO 500,Residential,5000,44499,0,49499
140520900401002,CONDO 500,Residential,5000,44499,0,49499
140520900401003,CONDO 500,Residential,5000,44499,0,49499
140520900401004,CONDO 500,Residential,5000,44415,0,49415
140520900401005,CONDO 500,Residential,5000,44415,0,49415
140520900401006,CONDO 500,Residential,5000,44415,0,49415
140520900401007,CONDO 500,Residential,5000,44415,0,49415
140520900501000,CONDO 500,Residential,5000,44499,0,49499
140520900501001,CONDO 500,Residential,5000,44499,0,49499
140520900501002,CONDO 500,Residential,5000,44499,0,49499
140520900501003,CONDO 500,Residential,5000,44499,0,49499
140520900501004,CONDO 500,Residential,5000,44415,0,49415
140520900501005,CONDO 500,Residential,5000,44415,0,49415
140520900501006,CONDO 500,Residential,5000,44415,0,49415
140520900501007,CONDO 500,Residential,5000,44415,0,49415
140520900601000,CONDO 500,Residential,5000,41435,0,46435
140520900601001,CONDO 500,Residential,5000,41435,0,46435
140520900601002,CONDO 500,Residential,5000,41435,0,46435
140520900601003,CONDO 500,Residential,5000,41435,0,46435
140520900601004,CONDO 500,Residential,5000,41351,0,46351
140520900601005,CONDO 500,Residential,5000,41351,0,46351
140520900601006,CONDO 500,Residential,5000,41351,0,46351
140520900601007,CONDO 500,Residential,5000,41351,0,46351
140522700100000,E-40 CHURCHES,Exempt,465264,0,670148,1135412
140522700200000,NE 113,Residential,22563,94157,0,116720
140522700300000,NE 113,Residential,22560,113818,0,136378
140522700400000,NE 113,Residential,22800,109770,0,132570
140522700500000,NE 113,Residential,22800,103663,0,126463
140522700600000,NE 113,Residential,23040,125960,0,149000
140522700700000,NE 113,Residential,22272,98758,0,121030
140522700800000,NE 113,Residential,26214,95706,0,121920
140522700900000,NE 113,Residential,26216,93404,0,119620
140522701000000,NE 113,Residential,22560,87837,0,110397
140522701100000,NE 113,Residential,22560,88356,0,110916
140522701200000,NE 113,Residential,22560,90212,0,112772
140522701300000,NE 113,Residential,24741,88010,0,112751
140522800100000,E-40 CHURCHES,Exempt,494640,0,1928974,2423614
140522800200000,NE 113,Residential,24696,120642,0,145338
140522800300000,NE 113,Residential,24020,106858,0,130878
140522800400000,NE 113,Residential,23775,105224,0,128999
140522800500000,NE 113,Residential,23775,91196,0,114971
140522800600000,NE 113,Residential,23530,112419,0,135949
140522800700000,NE 113,Residential,23530,106277,0,129807
140522800800000,NE 113,Residential,23530,103346,0,126876
140522800900000,NE 113,Residential,24530,130889,0,155419
140522801000000,NE 113,Residential,25868,120608,0,146476
140522801100000,NE 113,Residential,25536,118671,0,144207
140522801200000,NE 113,Residential,23703,101277,0,124980
140522801300000,NE 113,Residential,23530,96619,0,120149
140522801400000,NE 113,Residential,23530,90569,0,114099
140522900100000,NE 113,Residential,23436,108593,0,132029
140522900200000,NE 113,Residential,25380,101869,0,127249
140522900300000,NE 113,Residential,25380,105225,0,130605
140522900400000,NE 113,Residential,22560,90505,0,113065
140522900500000,NE 113,Residential,21933,101349,0,123282
140522900600000,NE 113,Residential,23218,101303,0,124521
140522900700000,NE 113,Residential,22560,99332,0,121892
140522900800000,NE 113,Residential,22560,99013,0,121573
140522900900000,NE 113,Residential,22560,103758,0,126318
140522901000000,NE 113,Residential,22560,101619,0,124179
140522901100000,NE 113,Residential,23436,99485,0,122921
140523000100000,NE 113,Residential,25273,107032,0,132305
140523000200000,NE 113,Residential,24510,109680,0,134190
140523000300000,NE 113,Residential,24510,99907,0,124417
140523000400000,NE 113,Residential,24510,107446,0,131956
140523000500000,NE 113,Residential,24510,98540,0,123050
140523000600000,NE 113,Residential,24510,105243,0,129753
140523000700000,NE 113,Residential,24510,108239,0,132749
140523000800000,NE 113,Residential,26784,105893,0,132677
140523000900000,NE 113,Residential,24735,105310,0,130045
140523001000000,NE 113,Residential,24735,147196,0,171931
140523001100000,NE 113,Residential,27962,94061,0,122023
140523001200000,NE 113,Residential,27789,115301,0,143090
140523001300000,NE 113,Residential,25500,118136,0,143636
140523001400000,NE 113,Residential,25500,114680,0,140180
140523001500000,NE 113,Residential,25500,108069,0,133569
140525100100000,NE 113,Residential,24785,90215,0,115000
140525100200000,NE 113,Residential,22560,95574,0,118134
140525100300000,NE 113,Residential,22560,102239,0,124799
140525100400000,NE 113,Residential,22560,86604,0,109164
140525100500000,NE 113,Residential,22560,101651,0,124211
140525100600000,NE 113,Residential,22560,101615,0,124175
140525100700000,NE 113,Residential,24252,100796,0,125048
140525100800000,NE 113,Residential,24252,94601,0,118853
140525100900000,NE 113,Residential,22560,96389,0,118949
140525101000000,NE 113,Residential,22560,95939,0,118499
140525101100000,NE 113,Residential,22560,100838,0,123398
140525101200000,NE 113,Residential,22560,90762,0,113322
140525101300000,NE 113,Residential,22560,95659,0,118219
140525101400000,NE 113,Residential,24785,101646,0,126431
140525101500000,NE 113,Residential,24741,101963,0,126704
140525101600000,NE 113,Residential,22560,95960,0,118520
140525101700000,NE 113,Residential,22560,108291,0,130851
140525101800000,NE 113,Residential,22560,100927,0,123487
140525101900000,NE 113,Residential,24741,111288,0,136029
140525102000000,NE 113,Residential,24785,116522,0,141307
140525102100000,NE 113,Residential,22560,88668,0,111228
140525102200000,NE 113,Residential,22560,93855,0,116415
140525102300000,NE 113,Residential,22560,92709,0,115269
140525102400000,NE 113,Residential,22560,105404,0,127964
140525102500000,NE 113,Residential,22560,99279,0,121839
140525102600000,NE 113,Residential,24252,106740,0,130992
140525102700000,NE 113,Residential,24252,105280,0,129532
140525102800000,NE 113,Residential,24252,84304,0,108556
140525102900000,NE 113,Residential,24252,92395,0,116647
140525103000000,NE 113,Residential,24252,106948,0,131200
140525103100000,NE 113,Residential,24252,109407,0,133659
140525103200000,NE 113,Residential,23823,113459,0,137282
140525103300000,NE 113,Residential,25305,92867,0,118172
140525103400000,NE 113,Residential,23834,113632,0,137466
140525103500000,NE 113,Residential,24252,93453,0,117705
140525103600000,NE 113,Residential,23562,96277,0,119839
140525200100000,NE 113,Residential,23603,83505,0,107108
140525200200000,NE 113,Residential,22560,102470,0,125030
140525200300000,NE 113,Residential,22560,103454,0,126014
140525200400000,NE 113,Residential,22560,104673,0,127233
140525200500000,NE 113,Residential,22560,98294,0,120854
140525200600000,NE 113,Residential,23039,126867,0,149906
140525200700000,NE 113,Residential,23039,89583,0,112622
140525200800000,NE 113,Residential,22560,103510,0,126070
140525200900000,NE 113,Residential,22560,103398,0,125958
140525201000000,NE 113,Residential,22560,109589,0,132149
140525201100000,NE 113,Residential,22560,105296,0,127856
140525201200000,NE 113,Residential,23603,100612,0,124215
140525300100000,NE 113,Residential,25500,107338,0,132838
140525300200000,NE 113,Residential,25500,92022,0,117522
140525300300000,NE 113,Residential,25500,103897,0,129397
140525300400000,NE 113,Residential,27789,98491,0,126280
140525300500000,NE 113,Residential,27744,115336,0,143080
140525300600000,NE 113,Residential,27393,119080,0,146473
140525300700000,NE 113,Residential,24735,104100,0,128835
140525300800000,NE 113,Residential,24735,93453,0,118188
140525300900000,NE 113,Residential,23280,102770,0,126050
140525301000000,NE 113,Residential,23280,102875,0,126155
140525301100000,NE 113,Residential,23280,100886,0,124166
140525301200000,NE 113,Residential,23346,91499,0,114845
140525301300000,NE 113,Residential,23214,93028,0,116242
140525301400000,NE 113,Residential,25200,116848,0,142048
140525301500000,NE 113,Residential,24000,85083,0,109083
140525301600000,NE 113,Residential,24000,96419,0,120419
140525301700000,NE 113,Residential,24000,89241,0,113241
140525301800000,NE 113,Residential,24000,78881,0,102881
140525301900000,NE 113,Residential,24000,88071,0,112071
140525302000000,NE 113,Residential,24000,86438,0,110438
140525302100000,NE 113,Residential,24000,102106,0,126106
140525302200000,NE 113,Residential,25200,103133,0,128333
140525302300000,NE 113,Residential,24000,97246,0,121246
140525302400000,NE 113,Residential,24600,98250,0,122850
140525302500000,NE 113,Residential,23400,96548,0,119948
140525302600000,NE 113,Residential,24000,73335,0,97335
140525302700000,NE 113,Residential,25862,93176,0,119038
140525302800000,NE 113,Residential,27257,94857,0,122114
140525302900000,NE 113,Residential,27393,98316,0,125709
140525303000000,NE 113,Residential,27853,104145,0,131998
140525303100000,NE 113,Residential,25862,114262,0,140124
140525303200000,NE 113,Residential,24000,100683,0,124683
140525303300000,NE 113,Residential,24000,101375,0,125375
140525303400000,NE 113,Residential,24000,84612,0,108612
140525303500000,NE 113,Residential,24000,113750,0,137750
140525400100000,NE 113,Residential,23530,123325,0,146855
140525400200000,NE 113,Residential,23530,114862,0,138392
140525400300000,NE 113,Residential,23040,104887,0,127927
140525400400000,NE 113,Residential,23309,107403,0,130712
140525400500000,NE 113,Residential,22771,84762,0,107533
140525400600000,NE 113,Residential,23040,122574,0,145614
140525400700000,NE 113,Residential,23040,80684,0,103724
140525400800000,NE 113,Residential,23280,108823,0,132103
140525400900000,NE 113,Residential,23280,108432,0,131712
140525401000000,NE 113,Residential,23280,92448,0,115728
140525500100000,NE 113,Residential,22801,98755,0,121556
140525500200000,NE 113,Residential,23039,105661,0,128700
140525500300000,NE 113,Residential,22861,110042,0,132903
140525500400000,NE 113,Residential,22861,94377,0,117238
140525500500000,NE 113,Residential,23116,103772,0,126888
140525500600000,NE 113,Residential,27141,96040,0,123181
140525500700000,NE 113,Residential,22639,96773,0,119412
140525500800000,NE 113,Residential,23354,115542,0,138896
140525500900000,NE 113,Residential,22800,99062,0,121862
140525600100000,NE 113,Residential,23925,126741,0,150666
140525600200000,NE 113,Residential,24132,123252,0,147384
140525600300000,NE 113,Residential,23206,115882,0,139088
140525600400000,NE 113,Residential,23232,107563,0,130795
140525600500000,NE 113,Residential,24276,123792,0,148068
140525600600000,NE 113,Residential,28187,113238,0,141425
140525600700000,NE 113,Residential,22988,99558,0,122546
140525600800000,NE 113,Residential,22988,110954,0,133942
140525600900000,NE 113,Residential,22988,103011,0,125999
140525601000000,NE 113,Residential,22988,107933,0,130921
140525601100000,NE 113,Residential,22988,106015,0,129003
140525601200000,NE 113,Residential,22988,115829,0,138817
140525601300000,NE 113,Residential,22988,110791,0,133779
140525601400000,NE 113,Residential,23530,104807,0,128337
140525601500000,NE 113,Residential,22988,104335,0,127323
140525601600000,NE 113,Residential,22988,105948,0,128936
140525601700000,NE 113,Residential,22988,122704,0,145692
140525601800000,NE 113,Residential,22988,107148,0,130136
140525601900000,NE 113,Residential,22885,100103,0,122988
140525602000000,NE 113,Residential,24840,109204,0,134044
140525602100000,NE 113,Residential,25222,112198,0,137420
140525602200000,NE 113,Residential,24781,106233,0,131014
140525602300000,NE 113,Residential,24149,97167,0,121316
140525602400000,NE 113,Residential,24411,106016,0,130427
140525602500000,NE 113,Residential,24265,97016,0,121281
140525602600000,NE 113,Residential,24265,119505,0,143770
140525602700000,NE 113,Residential,24265,111297,0,135562
140525602800000,NE 113,Residential,24577,93419,0,117996
140525602900000,NE 113,Residential,24444,93861,0,118305
140525603000000,NE 113,Residential,23775,108020,0,131795
140525603100000,NE 113,Residential,23775,102552,0,126327
140525700100000,NE 113,Residential,24145,163840,0,187985
140525700200000,NE 113,Residential,22560,101083,0,123643
140525700300000,NE 113,Residential,22560,84617,0,107177
140525700400000,NE 113,Residential,22560,103997,0,126557
140525700500000,NE 113,Residential,22560,91680,0,114240
140525700600000,NE 113,Residential,22560,102970,0,125530
140525700700000,NE 113,Residential,22560,105980,0,128540
140525700800000,NE 113,Residential,22560,100466,0,123026
140525700900000,NE 113,Residential,22560,101982,0,124542
140525701000000,NE 113,Residential,22560,99545,0,122105
140525701100000,NE 113,Residential,22560,102663,0,125223
140525701200000,NE 113,Residential,24252,93651,0,117903
140525701300000,NE 113,Residential,23718,96011,0,119729
140525701400000,NE 113,Residential,23775,103802,0,127577
140525701500000,NE 113,Residential,23775,119498,0,143273
140525701600000,NE 113,Residential,24512,108933,0,133445
140525701700000,NE 113,Residential,24250,113639,0,137889
140525701800000,NE 113,Residential,23775,106754,0,130529
140525701900000,NE 113,Residential,23775,116309,0,140084
140525702000000,NE 113,Residential,23775,117996,0,141771
140525702100000,NE 113,Residential,24796,95866,0,120662
140525702200000,NE 113,Residential,27972,95356,0,123328
140525702300000,NE 113,Residential,25600,113532,0,139132
140525702400000,NE 113,Residential,23530,114489,0,138019
140525702500000,NE 113,Residential,23775,105073,0,128848
140525702600000,NE 113,Residential,23775,112494,0,136269
140525702700000,NE 113,Residential,24020,110615,0,134635
140525702800000,NE 113,Residential,24020,142012,0,166032
140525800100000,NE 113,Residential,25250,121277,0,146527
140525800200000,NE 113,Residential,22560,94985,0,117545
140525800300000,NE 113,Residential,22560,95284,0,117844
140525800400000,NE 113,Residential,24064,97799,0,121863
140525800500000,NE 113,Residential,24252,99150,0,123402
140525900200000,NE 113,Residential,24095,102974,0,127069
140525900300000,NE 113,Residential,24016,102337,0,126353
140525900400000,NE 113,Residential,24265,96704,0,120969
140525900500000,NE 113,Residential,24265,98760,0,123025
140525900600000,NE 113,Residential,24265,105892,0,130157
140525900700000,NE 113,Residential,24265,107178,0,131443
140527600100000,COMM NE,Commercial,3363660,0,1747062,5110722
140530100100000,NE 123,Residential,16150,6764,0,22914
140530100200000,NE 123,Residential,25835,97919,0,123754
140530100300000,NE 123,Residential,25542,112378,0,137920
140530100400000,NE 123,Residential,25542,86747,0,112289
140530100500000,NE 123,Residential,25542,100737,0,126279
140530100600000,NE 123,Residential,26390,101324,0,127714
140530100700000,NE 123,Residential,26730,98786,0,125516
140530100800000,NE 123,Residential,26730,106800,0,133530
140530100900000,NE 123,Residential,27263,90866,0,118129
140530101000000,NE 123,Residential,25542,102800,0,128342
140530101100000,NE 123,Residential,25542,110908,0,136450
140530101200000,NE 123,Residential,25542,90992,0,116534
140530101300000,NE 123,Residential,27431,89632,0,117063
140530101400000,NE 123,Residential,36204,105506,0,141710
140530101500000,NE 123,Residential,32783,105238,0,138021
140530101600000,NE 123,Residential,31928,114432,0,146360
140530101700000,NE 123,Residential,31928,96907,0,128835
140530101800000,NE 123,Residential,31928,96010,0,127938
140530101900000,NE 123,Residential,31928,126154,0,158082
140530102000000,NE 123,Residential,31928,100989,0,132917
140530102100000,NE 123,Residential,31928,107579,0,139507
140530102200000,NE 123,Residential,31928,110743,0,142671
140530200100000,NE 123,Residential,26569,97456,0,124025
140530200200000,NE 123,Residential,25800,100477,0,126277
140530200300000,NE 123,Residential,25800,93656,0,119456
140530200400000,NE 123,Residential,25800,102570,0,128370
140530200500000,NE 123,Residential,25800,109622,0,135422
140530200600000,NE 123,Residential,25800,98132,0,123932
140530200700000,NE 123,Residential,25800,104422,0,130222
140530200800000,NE 123,Residential,25800,114336,0,140136
140530200900000,NE 123,Residential,25800,115385,0,141185
140530300100000,NE 123,Residential,26316,85611,0,111927
140530300200000,NE 123,Residential,26790,108260,0,135050
140530300300000,NE 123,Residential,25284,95935,0,121219
140530300400000,NE 123,Residential,26790,113210,0,140000
140530300500000,NE 123,Residential,25490,100499,0,125989
140530300600000,NE 123,Residential,26832,84035,0,110867
140530300700000,NE 123,Residential,25490,97978,0,123468
140530300800000,NE 123,Residential,24544,91859,0,116403
140530300900000,NE 123,Residential,27664,145174,0,172838
140530301000000,NE 123,Residential,25376,129957,0,155333
140530301100000,NE 123,Residential,26874,121461,0,148335
140530301200000,NE 123,Residential,24544,106584,0,131128
140530301300000,NE 123,Residential,28080,111872,0,139952
140530301400000,NE 123,Residential,24752,93123,0,117875
140530301500000,NE 123,Residential,26832,95026,0,121858
140530301600000,NE 123,Residential,26832,118837,0,145669
140530301700000,NE 123,Residential,26832,113088,0,139920
140530301800000,NE 123,Residential,26832,102293,0,129125
140530400100000,NE 123,Residential,27603,97397,0,125000
140530400200000,NE 123,Residential,26574,113553,0,140127
140530400300000,NE 123,Residential,26866,127004,0,153870
140530400400000,NE 123,Residential,26866,115030,0,141896
140530400500000,NE 123,Residential,26866,103570,0,130436
140530400600000,NE 123,Residential,26866,108360,0,135226
140530400700000,NE 123,Residential,26906,121992,0,148898
140530400800000,NE 123,Residential,26664,90306,0,116970
140530400900000,NE 123,Residential,26058,104706,0,130764
140530401000000,NE 123,Residential,26058,98802,0,124860
140530401100000,NE 123,Residential,26058,105260,0,131318
140530401200000,NE 123,Residential,26058,94844,0,120902
140530401300000,NE 123,Residential,26058,105906,0,131964
140530401400000,NE 123,Residential,26058,91670,0,117728
140530401500000,NE 123,Residential,26058,111267,0,137325
140532600100000,NE 123,Residential,24252,123512,0,147764
140532600200000,NE 123,Residential,30723,122482,0,153205
140532600300000,NE 123,Residential,32873,119864,0,152737
140532600400000,NE 123,Residential,25026,118543,0,143569
140532600500000,NE 123,Residential,24820,101550,0,126370
140532600600000,NE 123,Residential,24265,122185,0,146450
140532600700000,NE 123,Residential,27252,123084,0,150336
140532600800000,NE 123,Residential,25407,114985,0,140392
140532600900000,NE 113,Residential,24020,81726,0,105746
140532601000000,NE 113,Residential,23775,103388,0,127163
140532601100000,NE 113,Residential,23530,84136,0,107666
140532601300000,NE 113,Residential,24020,142502,0,166522
140532601400000,NE 123,Residential,36992,207291,0,244283
140532601500000,NE 123,Residential,33399,0,0,33399
140532601600000,NE 123,Residential,25740,0,0,25740
140532601700000,NE 123,Residential,26520,192745,0,219265
140532601800000,NE 123,Residential,27560,0,0,27560
140532601900000,NE 123,Residential,28340,0,0,28340
140532602000000,NE 123,Residential,28860,0,0,28860
140532602100000,NE 123,Residential,29491,0,0,29491
140532602200000,NE 123,Residential,33253,0,0,33253
140532602300000,NE 123,Residential,28653,0,0,28653
140535100100000,E-15 CITY,Exempt,0,0,0,0
140535900100000,NE 113,Residential,23530,93201,0,116731
140537600100000,NE 123,Residential,25800,103894,0,129694
140537600200000,NE 123,Residential,24020,98067,0,122087
140537600300000,NE 123,Residential,26030,98452,0,124482
140537600400000,NE 123,Residential,25800,100190,0,125990
140537600500000,NE 123,Residential,26337,87985,0,114322
140537600600000,NE 123,Residential,27904,109891,0,137795
140537600700000,NE 123,Residential,27904,100947,0,128851
140537600800000,NE 123,Residential,26015,95098,0,121113
140537600900000,NE 123,Residential,25744,103745,0,129489
140537601000000,NE 123,Residential,24956,114272,0,139228
140537601100000,NE 123,Residential,26000,102759,0,128759
140537601200000,NE 123,Residential,25836,88552,0,114388
140537601300000,NE 123,Residential,26154,122210,0,148364
140537601400000,NE 123,Residential,23040,95251,0,118291
140537601500000,NE 123,Residential,23040,115881,0,138921
140537601600000,NE 123,Residential,24576,117830,0,142406
140537601700000,NE 123,Residential,24576,110981,0,135557
140537601800000,NE 123,Residential,24576,100678,0,125254
140537601900000,NE 123,Residential,24576,92531,0,117107
140537602000000,NE 123,Residential,23922,91219,0,115141
140537602100000,NE 123,Residential,10,0,0,10
140537700100000,NE 123,Residential,25168,95125,0,120293
140537700200000,NE 123,Residential,26832,97594,0,124426
140537700300000,NE 123,Residential,26696,95386,0,122082
140537700400000,NE 123,Residential,27090,104640,0,131730
140537700500000,NE 123,Residential,30949,121602,0,152551
140537700600000,NE 123,Residential,28500,126320,0,154820
140537700700000,NE 123,Residential,25800,92760,0,118560
140537700800000,NE 123,Residential,25986,93612,0,119598
140537700900000,NE 123,Residential,25168,123200,0,148368
140537701000000,NE 123,Residential,28652,121472,0,150124
140537800100000,NE 123,Residential,26914,96560,0,123474
140537800200000,NE 123,Residential,26866,111343,0,138209
140537800300000,NE 123,Residential,26600,107821,0,134421
140537800400000,NE 123,Residential,26266,115664,0,141930
140537800500000,NE 123,Residential,26118,100156,0,126274
140537800600000,NE 123,Residential,25992,109974,0,135966
140537800700000,NE 123,Residential,25650,91801,0,117451
140537800800000,NE 123,Residential,24510,119482,0,143992
140537800900000,NE 123,Residential,25591,118927,0,144518
140537801000000,NE 123,Residential,26220,123601,0,149821
140537801100000,NE 123,Residential,26600,103011,0,129611
140537801200000,NE 123,Residential,26600,105164,0,131764
140537801300000,NE 123,Residential,26600,99820,0,126420
140537801400000,NE 123,Residential,26600,103531,0,130131
140537801500000,NE 123,Residential,26600,97880,0,124480
140537801600000,NE 123,Residential,26600,83666,0,110266
140537801700000,NE 123,Residential,26600,109661,0,136261
140537801800000,NE 123,Residential,26600,102722,0,129322
140537801900000,NE 123,Residential,26642,114770,0,141412
140537802000000,NE 123,Residential,24468,81320,0,105788
140537802100000,NE 123,Residential,24510,99974,0,124484
140537802200000,NE 123,Residential,24510,102878,0,127388
140537802300000,NE 123,Residential,24510,96256,0,120766
140537802400000,NE 123,Residential,24510,89923,0,114433
140537802500000,NE 123,Residential,24510,114675,0,139185
140537802600000,NE 123,Residential,24510,84730,0,109240
140537802700000,NE 123,Residential,24510,86182,0,110692
140537802800000,NE 123,Residential,24130,135294,0,159424
140537802900000,NE 123,Residential,24130,92862,0,116992
140537803000000,NE 123,Residential,24130,91584,0,115714
140537803100000,NE 123,Residential,24172,109040,0,133212
140537803200000,NE 123,Residential,24510,105476,0,129986
140537803300000,NE 123,Residential,25650,107753,0,133403
140537803400000,NE 123,Residential,25067,103592,0,128659
140537803500000,NE 123,Residential,26582,105170,0,131752
140537803600000,NE 123,Residential,26599,99269,0,125868
140537803700000,NE 123,Residential,28225,103703,0,131928
140537900100000,NE 123,Residential,31928,120410,0,152338
140537900200000,NE 123,Residential,31928,79232,0,111160
140537900300000,NE 123,Residential,33792,112454,0,146246
140537900400000,NE 123,Residential,33120,87912,0,121032
140537900500000,NE 123,Residential,32063,116550,0,148613
140537900600000,NE 123,Residential,32952,94213,0,127165
140537900700000,NE 123,Residential,32900,83352,0,116252
140537900800000,NE 123,Residential,32848,120934,0,153782
140537900900000,NE 123,Residential,32900,95747,0,128647
140537901000000,NE 123,Residential,32900,122052,0,154952
140537901100000,NE 123,Residential,32900,93723,0,126623
140537901200000,NE 123,Residential,32900,91099,0,123999
140537901300000,NE 123,Residential,32900,118083,0,150983
140537901400000,NE 123,Residential,32900,106674,0,139574
140537901500000,NE 123,Residential,32900,119218,0,152118
140537901600000,NE 123,Residential,32900,111637,0,144537
140537901700000,NE 123,Residential,30080,101522,0,131602
140537901800000,NE 123,Residential,33983,101907,0,135890
140538000100000,NE 123,Residential,5,0,0,5
140538000200000,NE 123,Residential,25737,89102,0,114839
140538000300000,NE 123,Residential,25568,136676,0,162244
140538000400000,NE 123,Residential,24440,115750,0,140190
140538000500000,NE 123,Residential,26696,116158,0,142854
140538000600000,NE 123,Residential,25568,108880,0,134448
140538000700000,NE 123,Residential,25651,113406,0,139057
140538000800000,NE 123,Residential,26655,106476,0,133131
140538000900000,NE 123,Residential,24252,101366,0,125618
140538001000000,NE 123,Residential,24252,109491,0,133743
140538001100000,NE 123,Residential,24252,107391,0,131643
140538001200000,NE 123,Residential,24252,88700,0,112952
140538001300000,NE 123,Residential,24252,101592,0,125844
140538001400000,NE 123,Residential,24252,107771,0,132023
140538001500000,NE 123,Residential,24252,107578,0,131830
140538001600000,NE 123,Residential,24293,99297,0,123590
140538001700000,NE 123,Exempt,26235,0,99285,125520
140538001800000,E-40 CHURCHES,Exempt,480600,0,191338,671938
140540100100000,NE 123,Residential,29029,82449,0,111478
140540100200000,NE 123,Residential,19866,79396,0,99262
140540100300000,NE 123,Residential,26488,95504,0,121992
140540100400000,NE 123,Residential,28195,114298,0,142493
140540100500000,NE 123,Residential,24151,95551,0,119702
140540100600000,NE 123,Residential,27300,97283,0,124583
140540200100000,E-15 CITY,Exempt,0,0,0,0
140540200200000,NE 123,Residential,26585,109059,0,135644
140540200300000,NE 123,Residential,25370,106825,0,132195
140540200400000,NE 123,Exempt,25542,111445,0,136987
140540200500000,NE 123,Residential,25542,125084,0,150626
140540200600000,NE 123,Residential,25542,117089,0,142631
140540200700000,NE 123,Residential,25542,114667,0,140209
140540200800000,NE 123,Residential,25542,118794,0,144336
140540200900000,NE 123,Residential,25542,106660,0,132202
140540201000000,NE 123,Residential,25542,103457,0,128999
140540201100000,NE 123,Residential,25542,94371,0,119913
140540201200000,NE 123,Residential,23562,113857,0,137419
140540201300000,NE 123,Residential,26146,117955,0,144101
140540201400000,NE 123,Residential,25202,127268,0,152470
140540300100000,NE 123,Residential,28160,123275,0,151435
140540300200000,NE 123,Residential,29376,104991,0,134367
140540300300000,NE 123,Residential,28560,123876,0,152436
140540300400000,NE 123,Residential,28560,74342,0,102902
140540300500000,NE 123,Residential,28560,112705,0,141265
140540300600000,NE 123,Residential,27948,102470,0,130418
140540300700000,NE 123,Residential,26316,100096,0,126412
140540300800000,NE 123,Residential,26316,120637,0,146953
140540400100000,NE 123,Residential,26389,105433,0,131822
140540400200000,NE 123,Residential,19305,97671,0,116976
140540400300000,NE 123,Residential,19305,99327,0,118632
140540400400000,NE 123,Residential,19305,109508,0,128813
140540400500000,NE 123,Residential,19305,92090,0,111395
140540400600000,NE 123,Residential,19305,83995,0,103300
140540400700000,NE 123,Residential,19305,107902,0,127207
140540400800000,NE 123,Residential,19305,89620,0,108925
140540400900000,NE 123,Residential,19305,105251,0,124556
140540401000000,NE 123,Residential,19305,98882,0,118187
140540401100000,NE 123,Residential,25542,104077,0,129619
140540401200000,NE 123,Residential,25542,119018,0,144560
140540401300000,NE 123,Residential,27086,94748,0,121834
140540401400000,NE 123,Residential,27086,99807,0,126893
140540401500000,NE 123,Residential,27086,110564,0,137650
140540401600000,NE 123,Residential,27086,108769,0,135855
140540401700000,NE 123,Residential,26334,94831,0,121165
140540500100000,NE 123,Residential,26792,107430,0,134222
140540500200000,NE 123,Residential,26023,93032,0,119055
140540500300000,NE 123,Residential,25800,101748,0,127548
140540500400000,NE 123,Residential,25800,108579,0,134379
140540500500000,NE 123,Residential,25800,97872,0,123672
140540500600000,NE 123,Residential,25800,86859,0,112659
140540500700000,NE 123,Residential,25800,119573,0,145373
140540500800000,NE 123,Residential,25800,106559,0,132359
140540500900000,NE 123,Residential,25800,89001,0,114801
140540501000000,NE 123,Residential,25800,99712,0,125512
140540501100000,NE 123,Residential,25800,101411,0,127211
140540501200000,NE 123,Residential,25800,119680,0,145480
140540501300000,NE 123,Residential,25556,114871,0,140427
140542600101000,CONDO 503,Residential,15000,115540,0,130540
140542600101001,CONDO 503,Residential,12000,106646,0,118646
140542600101002,CONDO 503,Residential,15000,109683,0,124683
140542600101003,CONDO 503,Residential,12000,95982,0,107982
140542600101004,CONDO 503,Residential,15000,115387,0,130387
140542600101005,CONDO 503,Residential,12000,99201,0,111201
140542600101006,CONDO 503,Residential,15000,104893,0,119893
140542600101007,CONDO 503,Residential,12000,96588,0,108588
140542600101008,CONDO 503,Residential,15000,115053,0,130053
140542600101009,CONDO 503,Residential,12000,107378,0,119378
140542600101010,CONDO 503,Residential,15000,105759,0,120759
140542600101011,CONDO 503,Residential,12000,95982,0,107982
140542600101012,CONDO 503,Residential,15000,114329,0,129329
140542600101013,CONDO 503,Residential,12000,107471,0,119471
140542600101014,CONDO 503,Residential,15000,107386,0,122386
140542600101015,CONDO 503,Residential,12000,91972,0,103972
140542600101016,CONDO 503,Residential,15000,115002,0,130002
140542600101017,CONDO 503,Residential,12000,100144,0,112144
140542600101018,CONDO 503,Residential,15000,102520,0,117520
140542600101019,CONDO 503,Residential,12000,91972,0,103972
140542600101020,CONDO 503,Residential,15000,107922,0,122922
140542600101021,CONDO 503,Residential,12000,100817,0,112817
140542600101022,CONDO 503,Residential,15000,104100,0,119100
140542600101023,CONDO 503,Residential,12000,91972,0,103972
140542600201000,CONDO 503,Residential,15000,114172,0,129172
140542600201001,CONDO 503,Residential,12000,99109,0,111109
140542600201002,CONDO 503,Residential,15000,100842,0,115842
140542600201003,CONDO 503,Residential,12000,91085,0,103085
140542600201004,CONDO 503,Residential,15000,117104,0,132104
140542600201005,CONDO 503,Residential,12000,99109,0,111109
140542600201006,CONDO 503,Residential,15000,100842,0,115842
140542600201007,CONDO 503,Residential,12000,94972,0,106972
140542600201008,CONDO 503,Residential,15000,113506,0,128506
140542600201009,CONDO 503,Residential,12000,99109,0,111109
140542600201010,CONDO 503,Residential,15000,107985,0,122985
140542600201011,CONDO 503,Residential,12000,91085,0,103085
140542600201012,CONDO 503,Residential,15000,108538,0,123538
140542600201013,CONDO 503,Residential,12000,107320,0,119320
140542600201014,CONDO 503,Residential,15000,101915,0,116915
140542600201015,CONDO 503,Residential,12000,96588,0,108588
140542600201016,CONDO 503,Residential,15000,107826,0,122826
140542600201017,CONDO 503,Residential,12000,106646,0,118646
140542600201018,CONDO 503,Residential,15000,105759,0,120759
140542600201019,CONDO 503,Residential,12000,92055,0,104055
140542700101000,CONDO 503,Residential,15000,110000,0,125000
140542700101001,CONDO 503,Residential,12000,109724,0,121724
140542700101002,CONDO 503,Residential,15000,110542,0,125542
140542700101003,CONDO 503,Residential,12000,92139,0,104139
140542700101004,CONDO 503,Residential,15000,115258,0,130258
140542700101005,CONDO 503,Residential,12000,107378,0,119378
140542700101006,CONDO 503,Residential,15000,106364,0,121364
140542700101007,CONDO 503,Residential,12000,95982,0,107982
140542700201000,CONDO 503,Residential,13000,113506,0,126506
140542700201001,CONDO 503,Residential,11000,103633,0,114633
140542700201002,CONDO 503,Residential,14000,100924,0,114924
140542700201003,CONDO 503,Residential,11000,91085,0,102085
140542700201004,CONDO 503,Residential,13000,113791,0,126791
140542700201005,CONDO 503,Residential,11000,106190,0,117190
140542700201006,CONDO 503,Residential,14000,103543,0,117543
140542700201007,CONDO 503,Residential,11000,91168,0,102168
140542700301000,CONDO 503,Residential,13000,112845,0,125845
140542700301001,CONDO 503,Residential,11000,104401,0,115401
140542700301002,CONDO 503,Residential,14000,99606,0,113606
140542700301003,CONDO 503,Residential,11000,93961,0,104961
140542700301004,CONDO 503,Residential,13000,105594,0,118594
140542700301005,CONDO 503,Residential,11000,102531,0,113531
140542700301006,CONDO 503,Residential,14000,99606,0,113606
140542700301007,CONDO 503,Residential,11000,90199,0,101199
140542800101000,CONDO 503,Residential,13000,114425,0,127425
140542800101001,CONDO 503,Residential,11000,106507,0,117507
140542800101002,CONDO 503,Residential,14000,106364,0,120364
140542800101003,CONDO 503,Residential,11000,88779,0,99779
140542800200000,NE 125,Residential,29664,196717,0,226381
140542800300000,NE 125,Residential,25298,187162,0,212460
140542800400000,NE 125,Residential,24174,216001,0,240175
140542800500000,NE 125,Residential,23256,169244,0,192500
140542800600000,NE 125,Residential,22950,187532,0,210482
140542800700000,NE 125,Residential,23256,185197,0,208453
140542800800000,NE 125,Residential,22950,198846,0,221796
140542800900000,NE 125,Residential,22950,179525,0,202475
140542801000000,NE 125,Residential,23256,212163,0,235419
140542801101000,CONDO 503,Residential,13000,113791,0,126791
140542801101001,CONDO 503,Residential,11000,105524,0,116524
140542801101002,CONDO 503,Residential,14000,102943,0,116943
140542801101003,CONDO 503,Residential,11000,96583,0,107583
140542801101004,CONDO 503,Residential,13000,113506,0,126506
140542801101005,CONDO 503,Residential,11000,99109,0,110109
140542801101006,CONDO 503,Residential,14000,107729,0,121729
140542801101007,CONDO 503,Residential,11000,91686,0,102686
140542801101008,CONDO 503,Residential,13000,106691,0,119691
140542801101009,CONDO 503,Residential,11000,99109,0,110109
140542801101010,CONDO 503,Residential,14000,103762,0,117762
140542801101011,CONDO 503,Residential,11000,91085,0,102085
140542801101012,CONDO 503,Residential,13000,106592,0,119592
140542801101013,CONDO 503,Residential,11000,98055,0,109055
140542801101014,CONDO 503,Residential,14000,100362,0,114362
140542801101015,CONDO 503,Residential,11000,90117,0,101117
140542801201000,CONDO 503,Residential,13000,112374,0,125374
140542801201001,CONDO 503,Residential,11000,98055,0,109055
140542801201002,CONDO 503,Residential,14000,106809,0,120809
140542801201003,CONDO 503,Residential,11000,92278,0,103278
140542801301000,CONDO 503,Residential,13000,114172,0,127172
140542801301001,CONDO 503,Residential,11000,99109,0,110109
140542801301002,CONDO 503,Residential,14000,105245,0,119245
140542801301003,CONDO 503,Residential,11000,91168,0,102168
140542801301004,CONDO 503,Residential,13000,106095,0,119095
140542801301005,CONDO 503,Residential,11000,99776,0,110776
140542801301006,CONDO 503,Residential,14000,106855,0,120855
140542801301007,CONDO 503,Residential,11000,91085,0,102085
140542801401000,CONDO 503,Residential,13000,114172,0,127172
140542801401001,CONDO 503,Residential,11000,99684,0,110684
140542801401002,CONDO 503,Residential,14000,102790,0,116790
140542801401003,CONDO 503,Residential,11000,96354,0,107354
140542801401004,CONDO 503,Residential,13000,107395,0,120395
140542801401005,CONDO 503,Residential,11000,103633,0,114633
140542801401006,CONDO 503,Residential,14000,103543,0,117543
140542801401007,CONDO 503,Residential,11000,91085,0,102085
140542801401008,CONDO 503,Residential,13000,111234,0,124234
140542801401009,CONDO 503,Residential,11000,104299,0,115299
140542801401010,CONDO 503,Residential,14000,101441,0,115441
140542801401011,CONDO 503,Residential,11000,94972,0,105972
140542801401012,CONDO 503,Residential,13000,113354,0,126354
140542801401013,CONDO 503,Residential,11000,103633,0,114633
140542801401014,CONDO 503,Residential,14000,101277,0,115277
140542801401015,CONDO 503,Residential,11000,91085,0,102085
140542801401016,CONDO 503,Residential,13000,118233,0,131233
140542801401017,CONDO 503,Residential,11000,99776,0,110776
140542801401018,CONDO 503,Residential,14000,104645,0,118645
140542801401019,CONDO 503,Residential,11000,91686,0,102686
140542900100000,NE 125,Residential,25075,205543,0,230618
140542900200000,NE 125,Residential,23280,192430,0,215710
140542900300000,NE 125,Residential,25143,200244,0,225387
140542900400000,NE 125,Residential,22758,164316,0,187074
140542900500000,NE 125,Residential,21600,139102,0,160702
140542900600000,NE 125,Residential,23700,174282,0,197982
140542900700000,NE 125,Residential,22200,165223,0,187423
140542900800000,NE 125,Residential,21600,159722,0,181322
140542900900000,NE 125,Residential,23700,203882,0,227582
140542901000000,NE 125,Residential,22200,172117,0,194317
140542901100000,NE 125,Residential,24000,184423,0,208423
140542901200000,NE 125,Residential,24000,179723,0,203723
140542901300000,NE 125,Residential,22800,169945,0,192745
140542901400000,NE 125,Residential,22800,204270,0,227070
140542901500000,NE 125,Residential,24000,187557,0,211557
140542901600000,NE 125,Residential,22800,187322,0,210122
140542901700000,NE 125,Residential,23632,268912,0,292544
140543000100000,NE 125,Residential,27173,178630,0,205803
140543000200000,NE 125,Residential,24385,179989,0,204374
140543000300000,NE 125,Residential,24480,167455,0,191935
140543000400000,NE 125,Residential,24480,176771,0,201251
140543000500000,NE 125,Residential,24480,158751,0,183231
140543000600000,NE 125,Residential,24480,143922,0,168402
140543000700000,NE 125,Residential,24480,186270,0,210750
140545100101000,CONDO 503,Residential,13000,110428,0,123428
140545100101001,CONDO 503,Residential,11000,103190,0,114190
140545100101002,CONDO 503,Residential,14000,102883,0,116883
140545100101003,CONDO 503,Residential,11000,90199,0,101199
140545100101004,CONDO 503,Residential,13000,111922,0,124922
140545100101005,CONDO 503,Residential,11000,104401,0,115401
140545100101006,CONDO 503,Residential,14000,104124,0,118124
140545100101007,CONDO 503,Residential,11000,93961,0,104961
140545100201000,CONDO 503,Residential,13000,109867,0,122867
140545100201001,CONDO 503,Residential,11000,100322,0,111322
140545100201002,CONDO 503,Residential,14000,98535,0,112535
140545100201003,CONDO 503,Residential,11000,88827,0,99827
140545100201004,CONDO 503,Residential,13000,112957,0,125957
140545100201005,CONDO 503,Residential,11000,97980,0,108980
140545100201006,CONDO 503,Residential,14000,101848,0,115848
140545100201007,CONDO 503,Residential,11000,89978,0,100978
140545100201008,CONDO 503,Residential,13000,111005,0,124005
140545100201009,CONDO 503,Residential,11000,88859,0,99859
140545100201010,CONDO 503,Residential,14000,104899,0,118899
140545100201011,CONDO 503,Residential,11000,90792,0,101792
140545100201012,CONDO 503,Residential,13000,109599,0,122599
140545100201013,CONDO 503,Residential,11000,104512,0,115512
140545100201014,CONDO 503,Residential,14000,104124,0,118124
140545100201015,CONDO 503,Residential,11000,94413,0,105413
140545100300000,E-40 CHURCHES,Exempt,461376,0,1250925,1712301
140545200101000,CONDO 503,Residential,13000,113178,0,126178
140545200101001,CONDO 503,Residential,11000,105061,0,116061
140545200101002,CONDO 503,Residential,14000,103532,0,117532
140545200101003,CONDO 503,Residential,11000,92278,0,103278
140545200101004,CONDO 503,Residential,13000,112957,0,125957
140545200101005,CONDO 503,Residential,11000,104401,0,115401
140545200101006,CONDO 503,Residential,14000,102657,0,116657
140545200101007,CONDO 503,Residential,11000,90199,0,101199
140545200101008,CONDO 503,Residential,13000,112299,0,125299
140545200101009,CONDO 503,Residential,11000,102531,0,113531
140545200101010,CONDO 503,Residential,14000,101848,0,115848
140545200101011,CONDO 503,Residential,11000,92278,0,103278
140545200101012,CONDO 503,Residential,13000,106127,0,119127
140545200101013,CONDO 503,Residential,11000,98623,0,109623
140545200101014,CONDO 503,Residential,14000,100199,0,114199
140545200101015,CONDO 503,Residential,11000,90117,0,101117
140545200101016,CONDO 503,Residential,13000,106216,0,119216
140545200101017,CONDO 503,Residential,11000,103328,0,114328
140545200101018,CONDO 503,Residential,14000,99606,0,113606
140545200101019,CONDO 503,Residential,11000,93394,0,104394
140545200101020,CONDO 503,Residential,13000,111922,0,124922
140545200101021,CONDO 503,Residential,11000,98055,0,109055
140545200101022,CONDO 503,Residential,14000,100199,0,114199
140545200101023,CONDO 503,Residential,11000,93168,0,104168
140545200200000,NE 125,Residential,23939,178759,0,202698
140545200300000,NE 125,Residential,26006,196110,0,222116
140545200400000,NE 125,Residential,25793,196015,0,221808
140545200500000,NE 125,Residential,24371,171940,0,196311
140545200600000,NE 125,Residential,22800,177063,0,199863
140545200700000,NE 125,Residential,26350,140021,0,166371
140545200801000,CONDO 503,Residential,13000,111005,0,124005
140545200801001,CONDO 503,Residential,11000,97980,0,108980
140545200801002,CONDO 503,Residential,14000,104153,0,118153
140545200801003,CONDO 503,Residential,11000,89385,0,100385
140545200801004,CONDO 503,Residential,13000,110464,0,123464
140545200801005,CONDO 503,Residential,11000,97578,0,108578
140545200801006,CONDO 503,Residential,14000,97784,0,111784
140545200801007,CONDO 503,Residential,11000,91348,0,102348
140545200801008,CONDO 503,Residential,13000,110942,0,123942
140545200801009,CONDO 503,Residential,11000,103210,0,114210
140545200801010,CONDO 503,Residential,14000,102419,0,116419
140545200801011,CONDO 503,Residential,11000,89010,0,100010
140545200801012,CONDO 503,Residential,13000,111631,0,124631
140545200801013,CONDO 503,Residential,11000,96925,0,107925
140545200801014,CONDO 503,Residential,14000,103005,0,117005
140545200801015,CONDO 503,Residential,11000,91442,0,102442
140545200901000,CONDO 503,Residential,13000,110258,0,123258
140545200901001,CONDO 503,Residential,11000,102531,0,113531
140545200901002,CONDO 503,Residential,14000,99606,0,113606
140545200901003,CONDO 503,Residential,11000,90199,0,101199
140545200901004,CONDO 503,Residential,13000,112580,0,125580
140545200901005,CONDO 503,Residential,11000,105061,0,116061
140545200901006,CONDO 503,Residential,14000,104124,0,118124
140545200901007,CONDO 503,Residential,11000,93250,0,104250
140545300100000,NE 125,Residential,25650,221159,0,246809
140545300200000,NE 125,Residential,25650,172919,0,198569
140545400100000,NE 125,Residential,24480,166072,0,190552
140545400200000,NE 125,Residential,24480,144353,0,168833
140545400300000,NE 125,Residential,23856,167784,0,191640
140545400400000,NE 125,Residential,25725,179668,0,205393
140545400500000,NE 125,Residential,26468,170052,0,196520
140545400600000,NE 125,Residential,25288,159535,0,184823
140545400700000,NE 125,Residential,23837,150612,0,174449
140545400800000,NE 125,Residential,26177,223863,0,250040
140545400900000,NE 125,Residential,25913,204162,0,230075
140545500101000,CONDO 503,Residential,13000,107625,0,120625
140545500101001,CONDO 503,Residential,11000,100186,0,111186
140545500101002,CONDO 503,Residential,14000,100317,0,114317
140545500101003,CONDO 503,Residential,11000,91442,0,102442
140545500101004,CONDO 503,Residential,13000,105030,0,118030
140545500101005,CONDO 503,Residential,11000,96925,0,107925
140545500101006,CONDO 503,Residential,14000,97784,0,111784
140545500101007,CONDO 503,Residential,11000,91442,0,102442
140545500101008,CONDO 503,Residential,13000,110308,0,123308
140545500101009,CONDO 503,Residential,11000,101546,0,112546
140545500101010,CONDO 503,Residential,14000,105661,0,119661
140545500101011,CONDO 503,Residential,11000,91286,0,102286
140545500101012,CONDO 503,Residential,13000,108786,0,121786
140545500101013,CONDO 503,Residential,11000,101105,0,112105
140545500101014,CONDO 503,Residential,14000,103005,0,117005
140545500101015,CONDO 503,Residential,11000,96997,0,107997
140545500101016,CONDO 503,Residential,13000,108650,0,121650
140545500101017,CONDO 503,Residential,11000,101353,0,112353
140545500101018,CONDO 503,Residential,14000,102877,0,116877
140545500101019,CONDO 503,Residential,11000,94527,0,105527
140545500200000,E-40 CHURCHES,Exempt,572400,0,2028898,2601298
140545600101000,CONDO 503,Residential,13000,109346,0,122346
140545600101001,CONDO 503,Residential,11000,100031,0,111031
140545600101002,CONDO 503,Residential,14000,101389,0,115389
140545600101003,CONDO 503,Residential,11000,88424,0,99424
140545600101004,CONDO 503,Residential,13000,108955,0,121955
140545600101005,CONDO 503,Residential,11000,97136,0,108136
140545600101006,CONDO 503,Residential,14000,99971,0,113971
140545600101007,CONDO 503,Residential,11000,92252,0,103252
140545600101008,CONDO 503,Residential,13000,111613,0,124613
140545600101009,CONDO 503,Residential,11000,105996,0,116996
140545600101010,CONDO 503,Residential,14000,103005,0,117005
140545600101011,CONDO 503,Residential,11000,91845,0,102845
140545600101012,CONDO 503,Residential,13000,106691,0,119691
140545600101013,CONDO 503,Residential,11000,105175,0,116175
140545600101014,CONDO 503,Residential,14000,104645,0,118645
140545600101015,CONDO 503,Residential,11000,92516,0,103516
140547600100000,NE 123,Residential,26316,113907,0,140223
140547600200000,NE 123,Residential,26316,93301,0,119617
140547600300000,NE 123,Residential,26316,117907,0,144223
140547600400000,NE 123,Residential,26316,117652,0,143968
140547600500000,NE 123,Residential,26316,116183,0,142499
140547600600000,NE 123,Residential,26316,107809,0,134125
140547600700000,NE 123,Residential,26316,102275,0,128591
140547600800000,NE 123,Residential,29249,98719,0,127968
140547600900000,NE 123,Residential,29718,103880,0,133598
140547601000000,NE 123,Residential,28682,105050,0,133732
140547601100000,NE 123,Residential,25628,105336,0,130964
140547601200000,NE 123,Exempt,26880,390,108924,136194
140547601300000,NE 123,Residential,26880,97132,0,124012
140547601400000,E-15 CITY,Exempt,0,0,0,0
140547601500000,E-40 CHURCHES,Exempt,473472,0,1392792,1866264
140547601600000,Empty,Exempt,0,0,0,0
140547700100000,NE 123,Residential,25740,110421,0,136161
140547700200000,NE 123,Residential,19305,121239,0,140544
140547700300000,NE 123,Residential,19157,95908,0,115065
140547700400000,NE 123,Residential,19157,115739,0,134896
140547700500000,NE 123,Residential,19157,88223,0,107380
140547700600000,NE 123,Residential,19157,92687,0,111844
140547700700000,NE 123,Residential,19157,91015,0,110172
140547700800000,NE 123,Residential,19157,85172,0,104329
140547700900000,NE 123,Residential,20196,93795,0,113991
140547701000000,NE 123,Residential,26384,90749,0,117133
140547701100000,NE 123,Residential,25542,103337,0,128879
140547701200000,NE 123,Residential,25542,81548,0,107090
140547701300000,NE 123,Residential,25542,84539,0,110081
140547701400000,NE 123,Residential,25542,94532,0,120074
140547701500000,NE 123,Residential,25542,87360,0,112902
140547701600000,NE 123,Residential,25542,90118,0,115660
140547800100000,Empty,Exempt,0,0,0,0
140610200100000,NE 168,Commercial,523800,0,0,523800
140610200200000,COMM NE,Commercial,523800,0,997614,1521414
140610300100000,COMM NE,Commercial,354780,0,514393,869173
140610300200000,NE 168,Residential,33740,55407,0,89147
140612800100000,E-40 CHURCHES,Exempt,69806,0,36351,106157
140612800200000,NE 168,Residential,76800,0,0,76800
140612800300000,NE 168,Residential,77350,0,0,77350
140612900100000,NE 168,Ag Land,19417,0,0,19417
140612900300000,COMM NE,Commercial,105300,0,229692,334992
140612900400000,NE 168,Residential,78300,170346,0,248646
140612900500000,NE 168,Residential,75825,0,0,75825
140615100100000,NE 168,Ag Dwelling,10020,4134,0,14154
140615200200000,NE 168,Ag Land,16785,0,1925,18710
140615200300000,NE 168,Ag Land,790,0,0,790
140615200400000,E-05 STATE,Exempt,0,0,0,0
140617600100000,NE 168,Ag Land,16201,0,0,16201
140617600300000,COMM NE,Commercial,356400,0,581461,937861
140617600400000,COMM NE,Commercial,526500,0,535167,1061667
140617600500000,NE 168,Commercial,963144,0,5608856,6572000
140617600800000,NE 168,Commercial,302400,0,621117,923517
140617600900000,COMM NE,Commercial,577800,0,1306033,1883833
140617601000000,COMM NE,Commercial,9500,0,22,9522
140617601100000,COMM NE,Commercial,1210,0,0,1210
140617601400000,COMM NE,Commercial,434700,0,0,434700
140617601500000,COMM NE,Commercial,407700,0,308235,715935
140620100200000,NE 168,Ag Dwelling,14209,102213,1416,117838
140620100300000,NE 168,Residential,87150,103408,0,190558
140620100400000,NE 168,Residential,80625,110367,0,190992
140620100500000,NE 168,Residential,40320,99720,0,140040
140620100600000,NE 168,Residential,48799,105721,0,154520
140620100700000,NE 168,Residential,48262,103320,0,151582
140620200100000,NE 168,Residential,64069,85407,0,149476
140620200200000,NE 168,Ag Dwelling,1486,111731,6008,119225
140620200300000,NE 168,Ag Land,2827,0,0,2827
140620200400000,NE 168,Residential,64294,0,0,64294
140620200500000,NE 168,Residential,64294,168515,0,232809
140620200600000,NE 168,Residential,81525,42605,0,124130
140620200700000,NE 168,Residential,68175,133425,0,201600
140620200800000,NE 168,Residential,68175,114211,0,182386
140620300100000,NE 168,Residential,57350,0,0,57350
140620300200000,NE 168,Residential,75975,66839,0,142814
140620300300000,NE 168,Residential,54850,220699,0,275549
140620300400000,NE 168,Residential,52400,150690,0,203090
140622600300000,NE 168,Residential,10350,0,0,10350
140622600400000,NE 160,Residential,2800,0,0,2800
140622600500000,NE 160,Residential,56100,22465,0,78565
140623000100000,NE 160,Residential,40361,161068,0,201429
140623000200000,NE 160,Residential,40626,190237,0,230863
140623100100000,NE 160,Residential,36443,131463,0,167906
140623100200000,NE 160,Residential,35764,132880,0,168644
140623100300000,NE 160,Residential,35764,129356,0,165120
140623100400000,NE 160,Residential,35764,130206,0,165970
140623100500000,NE 160,Residential,35786,124555,0,160341
140623100600000,NE 160,Residential,37920,194710,0,232630
140623100700000,NE 160,Residential,38031,150449,0,188480
140625100100000,NE 168,Ag Land,2282,0,0,2282
140625100200000,NE 168,Residential,2100,0,0,2100
140625200100000,COMM NE,Commercial,467424,0,2409481,2876905
140627600100000,NE 168,Ag Land,18322,0,0,18322
140627600200000,NE 168,Residential,45562,62005,0,107567
140627600300000,E-15 CITY,Exempt,0,0,0,0
140627600400000,COMM NE,Commercial,441936,0,2961221,3403157
140627600500000,COMM NE,Commercial,269568,0,1180432,1450000
140627600600000,COMM NE,Commercial,159840,0,607692,767532
140630100100000,COMM NE,Commercial,241920,0,889356,1131276
140630200100000,COMM NE,Commercial,50868,0,95354,146222
140630200200000,COMM NE,Commercial,583632,0,12310042,12893674
140630200300000,NE 168,Ag Land,6036,0,0,6036
140630200500000,NE 127,Residential,79100,298155,0,377255
140630200600000,NE 127,Residential,85124,336760,0,421884
140630200700000,NE 127,Residential,89107,310893,0,400000
140630200800000,NE 127,Residential,96075,330099,0,426174
140630200900000,NE 127,Residential,78709,342605,0,421314
140630201000000,NE 127,Residential,81270,300266,0,381536
140630201100000,NE 127,Residential,78240,340505,0,418745
140630201200000,NE 127,Residential,81573,338709,0,420282
140630201300000,NE 127,Residential,145,0,0,145
140630201400000,NE 127,Residential,67369,316314,0,383683
140630201500000,NE 127,Residential,67461,303989,0,371450
140630201600000,NE 127,Residential,71035,315563,0,386598
140630201700000,NE 127,Residential,69508,391276,0,460784
140630201800000,NE 127,Residential,67124,324457,0,391581
140630201900000,NE 127,Residential,67238,370622,0,437860
140630202000000,NE 127,Residential,87926,385067,0,472993
140630202100000,NE 127,Residential,67660,405814,0,473474
140630202200000,NE 127,Residential,69536,336656,0,406192
140630202300000,NE 127,Residential,71324,351032,0,422356
140630202400000,NE 127,Residential,50000,0,0,50000
140630202500000,NE 127,Residential,64802,380140,0,444942
140630202600000,NE 127,Residential,60180,374679,0,434859
140630202700000,NE 127,Residential,91825,279647,0,371472
140630300100000,NE 127,Residential,81605,291796,0,373401
140630300200000,NE 127,Residential,91741,306611,0,398352
140630300300000,NE 127,Residential,86205,361272,0,447477
140630300400000,NE 127,Residential,88000,301179,0,389179
140630300500000,NE 127,Residential,96507,359222,0,455729
140630300600000,NE 127,Residential,92215,272481,0,364696
140630300700000,NE 127,Residential,90862,383134,0,473996
140630300800000,NE 127,Residential,109386,413728,0,523114
140630300900000,NE 127,Residential,76868,314848,0,391716
140630301000000,NE 127,Residential,74038,0,0,74038
140632800100000,NE 161,Residential,1493,0,0,1493
140632800200000,NE 161,Residential,45870,239183,0,285053
140632800300000,NE 161,Residential,42500,263967,0,306467
140633000100000,NE 161,Residential,787,0,0,787
140633000200000,NE 161,Residential,47798,229768,0,277566
140635100100000,NE 128,Residential,110981,511657,0,622638
140635100200000,NE 128,Residential,154043,582068,0,736111
140635100300000,NE 128,Residential,154200,727286,0,881486
140635100400000,NE 128,Residential,128346,246654,0,375000
140635100500000,NE 128,Residential,155550,425062,0,580612
140635100600000,NE 128,Residential,152550,411015,0,563565
140635100700000,NE 128,Residential,141770,438319,0,580089
140635100800000,NE 128,Residential,170250,655643,0,825893
140635100900000,NE 128,Residential,148509,399535,0,548044
140635101000000,NE 128,Residential,113430,326790,0,440220
140635101100000,NE 128,Residential,154350,648632,0,802982
140635101200000,NE 128,Residential,4800,0,0,4800
140635101300000,NE 128,Residential,154800,638660,0,793460
140635101400000,NE 128,Residential,151200,569305,0,720505
140635101500000,NE 128,Residential,113732,572118,0,685850
140635101600000,NE 128,Residential,117720,403280,0,521000
140635101700000,NE 128,Residential,120752,344224,0,464976
140635101800000,NE 128,Residential,155850,404150,0,560000
140635101900000,NE 128,Residential,156900,479800,0,636700
140635102000000,NE 128,Residential,143999,404409,0,548408
140635102100000,NE 128,Residential,156392,452659,0,609051
140635102200000,NE 128,Residential,114829,495599,0,610428
140635102300000,NE 128,Residential,68963,173917,0,242880
140635102400000,NE 128,Residential,69414,132255,0,201669
140635102500000,NE 128,Residential,59840,195609,0,255449
140635102600000,NE 128,Residential,68889,83628,0,152517
140635200100000,NE 128,Residential,141114,258886,0,400000
140635200200000,NE 128,Residential,143943,639423,0,783366
140635200400000,NE 128,Residential,38619,6526,0,45145
140635200500000,NE 128,Residential,38619,70349,0,108968
140635200600000,NE 128,Residential,54332,0,0,54332
140635200700000,NE 128,Residential,120487,229513,0,350000
140637600100000,NE 127,Residential,57570,283983,0,341553
140637600200000,NE 127,Residential,57570,283063,0,340633
140637600300000,NE 127,Residential,57570,280736,0,338306
140637600400000,NE 127,Residential,57570,253273,0,310843
140637600500000,NE 127,Residential,72720,317409,0,390129
140637600600000,NE 127,Residential,64387,223568,0,287955
140637600700000,NE 127,Residential,60600,273919,0,334519
140637600800000,NE 127,Residential,68691,256309,0,325000
140637600900000,NE 127,Residential,65426,245099,0,310525
140637601000000,NE 127,Residential,65484,256004,0,321488
140637601100000,NE 127,Residential,71162,301935,0,373097
140637601200000,NE 127,Residential,65510,249699,0,315209
140637601300000,NE 127,Residential,59500,226639,0,286139
140637601400000,NE 127,Residential,62849,290203,0,353052
140637601500000,NE 127,Residential,66553,340613,0,407166
140637601600000,NE 127,Residential,65313,342120,0,407433
140637601700000,NE 127,Residential,101000,366756,0,467756
140637601800000,NE 127,Residential,95918,297477,0,393395
140637601900000,NE 127,Residential,88873,217308,0,306181
140637602000000,NE 127,Residential,115700,162736,0,278436
140637602100000,NE 127,Residential,110500,157662,0,268162
140637602200000,NE 127,Residential,100600,207247,0,307847
140637602300000,NE 127,Residential,74800,97098,0,171898
140637602400000,NE 127,Residential,60250,116966,0,177216
140637602500000,COMM NE,Commercial,146475,0,417983,564458
140637602600000,NE 127,Residential,66680,401468,0,468148
140637602700000,NE 127,Residential,85,0,0,85
140637700100000,NE 127,Residential,76304,192880,0,269184
140637700200000,NE 127,Residential,80199,251801,0,332000
140637800100000,NE 127,Residential,79683,288436,0,368119
140637800200000,NE 127,Residential,80109,354964,0,435073
140637800300000,NE 127,Residential,79490,226850,0,306340
140637800400000,NE 127,Residential,78540,363185,0,441725
140637800500000,NE 127,Residential,78540,340538,0,419078
140637800600000,NE 127,Residential,101795,247788,0,349583
140637800700000,NE 127,Residential,73920,212233,0,286153
140637800800000,NE 127,Residential,69942,286344,0,356286
140637800900000,NE 127,Residential,71832,282618,0,354450
140637801000000,NE 127,Residential,73092,189409,0,262501
140637801100000,NE 127,Residential,68363,261157,0,329520
140637801200000,NE 127,Residential,72832,279709,0,352541
140637801300000,NE 127,Residential,74060,173387,0,247447
140637801400000,NE 127,Residential,69724,266686,0,336410
140637801500000,NE 127,Residential,68782,272053,0,340835
140637801600000,NE 127,Residential,68340,261458,0,329798
140637801700000,NE 127,Residential,70928,290967,0,361895
140637801800000,NE 127,Residential,67575,247111,0,314686
140637801900000,NE 127,Residential,70676,328456,0,399132
140637802000000,NE 127,Residential,72733,423165,0,495898
140642600100000,NE 127,Ag Land,14538,0,0,14538
140642600200000,COMM NE,Commercial,354240,0,845760,1200000
140642700100000,COMM NE,Commercial,347976,0,17852024,18200000
140645100100000,COMM NE,Commercial,1046952,0,10833816,11880768
140645100200000,COMM NE,Commercial,84888,0,95722,180610
140645100300000,COMM NE,Commercial,21384,0,4956260,4977644
140710100100000,COMM NE,Commercial,292032,0,557968,850000
140710100200000,COMM NE,Commercial,267840,0,410122,677962
140710100300000,COMM NE,Commercial,307800,0,849181,1156981
140710100400000,COMM NE,Commercial,191160,0,903026,1094186
140710100500000,COMM NE,Commercial,445878,0,1446689,1892567
140710100600000,COMM NE,Commercial,39690,0,58596,98286
140710100700000,COMM NE,Commercial,171720,0,675338,847058
140710100800000,COMM NE,Commercial,84672,0,293506,378178
140710100900000,COMM NE,Commercial,76608,0,220789,297397
140710101000000,COMM NE,Commercial,317520,0,606514,924034
140710101001000,COMM NE,Commercial,124200,0,533450,657650
140710101001001,COMM NE,Commercial,124200,0,574868,699068
140710200100000,COMM NE,Commercial,948834,0,0,948834
140710200200000,COMM NE,Commercial,274752,0,857575,1132327
140710200300000,COMM NE,Commercial,117126,0,385549,502675
140710200400000,COMM NE,Commercial,127818,0,310764,438582
140710300100000,COMM NE,Commercial,309420,0,1050088,1359508
140710300200000,E-60 HOSPITAL,Exempt,170381,0,664203,834584
140710300300000,COMM NE,Commercial,446688,0,1919715,2366403
140712600100000,E-40 CHURCHES,Exempt,680400,0,366917,1047317
140712600200000,NE 140,Residential,48377,90867,0,139244
140712700400000,NE 140,Residential,50150,163019,0,213169
140712700500000,NE 140,Residential,50015,126396,0,176411
140712800700000,NE 140,Residential,44550,130105,0,174655
140712800800000,NE 140,Residential,45450,81413,0,126863
140712800900000,NE 140,Residential,44175,99774,0,143949
140715100700000,NE 140,Residential,45500,173822,0,219322
140715100800000,NE 140,Residential,45500,155511,0,201011
140715300200000,NE 140,Residential,45150,140836,0,185986
140715400100000,COMM NE,Commercial,250031,0,0,250031
140717600100000,COMM NE,Commercial,90407,0,332775,423182
140717600200000,COMM NE,Commercial,97200,0,346173,443373
140717600300000,COMM NE,Commercial,77246,0,358160,435406
140717600600000,COMM NE,Commercial,186300,0,609421,795721
140717600800000,COMM NE,Commercial,62246,0,332736,394982
140717600900000,COMM NE,Commercial,126360,0,16196,142556
140717601001000,CONDO 501,Residential,18000,285104,0,303104
140717601001001,CONDO 501,Residential,18000,283912,0,301912
140717601100000,CONDO 501,Residential,36000,0,0,36000
140717700100000,COMM NE,Commercial,186300,0,509050,695350
140717800100000,COMM NE,Commercial,124092,0,557007,681099
140717800200000,COMM NE,Commercial,452520,0,1017480,1470000
140717900100000,CONDO 501,Residential,26000,282726,0,308726
140717900200000,CONDO 501,Residential,26000,233322,0,259322
140717900300000,CONDO 501,Residential,26000,289415,0,315415
140717900400000,CONDO 501,Residential,26000,223308,0,249308
140717900500000,CONDO 501,Residential,26000,301491,0,327491
140717900600000,CONDO 501,Residential,26000,211533,0,237533
140717900700000,CONDO 501,Residential,26000,201350,0,227350
140717900800000,CONDO 501,Residential,26000,229610,0,255610
140717900900000,NE 138,Residential,73614,0,0,73614
140717901000000,NE 138,Residential,55982,379402,0,435384
140717901100000,NE 138,Residential,77163,312463,0,389626
140717901200000,NE 138,Residential,68508,338009,0,406517
140717901300000,NE 138,Residential,70632,354951,0,425583
140717901400000,NE 138,Residential,80039,331392,0,411431
140718000100000,COMM NE,Commercial,230850,0,528048,758898
140718000400000,COMM NE,Commercial,331560,0,206792,538352
140718000700000,NE 138,Residential,52452,314100,0,366552
140718000800000,NE 138,Residential,51859,0,0,51859
140718000900000,NE 138,Residential,54605,279180,0,333785
140718001000000,COMM NE,Commercial,140940,0,605488,746428
140718001100000,COMM NE,Commercial,453519,0,1075652,1529171
140718001400000,COMM NE,Commercial,264060,0,538179,802239
140718001500000,NE 138,Residential,55000,0,0,55000
140718001600000,NE 138,Residential,74112,286498,0,360610
140720100100000,NE 140,Residential,28950,132781,0,161731
140720100200000,NE 140,Residential,28980,165039,0,194019
140720100300000,NE 140,Residential,29389,145670,0,175059
140720100400000,NE 140,Residential,26780,139790,0,166570
140720100500000,NE 140,Residential,26780,125436,0,152216
140720100600000,NE 140,Residential,26520,141035,0,167555
140720100700000,NE 140,Residential,27200,151137,0,178337
140720100800000,NE 140,Residential,28156,148537,0,176693
140720100900000,NE 140,Residential,28154,144510,0,172664
140720101000000,NE 140,Residential,27820,122458,0,150278
140720101100000,NE 140,Residential,27560,155958,0,183518
140720101200000,NE 140,Residential,32136,184274,0,216410
140720101300000,NE 140,Residential,29952,155048,0,185000
140720101400000,NE 140,Residential,30223,166806,0,197029
140720101500000,NE 140,Residential,30106,156206,0,186312
140720101600000,NE 140,Residential,20929,141260,0,162189
140720101700000,NE 140,Residential,22266,155214,0,177480
140720101800000,NE 140,Residential,19344,143001,0,162345
140720101900000,NE 140,Residential,24779,155181,0,179960
140720102000000,NE 140,Residential,23888,179427,0,203315
140720102100000,NE 140,Residential,2355,0,0,2355
140720102200000,NE 140,Residential,27596,138698,0,166294
140720102300000,NE 140,Residential,22660,152528,0,175188
140720102400000,NE 140,Residential,23540,145385,0,168925
140720102500000,NE 140,Residential,23760,141240,0,165000
140720102600000,NE 140,Residential,23540,170831,0,194371
140720102700000,NE 140,Residential,25060,153671,0,178731
140720102800000,NE 140,Residential,28347,157197,0,185544
140720102900000,NE 140,Residential,28401,175890,0,204291
140720103000000,NE 140,Residential,25900,157198,0,183098
140720103100000,NE 158,Residential,36214,219654,0,255868
140720103200000,NE 158,Residential,34096,245664,0,279760
140720103300000,NE 158,Residential,32640,238267,0,270907
140720103400000,NE 158,Residential,30608,203258,0,233866
140720103500000,NE 158,Residential,31624,230189,0,261813
140720103600000,NE 158,Residential,31624,219215,0,250839
140720103700000,NE 158,Residential,31624,190921,0,222545
140720103800000,NE 158,Residential,31624,196764,0,228388
140720103900000,NE 158,Residential,33136,196953,0,230089
140720104000000,NE 140,Residential,3500,0,0,3500
140720104100000,NE 158,Residential,25678,208361,0,234039
140720104200000,NE 158,Residential,27132,274075,0,301207
140720104300000,NE 158,Residential,25574,223692,0,249266
140720200101000,CONDO 501,Residential,16500,166924,0,183424
140720200101001,CONDO 501,Residential,16500,160116,0,176616
140720200101002,CONDO 501,Residential,16500,125046,0,141546
140720200101003,CONDO 501,Residential,16500,138685,0,155185
140720200101004,CONDO 501,Residential,16500,125234,0,141734
140720200101005,CONDO 501,Residential,16500,154395,0,170895
140720200101006,CONDO 501,Residential,16500,159723,0,176223
140720200101007,CONDO 501,Residential,16500,153500,0,170000
140720200101008,CONDO 501,Residential,16500,151363,0,167863
140720200101009,CONDO 501,Residential,16500,160909,0,177409
140720200101010,CONDO 501,Residential,16500,150950,0,167450
140720200101011,CONDO 501,Residential,16500,174850,0,191350
140720200101012,CONDO 501,Residential,16500,152995,0,169495
140720200101013,CONDO 501,Residential,16500,132819,0,149319
140720200101014,CONDO 501,Residential,16500,150037,0,166537
140720200101015,CONDO 501,Residential,16500,152618,0,169118
140720200101016,CONDO 501,Residential,16500,151734,0,168234
140720200101017,CONDO 501,Residential,16500,142770,0,159270
140720200101018,CONDO 501,Residential,16500,146070,0,162570
140720200101019,CONDO 501,Residential,16500,143490,0,159990
140720200101020,CONDO 501,Residential,16500,154685,0,171185
140720200101021,CONDO 501,Residential,16500,143110,0,159610
140720200101022,CONDO 501,Residential,16500,125046,0,141546
140720200101023,CONDO 501,Residential,16500,151180,0,167680
140720200101024,CONDO 501,Residential,16500,155959,0,172459
140720200101025,CONDO 501,Residential,16500,140622,0,157122
140720200101026,CONDO 501,Residential,16500,143752,0,160252
140720200101027,CONDO 501,Residential,16500,131179,0,147679
140720200101028,CONDO 501,Residential,16500,155866,0,172366
140720200101029,CONDO 501,Residential,16500,149586,0,166086
140720200200000,NE 140,Residential,4400,0,0,4400
140720200300000,NE 140,Residential,16200,129052,0,145252
140720200400000,NE 140,Residential,6720,105036,0,111756
140720200500000,NE 140,Residential,7216,107796,0,115012
140720200600000,NE 140,Residential,7488,116405,0,123893
140720200700000,NE 140,Residential,7296,126201,0,133497
140720200800000,NE 140,Residential,12827,129785,0,142612
140720200900000,NE 140,Residential,4000,0,0,4000
140720201000000,NE 140,Residential,13500,136055,0,149555
140720201100000,NE 140,Residential,6240,98164,0,104404
140720201200000,NE 140,Residential,6952,105038,0,111990
140720201300000,NE 140,Residential,7488,115271,0,122759
140720201400000,NE 140,Residential,7392,123492,0,130884
140720201500000,NE 140,Residential,14040,128200,0,142240
140720201600000,NE 140,Residential,27648,156528,0,184176
140720201700000,NE 140,Residential,27548,153220,0,180768
140720201800000,NE 140,Residential,21120,133803,0,154923
140720201900000,NE 140,Residential,25161,156663,0,181824
140720202000000,NE 140,Residential,21763,136727,0,158490
140720202100000,NE 140,Residential,20253,145138,0,165391
140720202200000,NE 140,Residential,25207,139222,0,164429
140720202300000,NE 140,Residential,23796,146519,0,170315
140720202400000,NE 140,Residential,27412,133673,0,161085
140720202500000,NE 140,Residential,21460,136822,0,158282
140720202600000,NE 140,Residential,25931,131564,0,157495
140720202700000,NE 140,Residential,17712,145262,0,162974
140720202800000,NE 140,Residential,25476,129363,0,154839
140720202900000,NE 140,Residential,25595,161328,0,186923
140720203000000,NE 140,Residential,28043,153215,0,181258
140720203100000,NE 140,Residential,24600,143157,0,167757
140720203200000,NE 140,Residential,27360,149050,0,176410
140720203300000,NE 140,Residential,23040,142893,0,165933
140720203400000,NE 140,Residential,20736,132030,0,152766
140720203500000,NE 140,Residential,22079,146289,0,168368
140720203600000,NE 140,Residential,27309,129308,0,156617
140720203700000,NE 140,Residential,23781,139158,0,162939
140720203800000,NE 140,Residential,23296,126868,0,150164
140720203900000,NE 140,Residential,23040,145382,0,168422
140720204000000,NE 140,Residential,24444,135856,0,160300
140720204100000,NE 140,Residential,22666,132678,0,155344
140720204200000,NE 140,Residential,27904,158047,0,185951
140720204300000,NE 140,Residential,25024,152427,0,177451
140720204400000,NE 158,Residential,20382,204265,0,224647
140720204500000,NE 158,Residential,19280,187534,0,206814
140720204700000,NE 158,Residential,19280,251749,0,271029
140720204800000,NE 158,Residential,19280,235155,0,254435
140720204900000,NE 158,Residential,20389,250542,0,270931
140720205000000,NE 158,Residential,20403,258452,0,278855
140720205100000,NE 158,Residential,19280,216942,0,236222
140720205200000,NE 158,Residential,19280,0,0,19280
140720205300000,NE 158,Residential,19280,264971,0,284251
140720205400000,NE 158,Residential,19280,232220,0,251500
140720205500000,NE 158,Residential,20418,264415,0,284833
140720205600000,NE 158,Residential,27790,280449,0,308239
140720205700000,NE 158,Residential,19280,255897,0,275177
140720205800000,NE 158,Residential,19280,256659,0,275939
140720205900000,NE 158,Residential,27800,266983,0,294783
140720206000000,NE 158,Residential,25696,250296,0,275992
140720206100000,NE 158,Residential,21370,264171,0,285541
140720206200000,NE 158,Residential,25440,218270,0,243710
140720206300000,NE 158,Residential,26282,269150,0,295432
140722600300000,NE 158,Residential,38640,188579,0,227219
140722600400000,NE 158,Residential,39200,157174,0,196374
140722600500000,NE 158,Residential,37620,226788,0,264408
140722600600000,NE 158,Residential,37620,207919,0,245539
140722600700000,NE 158,Residential,37620,200373,0,237993
140722600800000,NE 158,Residential,39600,221671,0,261271
140722600900000,NE 158,Residential,39600,189678,0,229278
140722601000000,NE 158,Residential,39600,214345,0,253945
140722601100000,NE 158,Residential,40392,226053,0,266445
140722601200000,NE 158,Residential,40392,224034,0,264426
140722601300000,NE 158,Residential,40005,208361,0,248366
140722601400000,NE 158,Residential,44512,217924,0,262436
140722601500000,NE 158,Residential,38780,198817,0,237597
140722601600000,NE 158,Residential,31232,0,0,31232
140722601700000,NE 158,Residential,39118,236329,0,275447
140722601800000,NE 158,Residential,37620,205503,0,243123
140722601900000,NE 158,Residential,37620,264914,0,302534
140722602000000,NE 158,Residential,37620,220384,0,258004
140722602100000,NE 158,Residential,37620,227227,0,264847
140722602200000,NE 158,Residential,37620,233457,0,271077
140722602300000,NE 158,Residential,39320,214735,0,254055
140722602400000,NE 158,Residential,33482,192776,0,226258
140722602500000,NE 158,Residential,33482,216711,0,250193
140722602600000,NE 158,Residential,35640,231020,0,266660
140722602700000,NE 158,Residential,32579,0,0,32579
140722602800000,NE 158,Residential,30454,81181,0,111635
140722602900000,NE 158,Residential,1650,0,0,1650
140722603000000,NE 158,Residential,5,0,0,5
140722603100000,NE 158,Residential,34240,146718,0,180958
140722603200000,NE 158,Residential,33863,167810,0,201673
140722603300000,NE 158,Residential,34008,163187,0,197195
140722603400000,NE 158,Residential,34240,177298,0,211538
140722603500000,NE 158,Residential,30940,186951,0,217891
140722603600000,NE 158,Residential,32421,164487,0,196908
140722603700000,NE 158,Residential,1900,0,0,1900
140722603800000,NE 158,Residential,22715,236815,0,259530
140722603900000,NE 158,Residential,23312,239136,0,262448
140722604000000,NE 158,Residential,23312,224685,0,247997
140722604100000,NE 158,Residential,23312,249427,0,272739
140722604200000,NE 158,Residential,23312,245784,0,269096
140722604300000,NE 158,Residential,23312,263884,0,287196
140722604400000,NE 158,Residential,23312,239341,0,262653
140722604500000,NE 158,Residential,23312,271141,0,294453
140722604600000,NE 158,Residential,23312,245163,0,268475
140722604700000,NE 158,Residential,23312,248777,0,272089
140722604800000,NE 158,Residential,23312,248655,0,271967
140722604900000,NE 158,Residential,23312,267052,0,290364
140722605000000,NE 158,Residential,23312,246507,0,269819
140722605100000,NE 158,Residential,22560,238163,0,260723
140722605200000,NE 158,Residential,22016,223264,0,245280
140722605300000,NE 158,Residential,22304,223460,0,245764
140722605400000,NE 158,Residential,25110,231389,0,256499
140722605500000,NE 158,Residential,25608,261623,0,287231
140722605600000,NE 158,Residential,25095,204054,0,229149
140722605700000,NE 158,Residential,25200,252354,0,277554
140722605800000,NE 158,Residential,24304,248368,0,272672
140722700100000,NE 158,Residential,28672,137472,0,166144
140722700200000,NE 158,Residential,33981,184706,0,218687
140722700300000,NE 158,Residential,32400,208026,0,240426
140722700400000,NE 158,Residential,32700,178656,0,211356
140722700500000,NE 158,Residential,32700,211662,0,244362
140722700600000,NE 158,Residential,32700,211138,0,243838
140722700700000,NE 158,Residential,32700,185738,0,218438
140722700800000,NE 158,Residential,37060,180227,0,217287
140722700900000,NE 158,Residential,32400,222600,0,255000
140722701000000,NE 158,Residential,38407,232927,0,271334
140722701100000,NE 158,Residential,39974,243003,0,282977
140722701200000,NE 158,Residential,40320,246792,0,287112
140722701300000,NE 158,Residential,36252,209457,0,245709
140722701400000,NE 158,Residential,34240,192686,0,226926
140722701500000,NE 158,Residential,34560,225632,0,260192
140722701600000,NE 158,Residential,34560,224615,0,259175
140722701700000,NE 158,Residential,34560,234386,0,268946
140722701800000,NE 158,Residential,34560,217120,0,251680
140722701900000,NE 158,Residential,34560,204574,0,239134
140722702000000,NE 158,Residential,35415,201941,0,237356
140722702100000,NE 158,Residential,35418,236966,0,272384
140722702200000,NE 158,Residential,32151,194780,0,226931
140722702300000,NE 158,Residential,32670,213637,0,246307
140722702400000,NE 158,Residential,33796,205038,0,238834
140722702500000,NE 158,Residential,33117,207120,0,240237
140722702600000,NE 158,Residential,34445,182214,0,216659
140722702700000,NE 158,Residential,30796,139082,0,169878
140722702800000,NE 158,Residential,29120,151111,0,180231
140722702900000,NE 158,Residential,29120,143673,0,172793
140722703000000,NE 158,Residential,29120,146680,0,175800
140722703100000,NE 158,Residential,29120,145860,0,174980
140722703200000,NE 158,Residential,29120,134159,0,163279
140722703300000,NE 158,Residential,29120,137032,0,166152
140722703400000,NE 158,Residential,29120,148327,0,177447
140722703500000,NE 158,Residential,29120,118958,0,148078
140722703600000,NE 158,Residential,29120,134890,0,164010
140722800200000,NE 158,Residential,20544,256274,0,276818
140722800300000,NE 158,Residential,20544,0,0,20544
140722800400000,NE 158,Residential,20544,257997,0,278541
140722800500000,NE 158,Residential,20544,222233,0,242777
140722800600000,NE 158,Residential,20544,254373,0,274917
140722800700000,NE 158,Residential,40057,253142,0,293199
140725100100000,NE 158,Residential,27973,161111,0,189084
140725100200000,NE 158,Residential,32400,174702,0,207102
140725100300000,NE 158,Residential,32400,160496,0,192896
140725100400000,NE 158,Residential,32400,186621,0,219021
140725100500000,NE 158,Residential,32400,157437,0,189837
140725100600000,NE 158,Residential,36562,173768,0,210330
140725100700000,NE 158,Residential,34272,160381,0,194653
140725100800000,NE 158,Residential,36687,170517,0,207204
140725100900000,NE 158,Residential,35802,193832,0,229634
140725101000000,NE 158,Residential,39780,169985,0,209765
140725101100000,NE 158,Residential,35802,241447,0,277249
140725101200000,NE 158,Residential,35661,221558,0,257219
140725101300000,NE 158,Residential,32860,212684,0,245544
140725101400000,NE 158,Residential,32855,176488,0,209343
140725101500000,NE 158,Residential,37368,228392,0,265760
140725101600000,NE 158,Residential,37260,203730,0,240990
140725200100000,NE 158,Residential,32284,156686,0,188970
140725200200000,NE 158,Residential,30200,0,0,30200
140725200300000,NE 158,Residential,21950,0,0,21950
140725200400000,NE 158,Residential,34660,205295,0,239955
140725200500000,NE 158,Residential,32929,174434,0,207363
140725200600000,NE 140,Residential,350,0,0,350
140725200700000,NE 158,Residential,35360,218689,0,254049
140725200800000,NE 158,Residential,35031,226312,0,261343
140725200900000,NE 158,Residential,32548,226996,0,259544
140725201000000,NE 158,Residential,32548,204050,0,236598
140725201100000,NE 158,Residential,32471,229694,0,262165
140725201200000,NE 158,Residential,34745,250426,0,285171
140725201300000,NE 158,Residential,35083,236615,0,271698
140725201400000,NE 158,Residential,39923,232980,0,272903
140725201500000,NE 158,Residential,32056,0,0,32056
140725201600000,NE 158,Residential,31210,189431,0,220641
140725201700000,NE 158,Residential,29713,205408,0,235121
140725201800000,NE 158,Residential,29304,167915,0,197219
140725201900000,NE 158,Residential,29240,162055,0,191295
140725202000000,NE 158,Residential,29397,171150,0,200547
140725202100000,NE 158,Residential,30387,183284,0,213671
140725202200000,NE 158,Residential,30240,145827,0,176067
140725202300000,NE 158,Residential,30240,170779,0,201019
140725202400000,NE 158,Residential,30240,161707,0,191947
140725202500000,NE 158,Residential,31200,171675,0,202875
140725202600000,NE 158,Residential,29952,217506,0,247458
140725202700000,NE 158,Residential,30240,190629,0,220869
140725202800000,NE 158,Residential,30240,218357,0,248597
140725202900000,NE 158,Residential,30240,209772,0,240012
140725203000000,NE 158,Residential,34073,228377,0,262450
140725203100000,NE 158,Residential,35475,211401,0,246876
140725203200000,NE 158,Residential,33320,180736,0,214056
140725203300000,NE 158,Residential,28512,195755,0,224267
140725203400000,NE 158,Residential,30823,184182,0,215005
140725203500000,NE 158,Residential,30031,174025,0,204056
140725203600000,NE 158,Residential,32170,164662,0,196832
140725203700000,NE 158,Residential,31200,212409,0,243609
140725203800000,NE 158,Residential,31200,179960,0,211160
140725203900000,NE 158,Residential,31200,184236,0,215436
140725204000000,NE 158,Residential,31200,177141,0,208341
140725204100000,NE 158,Residential,31200,186667,0,217867
140725204200000,NE 158,Residential,31575,164879,0,196454
140727600100000,NE 158,Residential,35749,208274,0,244023
140727600200000,NE 158,Residential,32265,206667,0,238932
140727600300000,NE 158,Residential,32265,223100,0,255365
140727600400000,NE 158,Residential,32265,194981,0,227246
140727600500000,NE 158,Residential,32265,242532,0,274797
140727600600000,NE 158,Residential,32538,219436,0,251974
140727600700000,NE 158,Residential,32960,207722,0,240682
140727600800000,NE 158,Residential,34629,196330,0,230959
140727600900000,NE 158,Residential,35129,229930,0,265059
140727601000000,NE 158,Residential,39326,262165,0,301491
140727601100000,NE 158,Residential,39400,0,0,39400
140727601200000,NE 158,Residential,65300,0,0,65300
140727601300000,NE 158,Residential,32688,186518,0,219206
140727601400000,NE 158,Residential,34240,242655,0,276895
140727601500000,NE 158,Residential,34240,193947,0,228187
140727601600000,NE 158,Residential,34240,179297,0,213537
140727601700000,NE 158,Residential,35020,180666,0,215686
140727601800000,NE 158,Residential,35020,192958,0,227978
140727601900000,NE 158,Residential,35020,195769,0,230789
140727602000000,NE 158,Residential,35020,163941,0,198961
140727602100000,NE 158,Residential,38629,173682,0,212311
140727602200000,NE 158,Residential,40460,223758,0,264218
140727602300000,NE 158,Residential,41600,233314,0,274914
140727602400000,NE 158,Residential,43333,189652,0,232985
140727602500000,NE 158,Residential,44200,190607,0,234807
140727602600000,NE 158,Residential,44200,240434,0,284634
140727602700000,NE 158,Residential,44893,256442,0,301335
140727602800000,NE 158,Residential,47668,194381,0,242049
140727602900000,NE 158,Residential,44428,0,0,44428
140727603000000,NE 158,Residential,44836,199689,0,244525
140727603100000,NE 158,Residential,44081,212209,0,256290
140727603200000,NE 158,Residential,45125,264588,0,309713
140727603300000,NE 158,Residential,38500,229380,0,267880
140727603400000,NE 158,Residential,39220,197949,0,237169
140727603500000,NE 158,Residential,42293,213358,0,255651
140727603600000,NE 158,Residential,39000,195828,0,234828
140727603700000,NE 158,Residential,39000,181522,0,220522
140727603800000,NE 158,Residential,38454,190821,0,229275
140727603900000,NE 158,Residential,36528,176687,0,213215
140727604000000,NE 158,Residential,35333,168525,0,203858
140727604100000,NE 158,Residential,38023,189137,0,227160
140727604200000,NE 158,Residential,30218,166046,0,196264
140727604300000,NE 158,Residential,30900,168879,0,199779
140727604400000,NE 158,Residential,30900,221195,0,252095
140727604500000,NE 158,Residential,30900,205748,0,236648
140727604600000,NE 158,Residential,30900,176130,0,207030
140727604700000,NE 158,Residential,36055,212130,0,248185
140730100100000,NE 158,Residential,35020,164347,0,199367
140730100200000,NE 140,Residential,54600,0,0,54600
140730100300000,NE 158,Residential,34240,210563,0,244803
140730100400000,NE 158,Residential,37078,177488,0,214566
140730100500000,NE 158,Residential,35855,195861,0,231716
140730100600000,NE 158,Residential,36196,270435,0,306631
140730100700000,NE 158,Residential,34768,189826,0,224594
140730100800000,NE 158,Residential,33921,184228,0,218149
140730100900000,NE 158,Residential,32832,167537,0,200369
140730101000000,NE 158,Residential,29242,185430,0,214672
140730101100000,NE 158,Residential,29664,189401,0,219065
140730101200000,NE 158,Residential,33502,197001,0,230503
140730101300000,NE 158,Residential,37667,215988,0,253655
140730101400000,NE 158,Residential,38626,178524,0,217150
140730101500000,NE 158,Residential,34259,178022,0,212281
140730101600000,NE 158,Residential,36630,153370,0,190000
140730101700000,NE 158,Residential,34564,165970,0,200534
140730200100000,NE 158,Residential,30600,190078,0,220678
140730200200000,NE 158,Residential,37139,244454,0,281593
140730200300000,NE 158,Residential,38923,284778,0,323701
140730200400000,NE 158,Residential,37080,239599,0,276679
140730200500000,NE 158,Residential,38000,259609,0,297609
140730200600000,NE 158,Residential,30096,173494,0,203590
140730200700000,NE 158,Residential,30600,227772,0,258372
140730200800000,NE 158,Residential,30076,243339,0,273415
140730200900000,NE 158,Residential,29252,191073,0,220325
140730201000000,NE 158,Residential,29376,259503,0,288879
140730201100000,NE 158,Residential,31909,250395,0,282304
140730201200000,NE 158,Residential,30600,191349,0,221949
140730300100000,NE 158,Residential,34641,214646,0,249287
140730300200000,NE 158,Residential,36084,180036,0,216120
140730300300000,NE 158,Residential,34627,193155,0,227782
140730300400000,NE 158,Residential,49530,224882,0,274412
140730400100000,NE 158,Residential,49088,139726,0,188814
140730400200000,NE 158,Residential,47730,214965,0,262695
140730400300000,NE 158,Residential,42527,253667,0,296194
140730400400000,NE 158,Residential,41348,263651,0,304999
140730400500000,NE 140,Residential,18800,0,0,18800
140730400600000,NE 158,Residential,49046,232728,0,281774
140730400700000,NE 158,Residential,49046,206358,0,255404
140730400800000,NE 158,Residential,37547,204956,0,242503
140730400900000,NE 158,Residential,29100,0,0,29100
140730401000000,NE 158,Residential,55531,322609,0,378140
140730401100000,NE 158,Residential,6150,0,0,6150
140730401200000,NE 158,Residential,15659,222814,0,238473
140730401300000,NE 158,Residential,10933,169871,0,180804
140730401400000,NE 158,Residential,13160,173363,0,186523
140730401500000,NE 158,Residential,16572,185749,0,202321
140730401600000,NE 158,Residential,15452,202780,0,218232
140730401800000,NE 158,Residential,8000,0,0,8000
140730500100000,NE 158,Residential,36036,220026,0,256062
140732600100000,NE 158,Residential,30600,196792,0,227392
140732600200000,NE 158,Residential,31240,245038,0,276278
140732600300000,NE 158,Residential,35809,240912,0,276721
140732600400000,NE 158,Residential,37168,310241,0,347409
140732600500000,NE 158,Residential,38362,228044,0,266406
140732600600000,NE 158,Residential,38375,233367,0,271742
140732700100000,NE 158,Residential,40186,229225,0,269411
140732700200000,NE 158,Residential,102650,0,0,102650
140732700300000,NE 158,Residential,34849,187823,0,222672
140732700400000,NE 158,Residential,35613,239242,0,274855
140732700500000,NE 158,Residential,14375,190030,0,204405
140732700600000,NE 158,Residential,11454,157659,0,169113
140732700700000,NE 158,Residential,13155,185562,0,198717
140732700800000,NE 158,Residential,16380,207052,0,223432
140732700900000,NE 158,Residential,17550,196109,0,213659
140732701000000,NE 158,Residential,14900,0,0,14900
140732701100000,NE 158,Residential,15405,177631,0,193036
140732701200000,NE 140,Residential,11060,172865,0,183925
140732701300000,NE 158,Residential,14025,186815,0,200840
140732701400000,NE 158,Residential,16730,180799,0,197529
140732701500000,NE 158,Residential,17733,196810,0,214543
140732701600000,NE 158,Residential,15795,203314,0,219109
140732701700000,NE 158,Residential,11060,161138,0,172198
140732701800000,NE 158,Residential,12375,188057,0,200432
140732701900000,NE 158,Residential,15010,188957,0,203967
140732702000000,NE 158,Residential,14933,179375,0,194308
140732702100000,NE 158,Residential,16042,205055,0,221097
140732702200000,NE 158,Residential,15603,184352,0,199955
140732702300000,NE 158,Residential,12375,178770,0,191145
140732702400000,NE 158,Residential,11060,174126,0,185186
140732702500000,NE 158,Residential,15938,178480,0,194418
140732702600000,NE 158,Residential,16973,209859,0,226832
140732702700000,NE 158,Residential,14897,181503,0,196400
140732702800000,NE 158,Residential,12540,197965,0,210505
140732702900000,NE 158,Residential,10780,171253,0,182033
140732703000000,NE 158,Residential,16720,227494,0,244214
140732703100000,NE 158,Residential,38170,198039,0,236209
140732703200000,NE 158,Residential,38439,200539,0,238978
140732703300000,NE 158,Residential,36720,233140,0,269860
140732800100000,NE 158,Residential,38624,222974,0,261598
140732800200000,NE 158,Residential,7950,0,0,7950
140732800300000,NE 158,Residential,37092,264703,0,301795
140732800400000,NE 158,Residential,34690,252889,0,287579
140732800500000,NE 158,Residential,36432,250144,0,286576
140732800600000,NE 140,Residential,1900,0,0,1900
140732800700000,NE 140,Residential,850,0,0,850
140735100100000,NE 151,Residential,166500,0,0,166500
140735100200000,NE 151,Residential,7000,0,0,7000
140737600100000,E-15 CITY,Exempt,0,0,0,0
140740100100000,NE 138,Residential,70123,260690,0,330813
140740100200000,NE 138,Residential,63650,300105,0,363755
140740100300000,NE 138,Residential,78390,305294,0,383684
140740100400000,NE 138,Residential,80852,341548,0,422400
140740100500000,NE 138,Residential,97170,398739,0,495909
140740100600000,NE 138,Residential,75600,322331,0,397931
140740100700000,NE 138,Residential,103600,383077,0,486677
140740100800000,NE 138,Residential,114700,397646,0,512346
140740100900000,NE 157,Residential,70800,260710,0,331510
140740101000000,NE 157,Residential,71020,325152,0,396172
140740101100000,NE 157,Residential,64516,223065,0,287581
140740101200000,NE 157,Residential,125000,307956,0,432956
140740101300000,NE 157,Residential,103530,220218,0,323748
140740101400000,NE 157,Residential,109610,348632,0,458242
140740101500000,NE 157,Residential,114480,342486,0,456966
140740101600000,NE 157,Residential,111860,304049,0,415909
140740101700000,NE 157,Residential,108290,0,0,108290
140740101900000,NE 157,Residential,73220,260798,0,334018
140740102000000,NE 157,Residential,53234,0,0,53234
140740102100000,NE 157,Residential,72458,387686,0,460144
140740102200000,NE 157,Residential,75600,487606,0,563206
140740102300000,NE 157,Residential,100500,353263,0,453763
140740102400000,NE 157,Residential,100200,375161,0,475361
140740102500000,NE 138,Residential,65325,327401,0,392726
140740102600000,NE 138,Residential,56227,480689,0,536916
140740102700000,NE 138,Residential,53104,0,0,53104
140740102800000,NE 157,Residential,67320,329932,0,397252
140740102900000,NE 157,Residential,66482,233080,0,299562
140740103000000,NE 157,Residential,76028,250928,0,326956
140740103100000,NE 157,Residential,65450,259835,0,325285
140740103200000,NE 157,Residential,64900,369764,0,434664
140740103300000,NE 157,Residential,58580,298798,0,357378
140740103400000,NE 138,Residential,67667,287976,0,355643
140740103500000,NE 138,Residential,59547,323023,0,382570
140740103600000,Empty,Other,0,0,0,0
140742600200000,NE 157,Residential,50250,0,0,50250
140742600300000,NE 157,Residential,39100,0,0,39100
140742600400000,NE 157,Residential,45100,0,0,45100
140742600500000,NE 157,Residential,55050,0,0,55050
140742700100000,NE 158,Residential,74360,255139,0,329499
140742700200000,NE 158,Residential,35711,168994,0,204705
140742700300000,NE 158,Residential,37400,207240,0,244640
140742700400000,NE 158,Residential,35374,206651,0,242025
140742700500000,NE 158,Residential,34467,190533,0,225000
140742700600000,NE 158,Residential,54608,220788,0,275396
140742700700000,NE 158,Residential,65380,210818,0,276198
140742700800000,NE 158,Residential,106735,206097,0,312832
140742700900000,NE 158,Residential,49905,219095,0,269000
140742701000000,NE 158,Residential,49884,262322,0,312206
140742701100000,NE 158,Residential,49376,240721,0,290097
140745100100000,E-15 CITY,Exempt,0,0,0,0
140810100100000,NE 134,Residential,29236,124999,0,154235
140810100200000,NE 134,Residential,25830,125013,0,150843
140810100300000,NE 134,Residential,23765,141206,0,164971
140810100400000,NE 134,Residential,23765,114110,0,137875
140810100500000,NE 134,Residential,27352,127566,0,154918
140810100600000,NE 134,Residential,34047,125013,0,159060
140810100700000,NE 134,Residential,30870,99130,0,130000
140810100800000,NE 134,Residential,34342,124534,0,158876
140810100900000,NE 134,Residential,33708,110480,0,144188
140810101000000,NE 134,Residential,36112,138595,0,174707
140810101100000,NE 134,Residential,34884,127122,0,162006
140810101200000,NE 134,Residential,34884,133845,0,168729
140810101300000,NE 134,Residential,34884,108273,0,143157
140810101400000,NE 134,Residential,33836,129280,0,163116
140810101500000,NE 134,Residential,31482,107656,0,139138
140810101600000,NE 134,Residential,31137,94262,0,125399
140810101700000,NE 134,Residential,32602,87450,0,120052
140810200100000,NE 134,Residential,26082,113350,0,139432
140810200200000,NE 134,Residential,24784,131488,0,156272
140810200300000,NE 134,Residential,24784,95030,0,119814
140810200400000,NE 134,Residential,25463,103577,0,129040
140810200500000,E-40 CHURCHES,Exempt,99187,0,306685,405872
140810200600000,E-46 RELIG PARKING,Exempt,108518,0,14748,123266
140810200700000,NE 134,Residential,25725,108005,0,133730
140810200800000,NE 134,Residential,27930,128492,0,156422
140810200900000,NE 134,Residential,27930,115689,0,143619
140810201000000,NE 134,Residential,27645,108505,0,136150
140810201100000,NE 134,Residential,31101,113371,0,144472
140810201200000,E-46 RELIG PARKING,Exempt,100397,0,12072,112469
140810201300000,NE 134,Residential,27160,100619,0,127779
140810201400000,NE 134,Residential,27160,108151,0,135311
140810201500000,NE 134,Residential,27160,96607,0,123767
140810201600000,NE 134,Residential,27822,97604,0,125426
140810300100000,NE 134,Residential,36130,121738,0,157868
140810300200000,NE 134,Residential,34959,126807,0,161766
140810300300000,NE 134,Residential,26933,104220,0,131153
140810300400000,NE 134,Residential,27607,123637,0,151244
140810300500000,NE 134,Residential,27607,117069,0,144676
140810300600000,NE 134,Residential,28280,91485,0,119765
140810300700000,NE 134,Residential,27720,113207,0,140927
140810300800000,NE 134,Residential,27440,95364,0,122804
140810300900000,NE 134,Residential,28160,107035,0,135195
140810301000000,NE 134,Residential,28302,127513,0,155815
140810301100000,NE 134,Residential,29302,113619,0,142921
140810301200000,NE 134,Residential,36215,145232,0,181447
140810301300000,NE 134,Residential,33709,111009,0,144718
140810301400000,NE 134,Residential,33576,120128,0,153704
140810301500000,NE 134,Residential,32275,127163,0,159438
140810301600000,NE 134,Residential,33699,98901,0,132600
140810301700000,NE 134,Residential,32943,116029,0,148972
140810301800000,NE 134,Residential,32149,135490,0,167639
140810301900000,NE 134,Residential,33523,139461,0,172984
140810400100000,NE 134,Residential,31346,147642,0,178988
140810400200000,NE 134,Residential,28785,99713,0,128498
140810400300000,NE 134,Residential,28500,142146,0,170646
140810400400000,NE 134,Residential,28215,116494,0,144709
140810400500000,NE 134,Residential,27930,113441,0,141371
140810400600000,NE 134,Residential,29988,99657,0,129645
140810400700000,NE 134,Residential,27645,110967,0,138612
140810400800000,NE 134,Residential,27645,123057,0,150702
140810400900000,NE 134,Residential,27645,106042,0,133687
140810401000000,NE 134,Residential,27298,114764,0,142062
140810401100000,NE 134,Residential,32327,127390,0,159717
140810401200000,NE 134,Residential,32063,138435,0,170498
140810401300000,NE 134,Residential,31725,136878,0,168603
140810401400000,NE 134,Residential,32063,142765,0,174828
140810401500000,NE 134,Residential,33048,121463,0,154511
140810401600000,NE 134,Residential,32738,116997,0,149735
140810401700000,NE 134,Residential,33075,122791,0,155866
140810401800000,NE 134,Residential,33075,104137,0,137212
140810401900000,NE 134,Residential,31742,131987,0,163729
140810402000000,NE 134,Residential,32915,145095,0,178010
140810500100000,NE 134,Residential,29988,130208,0,160196
140810500200000,NE 134,Residential,31742,105955,0,137697
140810500300000,NE 134,Residential,31742,133626,0,165368
140810500400000,NE 134,Residential,32062,105087,0,137149
140810500500000,NE 134,Residential,32384,120156,0,152540
140810500600000,NE 134,Residential,32837,139532,0,172369
140810500700000,NE 134,Residential,32773,133311,0,166084
140810500800000,NE 134,Residential,33542,95869,0,129411
140810500900000,NE 134,Residential,31365,150356,0,181721
140810501000000,NE 134,Residential,32746,115370,0,148116
140810501100000,NE 134,Residential,34379,148178,0,182557
140810501200000,NE 134,Residential,32438,129114,0,161552
140810501300000,NE 134,Residential,34812,136390,0,171202
140810501400000,NE 134,Residential,34007,126927,0,160934
140810501500000,NE 134,Residential,31634,136935,0,168569
140810501600000,NE 134,Residential,32506,122480,0,154986
140810501700000,NE 134,Residential,32738,121726,0,154464
140810501800000,NE 134,Residential,30919,93743,0,124662
140810501900000,NE 134,Residential,32738,115993,0,148731
140810502000000,NE 134,Residential,33393,94890,0,128283
140810600100000,NE 134,Residential,33345,121431,0,154776
140810600200000,NE 134,Residential,35568,97949,0,133517
140810600300000,NE 134,Residential,34827,108698,0,143525
140810600400000,NE 134,Residential,35611,96065,0,131676
140810600500000,NE 134,Residential,34425,106457,0,140882
140810600600000,NE 134,Residential,33611,128396,0,162007
140810600700000,NE 134,Residential,34474,87526,0,122000
140810600800000,NE 134,Residential,34003,125267,0,159270
140810600900000,NE 134,Residential,34354,98848,0,133202
140810601000000,NE 134,Residential,34616,138908,0,173524
140810601100000,NE 134,Residential,34561,127867,0,162428
140810601200000,NE 134,Residential,34140,130365,0,164505
140810601300000,NE 134,Residential,34132,168333,0,202465
140810601400000,NE 134,Residential,33997,141137,0,175134
140810601500000,NE 134,Residential,34769,130261,0,165030
140810601600000,NE 134,Residential,33787,118690,0,152477
140810601700000,NE 134,Residential,36057,110684,0,146741
140810601800000,NE 134,Residential,36932,128677,0,165609
140810601900000,NE 134,Residential,34399,91953,0,126352
140810602000000,NE 134,Residential,35494,114896,0,150390
140810602100000,NE 134,Residential,33589,115324,0,148913
140810602200000,NE 134,Residential,30645,130230,0,160875
140810700100000,NE 134,Residential,35703,114297,0,150000
140810700200000,NE 134,Residential,33801,123631,0,157432
140810700300000,NE 134,Residential,33345,116489,0,149834
140810700400000,NE 134,Residential,33885,129801,0,163686
140810700500000,NE 134,Residential,32751,141682,0,174433
140812600100000,NE 134,Residential,25994,124771,0,150765
140812600200000,NE 134,Residential,28800,148804,0,177604
140812600300000,NE 134,Residential,28500,150023,0,178523
140812600400000,NE 134,Residential,30438,119166,0,149604
140812600500000,NE 134,Residential,29408,151081,0,180489
140812700100000,NE 134,Residential,28512,143179,0,171691
140812700200000,NE 134,Residential,33372,136628,0,170000
140812700300000,NE 134,Residential,33048,120389,0,153437
140812700400000,NE 134,Residential,33247,156042,0,189289
140812700500000,NE 134,Residential,29424,132704,0,162128
140812700600000,NE 134,Residential,32307,138381,0,170688
140812700700000,NE 134,Residential,30417,149024,0,179441
140812700800000,NE 134,Residential,31188,125404,0,156592
140812700900000,NE 134,Residential,31595,145150,0,176745
140812701000000,NE 134,Residential,31464,140481,0,171945
140812701100000,NE 134,Residential,30315,155825,0,186140
140812701200000,NE 134,Residential,32400,131359,0,163759
140812701300000,NE 134,Residential,27398,115256,0,142654
140812701400000,NE 134,Residential,28699,133727,0,162426
140812701500000,NE 134,Residential,30615,134223,0,164838
140812701600000,NE 134,Residential,30703,144353,0,175056
140812701700000,NE 134,Residential,29243,144148,0,173391
140812701800000,NE 134,Residential,27779,127057,0,154836
140812800100000,NE 134,Residential,32062,161311,0,193373
140812800200000,NE 134,Residential,35373,142187,0,177560
140812800300000,NE 134,Residential,31742,177135,0,208877
140812800400000,NE 134,Residential,34140,150182,0,184322
140812800500000,NE 134,Residential,33372,143900,0,177272
140812800600000,NE 134,Residential,34344,123172,0,157516
140812800700000,NE 134,Residential,34155,134118,0,168273
140812800800000,NE 134,Residential,39154,210188,0,249342
140812800900000,NE 134,Residential,36085,214065,0,250150
140812801000000,NE 134,Residential,36360,179348,0,215708
140812801100000,NE 134,Residential,37723,178048,0,215771
140812801200000,NE 134,Residential,37296,131204,0,168500
140812801300000,NE 134,Residential,36720,157443,0,194163
140812801400000,NE 134,Residential,35027,155140,0,190167
140812801500000,NE 134,Residential,32671,128985,0,161656
140812900100000,NE 134,Residential,35613,177906,0,213519
140812900200000,NE 134,Residential,32492,176001,0,208493
140812900300000,NE 134,Residential,34200,148720,0,182920
140812900400000,NE 134,Residential,34200,167754,0,201954
140812900500000,NE 134,Residential,34200,182411,0,216611
140812900600000,NE 134,Residential,34545,181646,0,216191
140812900700000,NE 134,Residential,35754,152585,0,188339
140812900800000,NE 134,Residential,36905,182470,0,219375
140812900900000,NE 134,Residential,32763,168621,0,201384
140812901000000,NE 134,Residential,32850,163035,0,195885
140812901100000,NE 134,Residential,32850,168131,0,200981
140812901200000,NE 134,Residential,32850,154603,0,187453
140812901300000,NE 134,Residential,32850,155499,0,188349
140813000100000,NE 134,Residential,33698,120620,0,154318
140813000200000,NE 134,Residential,36360,145976,0,182336
140813000300000,NE 134,Residential,36360,177309,0,213669
140813000400000,NE 134,Residential,36360,192659,0,229019
140813000500000,NE 134,Residential,35198,179232,0,214430
140813000600000,NE 134,Residential,39907,192950,0,232857
140813000700000,NE 134,Residential,42768,224577,0,267345
140813000800000,NE 135,Residential,47143,254857,0,302000
140813000900000,NE 135,Residential,45818,210112,0,255930
140813001000000,NE 135,Residential,45315,313333,0,358648
140813001100000,NE 135,Residential,45552,334715,0,380267
140813001200000,NE 135,Residential,42573,266047,0,308620
140813001300000,NE 135,Residential,43935,189812,0,233747
140813001400000,NE 135,Residential,38833,199713,0,238546
140813001500000,NE 135,Residential,39440,227658,0,267098
140813001600000,NE 135,Residential,39558,233247,0,272805
140813001700000,NE 135,Residential,39888,201636,0,241524
140813001800000,NE 134,Residential,35975,152726,0,188701
140813001900000,NE 134,Residential,34104,144768,0,178872
140813002000000,NE 134,Residential,33027,138694,0,171721
140813002100000,NE 134,Residential,37440,189356,0,226796
140813002200000,NE 134,Residential,37179,148087,0,185266
140813002300000,NE 134,Residential,33920,188892,0,222812
140813002400000,NE 134,Residential,35226,180330,0,215556
140813002500000,NE 134,Residential,36360,210930,0,247290
140813002600000,NE 134,Residential,39244,149536,0,188780
140813002700000,NE 134,Residential,39936,186547,0,226483
140813100100000,NE 134,Residential,32482,146606,0,179088
140813100200000,NE 134,Residential,32818,141282,0,174100
140813100300000,NE 134,Residential,31256,122783,0,154039
140813100400000,NE 134,Residential,33197,155641,0,188838
140813100500000,NE 134,Residential,32705,142945,0,175650
140813100600000,NE 134,Residential,38803,161227,0,200030
140813100700000,NE 134,Residential,35113,162562,0,197675
140813100800000,NE 134,Residential,36474,171489,0,207963
140813100900000,NE 134,Residential,31977,157660,0,189637
140813101000000,NE 134,Residential,34552,192883,0,227435
140813101100000,NE 134,Residential,32636,148236,0,180872
140813200100000,NE 134,Residential,31752,138041,0,169793
140813200200000,NE 134,Residential,33858,121071,0,154929
140813200300000,NE 134,Residential,32119,125621,0,157740
140813200400000,NE 134,Residential,32589,137573,0,170162
140813200500000,NE 134,Residential,31050,134669,0,165719
140813200600000,NE 134,Residential,31742,145073,0,176815
140813200700000,NE 135,Residential,39218,191716,0,230934
140813200800000,NE 135,Residential,43757,215491,0,259248
140813200900000,NE 135,Residential,39583,236657,0,276240
140813201000000,NE 135,Residential,41487,241762,0,283249
140813201100000,NE 135,Residential,45897,266580,0,312477
140813201200000,NE 135,Residential,43541,247392,0,290933
140813201300000,NE 135,Residential,46580,196420,0,243000
140813201400000,NE 135,Residential,43120,207405,0,250525
140813201500000,NE 135,Residential,43925,287889,0,331814
140813201600000,NE 135,Residential,46876,203803,0,250679
140813201700000,NE 135,Residential,42613,320450,0,363063
140813201800000,NE 135,Residential,34650,277692,0,312342
140813201900000,NE 135,Residential,41629,316823,0,358452
140813202000000,NE 135,Residential,47522,261062,0,308584
140813202100000,NE 135,Residential,46425,305535,0,351960
140813202200000,NE 134,Residential,42793,215342,0,258135
140813202300000,NE 134,Residential,44922,228661,0,273583
140813202400000,NE 134,Residential,40850,215849,0,256699
140813202500000,NE 134,Residential,37203,205318,0,242521
140813202600000,NE 134,Residential,35350,209725,0,245075
140813202700000,NE 134,Residential,35000,155000,0,190000
140815100100000,NE 134,Residential,39643,214945,0,254588
140815100200000,NE 134,Residential,39643,215004,0,254647
140815100300000,NE 134,Residential,42753,200154,0,242907
140815100400000,NE 135,Residential,61631,350116,0,411747
140815100500000,NE 135,Residential,48675,274142,0,322817
140815100600000,NE 135,Residential,48905,253785,0,302690
140815100700000,NE 135,Residential,51984,268932,0,320916
140815100800000,NE 135,Residential,53083,354334,0,407417
140815200100000,NE 135,Residential,85050,238321,0,323371
140815200200000,NE 135,Residential,48841,243942,0,292783
140815200300000,NE 135,Residential,46885,249930,0,296815
140815200400000,NE 135,Residential,44092,253076,0,297168
140815200500000,NE 135,Residential,44415,222017,0,266432
140815200600000,NE 135,Residential,50613,257594,0,308207
140815200700000,NE 135,Residential,48790,251565,0,300355
140815200800000,NE 135,Residential,48150,212911,0,261061
140815200900000,NE 135,Residential,51604,199189,0,250793
140815201000000,NE 135,Residential,52873,230048,0,282921
140815201100000,NE 135,Residential,58603,309766,0,368369
140815201200000,NE 135,Residential,53148,264648,0,317796
140815201300000,NE 135,Residential,54320,253546,0,307866
140815201400000,NE 135,Residential,49600,260230,0,309830
140815201500000,NE 135,Residential,49200,250997,0,300197
140815201600000,NE 135,Residential,52885,261837,0,314722
140815201700000,NE 135,Residential,53410,263249,0,316659
140815201800000,NE 135,Residential,47769,250892,0,298661
140815201900000,NE 135,Residential,48828,274912,0,323740
140815202000000,NE 135,Residential,49774,248977,0,298751
140815202100000,NE 135,Residential,47401,221876,0,269277
140815202200000,NE 136,Residential,65135,302208,0,367343
140815202300000,NE 136,Residential,60420,350742,0,411162
140815202400000,NE 136,Residential,58144,294327,0,352471
140815202500000,NE 136,Residential,64418,292866,0,357284
140815202600000,NE 136,Residential,49936,341200,0,391136
140815202700000,NE 136,Residential,92350,343435,0,435785
140815202800000,NE 136,Residential,74240,410719,0,484959
140815202900000,NE 136,Residential,67800,342330,0,410130
140815203000000,NE 136,Residential,65400,320117,0,385517
140815203100000,NE 136,Residential,59875,311892,0,371767
140815203200000,NE 136,Residential,48417,226253,0,274670
140815203300000,NE 136,Residential,49272,256954,0,306226
140815203400000,NE 136,Residential,50818,250004,0,300822
140815203500000,NE 136,Residential,76500,282292,0,358792
140815203600000,NE 136,Residential,85000,276124,0,361124
140815203700000,NE 136,Residential,52929,315634,0,368563
140815203800000,NE 136,Residential,44439,316685,0,361124
140817600100000,NE 134,Residential,32483,167521,0,200004
140817600200000,NE 134,Residential,35476,122524,0,158000
140817600300000,NE 134,Residential,31699,142952,0,174651
140817600400000,NE 134,Residential,30654,156655,0,187309
140817600500000,NE 134,Residential,30234,163998,0,194232
140817600600000,NE 134,Residential,30060,132940,0,163000
140817600700000,NE 134,Residential,33817,123433,0,157250
140817600800000,NE 134,Residential,30060,151805,0,181865
140817600900000,NE 134,Residential,30060,152940,0,183000
140817601000000,NE 134,Residential,30060,159940,0,190000
140817601100000,NE 134,Residential,30182,149818,0,180000
140817700100000,NE 134,Residential,29916,111654,0,141570
140817700200000,NE 134,Residential,36644,109410,0,146054
140817700300000,NE 134,Residential,37166,122212,0,159378
140817700400000,NE 134,Residential,33354,126452,0,159806
140817700500000,NE 134,Residential,36960,160051,0,197011
140817700600000,NE 134,Residential,35269,109223,0,144492
140817700700000,NE 134,Residential,36540,147129,0,183669
140817700800000,NE 134,Residential,33068,130040,0,163108
140817700900000,NE 134,Residential,32604,160673,0,193277
140817701000000,NE 134,Residential,34398,157158,0,191556
140817701100000,NE 134,Residential,40709,136743,0,177452
140817701200000,NE 134,Residential,39724,160061,0,199785
140817701300000,NE 134,Residential,32484,111895,0,144379
140817701400000,NE 134,Residential,32393,121530,0,153923
140817701500000,NE 134,Residential,30195,108830,0,139025
140817701600000,NE 134,Residential,28598,111220,0,139818
140817701700000,NE 134,Residential,29258,141973,0,171231
140817800100000,NE 134,Residential,34992,107724,0,142716
140817800200000,NE 134,Residential,34194,142509,0,176703
140817800300000,NE 134,Residential,37968,130761,0,168729
140817800400000,NE 134,Residential,34749,126750,0,161499
140817800500000,NE 134,Residential,33372,187382,0,220754
140817800600000,NE 134,Residential,34542,112881,0,147423
140817800700000,NE 135,Residential,64050,302742,0,366792
140817800800000,NE 135,Residential,75250,281793,0,357043
140817800900000,NE 134,Residential,46962,218066,0,265028
140817801000000,NE 134,Residential,32960,163341,0,196301
140817801100000,NE 134,Residential,32640,191087,0,223727
140817801200000,NE 134,Residential,43231,209523,0,252754
140817801300000,NE 134,Residential,39830,168302,0,208132
140817801400000,NE 134,Residential,34749,118286,0,153035
140817801500000,NE 134,Residential,34898,118637,0,153535
140817801600000,NE 134,Residential,37064,126936,0,164000
140817801700000,NE 134,Residential,34157,104526,0,138683
140817801800000,NE 134,Residential,36146,127421,0,163567
140817900100000,NE 134,Residential,45423,166774,0,212197
140817900200000,NE 134,Residential,39089,149883,0,188972
140817900300000,NE 134,Residential,38375,171406,0,209781
140817900400000,NE 134,Residential,37853,130737,0,168590
140817900700000,NE 134,Residential,38587,191554,0,230141
140818000100000,NE 134,Residential,38784,172943,0,211727
140818000200000,NE 134,Residential,38343,175649,0,213992
140818000300000,NE 134,Residential,53106,143537,0,196643
140818000400000,NE 134,Residential,39217,147775,0,186992
140818000500000,NE 134,Residential,36403,162652,0,199055
140818000600000,NE 134,Residential,35910,111622,0,147532
140818000700000,NE 134,Residential,43398,233185,0,276583
140818000800000,NE 134,Residential,31680,243682,0,275362
140818000900000,NE 134,Residential,31807,0,0,31807
140818001200000,Empty,Other,0,0,0,0
140818001300000,E-15 CITY,Exempt,0,0,0,0
140818100100000,NE 135,Residential,48208,163077,0,211285
140818100200000,NE 135,Residential,44408,192818,0,237226
140818100300000,NE 135,Residential,44167,196998,0,241165
140818100400000,NE 135,Residential,52148,195801,0,247949
140818100500000,NE 135,Residential,77000,252173,0,329173
140818100600000,NE 135,Residential,64743,262482,0,327225
140818100700000,NE 135,Residential,51520,225503,0,277023
140818100800000,NE 135,Residential,73905,332314,0,406219
140818100900000,NE 135,Residential,64424,211240,0,275664
140818101000000,NE 135,Residential,64565,224106,0,288671
140818101100000,NE 135,Residential,57306,228864,0,286170
140818101200000,NE 135,Residential,63220,216674,0,279894
140818200500000,NE 134,Residential,34729,154987,0,189716
140818200600000,NE 134,Residential,34884,159360,0,194244
140820100100000,NE 139,Residential,22450,0,0,22450
140820100200000,NE 139,Residential,29030,132653,0,161683
140820100300000,NE 139,Residential,27471,119030,0,146501
140820100400000,NE 139,Residential,27677,138271,0,165948
140820100500000,NE 139,Residential,29016,116707,0,145723
140820100600000,NE 139,Residential,26412,114075,0,140487
140820100700000,NE 139,Residential,25296,112766,0,138062
140820100800000,NE 139,Residential,24056,113720,0,137776
140820100900000,NE 139,Residential,24056,134911,0,158967
140820101000000,NE 139,Residential,23312,126321,0,149633
140820101100000,NE 139,Residential,26320,110395,0,136715
140820101201000,CONDO 501,Residential,13000,147670,0,160670
140820101201001,CONDO 501,Residential,13000,177419,0,190419
140820101301000,CONDO 501,Residential,13000,165325,0,178325
140820101301001,CONDO 501,Residential,13000,138458,0,151458
140820101400000,NE 139,Residential,15166,157406,0,172572
140820101500000,NE 139,Residential,10318,175307,0,185625
140820101600000,NE 139,Residential,21016,139830,0,160846
140820101700000,NE 139,Residential,9387,108937,0,118324
140820101800000,NE 139,Residential,15750,112754,0,128504
140820101900000,NE 139,Residential,16302,121287,0,137589
140820102000000,NE 139,Residential,9387,107585,0,116972
140820102101000,CONDO 501,Residential,12000,144354,0,156354
140820102101001,CONDO 501,Residential,12000,154425,0,166425
140820102201000,CONDO 501,Residential,12000,143581,0,155581
140820102201001,CONDO 501,Residential,12000,146088,0,158088
140820102300000,NE 139,Residential,13728,148891,0,162619
140820102400000,NE 139,Residential,12348,165178,0,177526
140820102501000,CONDO 501,Residential,14052,170849,0,184901
140820102501001,CONDO 501,Residential,12547,151481,0,164028
140820102600000,NE 139,Residential,28500,145617,0,174117
140820103900000,NE 139,Residential,16647,142351,0,158998
140820104000000,NE 139,Residential,10317,140225,0,150542
140820104100000,NE 139,Residential,26320,109313,0,135633
140820104200000,NE 139,Residential,29030,129223,0,158253
140820104300000,NE 139,Residential,25269,158942,0,184211
140820104400000,NE 139,Residential,25192,144158,0,169350
140820104500000,NE 139,Residential,27776,152638,0,180414
140820104600000,NE 139,Residential,27776,159266,0,187042
140820104700000,NE 139,Residential,27776,156403,0,184179
140820104800000,NE 139,Residential,25792,132825,0,158617
140820104900000,NE 139,Residential,26598,153987,0,180585
140820105000000,NE 139,Residential,26320,133977,0,160297
140820105100000,NE 139,Residential,26320,126002,0,152322
140820105200000,NE 139,Residential,29400,179715,0,209115
140820105300000,NE 139,Residential,29513,133931,0,163444
140820105400000,NE 139,Residential,28667,128443,0,157110
140820105500000,NE 139,Residential,28248,137291,0,165539
140820105600000,NE 139,Residential,27323,131802,0,159125
140820105700000,NE 139,Residential,28373,152729,0,181102
140820105800000,NE 139,Residential,28971,150462,0,179433
140820105900000,NE 139,Residential,27136,139506,0,166642
140820106000000,NE 139,Residential,28036,130488,0,158524
140820106100000,NE 139,Residential,22100,111133,0,133233
140820106200000,NE 139,Residential,29914,156237,0,186151
140820106300000,NE 139,Residential,27611,159965,0,187576
140820106400000,NE 139,Residential,30189,157029,0,187218
140820106500000,NE 139,Residential,29433,126272,0,155705
140820106600000,NE 139,Residential,28776,119703,0,148479
140820106700000,NE 139,Residential,30174,127260,0,157434
140820106800000,NE 139,Residential,28764,112866,0,141630
140820106900000,NE 139,Residential,28262,139444,0,167706
140820107000000,NE 139,Residential,28280,145737,0,174017
140820107100000,NE 139,Residential,28621,126847,0,155468
140820107200000,NE 139,Residential,50438,0,0,50438
140820107300000,NE 139,Residential,41817,221526,0,263343
140820107400000,NE 139,Residential,39220,212937,0,252157
140820107500000,NE 139,Residential,40838,197470,0,238308
140820107600000,NE 139,Residential,36537,200600,0,237137
140820107700000,NE 139,Residential,36320,179984,0,216304
140820107800000,NE 139,Residential,36719,193306,0,230025
140820107900000,NE 139,Residential,37893,199762,0,237655
140820108000000,NE 139,Residential,35520,196171,0,231691
140820108100000,NE 139,Residential,38220,223332,0,261552
140820108200000,NE 139,Residential,39215,202253,0,241468
140820108300000,NE 139,Residential,41807,191543,0,233350
140820108400000,NE 139,Residential,42244,199863,0,242107
140820108500000,NE 139,Residential,39990,205436,0,245426
140820108600000,NE 139,Residential,39835,195037,0,234872
140820108700000,NE 139,Residential,40058,212648,0,252706
140820108800000,NE 139,Residential,39480,180427,0,219907
140820108900000,NE 139,Residential,39480,232055,0,271535
140820109000000,NE 139,Residential,39480,179204,0,218684
140820109100000,NE 139,Residential,43986,191594,0,235580
140820109200000,NE 135,Residential,135,0,0,135
140820109300000,NE 139,Residential,42778,175008,0,217786
140820109400000,NE 139,Residential,42300,208453,0,250753
140820109500000,NE 139,Residential,42075,180393,0,222468
140820109600000,NE 139,Residential,41904,214149,0,256053
140820109700000,NE 139,Residential,41807,174580,0,216387
140820109800000,NE 139,Residential,42780,181938,0,224718
140820109900000,NE 139,Residential,41681,246585,0,288266
140820110000000,NE 139,Residential,42864,153657,0,196521
140820110100000,NE 139,Residential,42864,177544,0,220408
140820110200000,NE 139,Residential,43005,158378,0,201383
140820110400000,E-40 CHURCHES,Exempt,475416,0,2882463,3357879
140820200100000,NE 135,Residential,44042,310476,0,354518
140820200200000,NE 135,Residential,41876,299953,0,341829
140820200300000,NE 135,Residential,44585,297836,0,342421
140820200400000,NE 135,Residential,43614,191386,0,235000
140820200500000,NE 135,Residential,40480,241371,0,281851
140820300100000,NE 136,Residential,38882,136678,0,175560
140820300200000,NE 136,Residential,37331,161493,0,198824
140822600101000,CONDO 503,Residential,8000,93999,0,101999
140822600101001,CONDO 503,Residential,6000,80124,0,86124
140822600101002,CONDO 503,Residential,7000,79146,0,86146
140822600101003,CONDO 503,Residential,6000,73227,0,79227
140822600201000,CONDO 503,Residential,8000,94072,0,102072
140822600201001,CONDO 503,Residential,6000,82195,0,88195
140822600201002,CONDO 503,Residential,7000,79146,0,86146
140822600201003,CONDO 503,Residential,6000,73227,0,79227
140822600301000,CONDO 503,Residential,8000,98482,0,106482
140822600301001,CONDO 503,Residential,6000,79867,0,85867
140822600301002,CONDO 503,Residential,7000,78266,0,85266
140822600301003,CONDO 503,Residential,6000,72849,0,78849
140822600401000,CONDO 503,Residential,8000,92955,0,100955
140822600401001,CONDO 503,Residential,6000,80465,0,86465
140822600401002,CONDO 503,Residential,7000,78433,0,85433
140822600401003,CONDO 503,Residential,6000,82642,0,88642
140822600501000,CONDO 503,Residential,8000,100542,0,108542
140822600501001,CONDO 503,Residential,6000,80465,0,86465
140822600501002,CONDO 503,Residential,7000,77956,0,84956
140822600501003,CONDO 503,Residential,7000,73015,0,80015
140822600601000,CONDO 503,Residential,8000,90256,0,98256
140822600601001,CONDO 503,Residential,6000,76388,0,82388
140822600601002,CONDO 503,Residential,7000,75240,0,82240
140822600601003,CONDO 503,Residential,6000,70006,0,76006
140822600701000,CONDO 503,Residential,8000,92704,0,100704
140822600701001,CONDO 503,Residential,6000,82791,0,88791
140822600701002,CONDO 503,Residential,7000,78863,0,85863
140822600701003,CONDO 503,Residential,6000,73964,0,79964
140822600801000,CONDO 503,Residential,8000,93095,0,101095
140822600801001,CONDO 503,Residential,6000,78676,0,84676
140822600801002,CONDO 503,Residential,7000,78062,0,85062
140822600801003,CONDO 503,Residential,6000,69483,0,75483
140822600901000,CONDO 503,Residential,8000,98676,0,106676
140822600901001,CONDO 503,Residential,6000,85518,0,91518
140822600901002,CONDO 503,Residential,7000,79146,0,86146
140822600901003,CONDO 503,Residential,6000,73511,0,79511
140822601001000,CONDO 503,Residential,8000,104405,0,112405
140822601001001,CONDO 503,Residential,6000,80658,0,86658
140822601001002,CONDO 503,Residential,7000,79422,0,86422
140822601001003,CONDO 503,Residential,6000,76621,0,82621
140822601101000,CONDO 503,Residential,8000,93999,0,101999
140822601101001,CONDO 503,Residential,6000,80476,0,86476
140822601101002,CONDO 503,Residential,7000,79146,0,86146
140822601101003,CONDO 503,Residential,6000,73669,0,79669
140822601201000,CONDO 503,Residential,8000,98124,0,106124
140822601201001,CONDO 503,Residential,6000,87997,0,93997
140822601201002,CONDO 503,Residential,7000,85587,0,92587
140822601201003,CONDO 503,Residential,6000,77725,0,83725
140822601301000,CONDO 503,Residential,8000,105432,0,113432
140822601301001,CONDO 503,Residential,6000,85409,0,91409
140822601301002,CONDO 503,Residential,7000,86134,0,93134
140822601301003,CONDO 503,Residential,6000,77725,0,83725
140822601401000,CONDO 503,Residential,8000,97656,0,105656
140822601401001,CONDO 503,Residential,6000,85409,0,91409
140822601401002,CONDO 503,Residential,7000,85587,0,92587
140822601401003,CONDO 503,Residential,6000,77725,0,83725
140822601501000,CONDO 503,Residential,8000,100000,0,108000
140822601501001,CONDO 503,Residential,6000,86357,0,92357
140822601501002,CONDO 503,Residential,7000,87091,0,94091
140822601501003,CONDO 503,Residential,6000,78588,0,84588
140822601601000,CONDO 503,Residential,8000,102291,0,110291
140822601601001,CONDO 503,Residential,6000,86013,0,92013
140822601601002,CONDO 503,Residential,7000,87091,0,94091
140822601601003,CONDO 503,Residential,6000,79169,0,85169
140822601701000,CONDO 503,Residential,8000,99386,0,107386
140822601701001,CONDO 503,Residential,6000,94527,0,100527
140822601701002,CONDO 503,Residential,7000,87091,0,94091
140822601701003,CONDO 503,Residential,6000,78588,0,84588
140822601801000,CONDO 503,Residential,8000,98827,0,106827
140822601801001,CONDO 503,Residential,6000,94416,0,100416
140822601801002,CONDO 503,Residential,7000,87091,0,94091
140822601801003,CONDO 503,Residential,6000,78588,0,84588
140822601901000,CONDO 503,Residential,8000,99630,0,107630
140822601901001,CONDO 503,Residential,6000,86490,0,92490
140822601901002,CONDO 503,Residential,7000,88048,0,95048
140822601901003,CONDO 503,Residential,6000,79451,0,85451
140822602001000,CONDO 503,Residential,8000,100000,0,108000
140822602001001,CONDO 503,Residential,6000,87306,0,93306
140822602001002,CONDO 503,Residential,7000,90235,0,97235
140822602001003,CONDO 503,Residential,6000,79451,0,85451
140822602101000,CONDO 503,Residential,8000,108022,0,116022
140822602101001,CONDO 503,Residential,6000,92992,0,98992
140822602101002,CONDO 503,Residential,7000,93767,0,100767
140822602101003,CONDO 503,Residential,6000,83299,0,89299
140822602201000,CONDO 503,Residential,8000,108607,0,116607
140822602201001,CONDO 503,Residential,6000,87306,0,93306
140822602201002,CONDO 503,Residential,7000,88048,0,95048
140822602201003,CONDO 503,Residential,6000,82470,0,88470
140822602301000,CONDO 503,Residential,8000,100478,0,108478
140822602301001,CONDO 503,Residential,6000,89293,0,95293
140822602301002,CONDO 503,Residential,7000,88635,0,95635
140822602301003,CONDO 503,Residential,6000,79451,0,85451
140822602400000,E-15 CITY,Exempt,0,0,0,0
140822700101000,CONDO 503,Residential,8000,93332,0,101332
140822700101001,CONDO 503,Residential,6000,86564,0,92564
140822700101002,CONDO 503,Residential,7000,78150,0,85150
140822700101003,CONDO 503,Residential,6000,72826,0,78826
140822700201000,CONDO 503,Residential,8000,94349,0,102349
140822700201001,CONDO 503,Residential,6000,80026,0,86026
140822700201002,CONDO 503,Residential,7000,78150,0,85150
140822700201003,CONDO 503,Residential,6000,72826,0,78826
140822700301000,CONDO 503,Residential,8000,89589,0,97589
140822700301001,CONDO 503,Residential,6000,81021,0,87021
140822700301002,CONDO 503,Residential,7000,78150,0,85150
140822700301003,CONDO 503,Residential,6000,73830,0,79830
140822700401000,CONDO 503,Residential,8000,98842,0,106842
140822700401001,CONDO 503,Residential,6000,76891,0,82891
140822700401002,CONDO 503,Residential,7000,79303,0,86303
140822700401003,CONDO 503,Residential,6000,70006,0,76006
140822700501000,CONDO 503,Residential,8000,89589,0,97589
140822700501001,CONDO 503,Residential,6000,76891,0,82891
140822700501002,CONDO 503,Residential,7000,75328,0,82328
140822700501003,CONDO 503,Residential,6000,72826,0,78826
140822700601000,CONDO 503,Residential,8000,93774,0,101774
140822700601001,CONDO 503,Residential,6000,77500,0,83500
140822700601002,CONDO 503,Residential,7000,78150,0,85150
140822700601003,CONDO 503,Residential,6000,74391,0,80391
140822700701000,CONDO 503,Residential,8000,97269,0,105269
140822700701001,CONDO 503,Residential,6000,77125,0,83125
140822700701002,CONDO 503,Residential,7000,78404,0,85404
140822700701003,CONDO 503,Residential,6000,74181,0,80181
140822700801000,CONDO 503,Residential,8000,89450,0,97450
140822700801001,CONDO 503,Residential,6000,80199,0,86199
140822700801002,CONDO 503,Residential,7000,80494,0,87494
140822700801003,CONDO 503,Residential,6000,70920,0,76920
140822700901000,CONDO 503,Residential,8000,92724,0,100724
140822700901001,CONDO 503,Residential,6000,80556,0,86556
140822700901002,CONDO 503,Residential,7000,83331,0,90331
140822700901003,CONDO 503,Residential,6000,73374,0,79374
140822701001000,CONDO 503,Residential,8000,93165,0,101165
140822701001001,CONDO 503,Residential,6000,83981,0,89981
140822701001002,CONDO 503,Residential,7000,79077,0,86077
140822701001003,CONDO 503,Residential,6000,70093,0,76093
140822701101000,CONDO 503,Residential,8000,92380,0,100380
140822701101001,CONDO 503,Residential,6000,76911,0,82911
140822701101002,CONDO 503,Residential,7000,78449,0,85449
140822701101003,CONDO 503,Residential,6000,70394,0,76394
140822701201000,CONDO 503,Residential,8000,89589,0,97589
140822701201001,CONDO 503,Residential,6000,80026,0,86026
140822701201002,CONDO 503,Residential,7000,75328,0,82328
140822701201003,CONDO 503,Residential,6000,70006,0,76006
140822701301000,CONDO 503,Residential,8000,93165,0,101165
140822701301001,CONDO 503,Residential,6000,76311,0,82311
140822701301002,CONDO 503,Residential,7000,75328,0,82328
140822701301003,CONDO 503,Residential,6000,70006,0,76006
140822701401000,CONDO 503,Residential,8000,93640,0,101640
140822701401001,CONDO 503,Residential,6000,80026,0,86026
140822701401002,CONDO 503,Residential,7000,76130,0,83130
140822701401003,CONDO 503,Residential,6000,69483,0,75483
140822701501000,CONDO 503,Residential,8000,88080,0,96080
140822701501001,CONDO 503,Residential,6000,76891,0,82891
140822701501002,CONDO 503,Residential,7000,75876,0,82876
140822701501003,CONDO 503,Residential,6000,71364,0,77364
140822701601000,CONDO 503,Residential,8000,93600,0,101600
140822701601001,CONDO 503,Residential,6000,73964,0,79964
140822701601002,CONDO 503,Residential,7000,75328,0,82328
140822701601003,CONDO 503,Residential,6000,71447,0,77447
140822800101000,CONDO 503,Residential,8000,93999,0,101999
140822800101001,CONDO 503,Residential,6000,80124,0,86124
140822800101002,CONDO 503,Residential,7000,79146,0,86146
140822800101003,CONDO 503,Residential,6000,73227,0,79227
140822800201000,CONDO 503,Residential,8000,93999,0,101999
140822800201001,CONDO 503,Residential,6000,80986,0,86986
140822800201002,CONDO 503,Residential,7000,79720,0,86720
140822800201003,CONDO 503,Residential,6000,73774,0,79774
140822800301000,CONDO 503,Residential,8000,93694,0,101694
140822800301001,CONDO 503,Residential,6000,82286,0,88286
140822800301002,CONDO 503,Residential,7000,78150,0,85150
140822800301003,CONDO 503,Residential,6000,72877,0,78877
140822800401000,CONDO 503,Residential,8000,93842,0,101842
140822800401001,CONDO 503,Residential,6000,80219,0,86219
140822800401002,CONDO 503,Residential,7000,76269,0,83269
140822800401003,CONDO 503,Residential,6000,72826,0,78826
140822800501000,CONDO 503,Residential,8000,99713,0,107713
140822800501001,CONDO 503,Residential,6000,76891,0,82891
140822800501002,CONDO 503,Residential,7000,82020,0,89020
140822800501003,CONDO 503,Residential,6000,71008,0,77008
140822800601000,CONDO 503,Residential,8000,89589,0,97589
140822800601001,CONDO 503,Residential,6000,80026,0,86026
140822800601002,CONDO 503,Residential,7000,78150,0,85150
140822800601003,CONDO 503,Residential,6000,73967,0,79967
140822800701000,CONDO 503,Residential,8000,93165,0,101165
140822800701001,CONDO 503,Residential,6000,77500,0,83500
140822800701002,CONDO 503,Residential,7000,75328,0,82328
140822800701003,CONDO 503,Residential,6000,70006,0,76006
140822800801000,CONDO 503,Residential,8000,92990,0,100990
140822800801001,CONDO 503,Residential,6000,80026,0,86026
140822800801002,CONDO 503,Residential,7000,76962,0,83962
140822800801003,CONDO 503,Residential,6000,72826,0,78826
140822800901000,CONDO 503,Residential,8000,93999,0,101999
140822800901001,CONDO 503,Residential,6000,80488,0,86488
140822800901002,CONDO 503,Residential,7000,79146,0,86146
140822800901003,CONDO 503,Residential,6000,73800,0,79800
140822801000000,NE 140,Residential,11100,0,0,11100
140822801101000,CONDO 503,Residential,8000,102819,0,110819
140822801101001,CONDO 503,Residential,6000,90300,0,96300
140822801101002,CONDO 503,Residential,7000,91066,0,98066
140822801101003,CONDO 503,Residential,6000,79451,0,85451
140822801101004,CONDO 503,Residential,8000,105954,0,113954
140822801101005,CONDO 503,Residential,6000,91920,0,97920
140822801101006,CONDO 503,Residential,7000,91168,0,98168
140822801101007,CONDO 503,Residential,6000,80398,0,86398
140822801101008,CONDO 503,Residential,8000,100478,0,108478
140822801101009,CONDO 503,Residential,6000,87306,0,93306
140822801101010,CONDO 503,Residential,7000,91867,0,98867
140822801101011,CONDO 503,Residential,6000,80039,0,86039
140822801201000,CONDO 503,Residential,8000,100603,0,108603
140822801201001,CONDO 503,Residential,6000,83258,0,89258
140822801201002,CONDO 503,Residential,7000,82051,0,89051
140822801201003,CONDO 503,Residential,6000,77885,0,83885
140822801301000,CONDO 503,Residential,8000,98349,0,106349
140822801301001,CONDO 503,Residential,6000,83635,0,89635
140822801301002,CONDO 503,Residential,7000,80618,0,87618
140822801301003,CONDO 503,Residential,6000,76180,0,82180
140822801401000,CONDO 503,Residential,8000,97547,0,105547
140822801401001,CONDO 503,Residential,6000,80124,0,86124
140822801401002,CONDO 503,Residential,7000,82051,0,89051
140822801401003,CONDO 503,Residential,6000,73800,0,79800
140822801501000,CONDO 503,Residential,8000,93999,0,101999
140822801501001,CONDO 503,Residential,6000,80761,0,86761
140822801501002,CONDO 503,Residential,7000,82051,0,89051
140822801501003,CONDO 503,Residential,6000,73800,0,79800
140822900101000,CONDO 503,Residential,8000,106774,0,114774
140822900101001,CONDO 503,Residential,6000,86685,0,92685
140822900101002,CONDO 503,Residential,7000,88635,0,95635
140822900101003,CONDO 503,Residential,6000,81638,0,87638
140822900201000,CONDO 503,Residential,8000,99386,0,107386
140822900201001,CONDO 503,Residential,6000,87002,0,93002
140822900201002,CONDO 503,Residential,7000,87091,0,94091
140822900201003,CONDO 503,Residential,6000,82365,0,88365
140822900301000,CONDO 503,Residential,8000,106302,0,114302
140822900301001,CONDO 503,Residential,6000,92586,0,98586
140822900301002,CONDO 503,Residential,7000,87091,0,94091
140822900301003,CONDO 503,Residential,6000,78588,0,84588
140822900401000,CONDO 503,Residential,8000,102291,0,110291
140822900401001,CONDO 503,Residential,6000,86357,0,92357
140822900401002,CONDO 503,Residential,7000,87672,0,94672
140822900401003,CONDO 503,Residential,6000,78588,0,84588
140822900501000,CONDO 503,Residential,8000,105866,0,113866
140822900501001,CONDO 503,Residential,6000,86357,0,92357
140822900501002,CONDO 503,Residential,7000,93052,0,100052
140822900501003,CONDO 503,Residential,6000,78588,0,84588
140822900601000,CONDO 503,Residential,8000,104889,0,112889
140822900601001,CONDO 503,Residential,6000,86357,0,92357
140822900601002,CONDO 503,Residential,7000,91559,0,98559
140822900601003,CONDO 503,Residential,6000,78588,0,84588
140822900701000,CONDO 503,Residential,8000,105563,0,113563
140822900701001,CONDO 503,Residential,6000,87002,0,93002
140822900701002,CONDO 503,Residential,7000,92372,0,99372
140822900701003,CONDO 503,Residential,6000,82365,0,88365
140822900801000,CONDO 503,Residential,8000,104721,0,112721
140822900801001,CONDO 503,Residential,6000,85409,0,91409
140822900801002,CONDO 503,Residential,7000,86709,0,93709
140822900801003,CONDO 503,Residential,6000,77725,0,83725
140822900901000,CONDO 503,Residential,8000,98124,0,106124
140822900901001,CONDO 503,Residential,6000,92911,0,98911
140822900901002,CONDO 503,Residential,7000,90444,0,97444
140822900901003,CONDO 503,Residential,6000,80438,0,86438
140825100100000,NE 138,Residential,10944,0,0,10944
140825100200000,NE 138,Residential,61850,135643,0,197493
140825100300000,NE 138,Residential,50530,180254,0,230784
140825100400000,NE 138,Residential,48750,157916,0,206666
140825100500000,NE 138,Residential,55250,218320,0,273570
140825100600000,NE 138,Residential,43700,235131,0,278831
140825100700000,NE 138,Residential,51733,246315,0,298048
140825100800000,NE 138,Residential,44640,308359,0,352999
140825100900000,NE 138,Residential,48180,226562,0,274742
140825101000000,NE 138,Residential,49434,142885,0,192319
140825101100000,NE 138,Residential,45125,229839,0,274964
140825101200000,NE 138,Residential,46550,197653,0,244203
140825101300000,NE 138,Residential,46550,258531,0,305081
140825101400000,NE 138,Residential,49000,187466,0,236466
140825101500000,NE 138,Residential,51649,240984,0,292633
140825101600000,NE 138,Residential,48672,194196,0,242868
140825101700000,NE 138,Residential,124297,283821,0,408118
140825101800000,NE 138,Residential,63469,252486,0,315955
140825101900000,NE 138,Residential,76550,285110,0,361660
140825102000000,NE 138,Residential,76600,326366,0,402966
140825102100000,NE 138,Residential,53309,296463,0,349772
140825102200000,NE 138,Residential,52635,233603,0,286238
140825102300000,NE 138,Residential,75400,285533,0,360933
140825102400000,NE 138,Residential,54589,212911,0,267500
140825102500000,NE 138,Residential,49908,216083,0,265991
140825102600000,NE 138,Residential,46550,199514,0,246064
140825102700000,NE 138,Residential,46550,208977,0,255527
140825102800000,NE 138,Residential,51943,220648,0,272591
140825102900000,NE 138,Residential,44820,187648,0,232468
140825103000000,NE 138,Residential,52552,164091,0,216643
140825103100000,NE 138,Residential,60200,227688,0,287888
140825103200000,NE 138,Residential,50400,274600,0,325000
140825103300000,NE 138,Residential,75500,247675,0,323175
140825103400000,NE 138,Residential,48577,278511,0,327088
140825103500000,NE 138,Residential,48195,340532,0,388727
140825103600000,NE 138,Residential,51276,252419,0,303695
140825103700000,NE 138,Residential,56962,229288,0,286250
140825103800000,NE 138,Residential,56850,237332,0,294182
140825103900000,NE 138,Residential,61785,322017,0,383802
140825104000000,NE 138,Residential,20,0,0,20
140825104100000,NE 138,Residential,20,0,0,20
140825104200000,NE 138,Residential,20,0,0,20
140825200100000,NE 138,Residential,47923,208574,0,256497
140825200201000,CONDO 500,Residential,11000,98243,0,109243
140825200201001,CONDO 500,Residential,11000,102877,0,113877
140825200201002,CONDO 500,Residential,11000,100702,0,111702
140825200201003,CONDO 500,Residential,11000,100080,0,111080
140825200201004,CONDO 500,Residential,11000,103392,0,114392
140825200201005,CONDO 500,Residential,11000,103392,0,114392
140825200201006,CONDO 500,Residential,11000,105261,0,116261
140825200201007,CONDO 500,Residential,11000,102531,0,113531
140825200201008,CONDO 501,Residential,13000,224146,0,237146
140825200201009,CONDO 501,Residential,13000,212607,0,225607
140825200300000,NE 138,Residential,47500,173116,0,220616
140825200400000,NE 138,Residential,47500,176840,0,224340
140825200500000,NE 138,Residential,47500,141874,0,189374
140825300101000,CONDO 501,Residential,18000,195804,0,213804
140825300101001,CONDO 501,Residential,18000,173682,0,191682
140825300201000,CONDO 501,Residential,18000,199017,0,217017
140825300201001,CONDO 501,Residential,18000,206703,0,224703
140825300301000,CONDO 501,Residential,18000,164156,0,182156
140825300301001,CONDO 501,Residential,18000,170505,0,188505
140825300401000,CONDO 501,Residential,18000,230967,0,248967
140825300401001,CONDO 501,Residential,18000,185909,0,203909
140825300501000,CONDO 501,Residential,18000,208842,0,226842
140825300501001,CONDO 501,Residential,18000,222538,0,240538
140825300601000,CONDO 501,Residential,18000,196620,0,214620
140825300601001,CONDO 501,Residential,18000,200845,0,218845
140825300700000,NE 138,Residential,78,0,0,78
140825300701000,CONDO 501,Residential,18000,205238,0,223238
140825300701001,CONDO 501,Residential,18000,164661,0,182661
140825300801000,CONDO 501,Residential,18000,191056,0,209056
140825300801001,CONDO 501,Residential,18000,210207,0,228207
140825300901000,CONDO 501,Residential,18000,203717,0,221717
140825300901001,CONDO 501,Residential,18000,212000,0,230000
140825400100000,NE 138,Residential,51500,307426,0,358926
140825400200000,NE 138,Residential,51300,296654,0,347954
140825400300000,NE 138,Residential,50850,326131,0,376981
140825400400000,NE 138,Residential,52200,324364,0,376564
140825400500000,NE 138,Residential,56952,292569,0,349521
140825400600000,NE 138,Residential,55781,331194,0,386975
140825400700000,NE 138,Residential,47500,264634,0,312134
140827600100000,NE 136,Residential,38467,154478,0,192945
140827600200000,NE 136,Residential,37629,134256,0,171885
140827600300000,NE 136,Residential,38326,133596,0,171922
140827600400000,NE 136,Residential,39064,138945,0,178009
140827600500000,NE 136,Residential,39108,146821,0,185929
140827600600000,NE 136,Residential,37843,134554,0,172397
140827600700000,NE 136,Residential,38610,141256,0,179866
140827600800000,NE 136,Residential,38873,148864,0,187737
140827600900000,NE 136,Residential,37660,151111,0,188771
140827601000000,NE 136,Residential,37500,149306,0,186806
140827601100000,NE 136,Residential,39312,137698,0,177010
140827601200000,NE 136,Residential,38313,126978,0,165291
140827601300000,NE 136,Residential,37406,148986,0,186392
140827601400000,NE 136,Residential,40893,132431,0,173324
140827601500000,NE 136,Residential,34508,132072,0,166580
140827601600000,NE 136,Residential,35167,141132,0,176299
140827601700000,NE 136,Residential,36167,152210,0,188377
140827601800000,NE 136,Residential,35855,144433,0,180288
140827601900000,NE 136,Residential,36550,141035,0,177585
140827602000000,NE 136,Residential,35687,143574,0,179261
140827602100000,NE 136,Residential,36966,137418,0,174384
140827602200000,NE 136,Residential,36880,142710,0,179590
140827602300000,NE 136,Residential,37125,142582,0,179707
140827602400000,NE 136,Residential,38800,155100,0,193900
140827602500000,NE 136,Residential,39162,169780,0,208942
140827602600000,NE 136,Residential,37561,147825,0,185386
140827602700000,NE 136,Residential,38874,147462,0,186336
140827602800000,NE 136,Residential,34880,135877,0,170757
140827602900000,NE 136,Residential,35243,148092,0,183335
140827603000000,NE 136,Residential,38475,168404,0,206879
140827603100000,NE 136,Residential,38430,158536,0,196966
140827603200000,NE 136,Residential,36400,149020,0,185420
140827603300000,NE 136,Residential,35182,159066,0,194248
140827700100000,NE 136,Residential,37998,140333,0,178331
140827700200000,NE 136,Residential,37998,163256,0,201254
140827700300000,NE 136,Residential,37500,137887,0,175387
140827700400000,NE 136,Residential,37516,124739,0,162255
140827700500000,NE 136,Residential,37842,142583,0,180425
140827700600000,NE 136,Residential,40185,138568,0,178753
140827700700000,NE 136,Residential,37500,145303,0,182803
140827800100000,NE 136,Residential,40196,151004,0,191200
140827800200000,NE 136,Residential,40168,135965,0,176133
140827800300000,NE 136,Residential,40712,164418,0,205130
140827800400000,NE 136,Residential,41412,144012,0,185424
140827800500000,NE 136,Residential,40097,129232,0,169329
140827800600000,NE 136,Residential,41959,139366,0,181325
140827800700000,NE 136,Residential,39105,125198,0,164303
140827800800000,NE 136,Residential,39610,125094,0,164704
140827800900000,NE 136,Residential,39558,182057,0,221615
140827801000000,NE 136,Residential,41648,163054,0,204702
140827801100000,NE 136,Residential,41819,146589,0,188408
140827801200000,NE 136,Residential,44471,167187,0,211658
140827801300000,NE 136,Residential,46410,184803,0,231213
140827801400000,NE 136,Residential,41809,153279,0,195088
140827801500000,NE 136,Residential,42997,160565,0,203562
140827801600000,NE 136,Residential,43173,145278,0,188451
140827801700000,NE 136,Residential,40422,171028,0,211450
140827801800000,NE 136,Residential,40779,146064,0,186843
140827801900000,NE 136,Residential,36600,137066,0,173666
140827802000000,NE 136,Residential,39487,141036,0,180523
140827802100000,NE 136,Residential,40664,160136,0,200800
140827802200000,NE 136,Residential,40978,134910,0,175888
140827802300000,NE 136,Residential,41960,172350,0,214310
140827802400000,NE 136,Residential,37718,141571,0,179289
140827802500000,NE 136,Residential,39238,152174,0,191412
140827802600000,NE 136,Residential,42067,160711,0,202778
140827802700000,NE 136,Residential,45120,144783,0,189903
140827802800000,NE 136,Residential,45570,165538,0,211108
140827802900000,NE 136,Residential,46050,150713,0,196763
140827803000000,NE 136,Residential,45690,142563,0,188253
140827803100000,NE 136,Residential,1200,0,0,1200
140827900100000,NE 136,Residential,51370,287771,0,339141
140828000100000,NE 136,Residential,47320,208546,0,255866
140828000200000,NE 136,Residential,46611,230936,0,277547
140828000300000,NE 136,Residential,48357,264567,0,312924
140828000400000,NE 136,Residential,37206,161035,0,198241
140828000500000,NE 136,Residential,36813,137667,0,174480
140828000600000,NE 136,Residential,41007,150161,0,191168
140828000700000,NE 136,Residential,39346,154443,0,193789
140828000800000,NE 136,Residential,42997,174255,0,217252
140828000900000,NE 136,Residential,43125,177077,0,220202
140828001000000,NE 136,Residential,40116,185610,0,225726
140828001100000,NE 136,Residential,40836,150700,0,191536
140828001200000,NE 136,Residential,39924,127684,0,167608
140828001300000,NE 136,Residential,41850,164602,0,206452
140828001400000,NE 136,Residential,42187,161767,0,203954
140830100100000,NE 137,Residential,61820,227309,0,289129
140830100200000,NE 136,Residential,52741,195880,0,248621
140830100300000,NE 137,Residential,54981,238293,0,293274
140830100400000,NE 137,Residential,32520,178589,0,211109
140830100700000,NE 137,Residential,64020,322490,0,386510
140830100900000,NE 167,Residential,76454,327926,0,404380
140830101000000,NE 167,Residential,69041,346177,0,415218
140830101100000,NE 167,Residential,68322,389891,0,458213
140830101200000,NE 167,Residential,71229,366497,0,437726
140830101300000,NE 167,Residential,73401,384832,0,458233
140830101400000,NE 167,Residential,72069,366010,0,438079
140830101500000,NE 167,Residential,86402,310307,0,396709
140830101600000,NE 167,Residential,73442,364131,0,437573
140830101700000,NE 167,Residential,88061,390302,0,478363
140830101800000,NE 149,Residential,5138,0,0,5138
140830101900000,NE 149,Residential,5004,0,0,5004
140830102000000,NE 149,Residential,5004,0,0,5004
140830102100000,NE 149,Residential,4253,0,0,4253
140830102200000,NE 149,Residential,3628,0,0,3628
140830102300000,NE 149,Residential,3252,0,0,3252
140830102400000,NE 149,Residential,3628,0,0,3628
140830102600000,NE 149,Residential,6129,0,0,6129
140830102700000,NE 149,Residential,5004,0,0,5004
140830102800000,NE 149,Residential,4754,0,0,4754
140830102900000,NE 149,Residential,4754,0,0,4754
140830103000000,NE 149,Residential,4503,0,0,4503
140830103100000,NE 149,Residential,99910,340974,0,440884
140830103200000,NE 149,Residential,3850,0,0,3850
140830103300000,NE 149,Residential,25200,0,0,25200
140830103400000,NE 137,Residential,84525,348224,0,432749
140830200100000,NE 137,Residential,49511,210639,0,260150
140830200200000,NE 137,Residential,55685,204185,0,259870
140830200300000,NE 137,Residential,58352,345215,0,403567
140830200400000,NE 137,Residential,70276,355276,0,425552
140830200500000,NE 137,Residential,57288,297748,0,355036
140830200600000,NE 137,Residential,60366,208572,0,268938
140830200700000,NE 137,Residential,62016,222340,0,284356
140830200800000,NE 137,Residential,60336,299742,0,360078
140830200900000,NE 137,Residential,49895,191928,0,241823
140830201000000,NE 137,Residential,55105,213095,0,268200
140830201100000,NE 137,Residential,54388,194016,0,248404
140830201200000,NE 137,Residential,54945,212965,0,267910
140830300100000,NE 137,Residential,61123,259735,0,320858
140830300200000,NE 137,Residential,60900,274635,0,335535
140830300300000,NE 137,Residential,63825,275194,0,339019
140830300400000,NE 137,Residential,65151,326936,0,392087
140830300500000,NE 137,Residential,63990,257943,0,321933
140830300600000,NE 137,Residential,60833,248189,0,309022
140830300700000,NE 167,Residential,104558,541685,0,646243
140830300800000,NE 167,Residential,92800,336559,0,429359
140830300900000,NE 167,Residential,75582,349013,0,424595
140830301000000,NE 167,Residential,98325,342180,0,440505
140830301100000,NE 167,Residential,89390,377076,0,466466
140830301200000,NE 167,Residential,83448,384499,0,467947
140830301300000,NE 167,Residential,83362,370962,0,454324
140830301400000,NE 167,Residential,86402,372465,0,458867
140832600100000,NE 137,Residential,68995,441141,0,510136
140832600200000,NE 137,Residential,68818,378948,0,447766
140832600300000,NE 137,Residential,78150,300980,0,379130
140832600400000,NE 138,Residential,65875,268666,0,334541
140832600500000,NE 138,Residential,64062,270873,0,334935
140832600600000,NE 138,Residential,60560,229110,0,289670
140832600700000,NE 138,Residential,64260,381337,0,445597
140832600800000,NE 138,Residential,61680,363095,0,424775
140832600900000,NE 138,Residential,67680,317220,0,384900
140832601000000,NE 138,Residential,62320,294637,0,356957
140832601100000,NE 138,Residential,54702,372925,0,427627
140832601200000,NE 138,Residential,58032,318569,0,376601
140832601300000,NE 138,Residential,51012,205907,0,256919
140832601400000,NE 138,Residential,56407,304433,0,360840
140832601500000,NE 138,Residential,55526,334633,0,390159
140832601600000,NE 138,Residential,100600,290462,0,391062
140832601800000,NE 137,Residential,77200,312999,0,390199
140832601900000,NE 137,Residential,10000,0,0,10000
140832602000000,NE 137,Residential,78250,244985,0,323235
140832602100000,NE 137,Residential,77200,259724,0,336924
140832602300000,NE 167,Residential,91123,468878,0,560001
140832602400000,NE 167,Residential,78826,556996,0,635822
140832602500000,NE 167,Residential,99450,354193,0,453643
140832602600000,NE 167,Residential,86895,0,0,86895
140832602700000,E-15 CITY,Exempt,0,0,0,0
140832602800000,NE 167,Residential,74814,356112,0,430926
140832700100000,NE 138,Residential,62152,383661,0,445813
140835100100000,NE 167,Residential,71504,0,0,71504
140835100200000,NE 167,Residential,81081,431186,0,512267
140835100300000,NE 167,Residential,88036,456289,0,544325
140835100400000,NE 167,Residential,73400,445410,0,518810
140835200200000,NE 167,Residential,154100,968128,0,1122228
140835200300000,NE 167,Residential,71198,560596,0,631794
140835200400000,NE 167,Residential,92988,405917,0,498905
140835200500000,NE 167,Residential,88919,437654,0,526573
140835200600000,NE 167,Residential,102240,412693,0,514933
140835200700000,NE 167,Residential,90293,350852,0,441145
140835200800000,NE 167,Residential,53409,0,0,53409
140835200900000,NE 167,Residential,59129,343389,0,402518
140835201000000,NE 167,Residential,88585,296879,0,385464
140835201100000,NE 167,Residential,87675,282115,0,369790
140835201200000,Empty,Other,0,0,0,0
140835201300000,NE 167,Residential,77616,493840,0,571456
140835201400000,NE 167,Residential,82971,469051,0,552022
140835201500000,NE 167,Residential,129363,414878,0,544241
140835201600000,NE 167,Residential,131000,488568,0,619568
140835201700000,NE 167,Residential,206350,568919,0,775269
140835201800000,NE 167,Residential,122944,522282,0,645226
140835201900000,NE 167,Residential,98428,530618,0,629046
140835202000000,NE 167,Residential,95558,503318,0,598876
140837600100000,E-15 CITY,Exempt,0,0,0,0
140837600500000,NE 167,Residential,113227,369695,0,482922
140837600600000,NE 167,Residential,81354,338578,0,419932
140837600700000,NE 167,Residential,80535,372425,0,452960
140837600800000,NE 167,Residential,71938,0,0,71938
140837600900000,NE 167,Residential,82000,329637,0,411637
140837601000000,NE 167,Residential,74631,366901,0,441532
140837601100000,NE 167,Residential,75717,332953,0,408670
140837601200000,NE 167,Residential,64855,0,0,64855
140837601300000,NE 149,Residential,136710,277001,0,413711
140837601400000,NE 149,Residential,8070,0,0,8070
140837601500000,NE 149,Residential,7532,0,0,7532
140837601600000,NE 149,Residential,8070,0,0,8070
140837601700000,NE 149,Residential,9049,0,0,9049
140837700100000,NE 167,Residential,60775,371745,0,432520
140837700200000,NE 167,Residential,73173,354093,0,427266
140837700300000,NE 167,Residential,74725,365491,0,440216
140837700600000,NE 149,Residential,2995,0,0,2995
140837700900000,NE 167,Residential,57420,328044,0,385464
140837701000000,NE 167,Residential,68580,345661,0,414241
140837701300000,NE 167,Residential,58608,369866,0,428474
140837701600000,NE 167,Residential,37248,0,0,37248
140837701700000,NE 167,Residential,47064,0,0,47064
140840100100000,NE 135,Residential,22194,161376,0,183570
140840100200000,NE 135,Residential,24150,130668,0,154818
140840100300000,NE 135,Residential,24150,106025,0,130175
140840100400000,NE 135,Residential,24150,130287,0,154437
140840100500000,NE 135,Residential,25760,128316,0,154076
140840100600000,NE 135,Residential,25760,129076,0,154836
140840100700000,NE 135,Residential,27600,119365,0,146965
140840100800000,NE 135,Residential,25507,117269,0,142776
140840100900000,NE 135,Residential,24782,136339,0,161121
140840101000000,NE 135,Residential,24150,129179,0,153329
140840101100000,NE 135,Residential,25760,93443,0,119203
140840101200000,NE 135,Residential,24150,111327,0,135477
140840101300000,NE 135,Residential,24150,135253,0,159403
140840101400000,NE 135,Residential,24150,116202,0,140352
140840101500000,NE 135,Residential,25105,115107,0,140212
140840200100000,NE 135,Residential,28679,119420,0,148099
140840200200000,NE 135,Residential,28697,134697,0,163394
140840200300000,NE 135,Residential,61950,0,0,61950
140840200400000,NE 135,Residential,32908,153886,0,186794
140840200500000,NE 135,Residential,31617,152492,0,184109
140840200600000,NE 135,Residential,30683,130019,0,160702
140840200700000,NE 135,Residential,32083,121432,0,153515
140840200800000,NE 135,Residential,32480,178447,0,210927
140840200900000,NE 135,Residential,29211,149796,0,179007
140840201000000,NE 135,Residential,30428,146658,0,177086
140840201100000,NE 135,Residential,30013,160553,0,190566
140840201200000,NE 135,Residential,29750,132380,0,162130
140840201300000,NE 135,Residential,29353,127638,0,156991
140840201400000,NE 135,Residential,29393,115592,0,144985
140840201500000,NE 135,Residential,27014,141963,0,168977
140840201600000,NE 135,Residential,28600,144720,0,173320
140840201700000,NE 135,Residential,26096,141880,0,167976
140840201800000,NE 135,Residential,28359,149157,0,177516
140840300100000,NE 135,Residential,24878,104218,0,129096
140840300200000,NE 135,Residential,24675,119374,0,144049
140840300300000,NE 135,Residential,27038,127993,0,155031
140840300400000,NE 135,Residential,27212,151812,0,179024
140840300500000,NE 135,Residential,29452,154429,0,183881
140840300600000,NE 135,Residential,29717,119566,0,149283
140840300700000,NE 135,Residential,29592,143502,0,173094
140840300800000,NE 135,Residential,27515,123460,0,150975
140840300900000,NE 135,Residential,28102,130824,0,158926
140840301000000,NE 135,Residential,27189,122035,0,149224
140840301100000,NE 135,Residential,25561,120301,0,145862
140840301200000,NE 135,Residential,31841,120884,0,152725
140840301300000,NE 135,Residential,32116,137181,0,169297
140840301400000,NE 135,Residential,32116,147445,0,179561
140840301500000,NE 135,Residential,31862,144372,0,176234
140840301600000,NE 135,Residential,31862,146583,0,178445
140840301700000,NE 135,Residential,31865,148859,0,180724
140840301800000,NE 135,Residential,26034,151884,0,177918
140840301900000,NE 135,Residential,29699,150783,0,180482
140840302000000,NE 135,Residential,31108,139191,0,170299
140840302100000,NE 135,Residential,23436,144299,0,167735
140840302200000,NE 135,Residential,27927,152468,0,180395
140840302300000,NE 135,Residential,26160,113536,0,139696
140840302400000,NE 135,Residential,24750,109083,0,133833
140840302500000,NE 135,Residential,19813,118763,0,138576
140840302600000,NE 135,Residential,24355,122128,0,146483
140840400100000,NE 135,Residential,30692,106179,0,136871
140840400200000,NE 135,Residential,27370,119449,0,146819
140840400300000,NE 135,Residential,31267,128521,0,159788
140840400400000,NE 135,Residential,32585,181223,0,213808
140840400500000,NE 135,Residential,31609,135469,0,167078
140840400600000,NE 135,Residential,31235,149333,0,180568
140840400700000,NE 135,Residential,32862,153232,0,186094
140840400800000,NE 135,Residential,34257,157609,0,191866
140840400900000,NE 135,Residential,30801,124283,0,155084
140840401000000,NE 135,Residential,32820,135854,0,168674
140840401100000,NE 135,Residential,32504,155083,0,187587
140840401200000,NE 135,Residential,31331,114884,0,146215
140840401300000,NE 135,Residential,36750,227272,0,264022
140842600100000,NE 135,Residential,93300,0,0,93300
140842600200000,NE 135,Residential,176950,0,0,176950
140842600300000,NE 135,Residential,34510,158155,0,192665
140842600400000,NE 135,Residential,31145,176919,0,208064
140842600500000,NE 135,Residential,33220,150994,0,184214
140842600600000,NE 135,Residential,35094,159084,0,194178
140842600700000,NE 135,Residential,33220,146103,0,179323
140842600800000,NE 135,Residential,34857,204597,0,239454
140842600900000,NE 135,Residential,32050,161528,0,193578
140845100100000,NE 135,Residential,26142,148808,0,174950
140845100200000,NE 135,Residential,29050,144937,0,173987
140845100300000,NE 135,Residential,27720,146849,0,174569
140845200100000,NE 135,Residential,36109,133074,0,169183
140845200200000,NE 135,Residential,34252,224639,0,258891
140845200300000,NE 135,Residential,29155,175251,0,204406
140845200400000,NE 135,Residential,31150,171233,0,202383
140845200500000,NE 135,Residential,30210,146172,0,176382
140845200600000,NE 135,Residential,32035,135237,0,167272
140845200700000,NE 135,Residential,33453,158603,0,192056
140845200800000,NE 135,Residential,30940,203710,0,234650
140845200900000,NE 135,Residential,30702,161304,0,192006
140845201000000,NE 135,Residential,32427,176452,0,208879
140845201100000,NE 135,Residential,34791,173584,0,208375
140845201200000,NE 135,Residential,32760,177747,0,210507
140845201300000,NE 135,Residential,32664,174472,0,207136
140845201400000,NE 135,Residential,31487,157607,0,189094
140845201500000,NE 135,Residential,47650,184117,0,231767
140845201600000,NE 149,Residential,37468,174347,0,211815
140845201700000,NE 149,Residential,29211,201539,0,230750
140845201800000,NE 149,Residential,29211,198374,0,227585
140845201900000,NE 135,Residential,38114,148626,0,186740
140845202000000,NE 135,Residential,32505,175238,0,207743
140845202100000,NE 135,Residential,32725,194531,0,227256
140845202200000,NE 135,Residential,32907,160289,0,193196
140845202300000,NE 135,Residential,45350,181456,0,226806
140845202400000,NE 135,Residential,32997,162469,0,195466
140845202500000,NE 135,Residential,31327,136687,0,168014
140845202600000,NE 135,Residential,31059,125297,0,156356
140845202700000,NE 135,Residential,32319,136918,0,169237
140845202800000,NE 135,Residential,33165,166908,0,200073
140845202900000,NE 135,Residential,30527,166544,0,197071
140845300100000,NE 135,Residential,33495,159910,0,193405
140845300200000,NE 135,Residential,88550,0,0,88550
140845300300000,NE 135,Residential,47275,166636,0,213911
140845300400000,NE 135,Residential,46550,200240,0,246790
140845300500000,NE 135,Residential,47000,154257,0,201257
140845300600000,NE 149,Residential,49823,193988,0,243811
140845300700000,NE 149,Residential,27543,211202,0,238745
140845300800000,NE 135,Residential,30048,192058,0,222106
140845300900000,NE 135,Residential,34650,166673,0,201323
140845301000000,NE 135,Residential,34587,164013,0,198600
140845301100000,NE 135,Residential,34486,203755,0,238241
140845301200000,NE 135,Residential,28558,161739,0,190297
140845301300000,NE 135,Residential,35700,173847,0,209547
140845301400000,NE 135,Residential,45475,174363,0,219838
140845301500000,NE 135,Residential,35224,159747,0,194971
140845301600000,NE 135,Residential,32830,147417,0,180247
140845301700000,NE 135,Residential,32205,162271,0,194476
140845301800000,NE 135,Residential,30940,165473,0,196413
140845301900000,NE 135,Residential,31535,166203,0,197738
140845302000000,NE 135,Residential,31833,174485,0,206318
140845302100000,NE 135,Residential,32428,144011,0,176439
140845302200000,NE 135,Residential,33023,157715,0,190738
140845302300000,NE 135,Residential,33618,151341,0,184959
140847600100000,NE 135,Residential,95700,135436,0,231136
140847600200000,NE 135,Residential,29162,137480,0,166642
140847600300000,NE 135,Residential,29453,147627,0,177080
140847600400000,NE 135,Residential,30048,140229,0,170277
140847600500000,NE 135,Residential,31462,128210,0,159672
140847600600000,NE 135,Residential,33226,129949,0,163175
140847600700000,NE 135,Residential,34335,143106,0,177441
140847600800000,NE 135,Residential,28167,0,0,28167
140847600900000,NE 135,Residential,31582,126610,0,158192
140847601000000,NE 135,Residential,32246,120831,0,153077
140847601100000,NE 135,Residential,31640,109224,0,140864
140847601200000,NE 135,Residential,31261,156965,0,188226
140847601300000,NE 135,Residential,31533,134102,0,165635
140847601400000,NE 135,Residential,31809,151945,0,183754
140847601500000,NE 135,Residential,31659,148542,0,180201
140847601600000,NE 135,Residential,32787,178487,0,211274
140847601700000,NE 135,Residential,33278,134929,0,168207
140847601800000,NE 135,Residential,31594,153373,0,184967
140847601900000,NE 135,Residential,31327,156409,0,187736
140847602000000,NE 135,Residential,31327,128920,0,160247
140847602100000,NE 135,Residential,31424,145441,0,176865
140847602200000,NE 135,Residential,32103,150288,0,182391
140847602300000,NE 135,Residential,31832,138187,0,170019
140847602400000,NE 135,Residential,32694,171029,0,203723
140847602500000,NE 135,Residential,32012,153271,0,185283
140847602600000,NE 135,Residential,31594,171245,0,202839
140847602700000,NE 135,Residential,31785,152854,0,184639
140847602800000,NE 135,Residential,29155,122748,0,151903
140847602900000,NE 135,Residential,29155,145435,0,174590
140847603000000,NE 135,Residential,24908,149681,0,174589
140847603100000,NE 135,Residential,3525,0,0,3525
140847603201000,CONDO 505,Residential,10000,107220,0,117220
140847603201001,CONDO 505,Residential,10000,104093,0,114093
140847603201002,CONDO 505,Residential,10000,101220,0,111220
140847603201003,CONDO 505,Residential,10000,104042,0,114042
140847603201004,CONDO 505,Residential,10000,104319,0,114319
140847603201005,CONDO 505,Residential,10000,101920,0,111920
140847603201006,CONDO 505,Residential,10000,98944,0,108944
140847603201007,CONDO 505,Residential,10000,104037,0,114037
140847700100000,NE 135,Residential,29654,149850,0,179504
140847700200000,NE 135,Residential,27160,153263,0,180423
140847700300000,NE 135,Residential,28905,139591,0,168496
140847700400000,NE 135,Residential,31546,154180,0,185726
140847700500000,NE 135,Residential,46125,117801,0,163926
140847700600000,NE 135,Residential,45225,221153,0,266378
140847700700000,NE 135,Residential,34650,147777,0,182427
140847700800000,NE 135,Residential,32725,162180,0,194905
140847700900000,NE 135,Residential,31135,133745,0,164880
140847701000000,NE 135,Residential,29248,144187,0,173435
140847701100000,NE 135,Residential,27189,149285,0,176474
140847701200000,NE 135,Residential,35897,153284,0,189181
140847701300000,NE 135,Residential,37775,158923,0,196698
140847701400000,NE 135,Residential,35593,152017,0,187610
140847701500000,NE 135,Residential,29453,149757,0,179210
140847701600000,NE 135,Residential,26775,142268,0,169043
140910100100000,NE 132,Residential,30120,69888,0,100008
140910100200000,NE 132,Residential,24240,57206,0,81446
140910100300000,NE 132,Residential,23432,58886,0,82318
140910100400000,COMM NE,Commercial,64800,0,209606,274406
140910100500000,COMM NE,Commercial,129254,0,333967,463221
140910100600000,E-73 LOW RENT HOUSE,Exempt,61560,0,854683,916243
140910100701000,CONDO 500,Residential,4000,48991,0,52991
140910100701001,CONDO 500,Residential,4000,48991,0,52991
140910100701002,CONDO 500,Residential,4000,48991,0,52991
140910100701003,CONDO 500,Residential,4000,48991,0,52991
140910100701004,CONDO 500,Residential,4000,48991,0,52991
140910100701005,CONDO 500,Residential,4000,48991,0,52991
140910100701006,CONDO 500,Residential,4000,48991,0,52991
140910100701007,CONDO 500,Residential,4000,48991,0,52991
140910100701008,CONDO 500,Residential,4000,48991,0,52991
140910100701009,CONDO 500,Residential,4000,48991,0,52991
140910100701010,CONDO 500,Residential,4000,48991,0,52991
140910100701011,CONDO 500,Residential,4000,48991,0,52991
140910100701012,CONDO 500,Residential,4000,48991,0,52991
140910100701013,CONDO 500,Residential,4000,48991,0,52991
140910100701014,CONDO 500,Residential,4000,48991,0,52991
140910100701015,CONDO 500,Residential,4000,48991,0,52991
140910100701016,CONDO 500,Residential,4000,48991,0,52991
140910100701017,CONDO 500,Residential,4000,48991,0,52991
140910100701018,CONDO 500,Residential,4000,48991,0,52991
140910100701019,CONDO 500,Residential,4000,48991,0,52991
140910100701020,CONDO 500,Residential,4000,48991,0,52991
140910100701021,CONDO 500,Residential,4000,48991,0,52991
140910100701022,CONDO 500,Residential,4000,48991,0,52991
140910100701023,CONDO 500,Residential,4000,48991,0,52991
140910100800000,APTS NE,Commercial,69660,0,930340,1000000
140910101100000,Empty,Exempt,0,0,0,0
140910101200000,NE 132,Residential,29510,79711,0,109221
140910101300000,NE 132,Residential,31050,89684,0,120734
140910101400000,NE 132,Residential,31050,83721,0,114771
140910101500000,NE 132,Residential,31050,76223,0,107273
140910101600000,NE 132,Residential,31050,87369,0,118419
140910101700000,NE 132,Residential,31050,77898,0,108948
140910101800000,NE 132,Residential,31050,86740,0,117790
140910101900000,NE 132,Residential,31050,105246,0,136296
140910102000000,NE 132,Residential,31050,82608,0,113658
140910102100000,NE 132,Residential,31050,109569,0,140619
140910102200000,NE 132,Residential,31050,109488,0,140538
140910102300000,NE 132,Residential,31050,94153,0,125203
140910102400000,NE 132,Residential,31050,108997,0,140047
140910102500000,APTS NE,Commercial,104112,0,1071210,1175322
140910200100000,APTS NE,Commercial,863460,0,13397565,14261025
140910200200000,NE 132,Residential,33000,85349,0,118349
140910200300000,NE 132,Residential,30000,94004,0,124004
140910200400000,NE 132,Residential,33000,96856,0,129856
140910200500000,NE 132,Residential,33000,74028,0,107028
140910200600000,NE 132,Residential,33000,80729,0,113729
140910200700000,NE 132,Residential,33000,67145,0,100145
140910200800000,NE 132,Residential,33000,70504,0,103504
140910200900000,NE 132,Residential,33000,77119,0,110119
140910201000000,NE 132,Residential,33000,75844,0,108844
140910201100000,NE 132,Residential,33000,78563,0,111563
140910201200000,NE 132,Residential,36795,93743,0,130538
140910300100000,NE 132,Residential,33972,75659,0,109631
140910300200000,NE 132,Residential,33000,73464,0,106464
140910300300000,NE 132,Residential,33000,69354,0,102354
140910300400000,NE 132,Residential,33000,68281,0,101281
140910300500000,NE 132,Residential,33000,85559,0,118559
140910300600000,NE 132,Residential,33000,82128,0,115128
140910300700000,NE 132,Residential,33000,130590,0,163590
140910300800000,NE 132,Residential,33000,71170,0,104170
140910300900000,NE 132,Residential,33000,99064,0,132064
140910301000000,NE 132,Residential,33000,85921,0,118921
140910301100000,NE 132,Residential,33000,61084,0,94084
140910301200000,NE 132,Residential,33000,83123,0,116123
140910301300000,NE 132,Residential,31900,70766,0,102666
140910301400000,NE 132,Residential,33000,78465,0,111465
140910301500000,NE 132,Residential,33000,73985,0,106985
140910301600000,NE 132,Residential,33000,71980,0,104980
140910301700000,NE 132,Residential,33000,90025,0,123025
140910301800000,NE 132,Residential,33000,105431,0,138431
140910301900000,NE 132,Residential,30000,69790,0,99790
140910302000000,NE 132,Residential,33000,89006,0,122006
140910302100000,NE 132,Residential,33000,70919,0,103919
140910302200000,NE 132,Residential,32028,72715,0,104743
140912600100000,COMM NE,Commercial,184896,0,418332,603228
140912600200000,COMM NE,Commercial,761400,0,1353957,2115357
140912600300000,COMM NE,Commercial,340200,0,208732,548932
140912600400000,COMM NE,Commercial,97470,0,428369,525839
140912600500000,COMM NE,Commercial,305235,0,454946,760181
140912600600000,NE 132,Residential,40314,105560,0,145874
140912600700000,NE 132,Residential,35530,83994,0,119524
140912600800000,NE 132,Residential,33000,74233,0,107233
140912600900000,NE 132,Residential,33000,64599,0,97599
140912601000000,NE 132,Residential,33000,84603,0,117603
140912601100000,COMM NE,Commercial,34020,0,106869,140889
140912601200000,COMM NE,Commercial,41368,0,128632,170000
140912601300000,COMM NE,Commercial,30026,0,154349,184375
140912601400000,COMM NE,Commercial,45360,0,212488,257848
140912601500000,COMM NE,Commercial,178200,0,0,178200
140912700100000,COMM NE,Commercial,248184,0,280168,528352
140912700200000,COMM NE,Commercial,174420,0,65716,240136
140912700300000,COMM NE,Commercial,108432,0,91568,200000
140912700400000,COMM NE,Commercial,105192,0,94808,200000
140912700700000,Empty,Other,0,0,0,0
140912700800000,COMM NE,Commercial,86594,0,78824,165418
140912700900000,COMM NE,Commercial,60756,0,111822,172578
140912701000000,COMM NE,Commercial,284310,0,202423,486733
140912701100000,COMM NE,Commercial,209520,0,190413,399933
140912701200000,COMM NE,Commercial,94562,0,171658,266220
140912701300000,COMM NE,Commercial,193860,0,320415,514275
140912701400000,COMM NE,Commercial,361800,0,476781,838581
140912701500000,COMM NE,Commercial,130108,0,60523,190631
140912701600000,COMM NE,Commercial,313200,0,204934,518134
140912800100000,NE 132,Residential,33000,75399,0,108399
140912800200000,NE 132,Residential,33000,84128,0,117128
140912800300000,NE 132,Residential,33000,73653,0,106653
140912800400000,NE 132,Residential,33000,66055,0,99055
140912800500000,NE 132,Residential,35653,82656,0,118309
140912800600000,NE 132,Residential,33642,63764,0,97406
140912800700000,NE 132,Residential,33000,66131,0,99131
140912800800000,NE 132,Residential,31900,69460,0,101360
140912800900000,NE 132,Residential,33000,71686,0,104686
140912801000000,NE 132,Residential,31900,77676,0,109576
140912900100000,NE 133,Residential,146,0,0,146
140915100100000,NE 132,Residential,33000,84665,0,117665
140915100200000,NE 132,Residential,33000,74521,0,107521
140915100300000,NE 132,Residential,29333,97038,0,126371
140915100400000,NE 132,Residential,17271,75605,0,92876
140915100500000,NE 132,Residential,16920,79804,0,96724
140915100600000,NE 132,Residential,16920,74918,0,91838
140915100700000,NE 132,Residential,16826,74054,0,90880
140915100800000,NE 132,Residential,32450,82337,0,114787
140915100900000,NE 132,Residential,31900,69681,0,101581
140915101000000,NE 132,Residential,31900,72712,0,104612
140915102000000,Empty,Other,0,0,0,0
140915200100000,COMM NE,Commercial,159181,0,349120,508301
140915200200000,COMM NE,Commercial,154829,0,10171,165000
140915200300000,COMM NE,Commercial,118563,0,346021,464584
140915200500000,NE 132,Residential,20007,41225,0,61232
140915200600000,NE 132,Residential,20880,60428,0,81308
140915200700000,APTS NE,Commercial,25272,0,199728,225000
140915200800000,COMM NE,Commercial,45360,0,71453,116813
140915200900000,COMM NE,Commercial,150336,0,522008,672344
140915201000000,NE 132,Residential,21895,64495,0,86390
140915201100000,COMM NE,Commercial,100980,0,215955,316935
140915201200000,COMM NE,Commercial,98820,0,250994,349814
140915201300000,COMM NE,Commercial,95580,0,295421,391001
140915201400000,NE 132,Residential,18550,50130,0,68680
140915300100000,NE 132,Residential,32670,69901,0,102571
140915300200000,NE 132,Residential,32670,94904,0,127574
140915300300000,NE 132,Residential,31944,81998,0,113942
140915300400000,NE 132,Residential,43124,72734,0,115858
140915300500000,NE 132,Residential,24000,50815,0,74815
140915300600000,NE 132,Residential,23100,98816,0,121916
140915300700000,NE 132,Residential,33550,72360,0,105910
140915300800000,NE 132,Residential,33000,64671,0,97671
140915300900000,NE 132,Residential,33000,90726,0,123726
140915400100000,NE 132,Residential,33000,87015,0,120015
140915400200000,NE 132,Residential,33000,74232,0,107232
140915400300000,NE 132,Residential,33000,83644,0,116644
140915400400000,NE 132,Residential,33000,68043,0,101043
140915400500000,NE 132,Residential,32120,65931,0,98051
140915400600000,NE 132,Residential,26191,44363,0,70554
140915400700000,NE 132,Residential,25650,56794,0,82444
140915400800000,NE 132,Residential,25650,47295,0,72945
140915400900000,NE 132,Residential,25650,88815,0,114465
140915401000000,NE 132,Residential,25650,57820,0,83470
140915500100000,NE 132,Residential,27000,79154,0,106154
140915500200000,NE 132,Residential,27000,69956,0,96956
140915500300000,NE 132,Residential,27000,50192,0,77192
140915500400000,NE 132,Residential,26235,50293,0,76528
140915500500000,NE 132,Residential,16088,52736,0,68824
140915500600000,COMM NE,Commercial,71780,0,70994,142774
140915500700000,NE 132,Residential,29424,57862,0,87286
140915600100000,INDUSTRIAL,Industrial,202625,0,384791,587416
140915600200000,INDUSTRIAL,Industrial,89000,0,116267,205267
140915700100000,NE 132,Residential,25380,54449,0,79829
140915700200000,NE 132,Residential,25648,48607,0,74255
140915700300000,COMM NE,Commercial,114480,0,278616,393096
140917600100000,NE 132,Residential,32899,84091,0,116990
140917600200000,NE 132,Residential,32670,84826,0,117496
140917600300000,NE 132,Residential,33000,77516,0,110516
140917600400000,NE 132,Residential,33000,99355,0,132355
140917600500000,NE 132,Residential,33000,109450,0,142450
140917600600000,NE 132,Residential,33000,74680,0,107680
140917600700000,NE 132,Residential,33000,74123,0,107123
140917600800000,NE 132,Residential,33000,68064,0,101064
140917600900000,NE 132,Residential,33000,62619,0,95619
140917601000000,NE 132,Residential,33000,86047,0,119047
140917601100000,NE 132,Residential,33000,70532,0,103532
140917601200000,NE 132,Residential,31900,84826,0,116726
140917601300000,NE 132,Residential,32285,89029,0,121314
140917601400000,NE 132,Residential,33000,73574,0,106574
140917601500000,NE 132,Residential,33000,77049,0,110049
140917601600000,NE 132,Residential,33000,81005,0,114005
140917601700000,NE 132,Residential,33000,80667,0,113667
140917601800000,NE 132,Residential,33000,72966,0,105966
140917601900000,NE 132,Residential,33000,80301,0,113301
140917602000000,NE 132,Residential,32670,76877,0,109547
140917602100000,NE 132,Residential,32670,98726,0,131396
140917602200000,NE 132,Residential,35140,83951,0,119091
140917700100000,E-40 CHURCHES,Exempt,196560,0,141791,338351
140917700200000,NE 132,Residential,36944,96821,0,133765
140917700300000,NE 132,Residential,34496,102672,0,137168
140917700400000,NE 132,Residential,35200,81092,0,116292
140917700500000,NE 132,Residential,35200,110896,0,146096
140917700600000,NE 132,Residential,59657,89162,0,148819
140917700700000,NE 132,Residential,21375,54471,0,75846
140917700800000,NE 132,Residential,23085,50563,0,73648
140917700900000,NE 132,Residential,23085,46448,0,69533
140917701000000,NE 132,Residential,23085,43949,0,67034
140917701100000,NE 132,Residential,23085,44809,0,67894
140917701200000,NE 132,Residential,23085,59354,0,82439
140917701300000,NE 132,Residential,22804,47325,0,70129
140917800100000,NE 132,Residential,37897,67947,0,105844
140917800200000,NE 132,Residential,36432,87504,0,123936
140917800300000,NE 132,Residential,35228,87593,0,122821
140917800400000,NE 132,Residential,33772,91196,0,124968
140917800500000,NE 132,Residential,33862,79937,0,113799
140917800600000,NE 132,Residential,33396,82708,0,116104
140917800700000,NE 132,Residential,32670,95194,0,127864
140917800800000,NE 132,Residential,32670,90665,0,123335
140917800900000,NE 132,Residential,32670,70536,0,103206
140917801000000,NE 132,Residential,32670,82922,0,115592
140917801100000,NE 132,Residential,32670,67222,0,99892
140917801200000,NE 132,Residential,32670,70070,0,102740
140917801300000,NE 132,Residential,32670,82242,0,114912
140917801400000,NE 132,Residential,32670,77680,0,110350
140917801500000,NE 132,Residential,33000,78566,0,111566
140917801600000,NE 132,Residential,33000,94250,0,127250
140917801700000,NE 132,Residential,33000,79552,0,112552
140917801800000,NE 132,Residential,33000,89953,0,122953
140917801900000,NE 132,Residential,33000,78230,0,111230
140917802000000,NE 132,Residential,33000,68097,0,101097
140917802100000,NE 132,Residential,33000,57000,0,90000
140917802200000,NE 132,Residential,33000,69455,0,102455
140917802300000,NE 132,Residential,33000,66874,0,99874
140917802400000,NE 132,Residential,33660,64365,0,98025
140917802500000,NE 132,Residential,34320,86886,0,121206
140917802600000,NE 132,Residential,34650,66312,0,100962
140917802700000,NE 132,Residential,34980,85812,0,120792
140917802800000,NE 132,Residential,34376,68725,0,103101
140917802900000,NE 132,Residential,32670,62860,0,95530
140917803000000,NE 132,Residential,32340,77542,0,109882
140917803100000,NE 132,Residential,32670,80353,0,113023
140917900100000,NE 132,Residential,33532,79282,0,112814
140917900200000,NE 132,Residential,33000,75917,0,108917
140917900300000,NE 132,Residential,33000,66116,0,99116
140917900400000,NE 132,Residential,33000,81042,0,114042
140917900500000,NE 132,Residential,33000,76461,0,109461
140917900600000,NE 132,Residential,33000,72180,0,105180
140917900700000,NE 132,Residential,33000,74437,0,107437
140917900800000,NE 132,Residential,33000,78113,0,111113
140917900900000,NE 132,Residential,33000,74181,0,107181
140917901000000,NE 132,Residential,33000,73787,0,106787
140917901100000,NE 132,Residential,33000,77498,0,110498
140917901200000,NE 132,Residential,33000,71216,0,104216
140917901300000,NE 132,Residential,33000,83514,0,116514
140917901400000,NE 132,Residential,33000,79329,0,112329
140917901500000,NE 132,Residential,33000,81739,0,114739
140917901600000,NE 132,Residential,25736,51305,0,77041
140917901700000,NE 132,Residential,25650,52516,0,78166
140917901800000,NE 132,Residential,25650,51245,0,76895
140917901900000,NE 132,Residential,25650,49486,0,75136
140917902000000,NE 132,Residential,21375,86725,0,108100
140917902100000,NE 132,Residential,23513,76241,0,99754
140917902200000,NE 132,Residential,34628,62335,0,96963
140917902300000,NE 132,Residential,25650,79196,0,104846
140917902400000,NE 132,Residential,25650,71623,0,97273
140917902500000,NE 132,Residential,25650,53876,0,79526
140917902600000,NE 132,Residential,25650,50626,0,76276
140917902700000,NE 132,Residential,25650,45822,0,71472
140917902800000,NE 132,Residential,25650,50822,0,76472
140917902900000,NE 132,Residential,24239,54108,0,78347
140918000100000,NE 132,Residential,26043,51492,0,77535
140918000200000,NE 132,Residential,25380,51832,0,77212
140918000300000,NE 132,Residential,25944,67396,0,93340
140918000400000,NE 132,Residential,28130,54105,0,82235
140918100100000,NE 132,Residential,25380,51358,0,76738
140918100200000,NE 132,Residential,25380,58369,0,83749
140918100300000,NE 132,Residential,25380,53790,0,79170
140918100400000,NE 132,Residential,25380,57588,0,82968
140918100500000,NE 132,Residential,25380,57646,0,83026
140918100600000,NE 132,Residential,25380,51560,0,76940
140918100700000,NE 132,Residential,25380,48385,0,73765
140918100800000,NE 132,Residential,25380,57227,0,82607
140918100900000,NE 132,Residential,25380,43947,0,69327
140918101000000,NE 132,Residential,25380,53901,0,79281
140918101100000,NE 132,Residential,25380,65600,0,90980
140918101200000,NE 132,Residential,25380,54206,0,79586
140918101300000,NE 132,Residential,25380,39921,0,65301
140918101400000,NE 132,Residential,25380,55885,0,81265
140918101500000,NE 132,Residential,25380,46652,0,72032
140918101600000,NE 132,Residential,25380,53027,0,78407
140918101700000,NE 132,Residential,25380,42048,0,67428
140918101800000,NE 132,Residential,25621,52369,0,77990
140918101900000,NE 132,Residential,25659,49315,0,74974
140918102000000,NE 132,Residential,25659,85308,0,110967
140918102100000,NE 132,Residential,25621,52782,0,78403
140918102200000,NE 132,Residential,25380,40867,0,66247
140918102300000,NE 132,Residential,25380,55264,0,80644
140918102400000,NE 132,Residential,25380,55171,0,80551
140918102500000,NE 132,Residential,25380,52047,0,77427
140918102600000,NE 132,Residential,25380,54430,0,79810
140918102700000,NE 132,Residential,25380,53154,0,78534
140918102800000,NE 132,Residential,25380,60060,0,85440
140918102900000,NE 132,Residential,25380,59758,0,85138
140918103000000,NE 132,Residential,25380,49405,0,74785
140918103100000,NE 132,Residential,25380,52342,0,77722
140918103200000,NE 132,Residential,25380,47937,0,73317
140918103300000,NE 132,Residential,25380,48039,0,73419
140918103400000,NE 132,Residential,25380,57205,0,82585
140918103500000,NE 132,Residential,25380,44146,0,69526
140918103600000,NE 132,Residential,25380,51578,0,76958
140918103700000,NE 132,Residential,25380,56850,0,82230
140918103800000,NE 132,Residential,25380,80554,0,105934
140918200100000,NE 132,Residential,26043,51985,0,78028
140918200200000,NE 132,Residential,25380,55635,0,81015
140918200300000,NE 132,Residential,25380,53180,0,78560
140918200400000,NE 132,Residential,25380,49599,0,74979
140918200500000,NE 132,Residential,25380,53698,0,79078
140918200600000,NE 132,Residential,25380,49083,0,74463
140918200700000,NE 132,Residential,25380,52232,0,77612
140918200800000,NE 132,Residential,25380,52500,0,77880
140918200900000,NE 132,Residential,25380,51693,0,77073
140918201000000,NE 132,Residential,25380,44970,0,70350
140918201100000,NE 132,Residential,25380,56619,0,81999
140918201200000,NE 132,Residential,25380,50940,0,76320
140918201300000,NE 132,Residential,25380,45181,0,70561
140918201400000,NE 132,Residential,25380,57445,0,82825
140918201500000,NE 132,Residential,25380,71980,0,97360
140918201600000,NE 132,Residential,25380,58072,0,83452
140918201700000,NE 132,Residential,25380,59250,0,84630
140918201800000,NE 132,Residential,25380,54972,0,80352
140918201900000,NE 132,Residential,25380,47263,0,72643
140918202000000,NE 132,Residential,25380,48193,0,73573
140918202100000,NE 132,Residential,25380,51728,0,77108
140918202200000,NE 132,Residential,25380,48015,0,73395
140920100100000,NE 133,Residential,25617,106795,0,132412
140920100200000,NE 133,Residential,24419,87745,0,112164
140920100300000,NE 133,Residential,24419,83189,0,107608
140920100400000,NE 133,Residential,25704,102801,0,128505
140920100500000,NE 133,Residential,27310,103778,0,131088
140920100600000,NE 133,Residential,27132,97007,0,124139
140920100700000,NE 133,Residential,26561,114539,0,141100
140920100800000,NE 133,Residential,27310,105937,0,133247
140920100900000,NE 133,Residential,25436,92886,0,118322
140920101000000,NE 133,Residential,24414,92899,0,117313
140920101100000,NE 133,Residential,31676,105371,0,137047
140920101200000,NE 133,Residential,32738,114350,0,147088
140920101300000,NE 133,Residential,32738,107310,0,140048
140920101400000,NE 133,Residential,32738,100284,0,133022
140920101500000,NE 133,Residential,33174,112366,0,145540
140920101600000,NE 133,Residential,33174,110905,0,144079
140920101700000,NE 133,Residential,32738,121117,0,153855
140920101800000,NE 133,Residential,30555,118390,0,148945
140920101900000,NE 133,Residential,30555,115989,0,146544
140920102000000,NE 133,Residential,30555,106192,0,136747
140920102100000,NE 133,Residential,30555,105111,0,135666
140920102200000,NE 133,Residential,31541,107453,0,138994
140920102300000,NE 133,Residential,31907,113391,0,145298
140920102400000,NE 133,Residential,33860,122018,0,155878
140920102500000,NE 133,Residential,29750,93322,0,123072
140920102600000,NE 133,Residential,31185,109224,0,140409
140920102700000,NE 133,Residential,31185,106273,0,137458
140920102800000,NE 133,Residential,31185,116975,0,148160
140920102900000,NE 133,Residential,32447,103349,0,135796
140920103000000,NE 133,Residential,31815,93251,0,125066
140920103100000,NE 133,Residential,30128,101329,0,131457
140920103200000,NE 133,Residential,30713,90710,0,121423
140920103300000,NE 133,Residential,31590,94458,0,126048
140920103400000,NE 133,Residential,31883,91488,0,123371
140920103500000,NE 133,Residential,34155,101505,0,135660
140920103600000,NE 133,Residential,28958,102001,0,130959
140920103700000,NE 133,Residential,31356,109459,0,140815
140920103800000,NE 133,Residential,30732,90365,0,121097
140920103900000,NE 133,Residential,30136,101323,0,131459
140920200100000,NE 133,Residential,35647,112269,0,147916
140920200200000,NE 133,Residential,31540,100014,0,131554
140920200300000,NE 133,Residential,31725,92173,0,123898
140920200400000,NE 133,Residential,33068,143648,0,176716
140920200500000,NE 133,Residential,31725,117370,0,149095
140920200600000,NE 133,Residential,35013,114980,0,149993
140920200700000,NE 133,Residential,32168,94254,0,126422
140920200800000,NE 133,Residential,33180,130177,0,163357
140920200900000,NE 133,Residential,34254,119341,0,153595
140920201000000,NE 133,Residential,32592,94211,0,126803
140920201100000,NE 133,Residential,29928,101323,0,131251
140920201200000,NE 133,Residential,31380,95924,0,127304
140920201300000,NE 133,Residential,30555,114127,0,144682
140920201400000,NE 133,Residential,30555,97832,0,128387
140920201500000,NE 133,Residential,30555,98188,0,128743
140920201600000,NE 133,Residential,31635,99440,0,131075
140920201700000,NE 133,Residential,32018,126974,0,158992
140920201800000,NE 133,Residential,31667,112534,0,144201
140920201900000,NE 133,Residential,32818,98441,0,131259
140920202000000,NE 133,Residential,30294,112935,0,143229
140920202100000,NE 133,Residential,30294,102938,0,133232
140920202200000,NE 133,Residential,30294,110744,0,141038
140920202300000,NE 133,Residential,30870,109348,0,140218
140920202400000,NE 133,Residential,30870,108500,0,139370
140920202500000,NE 133,Residential,31239,115266,0,146505
140920202600000,NE 133,Residential,29610,104746,0,134356
140920202700000,NE 133,Residential,27965,91050,0,119015
140920300100000,NE 133,Residential,30878,129625,0,160503
140920300200000,NE 133,Residential,32128,93768,0,125896
140920300300000,NE 133,Residential,30555,95561,0,126116
140920300400000,NE 133,Residential,30555,108542,0,139097
140920300500000,NE 133,Residential,32400,89738,0,122138
140920300600000,NE 133,Residential,33886,93501,0,127387
140920300700000,NE 133,Residential,32401,99997,0,132398
140920300800000,NE 133,Residential,33244,115630,0,148874
140920300900000,NE 133,Residential,32490,118023,0,150513
140920301000000,NE 133,Residential,32994,116108,0,149102
140920301100000,NE 133,Residential,33037,113626,0,146663
140920301200000,NE 133,Residential,32913,81662,0,114575
140920301300000,NE 133,Residential,32582,113144,0,145726
140920301400000,NE 133,Residential,32015,103419,0,135434
140920301500000,NE 133,Residential,31210,123458,0,154668
140920301600000,NE 133,Residential,33546,121796,0,155342
140920301700000,NE 133,Residential,36067,104857,0,140924
140920301800000,NE 133,Residential,33392,100797,0,134189
140920400100000,NE 133,Residential,31160,112191,0,143351
140920400200000,NE 133,Residential,29246,108189,0,137435
140920400300000,NE 133,Residential,29246,91600,0,120846
140920400400000,NE 133,Residential,29246,95350,0,124596
140920400500000,NE 133,Residential,30770,88268,0,119038
140920400600000,NE 133,Exempt,31952,114015,0,145967
140920400700000,NE 133,Residential,32251,114600,0,146851
140920400800000,NE 133,Residential,31059,93806,0,124865
140920400900000,NE 133,Residential,30750,91192,0,121942
140920401000000,NE 133,Residential,31865,102003,0,133868
140920401100000,NE 133,Residential,31536,98045,0,129581
140920401200000,NE 133,Residential,29682,103631,0,133313
140920401300000,NE 133,Residential,29391,74639,0,104030
140920401400000,NE 133,Residential,30826,95108,0,125934
140920401500000,NE 133,Residential,31579,102613,0,134192
140920401600000,NE 133,Residential,29682,85089,0,114771
140920401700000,NE 133,Residential,33157,105351,0,138508
140920401800000,NE 133,Residential,31812,116380,0,148192
140920401900000,NE 133,Residential,30798,84110,0,114908
140920402000000,NE 133,Residential,27323,81329,0,108652
140920402100000,NE 133,Residential,29529,102839,0,132368
140920402200000,NE 133,Residential,28958,101214,0,130172
140920402300000,NE 133,Residential,28665,106079,0,134744
140920402400000,NE 133,Residential,29397,91984,0,121381
140920402500000,NE 133,Residential,30870,89235,0,120105
140920402600000,NE 133,Residential,30240,97769,0,128009
140920402700000,NE 133,Residential,31410,93242,0,124652
140920402800000,NE 133,Residential,30863,81273,0,112136
140920500100000,NE 133,Residential,30816,96314,0,127130
140920500200000,NE 133,Residential,31085,122631,0,153716
140920500300000,NE 133,Residential,29682,109027,0,138709
140920500400000,NE 133,Residential,28373,101033,0,129406
140920500500000,NE 133,Residential,29512,84901,0,114413
140920500600000,NE 133,Residential,29682,99127,0,128809
140920500700000,NE 133,Residential,28373,86097,0,114470
140920500800000,NE 133,Residential,28373,104896,0,133269
140920500900000,NE 133,Residential,30034,131378,0,161412
140920501000000,NE 133,Residential,32701,109433,0,142134
140920501100000,NE 133,Residential,32724,83173,0,115897
140920501200000,NE 133,Residential,31541,99212,0,130753
140920501300000,NE 133,Residential,31906,114031,0,145937
140920501400000,NE 133,Residential,32112,101898,0,134010
140920600100000,NE 133,Residential,32340,104292,0,136632
140920600200000,NE 133,Residential,33285,98912,0,132197
140920600300000,NE 133,Residential,30900,91114,0,122014
140922600100000,NE 133,Residential,23961,80316,0,104277
140922600200000,NE 133,Residential,24990,94271,0,119261
140922600300000,NE 133,Residential,24990,93207,0,118197
140922600400000,NE 133,Residential,24990,98154,0,123144
140922600500000,NE 133,Residential,24990,82424,0,107414
140922600600000,NE 133,Residential,34769,117545,0,152314
140922600700000,NE 133,Residential,33915,81000,0,114915
140922600800000,NE 133,Residential,35329,117764,0,153093
140922600900000,NE 133,Residential,30555,90948,0,121503
140922601000000,NE 133,Residential,29900,88603,0,118503
140922601100000,NE 133,Residential,31210,99077,0,130287
140922601200000,NE 133,Residential,30555,110475,0,141030
140922601300000,NE 133,Residential,31915,87728,0,119643
140922700100000,NE 133,Residential,34425,91007,0,125432
140922700200000,NE 133,Residential,27039,126408,0,153447
140922700300000,NE 133,Residential,25480,115281,0,140761
140922700400000,NE 133,Residential,24998,128029,0,153027
140922700500000,NE 133,Residential,25712,143022,0,168734
140922700600000,NE 133,Residential,34761,106660,0,141421
140922700700000,NE 133,Residential,36982,122752,0,159734
140922700800000,NE 133,Residential,35113,138036,0,173149
140922700900000,NE 133,Residential,36490,132787,0,169277
140922701000000,NE 133,Residential,33416,133830,0,167246
140922701100000,NE 133,Residential,32089,110683,0,142772
140922701200000,NE 133,Residential,32471,97716,0,130187
140922701300000,NE 133,Residential,28925,104749,0,133674
140922701400000,NE 133,Residential,35806,116833,0,152639
140922701500000,NE 133,Residential,31765,113523,0,145288
140922800100000,NE 133,Residential,32728,95473,0,128201
140922800200000,NE 133,Residential,26472,115547,0,142019
140922800300000,NE 133,Residential,35133,142620,0,177753
140922800400000,NE 133,Residential,35589,127098,0,162687
140922800500000,NE 133,Residential,34509,120026,0,154535
140922800600000,NE 133,Residential,34425,102597,0,137022
140922800700000,NE 133,Residential,35100,119695,0,154795
140922800800000,NE 133,Residential,33412,110141,0,143553
140922800900000,NE 133,Residential,35317,135139,0,170456
140922801000000,NE 133,Residential,37066,118877,0,155943
140922801100000,NE 133,Residential,29482,104650,0,134132
140922801200000,NE 133,Residential,28958,77323,0,106281
140922801300000,NE 133,Residential,34116,119213,0,153329
140922801400000,NE 133,Residential,30936,101746,0,132682
140922801500000,NE 133,Residential,29917,114060,0,143977
140922801600000,NE 133,Residential,32957,119463,0,152420
140922801700000,NE 133,Residential,35089,107284,0,142373
140922801800000,NE 133,Residential,35509,115410,0,150919
140922801900000,NE 133,Residential,35036,119373,0,154409
140922802000000,NE 133,Residential,34580,139062,0,173642
140922802100000,NE 133,Residential,33392,107443,0,140835
140922802200000,NE 133,Residential,32760,101042,0,133802
140922802300000,NE 133,Residential,34425,123607,0,158032
140922802400000,NE 133,Residential,37323,136893,0,174216
140922802500000,NE 133,Residential,35662,130535,0,166197
140922802600000,NE 133,Residential,33680,108942,0,142622
140922802700000,NE 133,Residential,31815,143993,0,175808
140922802800000,NE 133,Residential,36949,117440,0,154389
140922802900000,NE 133,Residential,34838,103657,0,138495
140922803000000,NE 133,Residential,30555,120268,0,150823
140922803100000,NE 133,Residential,33174,123709,0,156883
140922803200000,NE 133,Residential,33174,138037,0,171211
140922900100000,NE 133,Residential,28315,94583,0,122898
140922900200000,NE 133,Residential,28958,77847,0,106805
140922900300000,NE 133,Residential,28958,79530,0,108488
140922900400000,NE 133,Residential,28958,89485,0,118443
140922900500000,NE 133,Residential,28958,87224,0,116182
140922900600000,NE 133,Residential,30054,96356,0,126410
140922900700000,NE 133,Residential,30054,80309,0,110363
140922900800000,NE 133,Residential,30054,98309,0,128363
140922900900000,NE 133,Residential,30685,120931,0,151616
140923000100000,NE 133,Residential,29932,76038,0,105970
140923000200000,NE 133,Residential,30555,91916,0,122471
140923000300000,NE 133,Residential,30870,91379,0,122249
140923000400000,NE 133,Residential,31656,118620,0,150276
140923000500000,NE 133,Residential,32445,84645,0,117090
140923000600000,NE 133,Residential,32445,131182,0,163627
140923000700000,NE 133,Residential,31668,84147,0,115815
140923000800000,NE 133,Residential,29183,106738,0,135921
140923000900000,NE 133,Residential,31020,104915,0,135935
140923001000000,NE 133,Residential,30906,107498,0,138404
140923001100000,NE 133,Residential,33025,128694,0,161719
140923001200000,NE 133,Residential,32729,97512,0,130241
140923001300000,NE 133,Residential,29988,106441,0,136429
140923001400000,NE 133,Residential,31360,121686,0,153046
140923001500000,NE 133,Residential,32130,85563,0,117693
140923001600000,NE 133,Residential,32130,96452,0,128582
140923100100000,NE 133,Residential,32878,94634,0,127512
140923100200000,NE 133,Residential,28958,94472,0,123430
140923100300000,NE 133,Residential,28958,92706,0,121664
140923100400000,NE 133,Residential,32188,103104,0,135292
140923200100000,NE 133,Residential,34366,89293,0,123659
140923200200000,NE 133,Residential,31500,103677,0,135177
140923200300000,NE 133,Residential,29155,103717,0,132872
140923200400000,NE 133,Residential,34633,92345,0,126978
140923200500000,NE 133,Residential,31800,100977,0,132777
140923200600000,NE 133,Residential,31298,75752,0,107050
140923200700000,NE 133,Residential,31590,92655,0,124245
140923200800000,NE 133,Residential,33345,80205,0,113550
140923200900000,NE 133,Residential,30420,122798,0,153218
140923201000000,NE 133,Residential,30420,88124,0,118544
140923300100000,NE 133,Residential,31528,90247,0,121775
140923300200000,NE 133,Residential,35923,107080,0,143003
140923300300000,NE 133,Residential,34884,130079,0,164963
140923300400000,NE 133,Residential,34504,110047,0,144551
140923300500000,NE 133,Residential,33907,110610,0,144517
140923300600000,NE 133,Residential,35431,129022,0,164453
140923300700000,NE 133,Residential,34559,98441,0,133000
140923300800000,NE 133,Residential,33442,110973,0,144415
140923300900000,NE 133,Residential,33393,124086,0,157479
140923301000000,NE 133,Residential,34155,116809,0,150964
140923301100000,NE 133,Residential,32148,115602,0,147750
140923301200000,NE 133,Residential,30118,95515,0,125633
140923301300000,NE 133,Residential,34483,105292,0,139775
140923301400000,NE 133,Residential,30555,108543,0,139098
140923301500000,NE 133,Residential,30555,107594,0,138149
140923301600000,NE 133,Residential,30555,116636,0,147191
140923301700000,NE 133,Residential,32225,121729,0,153954
140923301800000,NE 133,Residential,31185,94813,0,125998
140923301900000,NE 133,Residential,28958,96708,0,125666
140923302000000,NE 133,Residential,28958,108768,0,137726
140923302100000,NE 133,Residential,28958,109984,0,138942
140923400100000,NE 133,Residential,30600,107841,0,138441
140923400200000,NE 133,Residential,32400,121566,0,153966
140923400300000,NE 133,Residential,31500,97252,0,128752
140923400400000,NE 133,Residential,27000,94898,0,121898
140923400500000,NE 133,Residential,32300,121748,0,154048
140925100100000,NE 133,Residential,34081,100683,0,134764
140925200100000,NE 133,Residential,33345,87135,0,120480
140925200200000,NE 133,Residential,34320,112007,0,146327
140925200300000,NE 133,Residential,32917,101976,0,134893
140925200400000,NE 133,Residential,33791,100069,0,133860
140925200500000,NE 133,Residential,31258,87704,0,118962
140925200600000,NE 133,Residential,34234,114321,0,148555
140925200700000,NE 133,Residential,35894,112916,0,148810
140925200800000,NE 133,Residential,37908,113293,0,151201
140925200900000,NE 133,Residential,39621,121621,0,161242
140925201000000,NE 133,Residential,36598,112257,0,148855
140925201100000,NE 133,Residential,34571,100427,0,134998
140925201200000,NE 133,Residential,34150,122878,0,157028
140925201300000,NE 133,Residential,34876,113404,0,148280
140925201400000,NE 133,Residential,34288,102197,0,136485
140925201500000,NE 133,Residential,37125,118031,0,155156
140925201600000,NE 133,Residential,41040,119023,0,160063
140925201700000,NE 133,Residential,41876,117632,0,159508
140925201800000,NE 133,Residential,44839,151873,0,196712
140925201900000,NE 133,Residential,44348,123273,0,167621
140925202000000,NE 133,Residential,45441,115867,0,161308
140925202100000,NE 133,Residential,45562,195309,0,240871
140925202200000,NE 133,Residential,35193,180458,0,215651
140925202300000,NE 133,Residential,38913,139173,0,178086
140925202400000,NE 133,Residential,36433,125845,0,162278
140925202500000,NE 133,Residential,40014,141460,0,181474
140925202600000,NE 133,Residential,39672,156184,0,195856
140925202700000,NE 133,Residential,40365,153529,0,193894
140925202800000,NE 133,Residential,35946,132999,0,168945
140925202900000,NE 133,Residential,32062,126344,0,158406
140925203000000,NE 133,Residential,31881,124688,0,156569
140925203100000,NE 133,Residential,30353,116428,0,146781
140925203200000,NE 133,Residential,33846,113833,0,147679
140925203300000,NE 133,Residential,32119,128862,0,160981
140925203400000,NE 133,Residential,33813,108933,0,142746
140925300100000,NE 133,Residential,34920,103977,0,138897
140925300200000,NE 133,Residential,32445,102438,0,134883
140925300300000,NE 133,Residential,32174,113212,0,145386
140925300400000,NE 133,Residential,36674,145922,0,182596
140925300500000,NE 133,Residential,33700,118541,0,152241
140925300600000,NE 133,Residential,34020,110297,0,144317
140925300700000,NE 133,Residential,33453,119979,0,153432
140925300800000,NE 133,Residential,33815,116662,0,150477
140925300900000,NE 133,Residential,33815,104616,0,138431
140925301000000,NE 133,Residential,41059,277844,0,318903
140925301100000,NE 133,Residential,36701,99059,0,135760
140925301200000,NE 133,Residential,34700,108317,0,143017
140925301300000,NE 133,Residential,36555,107059,0,143614
140925301400000,NE 133,Residential,35016,118333,0,153349
140925301500000,NE 133,Residential,33882,115417,0,149299
140925301600000,NE 133,Residential,34330,106448,0,140778
140925400100000,NE 133,Residential,34425,110668,0,145093
140925400200000,NE 133,Residential,44550,175257,0,219807
140925400300000,NE 133,Residential,34425,143101,0,177526
140925400400000,NE 133,Residential,34200,95484,0,129684
140925400500000,NE 133,Residential,33210,118179,0,151389
140925400600000,NE 133,Residential,35802,132443,0,168245
140925400700000,NE 133,Residential,37950,131150,0,169100
140925400800000,NE 133,Residential,37915,123880,0,161795
140925400900000,NE 133,Residential,35829,126164,0,161993
140925401000000,NE 133,Residential,38070,121761,0,159831
140925401100000,NE 133,Residential,37167,125871,0,163038
140925401200000,NE 133,Residential,41313,136257,0,177570
140925401300000,NE 133,Residential,66150,215074,0,281224
140925401400000,NE 133,Residential,38137,109060,0,147197
140925401500000,NE 133,Residential,38316,107584,0,145900
140925401600000,NE 133,Residential,31188,123387,0,154575
140925401700000,NE 133,Residential,38652,125291,0,163943
140925401800000,NE 133,Residential,39780,112642,0,152422
140925401900000,NE 133,Residential,35038,113285,0,148323
140925402000000,NE 133,Residential,40095,122859,0,162954
140925402100000,NE 133,Residential,42294,141359,0,183653
140925402200000,NE 133,Residential,43092,104099,0,147191
140925402300000,NE 133,Residential,41850,139533,0,181383
140925402400000,NE 133,Residential,42300,129176,0,171476
140925402500000,NE 133,Residential,43680,153323,0,197003
140925500100000,NE 133,Residential,33075,123080,0,156155
140925500200000,NE 133,Residential,32351,124170,0,156521
140925500300000,NE 133,Residential,35226,123149,0,158375
140925500400000,NE 133,Residential,32516,151241,0,183757
140925500500000,NE 133,Residential,34884,118719,0,153603
140925500600000,NE 133,Residential,34425,134382,0,168807
140925500700000,NE 133,Residential,34884,146818,0,181702
140925500800000,NE 133,Residential,34884,110727,0,145611
140925500900000,NE 133,Residential,34884,137649,0,172533
140925501000000,NE 133,Residential,34783,128846,0,163629
140925600100000,NE 133,Residential,40832,119207,0,160039
140925600200000,NE 133,Residential,37936,151783,0,189719
140925600300000,NE 133,Residential,37898,108703,0,146601
140925600400000,NE 133,Residential,37705,114224,0,151929
140925600500000,NE 133,Residential,32130,104358,0,136488
140925600600000,NE 133,Residential,39792,130594,0,170386
140925600700000,NE 133,Residential,39895,172484,0,212379
140927600100000,NE 133,Residential,31273,97813,0,129086
140927600200000,NE 133,Residential,29680,86816,0,116496
140927600300000,NE 133,Residential,30573,99816,0,130389
140927600400000,NE 133,Residential,31005,101443,0,132448
140927600500000,NE 133,Residential,31005,91010,0,122015
140927600600000,NE 133,Residential,31005,94210,0,125215
140927600700000,NE 133,Residential,31005,111564,0,142569
140927600800000,NE 133,Residential,31005,93749,0,124754
140927600900000,NE 133,Residential,31005,96698,0,127703
140927601000000,NE 133,Residential,382,0,0,382
140927700100000,NE 133,Residential,32999,95179,0,128178
140927700200000,NE 133,Residential,31269,94804,0,126073
140927700300000,NE 133,Residential,32400,108009,0,140409
140927700400000,NE 133,Residential,30991,94696,0,125687
140927700500000,NE 133,Residential,30328,107314,0,137642
140927700600000,NE 133,Residential,30240,96974,0,127214
140927700700000,NE 133,Residential,30240,90256,0,120496
140927700800000,NE 133,Residential,30240,93690,0,123930
140927700900000,NE 133,Residential,28958,106472,0,135430
140927701000000,NE 133,Residential,28958,95159,0,124117
140927701100000,NE 133,Residential,28958,119254,0,148212
140927701200000,NE 133,Residential,28958,103760,0,132718
140927701300000,NE 133,Residential,28958,83809,0,112767
140927701400000,NE 133,Residential,28614,103236,0,131850
140927800100000,NE 133,Residential,29301,118813,0,148114
140927800200000,NE 133,Residential,27063,88974,0,116037
140927900100000,NE 133,Residential,34611,113722,0,148333
140927900200000,NE 133,Residential,29232,134846,0,164078
140927900300000,NE 133,Residential,31597,94662,0,126259
140927900400000,NE 133,Residential,32054,92583,0,124637
140927900500000,NE 133,Residential,32182,91438,0,123620
140927900600000,NE 133,Residential,28958,86049,0,115007
140927900700000,NE 133,Residential,27349,81030,0,108379
140927900800000,NE 133,Residential,28958,82218,0,111176
140927900900000,NE 133,Residential,28958,90526,0,119484
140927901000000,NE 133,Residential,28958,94138,0,123096
140927901100000,NE 133,Residential,28958,121911,0,150869
140927901200000,NE 133,Residential,27349,107567,0,134916
140927901300000,NE 133,Residential,28958,97402,0,126360
140927901400000,NE 133,Residential,29301,97937,0,127238
140927901500000,NE 133,Residential,29973,86436,0,116409
140927901600000,NE 133,Residential,28858,95343,0,124201
140927901700000,NE 133,Residential,30555,99732,0,130287
140927901800000,NE 133,Residential,30555,98514,0,129069
140927901900000,NE 133,Residential,30555,100069,0,130624
140927902000000,NE 133,Residential,30555,93007,0,123562
140927902100000,NE 133,Residential,30555,97463,0,128018
140927902200000,NE 133,Residential,30682,104286,0,134968
140927902300000,NE 133,Residential,33097,105006,0,138103
140927902400000,NE 133,Residential,32265,120433,0,152698
140927902500000,NE 133,Residential,31876,108028,0,139904
140927902600000,NE 133,Residential,31185,96239,0,127424
140927902700000,NE 133,Residential,34593,116761,0,151354
140928000100000,NE 133,Residential,28614,94196,0,122810
140928000200000,NE 133,Residential,29341,126984,0,156325
140928000300000,NE 133,Residential,31864,104888,0,136752
140928000400000,NE 133,Residential,33232,103043,0,136275
140928000500000,NE 133,Residential,34702,122683,0,157385
140928000600000,NE 133,Residential,30555,108532,0,139087
140928000700000,NE 133,Residential,32738,104056,0,136794
140928000800000,NE 133,Residential,30919,103838,0,134757
140928000900000,NE 133,Residential,32738,108014,0,140752
140928001000000,NE 133,Residential,32738,113814,0,146552
140928001100000,NE 133,Residential,34556,126508,0,161064
140928100100000,NE 133,Residential,32815,98580,0,131395
140928100200000,NE 133,Residential,31185,85517,0,116702
140928100300000,NE 133,Residential,30870,107908,0,138778
140928100400000,NE 133,Residential,32544,100591,0,133135
140928100500000,NE 133,Residential,31464,101875,0,133339
140928100600000,NE 133,Residential,30132,100097,0,130229
140928100700000,NE 133,Residential,32422,95987,0,128409
140928100800000,NE 133,Residential,31355,102482,0,133837
140928100900000,NE 133,Residential,31742,85079,0,116821
140928101000000,NE 133,Residential,31742,102407,0,134149
140928101100000,NE 133,Residential,32980,117097,0,150077
140928101200000,NE 133,Residential,30870,101134,0,132004
140928101300000,NE 133,Residential,31421,96353,0,127774
140928101400000,NE 133,Residential,33075,103536,0,136611
140928101500000,NE 133,Residential,34992,110827,0,145819
140928101600000,NE 133,Residential,34668,121871,0,156539
140928101700000,NE 133,Residential,35274,127542,0,162816
140928101800000,NE 133,Residential,32730,105843,0,138573
140928101900000,NE 133,Residential,31703,96576,0,128279
140928102000000,NE 133,Residential,31519,111103,0,142622
140928102100000,NE 133,Residential,31500,102760,0,134260
140928102200000,NE 133,Residential,30433,108782,0,139215
140928102300000,NE 133,Residential,33248,107412,0,140660
140928102400000,NE 133,Residential,33482,107374,0,140856
140928102500000,NE 133,Residential,32384,86992,0,119376
140928200100000,NE 133,Residential,33041,104942,0,137983
140928200200000,NE 133,Residential,31005,78631,0,109636
140928200300000,NE 133,Residential,32020,83614,0,115634
140928200400000,NE 133,Residential,32020,88467,0,120487
140928200500000,NE 133,Residential,34303,93149,0,127452
140928200600000,NE 133,Residential,33432,103688,0,137120
140928200700000,NE 133,Residential,33298,97702,0,131000
140928200800000,NE 133,Residential,27961,0,0,27961
140928300100000,NE 133,Residential,32400,86731,0,119131
140928300200000,NE 133,Residential,32135,114926,0,147061
140928300300000,NE 133,Residential,31864,105807,0,137671
140928300400000,NE 133,Residential,31500,108389,0,139889
140928300500000,NE 133,Residential,34884,109539,0,144423
140928300600000,NE 133,Residential,33721,108808,0,142529
140928300700000,NE 133,Residential,31686,102374,0,134060
140928300800000,NE 133,Residential,33915,104843,0,138758
140928300900000,NE 133,Residential,33385,103800,0,137185
140928301000000,NE 133,Residential,34200,136975,0,171175
140928301100000,NE 133,Residential,35611,115669,0,151280
140928301200000,NE 133,Residential,37278,103098,0,140376
140928301300000,NE 133,Residential,35568,123495,0,159063
140928301400000,NE 133,Residential,35234,105411,0,140645
140928301500000,NE 133,Residential,34200,122842,0,157042
140928301600000,NE 133,Residential,33025,114438,0,147463
140928301700000,NE 133,Residential,33666,97269,0,130935
140928301800000,NE 133,Residential,33666,100698,0,134364
140928301900000,NE 133,Residential,32704,115299,0,148003
140928302000000,NE 133,Residential,33772,112307,0,146079
140928302100000,NE 133,Residential,32323,100606,0,132929
140928302200000,NE 133,Residential,33382,111637,0,145019
140928302300000,NE 133,Residential,33174,88275,0,121449
140928400100000,NE 133,Residential,35694,109302,0,144996
140928400200000,NE 133,Residential,36450,102732,0,139182
140928400300000,NE 133,Residential,34627,98817,0,133444
140928400400000,NE 133,Residential,34627,137942,0,172569
140928400500000,NE 133,Residential,34627,105207,0,139834
140928400600000,NE 133,Residential,34627,122317,0,156944
140928400700000,NE 133,Residential,33874,105916,0,139790
140928400800000,NE 133,Residential,33048,118399,0,151447
140928400900000,NE 133,Residential,34627,121071,0,155698
140928401000000,NE 133,Residential,40540,121831,0,162371
140928401100000,NE 133,Residential,39996,132535,0,172531
140928401200000,NE 133,Residential,41400,113304,0,154704
140928401300000,NE 133,Residential,37834,120642,0,158476
140928401400000,NE 133,Residential,39502,112432,0,151934
140928401500000,NE 133,Residential,40969,128376,0,169345
140930100100000,APTS NE,Commercial,488160,0,3043474,3531634
140930100200000,NE 147,Residential,24939,0,0,24939
140930100300000,NE 147,Residential,38400,101092,0,139492
140930100400000,NE 147,Residential,40200,138195,0,178395
140930100500000,NE 147,Residential,25392,0,0,25392
140930100600000,NE 147,Residential,39600,140791,0,180391
140930100700000,NE 147,Residential,19788,0,0,19788
140930200100000,NE 147,Residential,42075,98328,0,140403
140930200200000,NE 147,Residential,30398,97657,0,128055
140930200300000,NE 147,Residential,32665,99705,0,132370
140930200400000,NE 147,Residential,38376,96252,0,134628
140930200500000,NE 147,Residential,39577,118220,0,157797
140930200600000,NE 147,Residential,26153,59560,0,85713
140930200700000,NE 147,Residential,27936,104797,0,132733
140930200800000,NE 147,Residential,34422,117712,0,152134
140930200900000,NE 147,Residential,16422,137649,0,154071
140930201000000,NE 147,Residential,35770,88407,0,124177
140930201100000,NE 147,Residential,36096,83588,0,119684
140930201200000,NE 147,Residential,31815,103318,0,135133
140930201300000,NE 147,Residential,30420,78530,0,108950
140930201400000,NE 147,Residential,29925,80841,0,110766
140930201500000,NE 147,Residential,32020,64209,0,96229
140930201600000,E-15 CITY,Exempt,0,0,0,0
140930201700000,NE 147,Residential,36923,157140,0,194063
140930201800000,NE 147,Residential,36360,152892,0,189252
140930201900000,NE 147,Residential,36360,131692,0,168052
140930202000000,NE 147,Residential,36360,129188,0,165548
140930202100000,NE 147,Residential,36360,133089,0,169449
140930202200000,NE 147,Residential,36112,127168,0,163280
140930202300000,NE 147,Residential,38750,179417,0,218167
140930202400000,NE 147,Residential,37791,121647,0,159438
140930202500000,NE 147,Residential,38454,147172,0,185626
140930202600000,NE 147,Residential,36978,116679,0,153657
140930202700000,NE 147,Residential,37133,153593,0,190726
140930202800000,NE 147,Residential,36765,158046,0,194811
140930202900000,NE 147,Residential,36765,129108,0,165873
140930203000000,NE 147,Residential,38090,131589,0,169679
140930203100000,NE 147,Residential,35802,125922,0,161724
140930203200000,NE 147,Residential,43850,50378,0,94228
140930203300000,NE 147,Residential,55803,261052,0,316855
140930203400000,NE 147,Residential,60333,184091,0,244424
140930203500000,NE 147,Residential,41175,55650,0,96825
140930203600000,NE 147,Residential,20400,73688,0,94088
140930203700000,NE 147,Residential,25070,148785,0,173855
140930203800000,NE 147,Residential,25200,136658,0,161858
140930203900000,NE 147,Residential,24960,116751,0,141711
140930204000000,NE 147,Residential,24240,1254,0,25494
140930204100000,NE 147,Residential,21275,94704,0,115979
140930204200000,NE 147,Residential,21691,130977,0,152668
140932600100000,NE 147,Residential,40545,92201,0,132746
140932600200000,NE 146,Residential,37674,142129,0,179803
140932700100000,NE 147,Residential,58032,138715,0,196747
140932700200000,NE 147,Residential,58223,161777,0,220000
140932700300000,NE 147,Residential,32368,97970,0,130338
140932700400000,NE 147,Residential,31173,126018,0,157191
140932700500000,NE 147,Residential,29235,0,0,29235
140932700600000,NE 147,Residential,31036,108626,0,139662
140932701000000,NE 147,Residential,19100,93478,0,112578
140932701100000,NE 147,Residential,27060,117824,0,144884
140932701200000,NE 147,Residential,17762,76190,0,93952
140932701300000,NE 147,Residential,20160,70259,0,90419
140932701400000,NE 147,Residential,23380,130187,0,153567
140932701500000,NE 147,Residential,21141,72910,0,94051
140932701600000,NE 147,Residential,38347,121762,0,160109
140932701700000,NE 147,Residential,27964,61092,0,89056
140932701800000,NE 147,Residential,24705,190743,0,215448
140932701900000,NE 147,Residential,24589,120995,0,145584
140932702000000,NE 147,Residential,38547,55310,0,93857
140932702100000,NE 145,Residential,35880,214268,0,250148
140932702300000,NE 147,Residential,27979,107792,0,135771
140932800100000,NE 147,Residential,24266,99133,0,123399
140932800200000,NE 147,Residential,26160,33830,0,59990
140932800300000,NE 147,Residential,37178,69704,0,106882
140932800400000,NE 147,Residential,30317,140349,0,170666
140932800500000,NE 147,Residential,31620,156901,0,188521
140932800600000,NE 147,Residential,24180,104529,0,128709
140932800700000,NE 147,Residential,30480,121714,0,152194
140932800800000,NE 147,Residential,30960,101343,0,132303
140932800900000,NE 147,Residential,40425,53402,0,93827
140932801000000,NE 147,Residential,40500,106537,0,147037
140932801100000,NE 147,Residential,42275,109572,0,151847
140932801200000,NE 147,Residential,27885,114952,0,142837
140932801300000,NE 147,Residential,26250,100718,0,126968
140932801400000,NE 147,Residential,24747,142592,0,167339
140932801500000,NE 147,Residential,21421,143223,0,164644
140932801600000,NE 147,Residential,23031,113165,0,136196
140932801700000,NE 147,Residential,22800,114255,0,137055
140932801800000,NE 147,Residential,26353,121555,0,147908
140932801900000,NE 147,Residential,22374,127060,0,149434
140932802000000,NE 147,Residential,26220,222319,0,248539
140932802100000,NE 147,Residential,28017,180036,0,208053
140932802200000,NE 147,Residential,37442,42438,0,79880
140932802300000,NE 147,Residential,28381,167929,0,196310
140932802400000,NE 147,Residential,40525,78117,0,118642
140932802500000,NE 147,Residential,34744,42737,0,77481
140932802600000,NE 147,Residential,40100,234424,0,274524
140932802700000,NE 147,Residential,40075,242060,0,282135
140932802800000,NE 147,Residential,35670,102559,0,138229
140932802900000,NE 147,Residential,39917,119904,0,159821
140932803000000,NE 147,Residential,39000,44762,0,83762
140932803100000,NE 147,Residential,23985,92514,0,116499
140932803400000,NE 147,Residential,1131,0,0,1131
140935100100000,NE 147,Residential,20706,97080,0,117786
140935100200000,NE 147,Residential,35910,98637,0,134547
140935100300000,NE 147,Residential,39906,124858,0,164764
140935100400000,NE 147,Residential,23085,93931,0,117016
140935100500000,NE 147,Residential,22572,128215,0,150787
140935100600000,NE 147,Residential,22800,135312,0,158112
140935100700000,NE 147,Residential,22800,112216,0,135016
140935100800000,NE 147,Residential,22572,125885,0,148457
140935100900000,NE 147,Residential,22116,102727,0,124843
140935101000000,NE 147,Residential,20766,127587,0,148353
140935101100000,NE 147,Residential,41075,37346,0,78421
140935101200000,NE 147,Residential,41075,384913,0,425988
140935101300000,NE 147,Residential,22192,0,0,22192
140935101400000,NE 147,Residential,21517,0,0,21517
140935101500000,NE 147,Residential,15300,37025,0,52325
140935101600000,NE 147,Residential,16950,0,0,16950
140935101700000,NE 147,Residential,20340,75244,0,95584
140935101800000,NE 147,Residential,18656,68078,0,86734
140935101900000,NE 147,Residential,15300,87604,0,102904
140935102000000,NE 147,Residential,15300,92470,0,107770
140935102100000,NE 147,Residential,4200,0,0,4200
140935102200000,NE 147,Residential,42475,174560,0,217035
140935102300000,NE 147,Residential,42725,50813,0,93538
140935102400000,NE 147,Residential,43300,99901,0,143201
140935102500000,NE 147,Residential,30000,107998,0,137998
140935102600000,NE 147,Residential,30094,70184,0,100278
140935102700000,NE 147,Residential,42175,74072,0,116247
140935102800000,NE 147,Residential,42380,0,0,42380
140935102900000,NE 147,Residential,33789,0,0,33789
140935103000000,NE 147,Residential,25025,0,0,25025
140935200100000,NE 147,Residential,29971,128991,0,158962
140935200200000,NE 147,Residential,24184,71025,0,95209
140935200300000,NE 147,Residential,41328,222016,0,263344
140935200400000,NE 147,Residential,26451,98461,0,124912
140935200500000,NE 147,Residential,25800,129068,0,154868
140935200600000,NE 147,Residential,25800,109189,0,134989
140935200700000,NE 147,Residential,27997,94578,0,122575
140935300100000,NE 147,Residential,23184,182617,0,205801
140935300200000,NE 147,Residential,38250,103825,0,142075
140935300300000,NE 147,Residential,21120,0,0,21120
140935300500000,NE 147,Residential,21615,88553,0,110168
140935300600000,NE 147,Residential,29925,46532,0,76457
140935300700000,NE 147,Residential,23166,0,0,23166
140935300800000,NE 147,Residential,22563,66581,0,89144
140935300900000,NE 147,Residential,10017,31,0,10048
140935301000000,NE 147,Residential,16538,59100,0,75638
140935301100000,NE 147,Residential,24883,94245,0,119128
140935301200000,NE 147,Residential,29606,57021,0,86627
140935301300000,NE 147,Residential,1666,416,0,2082
140935301400000,NE 147,Residential,26670,106004,0,132674
140935301500000,NE 147,Residential,26880,100379,0,127259
140935301600000,NE 147,Residential,27648,94190,0,121838
140935301700000,NE 147,Residential,17415,33531,0,50946
140935301800000,NE 147,Residential,25880,103445,0,129325
140935301900000,NE 147,Residential,26865,99176,0,126041
140935302000000,NE 147,Residential,26585,101112,0,127697
140937600100000,NE 147,Residential,40575,94185,0,134760
140937600200000,NE 147,Residential,33800,88308,0,122108
140937600300000,NE 147,Residential,31360,52704,0,84064
140937600400000,NE 147,Residential,30480,138775,0,169255
140937600500000,NE 147,Residential,22860,75605,0,98465
140937600600000,NE 147,Residential,36195,43516,0,79711
140937600700000,NE 147,Residential,19500,38867,0,58367
140937600800000,NE 147,Residential,24060,84907,0,108967
140937600900000,NE 147,Residential,28560,73011,0,101571
140937601000000,NE 147,Residential,22995,86826,0,109821
140937601100000,NE 147,Residential,20280,75160,0,95440
140937601200000,NE 147,Residential,19790,86813,0,106603
140937601300000,NE 147,Residential,18720,80996,0,99716
140937601400000,NE 147,Residential,19305,93783,0,113088
140937601500000,NE 147,Residential,18000,81567,0,99567
140937601600000,NE 147,Residential,18000,86409,0,104409
140937601700000,NE 147,Residential,18900,84612,0,103512
140937601800000,NE 147,Residential,18850,102254,0,121104
140937601900000,NE 147,Residential,5265,0,0,5265
140937700100000,NE 147,Residential,20490,133806,0,154296
140937700200000,NE 147,Residential,20827,117844,0,138671
140937700300000,NE 147,Residential,17919,110586,0,128505
140937700400000,NE 147,Residential,19157,85607,0,104764
140937700500000,NE 147,Residential,20927,112637,0,133564
140937700600000,NE 147,Residential,20790,113064,0,133854
140937700700000,NE 147,Residential,20790,124449,0,145239
140937700800000,NE 147,Residential,21261,119334,0,140595
140937700900000,NE 147,Residential,21885,97991,0,119876
140937701000000,NE 147,Residential,20265,99835,0,120100
140937701100000,NE 147,Residential,19157,100996,0,120153
140937701200000,NE 147,Residential,19157,104550,0,123707
140937701300000,NE 147,Residential,23851,125928,0,149779
140937701400000,NE 147,Residential,22626,112220,0,134846
140937701500000,NE 147,Residential,19355,140573,0,159928
140937701600000,NE 147,Residential,17087,119375,0,136462
140937701700000,NE 147,Residential,27056,88621,0,115677
140937701800000,NE 147,Residential,45500,108199,0,153699
140937701900000,NE 147,Residential,43275,46231,0,89506
140937702000000,NE 147,Residential,20116,61361,0,81477
140937702100000,NE 147,Residential,21293,101686,0,122979
140937702200000,NE 147,Residential,38749,128744,0,167493
140937702300000,NE 147,Residential,31446,114112,0,145558
140937702400000,NE 147,Residential,22863,70367,0,93230
140937702500000,NE 147,Residential,14974,67858,0,82832
140937702600000,NE 147,Residential,14985,51276,0,66261
140937702700000,NE 147,Residential,18315,53127,0,71442
140937702800000,NE 147,Residential,18315,40631,0,58946
140937702900000,NE 147,Residential,25704,93791,0,119495
140937703000000,NE 147,Residential,23617,72695,0,96312
140937703100000,NE 147,Residential,36695,186187,0,222882
140937703200000,NE 147,Residential,21797,115014,0,136811
140937703300000,NE 147,Residential,22950,119822,0,142772
140937703400000,NE 147,Residential,22950,138535,0,161485
140937703500000,NE 147,Residential,22950,127000,0,149950
140937703600000,NE 147,Residential,22950,116909,0,139859
140937703700000,NE 147,Residential,22950,130324,0,153274
140937703800000,NE 147,Residential,23720,123934,0,147654
140937703900000,NE 147,Residential,23940,116989,0,140929
140937704000000,NE 147,Residential,4700,0,0,4700
140937704100000,NE 147,Residential,24885,180484,0,205369
140937704200000,NE 147,Residential,24210,140978,0,165188
140937704300000,NE 147,Residential,26481,150764,0,177245
140937704400000,NE 147,Residential,22711,128121,0,150832
140937704500000,NE 147,Residential,23072,146215,0,169287
140937704600000,NE 147,Residential,23072,137485,0,160557
140937704700000,NE 147,Residential,22873,132446,0,155319
140937704800000,NE 147,Residential,22476,136794,0,159270
140937704900000,NE 147,Residential,22497,114430,0,136927
140937800100000,NE 147,Residential,14553,9754,0,24307
140937800200000,NE 147,Residential,12615,98077,0,110692
140937800300000,NE 147,Residential,18300,90059,0,108359
140937800400000,NE 147,Residential,18300,83758,0,102058
140937800500000,NE 147,Residential,18300,94609,0,112909
140937800600000,NE 147,Residential,18300,79138,0,97438
140937800700000,NE 147,Residential,18300,115416,0,133716
140937800800000,NE 147,Residential,18000,88053,0,106053
140937800900000,NE 147,Residential,18000,81638,0,99638
140937801000000,NE 147,Residential,18000,106377,0,124377
140937803200000,NE 147,Residential,31487,167788,0,199275
140937803300000,NE 147,Residential,31944,81344,0,113288
140937803500000,NE 147,Residential,21465,64130,0,85595
140937900100000,NE 147,Residential,19500,95921,0,115421
140937900200000,NE 147,Residential,18000,76440,0,94440
140937900300000,NE 147,Residential,19500,71981,0,91481
140937900400000,NE 147,Residential,18000,87219,0,105219
140937900500000,NE 147,Residential,20800,77379,0,98179
140937900600000,NE 147,Residential,18772,89632,0,108404
140937900700000,NE 147,Residential,18000,91793,0,109793
140937900800000,NE 147,Residential,18525,96770,0,115295
140937900900000,NE 147,Residential,18000,79216,0,97216
140937901000000,NE 147,Residential,18525,97806,0,116331
140938000100000,NE 147,Residential,22890,61658,0,84548
140938000200000,NE 147,Residential,28554,127724,0,156278
140938000300000,NE 147,Residential,35422,157180,0,192602
140938000400000,NE 147,Residential,25294,56671,0,81965
140938000500000,NE 147,Residential,23408,103735,0,127143
140938000600000,NE 147,Residential,16120,38815,0,54935
140940100100000,NE 131,Residential,12870,103745,0,116615
140940100200000,NE 131,Residential,19012,87315,0,106327
140940100300000,NE 131,Residential,14625,28666,0,43291
140940100400000,NE 131,Residential,14625,114340,0,128965
140940100500000,NE 131,Residential,16088,84582,0,100670
140940100600000,NE 131,Residential,13163,90524,0,103687
140940100700000,NE 131,Residential,14625,99079,0,113704
140940100800000,NE 131,Residential,14625,89790,0,104415
140940100900000,NE 131,Residential,29000,119088,0,148088
140940101000000,NE 131,Residential,16530,79237,0,95767
140940101100000,NE 131,Residential,12180,55524,0,67704
140940101200000,NE 131,Residential,12180,54577,0,66757
140940101300000,NE 131,Residential,16240,57028,0,73268
140940101400000,NE 131,Residential,14500,71096,0,85596
140940101500000,NE 131,Residential,14500,83429,0,97929
140940101600000,NE 131,Residential,17400,105204,0,122604
140940101700000,NE 131,Residential,17400,49003,0,66403
140940101800000,NE 131,Residential,14500,47438,0,61938
140940101900000,NE 131,Residential,14500,68737,0,83237
140940102000000,NE 131,Residential,14500,75507,0,90007
140940102100000,NE 131,Residential,12125,30829,0,42954
140940102200000,NE 131,Residential,16875,110101,0,126976
140940102300000,NE 131,Residential,19597,41133,0,60730
140940200100000,NE 131,Residential,9326,33692,0,43018
140940200200000,NE 131,Residential,14375,55698,0,70073
140940200300000,NE 131,Residential,14375,76042,0,90417
140940200400000,NE 131,Residential,14375,37240,0,51615
140940200500000,NE 131,Residential,14375,47825,0,62200
140940200600000,NE 131,Residential,14375,48966,0,63341
140940200700000,NE 131,Residential,14375,77471,0,91846
140940200800000,NE 131,Residential,14375,60805,0,75180
140940200900000,NE 131,Residential,14375,31056,0,45431
140940201000000,NE 131,Residential,14375,47712,0,62087
140940201100000,NE 131,Residential,14375,25136,0,39511
140940201200000,NE 131,Residential,18687,84288,0,102975
140940201300000,NE 131,Residential,18687,99992,0,118679
140940201400000,NE 131,Residential,14375,60005,0,74380
140940201500000,NE 131,Residential,14375,101489,0,115864
140940201600000,NE 131,Residential,14375,70110,0,84485
140940201700000,NE 131,Residential,14375,59222,0,73597
140940201800000,NE 131,Residential,18550,101094,0,119644
140940201900000,NE 131,Residential,15400,84141,0,99541
140940300100000,NE 131,Residential,18000,66349,0,84349
140940300200000,NE 131,Residential,16359,101892,0,118251
140940300300000,NE 131,Residential,16359,87013,0,103372
140940300400000,NE 131,Residential,17280,91630,0,108910
140940300500000,NE 131,Residential,26937,114357,0,141294
140940300600000,NE 131,Residential,14250,45768,0,60018
140940300700000,NE 131,Residential,14125,93728,0,107853
140940300800000,NE 131,Residential,21187,52648,0,73835
140940300900000,NE 131,Residential,16809,43751,0,60560
140940301000000,NE 131,Residential,17920,103781,0,121701
140940301200000,NE 131,Residential,14000,0,0,14000
140940301300000,COMM NE,Commercial,91692,0,11940,103632
140940301400000,NE 131,Residential,14125,0,0,14125
140940301500000,NE 131,Residential,16830,90834,0,107664
140940301600000,NE 131,Residential,16500,112707,0,129207
140940301700000,NE 131,Residential,16500,93866,0,110366
140940302000000,NE 131,Residential,21562,74403,0,95965
140940302100000,NE 131,Residential,14375,119647,0,134022
140940302200000,NE 131,Residential,14375,89996,0,104371
140940302300000,NE 131,Residential,14375,64581,0,78956
140940302400000,NE 131,Residential,18687,85389,0,104076
140940302500000,NE 131,Residential,14375,48526,0,62901
140940302600000,NE 131,Residential,14375,83129,0,97504
140940302700000,NE 131,Residential,14375,31482,0,45857
140940302800000,NE 131,Residential,18687,66311,0,84998
140940302900000,NE 131,Residential,18687,78720,0,97407
140940303000000,NE 131,Residential,18687,57818,0,76505
140940303100000,NE 131,Residential,18687,65124,0,83811
140940303200000,NE 131,Residential,16129,37985,0,54114
140940400100000,COMM NE,Commercial,948834,0,2048646,2997480
140940400200000,NE 131,Residential,12650,47103,0,59753
140940400300000,NE 131,Residential,16100,69446,0,85546
140940400400000,NE 131,Residential,17812,70078,0,87890
140940400500000,NE 131,Residential,16625,102346,0,118971
140940400600000,NE 131,Residential,16650,0,0,16650
140940400700000,NE 131,Residential,16650,56947,0,73597
140940400800000,NE 131,Residential,13200,67992,0,81192
140940400900000,NE 131,Residential,14375,55423,0,69798
140940401000000,NE 131,Residential,11875,60732,0,72607
140940401100000,NE 131,Residential,14000,63378,0,77378
140940401200000,NE 131,Residential,14000,72499,0,86499
140940401400000,COMM NE,Commercial,207360,0,410287,617647
140940401500000,NE 131,Residential,14375,76730,0,91105
140940401600000,NE 131,Residential,14375,70736,0,85111
140940401700000,NE 131,Residential,14375,52999,0,67374
140940401800000,NE 131,Residential,14375,0,0,14375
140940401900000,NE 131,Residential,14375,40092,0,54467
140942600100000,COMM NE,Commercial,102816,0,10880,113696
140942600200000,COMM NE,Commercial,116640,0,287123,403763
140942600300000,NE 132,Residential,18600,111302,0,129902
140942600400000,NE 131,Residential,16815,86073,0,102888
140942600500000,NE 132,Residential,17325,65013,0,82338
140942600600000,COMM NE,Commercial,123690,0,84480,208170
140942600700000,COMM NE,Commercial,26849,0,37801,64650
140942600800000,COMM NE,Commercial,526500,0,701207,1227707
140942600900000,COMM NE,Commercial,27672,0,57712,85384
140942601000000,COMM NE,Commercial,364500,0,183136,547636
140942601100000,COMM NE,Commercial,105235,0,180484,285719
140942601200000,COMM NE,Commercial,257904,0,392183,650087
140942700100000,NE 132,Residential,16537,93487,0,110024
140942700200000,NE 132,Residential,16950,56522,0,73472
140942700300000,NE 132,Residential,18058,55701,0,73759
140942700400000,NE 132,Residential,13000,39709,0,52709
140942700500000,NE 132,Residential,12750,0,0,12750
140942700600000,COMM NE,Commercial,107571,0,152653,260224
140942800100000,COMM NE,Commercial,187326,0,420614,607940
140942900100000,COMM NE,Commercial,83203,0,27086,110289
140942900200000,COMM NE,Commercial,147111,0,137889,285000
140942900300000,COMM NE,Commercial,156492,0,82130,238622
140942900400000,COMM NE,Commercial,259200,0,164249,423449
140943000100000,COMM NE,Commercial,38048,0,0,38048
140945100100000,COMM NE,Commercial,198323,0,448032,646355
140945100200000,COMM NE,Commercial,109572,0,320428,430000
140945100300000,COMM NE,Commercial,83529,0,108804,192333
140945100401000,COMM NE,Commercial,92880,0,233915,326795
140945100401001,COMM NE,Commercial,92880,0,310582,403462
140945100500000,NE 146,Residential,16928,36057,0,52985
140945100600000,NE 146,Residential,22448,25073,0,47521
140945100700000,COMM NE,Commercial,235440,0,338267,573707
140945100800000,COMM NE,Commercial,261360,0,239391,500751
140945100900000,NE 146,Residential,19775,62372,0,82147
140945101000000,NE 146,Residential,16120,48193,0,64313
140945101100000,NE 146,Residential,27363,77668,0,105031
140945101200000,NE 146,Residential,19988,81616,0,101604
140945101400000,Empty,Other,0,0,0,0
140945200100000,E-15 CITY,Exempt,0,0,0,0
140945200200000,NE 146,Residential,8779,0,0,8779
140945200300000,NE 147,Residential,10632,88906,0,99538
140945200400000,NE 147,Residential,15250,85160,0,100410
140945200500000,NE 147,Residential,15250,85818,0,101068
140945200600000,NE 147,Residential,15250,76194,0,91444
140945200700000,NE 147,Residential,15250,80844,0,96094
140945200800000,NE 147,Residential,15250,93218,0,108468
140945200900000,NE 147,Residential,15000,104901,0,119901
140945201100000,NE 147,Residential,25200,76723,0,101923
140947600100000,COMM NE,Commercial,476442,0,582387,1058829
140947700200000,COMM NE,Commercial,625709,0,427301,1053010
140947700500000,NE 146,Residential,10688,29313,0,40001
140947700600000,NE 146,Residential,9500,67273,0,76773
140947700700000,NE 146,Residential,10450,38334,0,48784
140947700800000,NE 146,Residential,13063,18186,0,31249
140947700900000,COMM NE,Commercial,293760,0,1135088,1428848
140947701100000,NE 146,Residential,15750,27756,0,43506
140947701200000,NE 146,Residential,15625,0,0,15625
140947701300000,NE 146,Residential,44090,134029,0,178119
140947701400000,NE 146,Residential,28898,163496,0,192394
140947701500000,NE 146,Residential,20616,87676,0,108292
140947701600000,NE 146,Residential,20520,70847,0,91367
140947701700000,NE 146,Residential,20520,72410,0,92930
140947701800000,NE 146,Residential,20520,80536,0,101056
140947701900000,NE 146,Residential,20520,77025,0,97545
140947702000000,NE 146,Residential,20520,84878,0,105398
140947702100000,NE 146,Residential,12125,77084,0,89209
140947702200000,APTS NE,Commercial,17694,0,142306,160000
140947702300000,NE 146,Residential,13426,100750,0,114176
140947702400000,NE 146,Residential,12375,70329,0,82704
140947702500000,NE 146,Residential,12625,73512,0,86137
140947702600000,NE 146,Residential,14794,71169,0,85963
140947702700000,NE 146,Residential,21187,58830,0,80017
140947702800000,NE 146,Residential,17500,102599,0,120099
140947702900000,NE 146,Residential,12875,72419,0,85294
140947703000000,NE 146,Residential,12750,60309,0,73059
140947703100000,NE 146,Residential,12750,37624,0,50374
140947703200000,NE 146,Residential,20825,105433,0,126258
140947703300000,NE 146,Residential,18000,77121,0,95121
140947703400000,NE 146,Residential,21175,73573,0,94748
140947800200000,NE 146,Residential,13388,59018,0,72406
140947800300000,NE 146,Residential,13655,74574,0,88229
140947800400000,NE 146,Residential,11875,42696,0,54571
140947800500000,NE 146,Residential,11875,57656,0,69531
140947800600000,NE 146,Residential,11875,32782,0,44657
140947800700000,COMM NE,Commercial,383940,0,694679,1078619
140947801300000,NE 146,Residential,17010,0,0,17010
140947801401000,CONDO 500,Residential,6000,73457,0,79457
140947801401001,CONDO 500,Residential,6000,73457,0,79457
140947801401002,CONDO 500,Residential,6000,73457,0,79457
140947801401003,CONDO 500,Residential,6000,73457,0,79457
140947801401004,CONDO 500,Residential,6000,74485,0,80485
140947801401005,CONDO 500,Residential,6000,74485,0,80485
140947801401006,CONDO 500,Residential,6000,74485,0,80485
140947801401007,CONDO 500,Residential,6000,74485,0,80485
140947801401008,CONDO 500,Residential,6000,75274,0,81274
140947801401009,CONDO 500,Residential,6000,75274,0,81274
140947801401010,CONDO 500,Residential,6000,75274,0,81274
140947801401011,CONDO 500,Residential,6000,75274,0,81274
140947801401012,CONDO 500,Residential,6000,73457,0,79457
140947801401013,CONDO 500,Residential,6000,73457,0,79457
140947801401014,CONDO 500,Residential,6000,73457,0,79457
140947801401015,CONDO 500,Residential,6000,73457,0,79457
140947801401016,CONDO 500,Residential,6000,74485,0,80485
140947801401017,CONDO 500,Residential,6000,74485,0,80485
140947801401018,CONDO 500,Residential,6000,74485,0,80485
140947801401019,CONDO 500,Residential,6000,74485,0,80485
140947801401020,CONDO 500,Residential,6000,75274,0,81274
140947801401021,CONDO 500,Residential,6000,75274,0,81274
140947801401022,CONDO 500,Residential,6000,75274,0,81274
140947801401023,CONDO 500,Residential,6000,75274,0,81274
140947801401024,CONDO 500,Residential,6000,73457,0,79457
140947801401025,CONDO 500,Residential,6000,73457,0,79457
140947801401026,CONDO 500,Residential,6000,73457,0,79457
140947801401027,CONDO 500,Residential,6000,73457,0,79457
140947801401028,CONDO 500,Residential,6000,74485,0,80485
140947801401029,CONDO 500,Residential,6000,74485,0,80485
140947801401030,CONDO 500,Residential,6000,74485,0,80485
140947801401031,CONDO 500,Residential,6000,74485,0,80485
140947801401032,CONDO 500,Residential,6000,75274,0,81274
140947801401033,CONDO 500,Residential,6000,75274,0,81274
140947801401034,CONDO 500,Residential,6000,75274,0,81274
140947801401035,CONDO 500,Residential,6000,75274,0,81274
140947801500000,NE 146,Residential,18900,63279,0,82179
140947801600000,NE 146,Residential,22437,62029,0,84466
140947801700000,NE 146,Residential,22035,41468,0,63503
140947801800000,NE 146,Residential,22035,47499,0,69534
140947801900000,NE 146,Residential,20638,129489,0,150127
140947802000000,NE 146,Residential,20638,67651,0,88289
140947802100000,NE 146,Residential,22225,95281,0,117506
140947802200000,NE 146,Residential,25400,58134,0,83534
140947802300000,NE 146,Residential,16828,55314,0,72142
140947802400000,NE 146,Residential,14335,65473,0,79808
140947802500000,COMM NE,Commercial,157286,0,169340,326626
140947802600000,NE 146,Residential,27270,73750,0,101020
140947802700000,NE 146,Residential,22725,63674,0,86399
140947802800000,NE 146,Residential,36360,89162,0,125522
140947802900000,NE 146,Residential,31815,57106,0,88921
140947803000000,NE 146,Residential,20976,81697,0,102673
140947803100000,NE 146,Residential,21204,98935,0,120139
140947803200000,NE 146,Residential,21432,76402,0,97834
140947803300000,NE 146,Residential,24138,132304,0,156442
140947803400000,NE 146,Residential,21660,82887,0,104547
140947803500000,NE 146,Residential,22042,80439,0,102481
140947803600000,NE 146,Residential,22504,97457,0,119961
140947803700000,NE 146,Residential,27160,106678,0,133838
140947803800000,NE 146,Residential,28255,98509,0,126764
140947900200000,NE 143,Residential,15108,57366,0,72474
140947900300000,NE 143,Residential,15300,60170,0,75470
140947900400000,NE 143,Residential,13760,64229,0,77989
140947900500000,NE 143,Residential,14967,90415,0,105382
140947900600000,NE 143,Residential,17280,74435,0,91715
140947900700000,NE 143,Residential,15595,65880,0,81475
140947900800000,NE 143,Residential,20400,32697,0,53097
140947900900000,NE 143,Residential,24240,61008,0,85248
140948000100000,NE 143,Residential,25926,75709,0,101635
140948000200000,NE 143,Residential,24948,97537,0,122485
140948000300000,NE 143,Residential,17856,69679,0,87535
140948000400000,NE 143,Residential,24525,149401,0,173926
140948000500000,NE 143,Residential,26676,99030,0,125706
140948000600000,NE 143,Residential,20475,88062,0,108537
140948000700000,NE 143,Residential,13685,91720,0,105405
140948000800000,NE 143,Residential,15000,71705,0,86705
140948000900000,NE 143,Residential,24858,69287,0,94145
140948001000000,NE 143,Residential,10875,60952,0,71827
140948001100000,NE 143,Residential,23400,82694,0,106094
140948001200000,E-46 RELIG PARKING,Exempt,16034,0,6882,22916
140948001300000,NE 143,Residential,29998,124007,0,154005
140948001400000,NE 143,Residential,20400,84808,0,105208
140948001500000,NE 143,Residential,18768,76692,0,95460
140948001600000,NE 143,Residential,26112,94737,0,120849
140948001700000,NE 143,Residential,27669,77984,0,105653
140948001800000,NE 143,Residential,28560,79745,0,108305
140948001900000,NE 143,Residential,29451,120920,0,150371
141010100100000,NE 130,Residential,29507,76511,0,106018
141010100200000,NE 130,Residential,30264,82181,0,112445
141010100300000,NE 130,Residential,27063,56067,0,83130
141010100400000,NE 130,Residential,26190,68602,0,94792
141010100500000,NE 130,Residential,23280,83286,0,106566
141010100600000,NE 130,Residential,23280,72990,0,96270
141010100700000,NE 130,Residential,23280,86123,0,109403
141010100800000,NE 130,Residential,23280,61327,0,84607
141010100900000,NE 130,Residential,23280,65541,0,88821
141010101000000,NE 130,Residential,23280,69109,0,92389
141010101100000,NE 130,Residential,23280,73554,0,96834
141010101200000,NE 130,Residential,24880,70915,0,95795
141010200100000,NE 130,Residential,26190,59789,0,85979
141010200200000,NE 130,Residential,28372,87154,0,115526
141010200300000,NE 130,Residential,23280,59506,0,82786
141010200400000,NE 130,Residential,23280,66578,0,89858
141010200500000,NE 130,Residential,23280,57258,0,80538
141010200600000,NE 130,Residential,23280,67668,0,90948
141010300100000,NE 130,Residential,25972,80112,0,106084
141010300200000,NE 130,Residential,25972,64977,0,90949
141010300300000,NE 130,Residential,26190,81884,0,108074
141010300400000,NE 130,Residential,26190,63016,0,89206
141010300500000,NE 130,Residential,26190,55409,0,81599
141010400100000,NE 130,Residential,28518,89121,0,117639
141010400200000,NE 130,Residential,26190,62509,0,88699
141010400300000,NE 130,Residential,26190,80719,0,106909
141010400400000,NE 130,Residential,23280,97343,0,120623
141010400500000,NE 130,Residential,23280,85529,0,108809
141010400600000,NE 130,Residential,26190,62484,0,88674
141010400700000,NE 130,Residential,23280,72172,0,95452
141010400800000,NE 130,Residential,23280,70928,0,94208
141010400900000,NE 130,Residential,23280,53940,0,77220
141010401000000,NE 130,Residential,23280,76364,0,99644
141010401100000,NE 130,Residential,23280,56731,0,80011
141010401200000,NE 130,Residential,23280,58512,0,81792
141010401300000,NE 130,Residential,24880,63570,0,88450
141010401400000,NE 130,Residential,29294,57706,0,87000
141010401500000,NE 130,Residential,29294,39035,0,68329
141010401600000,NE 130,Residential,29100,50295,0,79395
141010401700000,NE 130,Residential,29682,54535,0,84217
141010401800000,NE 130,Residential,29682,55830,0,85512
141010401900000,NE 130,Residential,29100,71534,0,100634
141010402000000,NE 130,Residential,29682,69890,0,99572
141010402100000,NE 130,Residential,29100,40728,0,69828
141010402200000,NE 130,Residential,29539,86187,0,115726
141010402300000,NE 130,Residential,28800,66494,0,95294
141010402400000,NE 130,Residential,24192,50549,0,74741
141010402500000,NE 130,Residential,34368,77912,0,112280
141010500100000,NE 130,Residential,24880,77997,0,102877
141010500200000,NE 130,Residential,23280,88258,0,111538
141010500300000,NE 130,Residential,23280,71316,0,94596
141010500400000,NE 130,Residential,23280,74251,0,97531
141010500500000,NE 130,Residential,23280,82236,0,105516
141010500600000,NE 130,Residential,25920,61824,0,87744
141010500700000,NE 130,Residential,25920,52580,0,78500
141010500800000,NE 130,Residential,23280,89598,0,112878
141010500900000,NE 130,Residential,23280,72974,0,96254
141010501000000,NE 130,Residential,23280,85503,0,108783
141010501100000,NE 130,Residential,23280,81093,0,104373
141010501200000,NE 130,Residential,23280,73872,0,97152
141010501300000,NE 130,Residential,23280,60668,0,83948
141010501400000,NE 130,Residential,26190,69511,0,95701
141010600100000,NE 130,Residential,30264,70928,0,101192
141010600200000,NE 130,Residential,28371,74693,0,103064
141010600300000,NE 130,Residential,27761,67764,0,95525
141010600400000,NE 130,Residential,28779,57680,0,86459
141010600500000,NE 130,Residential,32432,98789,0,131221
141010600600000,NE 130,Residential,37867,68054,0,105921
141010600700000,NE 130,Residential,34920,52704,0,87624
141010600800000,NE 130,Residential,34920,28187,0,63107
141010600900000,NE 130,Residential,34920,78216,0,113136
141010601000000,NE 130,Residential,26190,52016,0,78206
141010700100000,NE 130,Residential,32340,113902,0,146242
141010700200000,NE 130,Residential,34650,92363,0,127013
141010700300000,NE 130,Residential,35763,59554,0,95317
141010700400000,NE 130,Residential,35910,73724,0,109634
141010700500000,NE 130,Residential,34020,66519,0,100539
141010700600000,NE 130,Residential,34020,58901,0,92921
141010700700000,NE 130,Residential,35910,85656,0,121566
141010700800000,NE 130,Residential,34020,49685,0,83705
141010700900000,NE 130,Residential,34020,50754,0,84774
141010701000000,NE 130,Residential,35568,53047,0,88615
141010701100000,NE 130,Residential,35474,69330,0,104804
141010701200000,NE 130,Residential,24057,74319,0,98376
141010701300000,NE 130,Residential,23760,66418,0,90178
141010701400000,NE 130,Residential,23760,46553,0,70313
141010701500000,NE 130,Residential,23760,81603,0,105363
141010701600000,NE 130,Residential,23760,45418,0,69178
141010701700000,NE 130,Residential,23760,34640,0,58400
141010701800000,NE 130,Residential,23760,69801,0,93561
141010701900000,NE 130,Residential,25245,80191,0,105436
141010702000000,NE 130,Residential,23760,62547,0,86307
141010702100000,NE 130,Residential,23760,38436,0,62196
141010702200000,NE 130,Residential,23760,55449,0,79209
141010702300000,NE 130,Residential,23760,77375,0,101135
141010702400000,NE 130,Residential,28512,93825,0,122337
141010702500000,NE 130,Residential,24057,53933,0,77990
141010800100000,NE 130,Residential,37128,50751,0,87879
141010800200000,NE 130,Residential,29490,69839,0,99329
141010800300000,NE 130,Residential,27810,82340,0,110150
141010800400000,NE 130,Residential,27810,80147,0,107957
141010800500000,NE 130,Residential,27810,90456,0,118266
141010800600000,NE 130,Residential,24240,56601,0,80841
141010800700000,NE 130,Residential,24240,54139,0,78379
141010800800000,NE 130,Residential,24240,54807,0,79047
141010800900000,NE 130,Residential,24240,59975,0,84215
141010801000000,NE 130,Residential,30600,86600,0,117200
141010801100000,NE 130,Residential,31416,89466,0,120882
141010801200000,NE 130,Residential,33936,54404,0,88340
141010801300000,NE 130,Residential,26316,78210,0,104526
141010900100000,NE 130,Residential,30547,84189,0,114736
141010900200000,NE 130,Residential,27810,44244,0,72054
141010900300000,NE 130,Residential,27270,56512,0,83782
141010900400000,NE 130,Residential,27270,48110,0,75380
141010900500000,NE 130,Residential,27270,52776,0,80046
141010900600000,NE 130,Residential,6600,0,0,6600
141010900700000,NE 130,Residential,26190,50229,0,76419
141010900800000,NE 130,Residential,27354,47234,0,74588
141010900900000,NE 130,Residential,25026,60026,0,85052
141010901000000,NE 130,Residential,24240,91488,0,115728
141010901100000,NE 130,Residential,24240,68466,0,92706
141010901200000,NE 130,Residential,24240,63168,0,87408
141010901300000,NE 130,Residential,24240,85259,0,109499
141010901400000,NE 130,Residential,29309,59442,0,88751
141011000100000,NE 130,Residential,38784,64040,0,102824
141011000200000,NE 130,Residential,34920,68406,0,103326
141011000300000,NE 130,Residential,37102,71745,0,108847
141011000400000,NE 130,Residential,24240,56366,0,80606
141011000500000,NE 130,Residential,24240,81123,0,105363
141011000600000,NE 130,Residential,24240,60439,0,84679
141011000700000,NE 130,Residential,24240,79844,0,104084
141011000800000,NE 130,Residential,24240,95679,0,119919
141011000900000,NE 130,Residential,36666,63591,0,100257
141011001000000,NE 130,Residential,37714,60344,0,98058
141011001100000,NE 130,Residential,24240,75947,0,100187
141011001200000,NE 130,Residential,24240,56694,0,80934
141011001300000,NE 130,Residential,38784,85421,0,124205
141011001400000,NE 130,Residential,36360,62502,0,98862
141011001500000,NE 130,Residential,36360,78883,0,115243
141011001600000,NE 130,Residential,38784,50372,0,89156
141011100100000,NE 130,Residential,36855,61127,0,97982
141011100200000,NE 130,Residential,36855,69132,0,105987
141011100300000,NE 130,Residential,33936,74099,0,108035
141011100400000,NE 130,Residential,42420,55320,0,97740
141011100500000,NE 130,Residential,42420,71132,0,113552
141011100700000,NE 130,Residential,24240,45930,0,70170
141011100800000,NE 130,Residential,24240,51837,0,76077
141011100900000,NE 130,Residential,24240,58679,0,82919
141011101000000,NE 130,Residential,24240,69003,0,93243
141011101100000,NE 130,Residential,38784,60075,0,98859
141011101200000,NE 130,Residential,24240,54943,0,79183
141011101300000,NE 130,Residential,36360,80253,0,116613
141011101400000,NE 130,Residential,36360,79577,0,115937
141011101500000,NE 130,Residential,24240,43650,0,67890
141011101600000,NE 130,Residential,36360,69136,0,105496
141011200100000,NE 130,Residential,24240,83595,0,107835
141011200200000,NE 130,Residential,32400,66152,0,98552
141011200300000,NE 130,Residential,32400,71744,0,104144
141011200400000,NE 130,Residential,24240,71307,0,95547
141011200500000,NE 130,Residential,24240,39393,0,63633
141011200600000,NE 130,Residential,32724,51245,0,83969
141011200700000,NE 130,Residential,27876,47946,0,75822
141011200800000,NE 130,Residential,32724,55327,0,88051
141011200900000,NE 130,Residential,27876,46326,0,74202
141011201000000,NE 130,Residential,32400,49297,0,81697
141011201100000,NE 130,Residential,32400,56700,0,89100
141011201200000,NE 130,Residential,24240,48132,0,72372
141011201300000,NE 130,Residential,24240,86234,0,110474
141011201400000,NE 130,Residential,36360,57641,0,94001
141011201500000,NE 130,Residential,36360,77175,0,113535
141011201600000,NE 130,Residential,38784,76940,0,115724
141011201700000,NE 130,Residential,15150,0,0,15150
141011201800000,NE 130,Residential,40299,80323,0,120622
141011300100000,NE 130,Residential,38784,70120,0,108904
141011300200000,NE 130,Residential,37537,69435,0,106972
141011300300000,NE 130,Residential,36191,72054,0,108245
141011300400000,NE 130,Residential,36360,88233,0,124593
141011300500000,NE 130,Residential,36360,83635,0,119995
141011300600000,NE 130,Residential,36360,92946,0,129306
141011300700000,NE 130,Residential,33330,71530,0,104860
141011300900000,NE 130,Residential,38669,73657,0,112326
141011301000000,NE 130,Residential,32364,77608,0,109972
141011301100000,NE 130,Residential,38784,78396,0,117180
141011301200000,NE 130,Residential,38784,109759,0,148543
141011301300000,NE 130,Residential,32724,52927,0,85651
141011301400000,NE 130,Residential,27876,69703,0,97579
141011301500000,NE 130,Residential,32724,58474,0,91198
141011301600000,NE 130,Residential,27876,40277,0,68153
141012600100000,COMM NE,Commercial,356400,0,277408,633808
141015100100000,NE 131,Residential,32360,49445,0,81805
141015100200000,NE 131,Residential,32565,37244,0,69809
141015100300000,NE 131,Residential,30846,53928,0,84774
141015100400000,NE 131,Residential,31428,40427,0,71855
141015100500000,NE 131,Residential,28518,43828,0,72346
141015100600000,NE 131,Residential,31428,51401,0,82829
141015100700000,NE 131,Residential,30846,54312,0,85158
141015100800000,NE 131,Residential,31428,61326,0,92754
141015100900000,NE 131,Residential,28518,59466,0,87984
141015101000000,NE 131,Residential,31428,57867,0,89295
141015101100000,NE 131,Residential,30846,52483,0,83329
141015101200000,NE 131,Residential,33174,66279,0,99453
141015101300000,NE 131,Residential,35568,66409,0,101977
141015101400000,NE 131,Residential,32754,54045,0,86799
141015101500000,NE 131,Residential,33048,57338,0,90386
141015101600000,NE 131,Residential,29988,53643,0,83631
141015101700000,NE 131,Residential,32724,51946,0,84670
141015101800000,NE 131,Residential,31800,73165,0,104965
141015101900000,NE 131,Residential,32076,63333,0,95409
141015102000000,NE 131,Residential,29106,50482,0,79588
141015102100000,NE 131,Residential,31752,58522,0,90274
141015102200000,NE 131,Residential,30846,50604,0,81450
141015200100000,NE 131,Residential,33326,51289,0,84615
141015200200000,NE 131,Residential,35400,64001,0,99401
141015200300000,NE 131,Residential,36000,54708,0,90708
141015200400000,NE 131,Residential,33600,49316,0,82916
141015200500000,NE 131,Residential,36000,73581,0,109581
141015200600000,NE 131,Residential,33600,46994,0,80594
141015200700000,NE 131,Residential,36000,79581,0,115581
141015200800000,NE 131,Residential,33600,50056,0,83656
141015200900000,NE 131,Residential,36000,62717,0,98717
141015201000000,NE 131,Residential,36000,77856,0,113856
141015201100000,NE 131,Residential,34746,70389,0,105135
141015201200000,NE 131,Residential,34200,49063,0,83263
141015201300000,NE 131,Residential,31800,51881,0,83681
141015201400000,NE 131,Residential,32400,53325,0,85725
141015201500000,NE 131,Residential,29400,43139,0,72539
141015201600000,NE 131,Residential,32400,41201,0,73601
141015201700000,NE 131,Residential,31800,11790,0,43590
141015201800000,NE 131,Residential,32400,49899,0,82299
141015201900000,NE 131,Residential,29400,46417,0,75817
141015202000000,NE 131,Residential,32400,51420,0,83820
141015202100000,NE 131,Residential,31800,49092,0,80892
141015300100000,NE 131,Residential,34244,64541,0,98785
141015300200000,NE 131,Residential,32232,34887,0,67119
141015300300000,NE 131,Residential,32076,58543,0,90619
141015300400000,NE 131,Residential,32076,54542,0,86618
141015300500000,NE 131,Residential,30888,52200,0,83088
141015300600000,NE 131,Residential,31482,69750,0,101232
141015300700000,NE 131,Residential,29700,51442,0,81142
141015300800000,NE 131,Residential,32076,63269,0,95345
141015300900000,NE 131,Residential,31482,55078,0,86560
141015301000000,NE 131,Residential,29700,43293,0,72993
141015301100000,NE 131,Residential,31482,59174,0,90656
141015301200000,NE 131,Residential,33858,59859,0,93717
141015301300000,NE 131,Residential,35046,55902,0,90948
141015301400000,NE 131,Residential,33264,46195,0,79459
141015301500000,NE 131,Residential,35640,53558,0,89198
141015301600000,NE 131,Residential,35640,56940,0,92580
141015301700000,NE 131,Residential,33264,53136,0,86400
141015301800000,NE 131,Residential,35640,74867,0,110507
141015301900000,NE 131,Residential,35640,81484,0,117124
141015302000000,NE 131,Residential,35640,63831,0,99471
141015302100000,NE 131,Residential,33264,62117,0,95381
141015400100000,NE 131,Residential,31897,53642,0,85539
141015400200000,NE 131,Residential,43738,96913,0,140651
141015400300000,NE 131,Residential,44676,81212,0,125888
141015400400000,NE 131,Residential,44676,82778,0,127454
141015400500000,NE 131,Residential,44238,89197,0,133435
141015400600000,NE 131,Residential,43800,110957,0,154757
141015400700000,NE 131,Residential,43800,86467,0,130267
141015400800000,NE 131,Residential,43362,102187,0,145549
141015400900000,NE 131,Residential,44100,116700,0,160800
141015401000000,NE 131,Residential,30780,54284,0,85064
141015401100000,NE 131,Residential,30210,50443,0,80653
141015401200000,NE 131,Residential,30780,48576,0,79356
141015401300000,NE 131,Residential,30780,64550,0,95330
141015401400000,NE 131,Residential,28500,51581,0,80081
141015401500000,NE 131,Residential,30780,54085,0,84865
141015401600000,NE 131,Residential,30210,65119,0,95329
141015401700000,NE 131,Residential,28500,51069,0,79569
141015401800000,NE 131,Residential,30780,59974,0,90754
141015401900000,NE 131,Exempt,29640,0,47418,77058
141015500100000,NE 131,Residential,35000,71777,0,106777
141015500200000,NE 131,Residential,35000,77194,0,112194
141015500300000,NE 131,Residential,35000,111930,0,146930
141015500400000,NE 131,Residential,35000,110313,0,145313
141015500500000,NE 131,Residential,35000,79589,0,114589
141015500600000,NE 131,Residential,23050,47061,0,70111
141015500700000,NE 131,Residential,23450,43693,0,67143
141015500800000,NE 131,Residential,23500,44573,0,68073
141015500900000,NE 131,Residential,35000,43515,0,78515
141015501000000,NE 131,Residential,35000,107942,0,142942
141015501100000,NE 131,Residential,35000,99281,0,134281
141015501200000,NE 131,Residential,35000,50785,0,85785
141015501300000,NE 131,Residential,35000,32375,0,67375
141015501400000,NE 131,Residential,35000,79760,0,114760
141015501500000,NE 131,Residential,35000,58584,0,93584
141015600100000,NE 131,Residential,35000,86714,0,121714
141015600200000,NE 131,Residential,35000,73137,0,108137
141015600300000,NE 131,Residential,35000,66760,0,101760
141015600400000,NE 131,Residential,35000,95200,0,130200
141015600500000,NE 131,Residential,35000,96027,0,131027
141015600600000,NE 131,Residential,35000,59792,0,94792
141015600700000,NE 131,Residential,35000,98633,0,133633
141015600800000,NE 131,Residential,32500,83817,0,116317
141015600900000,NE 131,Residential,37500,94745,0,132245
141015601000000,NE 131,Residential,35000,80874,0,115874
141015601100000,NE 131,Residential,35000,66402,0,101402
141015601200000,NE 131,Residential,17500,39313,0,56813
141015601300000,NE 131,Residential,17500,41451,0,58951
141015700100000,NE 131,Residential,24000,89147,0,113147
141015700200000,NE 131,Residential,40500,96675,0,137175
141015700400000,NE 131,Residential,22500,0,0,22500
141015700500000,NE 131,Residential,22500,84064,0,106564
141015700600000,NE 131,Residential,38792,111032,0,149824
141015700700000,NE 131,Residential,37875,118081,0,155956
141015700800000,NE 131,Residential,38000,98560,0,136560
141015700900000,NE 131,Residential,38000,67212,0,105212
141015701000000,NE 131,Residential,38000,69145,0,107145
141015800100000,NE 131,Residential,26250,54299,0,80549
141015800200000,NE 131,Residential,26250,72803,0,99053
141015800300000,NE 131,Residential,17500,29351,0,46851
141015800400000,NE 131,Residential,35000,55593,0,90593
141015800500000,NE 131,Residential,35000,66213,0,101213
141015800600000,NE 131,Residential,35000,75178,0,110178
141015800700000,NE 131,Residential,22500,52291,0,74791
141015800800000,NE 131,Residential,25000,32026,0,57026
141015800900000,NE 131,Residential,22500,47340,0,69840
141015801000000,NE 131,Residential,35000,63340,0,98340
141015801100000,NE 131,Residential,35000,74794,0,109794
141015801200000,NE 131,Residential,35000,58281,0,93281
141015801300000,NE 131,Residential,35000,51286,0,86286
141015801400000,NE 131,Residential,35000,80460,0,115460
141015801500000,NE 131,Residential,35000,80867,0,115867
141015801600000,NE 131,Residential,35000,66969,0,101969
141015900100000,NE 131,Residential,35000,53417,0,88417
141015900200000,NE 131,Residential,35000,64065,0,99065
141015900300000,NE 131,Residential,35000,74962,0,109962
141015900400000,NE 131,Residential,36125,37994,0,74119
141015900500000,NE 131,Residential,20000,43216,0,63216
141015900600000,NE 131,Residential,25000,66531,0,91531
141015900700000,NE 131,Residential,17500,33100,0,50600
141015900800000,E-15 CITY,Exempt,0,0,0,0
141015900900000,NE 131,Residential,22750,29321,0,52071
141015901000000,NE 131,Residential,22750,38763,0,61513
141015901100000,NE 131,Residential,36400,89780,0,126180
141015901200000,NE 131,Residential,38111,108780,0,146891
141015901300000,NE 131,Residential,35000,100241,0,135241
141015901400000,NE 131,Residential,35000,77294,0,112294
141015901500000,NE 131,Residential,35000,55050,0,90050
141015901600000,NE 131,Residential,35000,56162,0,91162
141015901700000,NE 131,Residential,35000,42713,0,77713
141015901800000,NE 131,Residential,35000,68688,0,103688
141017600100000,NE 129,Residential,24030,71309,0,95339
141017600200000,NE 129,Residential,31500,43821,0,75321
141017600300000,NE 129,Residential,32130,95806,0,127936
141017600400000,NE 129,Residential,34650,83595,0,118245
141017600500000,NE 129,Residential,43092,106928,0,150020
141017600600000,NE 129,Residential,40950,95412,0,136362
141017600700000,NE 129,Residential,35910,63539,0,99449
141017600800000,NE 129,Residential,33390,75293,0,108683
141017600900000,NE 129,Residential,31500,46861,0,78361
141017601000000,NE 129,Residential,28050,87682,0,115732
141017601100000,NE 129,Residential,27600,69760,0,97360
141017601200000,NE 129,Residential,23000,70946,0,93946
141017601300000,NE 129,Residential,23000,93285,0,116285
141017601400000,NE 129,Residential,33600,68275,0,101875
141017601500000,NE 129,Residential,33600,68658,0,102258
141017601600000,NE 129,Residential,35700,94777,0,130477
141017601700000,NE 129,Residential,31500,83933,0,115433
141017601800000,NE 129,Residential,33600,102247,0,135847
141017601900000,NE 129,Residential,27200,71194,0,98394
141017602000000,NE 129,Residential,24638,72759,0,97397
141017602100000,NE 129,Residential,22028,64878,0,86906
141017602200000,NE 129,Residential,24030,61255,0,85285
141017700100000,Empty,Exempt,0,0,0,0
141017800100000,NE 129,Residential,31918,107170,0,139088
141017800200000,NE 129,Residential,31280,65689,0,96969
141017800300000,NE 129,Residential,31500,102687,0,134187
141017800400000,NE 129,Residential,31500,93143,0,124643
141017800500000,NE 129,Residential,31500,77600,0,109100
141017800600000,NE 129,Residential,31500,99598,0,131098
141017800700000,NE 129,Residential,31500,98005,0,129505
141017800800000,NE 129,Residential,31500,62752,0,94252
141017800900000,NE 129,Residential,31500,59858,0,91358
141017801000000,NE 129,Residential,30258,84707,0,114965
141017801100000,NE 129,Residential,32742,121551,0,154293
141017801200000,NE 129,Residential,31500,69902,0,101402
141017801300000,NE 129,Residential,31500,92170,0,123670
141017801400000,NE 129,Residential,31500,65507,0,97007
141017801500000,NE 129,Residential,31500,71551,0,103051
141017801600000,NE 129,Residential,31500,103037,0,134537
141017801700000,NE 129,Residential,31500,73031,0,104531
141017801800000,NE 129,Residential,31500,56459,0,87959
141017801900000,NE 129,Residential,23000,69022,0,92022
141017802000000,NE 129,Residential,34883,90186,0,125069
141017802100000,NE 129,Residential,25088,108654,0,133742
141017802200000,NE 129,Residential,25585,87005,0,112590
141017900100000,NE 131,Residential,35000,98064,0,133064
141017900200000,NE 131,Residential,35000,75447,0,110447
141017900300000,NE 131,Residential,35000,80831,0,115831
141017900400000,NE 131,Residential,26250,76668,0,102918
141017900500000,NE 131,Residential,26250,82691,0,108941
141017900600000,NE 131,Residential,35000,81716,0,116716
141017900700000,NE 131,Residential,17500,57337,0,74837
141017900800000,NE 131,Residential,17500,59852,0,77352
141017900900000,NE 131,Residential,35000,62828,0,97828
141017901000000,NE 131,Residential,17500,55360,0,72860
141017901100000,NE 131,Residential,42000,55695,0,97695
141017901200000,NE 131,Residential,35000,87838,0,122838
141017901300000,NE 131,Residential,17500,57631,0,75131
141017901400000,NE 131,Residential,26250,41948,0,68198
141017901500000,NE 131,Residential,26250,70047,0,96297
141017901600000,NE 131,Residential,17500,45260,0,62760
141017901700000,NE 131,Residential,32500,45306,0,77806
141017901800000,NE 131,Residential,20000,34905,0,54905
141017901900000,NE 131,Residential,35000,59637,0,94637
141018000100000,NE 129,Residential,21000,48063,0,69063
141018000200000,NE 129,Residential,22050,68772,0,90822
141018000300000,NE 129,Residential,32760,53835,0,86595
141018000400000,NE 129,Residential,21000,36856,0,57856
141018000500000,NE 129,Residential,21000,95265,0,116265
141018000600000,NE 129,Residential,26250,70170,0,96420
141018000700000,NE 129,Residential,26250,44394,0,70644
141018000800000,NE 129,Residential,26250,67190,0,93440
141018000900000,NE 129,Residential,26250,83232,0,109482
141018001000000,NE 129,Residential,21000,80001,0,101001
141018001100000,NE 129,Residential,21000,91128,0,112128
141018001200000,NE 129,Residential,31500,80961,0,112461
141018001300000,NE 129,Residential,31500,88845,0,120345
141018001400000,NE 129,Residential,21000,45767,0,66767
141018001500000,NE 129,Residential,21000,51870,0,72870
141018001600000,NE 129,Residential,21000,44246,0,65246
141018001700000,NE 129,Residential,21000,62318,0,83318
141018001800000,NE 129,Residential,21000,61041,0,82041
141018001900000,NE 129,Residential,23625,50059,0,73684
141018002000000,NE 129,Residential,33469,62159,0,95628
141018002100000,NE 129,Residential,26250,55311,0,81561
141018002200000,NE 129,Residential,26250,84114,0,110364
141018002300000,NE 129,Residential,31500,72991,0,104491
141018002400000,NE 129,Residential,23625,65481,0,89106
141018002500000,NE 129,Residential,23625,65558,0,89183
141018002600000,NE 129,Residential,36750,67743,0,104493
141018100100000,NE 131,Residential,35000,69952,0,104952
141018100200000,NE 131,Residential,35000,129913,0,164913
141018100300000,NE 131,Residential,24333,81531,0,105864
141018100400000,NE 131,Residential,22167,67961,0,90128
141018100500000,NE 131,Residential,23500,63869,0,87369
141018100600000,NE 131,Residential,35000,68686,0,103686
141018100700000,NE 131,Residential,35000,108815,0,143815
141018100800000,NE 131,Residential,35000,72824,0,107824
141018100900000,NE 131,Residential,35000,42339,0,77339
141018101000000,NE 131,Residential,23330,60719,0,84049
141018101100000,NE 131,Residential,23330,61546,0,84876
141018101200000,NE 131,Residential,28330,53866,0,82196
141018101300000,NE 131,Residential,30000,78527,0,108527
141018101400000,NE 131,Residential,35000,65339,0,100339
141018101500000,NE 131,Residential,29165,54277,0,83442
141018101600000,NE 131,Residential,29165,71432,0,100597
141018101700000,NE 131,Residential,29165,52258,0,81423
141018101800000,NE 131,Residential,35000,63168,0,98168
141018101900000,NE 131,Residential,17500,46093,0,63593
141020100100000,COMM NE,Commercial,320047,0,290827,610874
141020200100000,COMM NE,Commercial,80568,0,197882,278450
141020200200000,COMM NE,Commercial,66528,0,160933,227461
141020200300000,COMM NE,Commercial,117504,0,443145,560649
141022600100000,COMM NE,Commercial,59616,0,188132,247748
141022600200000,NE 132,Residential,40838,74596,0,115434
141022600300000,NE 132,Residential,35640,79419,0,115059
141022600400000,NE 132,Residential,16830,71943,0,88773
141022600500000,NE 132,Residential,36900,49642,0,86542
141022600600000,NE 132,Residential,33840,96334,0,130174
141022600700000,NE 132,Residential,36981,95164,0,132145
141022600800000,NE 132,Residential,42075,84936,0,127011
141022600900000,NE 132,Residential,37622,96777,0,134399
141022601000000,NE 132,Residential,30410,85029,0,115439
141022601100000,NE 132,Residential,33580,81932,0,115512
141022601200000,NE 132,Residential,37345,79137,0,116482
141022601300000,NE 132,Residential,34411,103873,0,138284
141022601400000,APTS NE,Commercial,30132,0,358203,388335
141022601500000,COMM NE,Commercial,105406,0,45267,150673
141022700100000,NE 132,Residential,32928,78156,0,111084
141022700200000,NE 132,Residential,32670,85776,0,118446
141022700300000,NE 132,Residential,28840,106288,0,135128
141022700400000,NE 132,Residential,43715,124611,0,168326
141022700500000,NE 132,Residential,45357,78725,0,124082
141022700600000,NE 132,Residential,32670,93544,0,126214
141022700700000,NE 132,Residential,28350,66517,0,94867
141022700800000,NE 132,Residential,22522,10940,0,33462
141022700900000,NE 132,Residential,26730,77276,0,104006
141022701000000,NE 132,Residential,26730,90176,0,116906
141022701100000,NE 132,Residential,26957,90771,0,117728
141022701200000,NE 132,Residential,30240,95271,0,125511
141022701300000,NE 132,Residential,28343,93287,0,121630
141022701400000,NE 132,Residential,39847,115680,0,155527
141022701500000,NE 132,Residential,37950,146494,0,184444
141022701600000,NE 132,Residential,37950,81861,0,119811
141022701700000,NE 132,Residential,37950,100978,0,138928
141022701800000,NE 132,Residential,38280,95374,0,133654
141022701900000,NE 132,Residential,38940,86483,0,125423
141022702000000,NE 132,Residential,33557,84413,0,117970
141022702100000,NE 132,Residential,34320,71785,0,106105
141022702200000,NE 132,Residential,34320,101574,0,135894
141022702300000,NE 132,Residential,34320,74427,0,108747
141022702400000,NE 132,Residential,38324,82185,0,120509
141022702500000,NE 132,Residential,37180,92247,0,129427
141022702600000,NE 132,Residential,32604,83441,0,116045
141022800100000,NE 132,Residential,60950,79002,0,139952
141022800200000,NE 132,Residential,28759,73039,0,101798
141022800300000,NE 132,Residential,31680,74532,0,106212
141022800400000,NE 132,Residential,31680,86216,0,117896
141022800500000,NE 132,Residential,30624,88520,0,119144
141022800600000,NE 132,Residential,30624,68097,0,98721
141022800700000,NE 132,Residential,27701,82586,0,110287
141022800800000,NE 132,Residential,22141,79013,0,101154
141022900100000,NE 132,Residential,33110,92814,0,125924
141022900200000,NE 132,Residential,33330,90734,0,124064
141022900300000,NE 132,Residential,31123,81637,0,112760
141022900400000,NE 132,Residential,34011,98062,0,132073
141022900500000,NE 132,Residential,33941,83419,0,117360
141022900600000,NE 132,Residential,34202,95081,0,129283
141022900700000,NE 132,Residential,34277,88247,0,122524
141022900800000,NE 132,Residential,34277,67929,0,102206
141022900900000,NE 132,Residential,34277,81144,0,115421
141022901000000,NE 132,Residential,34558,93204,0,127762
141022901100000,NE 132,Residential,34950,90854,0,125804
141022901200000,NE 132,Residential,34782,70689,0,105471
141022901300000,NE 132,Residential,34782,85257,0,120039
141022901400000,NE 132,Residential,34782,73628,0,108410
141022901500000,NE 132,Residential,34782,84533,0,119315
141022901600000,NE 132,Residential,34782,75697,0,110479
141022901700000,NE 132,Residential,35567,74262,0,109829
141022901800000,NE 132,Residential,34631,73979,0,108610
141022901900000,NE 132,Residential,35306,92434,0,127740
141022902000000,NE 132,Residential,34320,68176,0,102496
141022902100000,NE 132,Residential,36960,58095,0,95055
141022902200000,NE 132,Residential,38204,82013,0,120217
141023000100000,NE 132,Residential,55224,97692,0,152916
141023000200000,NE 132,Residential,31715,89841,0,121556
141023000300000,NE 132,Residential,38662,69901,0,108563
141023000400000,NE 132,Residential,28093,75422,0,103515
141023000500000,NE 132,Residential,28440,76373,0,104813
141023000600000,NE 132,Residential,28704,76592,0,105296
141023000700000,NE 132,Residential,28915,89182,0,118097
141023000800000,NE 132,Residential,32480,86537,0,119017
141023000900000,NE 132,Residential,25203,79797,0,105000
141023001000000,NE 132,Residential,22387,91547,0,113934
141023001100000,NE 132,Residential,22046,70176,0,92222
141023100100000,NE 132,Residential,31372,69608,0,100980
141023100200000,NE 132,Residential,31680,63955,0,95635
141023100300000,NE 132,Residential,31680,70555,0,102235
141023100400000,NE 132,Residential,31680,76232,0,107912
141023100500000,NE 132,Residential,31680,83109,0,114789
141023100600000,NE 132,Residential,33247,87840,0,121087
141023100700000,NE 132,Residential,32616,54518,0,87134
141023100800000,NE 132,Residential,32933,90273,0,123206
141023100900000,NE 132,Residential,22560,72434,0,94994
141023101000000,NE 132,Residential,22560,49440,0,72000
141023101100000,NE 132,Residential,24750,42140,0,66890
141023200100000,NE 132,Residential,34320,69953,0,104273
141023200200000,NE 132,Residential,34320,70783,0,105103
141023200300000,NE 132,Residential,34267,80453,0,114720
141023200400000,NE 132,Residential,32683,80245,0,112928
141023200500000,NE 132,Residential,33792,104074,0,137866
141023200600000,NE 132,Residential,31680,81503,0,113183
141023200700000,NE 132,Residential,33792,81572,0,115364
141023200800000,NE 132,Residential,32736,88256,0,120992
141023200900000,NE 132,Residential,32736,68725,0,101461
141023201000000,NE 132,Residential,32736,89423,0,122159
141023201100000,NE 132,Residential,32472,76006,0,108478
141023201200000,NE 132,Residential,33052,96909,0,129961
141023201300000,NE 132,Residential,29343,87214,0,116557
141023201400000,NE 132,Residential,29343,87224,0,116567
141023201500000,NE 132,Residential,29343,76874,0,106217
141023201600000,NE 132,Residential,29343,81807,0,111150
141023201700000,NE 132,Residential,29343,91655,0,120998
141023201800000,NE 132,Residential,29343,65678,0,95021
141023201900000,NE 132,Residential,29343,81429,0,110772
141023202000000,NE 132,Residential,29343,76935,0,106278
141023202100000,NE 132,Residential,29343,80999,0,110342
141023202200000,NE 132,Residential,29343,69671,0,99014
141023202300000,NE 132,Exempt,33013,0,111712,144725
141023300100000,NE 132,Residential,30456,62134,0,92590
141023300200000,NE 132,Residential,29610,51058,0,80668
141023300300000,NE 132,Residential,32359,68595,0,100954
141023300400000,NE 132,Residential,26100,44518,0,70618
141023400100000,NE 132,Residential,29695,51831,0,81526
141023400200000,NE 132,Residential,38525,67403,0,105928
141023400300000,NE 132,Residential,30690,70674,0,101364
141023400400000,NE 132,Residential,40755,82856,0,123611
141023400500000,NE 132,Residential,32010,67114,0,99124
141023400600000,NE 132,Residential,31882,131141,0,163023
141023400700000,NE 132,Residential,34612,75406,0,110018
141023400800000,NE 132,Residential,31020,74173,0,105193
141023400900000,NE 132,Residential,31020,84609,0,115629
141023401000000,NE 132,Residential,31020,66592,0,97612
141023401100000,NE 132,Residential,34496,89122,0,123618
141023401200000,NE 132,Residential,32724,80826,0,113550
141025100100000,COMM NE,Commercial,45441,0,38119,83560
141025100200000,NE 132,Residential,33516,66100,0,99616
141025100300000,NE 132,Residential,27440,57394,0,84834
141025100400000,NE 132,Residential,33264,57200,0,90464
141025100500000,NE 132,Residential,34650,57796,0,92446
141025100600000,NE 132,Residential,30600,60813,0,91413
141025100700000,NE 132,Residential,30282,60175,0,90457
141025100800000,NE 132,Residential,32738,66165,0,98903
141025100900000,NE 132,Residential,32738,54708,0,87446
141025101000000,NE 132,Exempt,32738,49082,0,81820
141025101100000,NE 132,Residential,32738,68234,0,100972
141025101200000,NE 132,Residential,33369,60735,0,94104
141025101300000,NE 132,Residential,32760,77204,0,109964
141025101400000,NE 132,Residential,33264,60816,0,94080
141025101500000,NE 132,Residential,31590,49285,0,80875
141025101600000,NE 131,Residential,29700,67006,0,96706
141025101700000,NE 131,Residential,29700,68355,0,98055
141025101800000,NE 131,Residential,33660,65329,0,98989
141025200100000,NE 132,Residential,24000,53831,0,77831
141025200200000,NE 132,Residential,24750,42623,0,67373
141025200300000,NE 132,Residential,24750,42799,0,67549
141025200400000,NE 132,Residential,24750,44061,0,68811
141025200500000,NE 132,Residential,24750,52901,0,77651
141025200600000,NE 132,Residential,24750,48464,0,73214
141025200700000,NE 132,Residential,24750,45346,0,70096
141025200800000,NE 132,Residential,24750,46358,0,71108
141025200900000,NE 132,Residential,24750,42600,0,67350
141025201000000,NE 132,Residential,24750,38124,0,62874
141025201100000,NE 132,Residential,24750,46915,0,71665
141025201200000,NE 132,Residential,25650,64033,0,89683
141025201300000,NE 132,Residential,32359,65412,0,97771
141025201400000,NE 132,Residential,29610,52785,0,82395
141025201500000,NE 132,Residential,30456,63789,0,94245
141025201600000,NE 132,Residential,24000,39369,0,63369
141025201700000,NE 132,Residential,24000,40142,0,64142
141025201800000,NE 132,Residential,24000,72023,0,96023
141025201900000,NE 132,Residential,24000,78187,0,102187
141025202000000,NE 132,Residential,24000,61814,0,85814
141025202100000,NE 132,Residential,26000,45942,0,71942
141025202200000,NE 132,Residential,24000,61244,0,85244
141025202300000,NE 132,Residential,24000,43335,0,67335
141025202400000,NE 132,Residential,24000,50402,0,74402
141025202500000,NE 132,Residential,24000,57824,0,81824
141025300100000,NE 132,Residential,25380,51351,0,76731
141025300200000,NE 132,Residential,37218,73463,0,110681
141025300300000,NE 132,Residential,32912,90459,0,123371
141025300400000,NE 132,Residential,27495,44771,0,72266
141025300500000,NE 132,Residential,27495,62554,0,90049
141025300600000,NE 132,Residential,25380,42170,0,67550
141025300700000,NE 132,Residential,30679,59147,0,89826
141025300800000,NE 132,Residential,29295,44073,0,73368
141025300900000,NE 132,Residential,31697,61553,0,93250
141025301000000,NE 132,Residential,27788,56516,0,84304
141025301100000,NE 132,Residential,25245,42177,0,67422
141025301200000,NE 132,Residential,25380,47704,0,73084
141025400100000,NE 132,Residential,24840,54933,0,79773
141025400200000,NE 132,Residential,28518,45921,0,74439
141025400300000,NE 132,Residential,24008,40427,0,64435
141025400400000,NE 132,Residential,26190,39329,0,65519
141025400500000,NE 132,Residential,26190,42202,0,68392
141025400600000,NE 132,Residential,26190,62968,0,89158
141025400700000,NE 132,Residential,26190,43656,0,69846
141025400800000,NE 132,Residential,26190,42938,0,69128
141025400900000,NE 132,Residential,28000,92040,0,120040
141025401000000,NE 132,Residential,34178,90106,0,124284
141025401100000,NE 132,Residential,26190,96679,0,122869
141025401200000,NE 132,Residential,24008,123022,0,147030
141025401300000,NE 132,Residential,26190,76618,0,102808
141025401400000,NE 132,Residential,26190,100123,0,126313
141025401500000,NE 132,Residential,27495,78070,0,105565
141025401600000,NE 132,Residential,26313,65359,0,91672
141025401700000,NE 132,Residential,25380,62419,0,87799
141025500100000,NE 132,Residential,36045,75508,0,111553
141025500200000,NE 132,Residential,36000,52622,0,88622
141025500300000,NE 132,Residential,33075,57782,0,90857
141025500400000,NE 132,Residential,34155,55952,0,90107
141025500500000,NE 132,Residential,36450,60633,0,97083
141025500600000,NE 132,Residential,23280,43126,0,66406
141025500700000,NE 132,Residential,25200,58371,0,83571
141025500800000,NE 132,Residential,24240,49359,0,73599
141025500900000,NE 132,Residential,24159,79596,0,103755
141025501000000,NE 132,Residential,23280,44523,0,67803
141025501100000,NE 132,Residential,23280,84187,0,107467
141025501200000,NE 132,Residential,24240,41946,0,66186
141025501300000,NE 132,Residential,27071,58187,0,85258
141025501400000,NE 131,Residential,35522,85737,0,121259
141025501500000,NE 131,Residential,29700,78573,0,108273
141025501600000,NE 131,Residential,29700,67381,0,97081
141025501700000,NE 131,Residential,29700,69269,0,98969
141025501800000,NE 131,Residential,29700,65484,0,95184
141025501900000,NE 131,Residential,29700,62185,0,91885
141025502000000,NE 131,Residential,29700,67639,0,97339
141025502100000,NE 131,Residential,29700,66301,0,96001
141025502200000,NE 131,Residential,29700,88117,0,117817
141025502300000,NE 131,Residential,29700,88764,0,118464
141025502400000,NE 132,Residential,27540,43611,0,71151
141025502500000,NE 132,Residential,29952,75720,0,105672
141025502600000,NE 132,Residential,36115,56386,0,92501
141025502700000,NE 132,Residential,29970,53874,0,83844
141025502800000,NE 132,Residential,28936,42490,0,71426
141025502900000,NE 132,Residential,27027,46726,0,73753
141025503000000,NE 132,Residential,30450,46104,0,76554
141025503100000,NE 132,Residential,33784,49198,0,82982
141025503200000,NE 132,Residential,29187,43636,0,72823
141025503300000,NE 132,Residential,29952,58425,0,88377
141025503400000,NE 132,Residential,37395,45477,0,82872
141025600100000,NE 132,Residential,30070,94952,0,125022
141025600200000,NE 132,Residential,28665,46844,0,75509
141025600300000,NE 132,Residential,29581,58928,0,88509
141025600400000,NE 132,Residential,25110,43817,0,68927
141025600500000,NE 132,Residential,26064,52371,0,78435
141025600600000,NE 132,Residential,27846,65287,0,93133
141025600700000,NE 132,Residential,28704,39769,0,68473
141025600800000,NE 132,Residential,26730,60660,0,87390
141025600900000,NE 132,Residential,25920,40076,0,65996
141025601000000,NE 132,Residential,29952,53866,0,83818
141025601100000,NE 132,Residential,25389,99796,0,125185
141025601200000,NE 132,Residential,27437,85065,0,112502
141025601300000,NE 132,Residential,27852,71044,0,98896
141025601400000,NE 132,Residential,31661,109611,0,141272
141025601500000,NE 132,Residential,24703,73336,0,98039
141025601600000,NE 132,Residential,27241,73668,0,100909
141025601700000,NE 132,Residential,31304,103292,0,134596
141025601800000,COMM NE,Commercial,27341,0,112037,139378
141025601900000,NE 132,Residential,29329,84989,0,114318
141025602000000,NE 132,Residential,27550,95520,0,123070
141025602100000,NE 132,Residential,27151,57736,0,84887
141025602200000,NE 132,Residential,28186,65784,0,93970
141025602300000,NE 132,Residential,27533,59264,0,86797
141025700100000,NE 132,Residential,29610,58847,0,88457
141025700200000,NE 132,Residential,27918,52891,0,80809
141025700300000,NE 132,Residential,32371,97490,0,129861
141025700400000,NE 132,Residential,30467,107086,0,137553
141025700500000,NE 132,Residential,34112,74170,0,108282
141025700600000,NE 132,Residential,39824,188835,0,228659
141025700700000,NE 132,Residential,36353,118335,0,154688
141025700800000,NE 132,Residential,30740,45780,0,76520
141025700900000,NE 132,Residential,26010,64067,0,90077
141025701000000,NE 132,Residential,27693,76338,0,104031
141025701100000,NE 132,Residential,30210,61339,0,91549
141027600100000,COMM NE,Commercial,528601,0,2781993,3310594
141027600200000,NE 131,Residential,24750,58957,0,83707
141027600300000,NE 131,Residential,24750,89147,0,113897
141027600400000,NE 131,Residential,32175,98179,0,130354
141027600500000,NE 131,Residential,32175,83677,0,115852
141027600600000,NE 131,Residential,32175,123915,0,156090
141027600700000,NE 131,Residential,31705,99864,0,131569
141027600800000,NE 131,Residential,29700,104852,0,134552
141027600900000,NE 131,Residential,29700,74949,0,104649
141027601000000,NE 131,Residential,38610,126088,0,164698
141027601100000,NE 131,Residential,33660,74607,0,108267
141027601200000,NE 131,Residential,37125,116024,0,153149
141027601300000,NE 131,Residential,29700,73167,0,102867
141027601400000,NE 131,Residential,29700,83696,0,113396
141027601500000,NE 131,Residential,29700,86387,0,116087
141027601600000,NE 131,Residential,29700,58003,0,87703
141027601700000,NE 131,Residential,29700,50255,0,79955
141027601800000,NE 131,Residential,29700,70620,0,100320
141027601900000,NE 131,Residential,30598,60466,0,91064
141030100100000,NE 131,Residential,18311,43149,0,61460
141030100200000,NE 131,Residential,22725,61692,0,84417
141030100300000,NE 131,Residential,35200,67122,0,102322
141030100400000,NE 131,Residential,26765,53235,0,80000
141030100500000,NE 131,Residential,27270,60344,0,87614
141030100600000,NE 131,Residential,28280,88519,0,116799
141030100700000,NE 131,Residential,38885,59284,0,98169
141030100800000,NE 131,Residential,40400,76456,0,116856
141030100900000,NE 131,Residential,32320,57423,0,89743
141030101000000,NE 131,Residential,32320,34266,0,66586
141030101100000,NE 131,Residential,39600,78757,0,118357
141030101200000,NE 131,Residential,40400,77115,0,117515
141030101300000,NE 131,Residential,40400,101884,0,142284
141030101400000,NE 131,Residential,40400,99235,0,139635
141030101500000,NE 131,Residential,32320,151593,0,183913
141030101600000,NE 131,Residential,40000,94886,0,134886
141030101700000,NE 131,Residential,32320,45488,0,77808
141030101800000,NE 131,Residential,32320,65569,0,97889
141030101900000,NE 131,Residential,32320,55890,0,88210
141030102000000,NE 131,Residential,32960,32757,0,65717
141030102100000,NE 131,Residential,40000,69712,0,109712
141030102200000,NE 131,Residential,40000,104352,0,144352
141030102300000,NE 131,Residential,34424,96062,0,130486
141030102400000,NE 131,Residential,32724,68653,0,101377
141030102500000,NE 131,Residential,18584,75041,0,93625
141030102600000,NE 131,Residential,21816,81401,0,103217
141030102700000,NE 131,Residential,21412,65214,0,86626
141030102800000,NE 131,Residential,34560,103558,0,138118
141030102900000,NE 131,Residential,21054,81656,0,102710
141030103000000,NE 131,Residential,19346,99406,0,118752
141030103100000,NE 131,Residential,24240,71505,0,95745
141030103200000,NE 131,Residential,17672,41488,0,59160
141030103300000,NE 131,Residential,17672,41752,0,59424
141030200100000,NE 131,Residential,40400,113308,0,153708
141030200200000,NE 131,Residential,40400,78448,0,118848
141030200300000,NE 131,Residential,21816,75031,0,96847
141030200400000,NE 131,Residential,32320,64877,0,97197
141030300100000,Empty,Other,0,0,0,0
141030300200000,NE 131,Residential,16000,42366,0,58366
141030300300000,NE 131,Residential,24000,75208,0,99208
141030300400000,NE 131,Residential,32000,41125,0,73125
141030300500000,NE 131,Residential,32000,97534,0,129534
141030300600000,NE 131,Residential,32000,103242,0,135242
141030300700000,NE 131,Residential,32000,72770,0,104770
141030300800000,NE 131,Residential,32000,58552,0,90552
141030300900000,NE 131,Residential,32000,83093,0,115093
141030301000000,NE 131,Residential,33280,64811,0,98091
141030301200000,NE 131,Residential,28560,51359,0,79919
141030301300000,NE 131,Residential,32640,83883,0,116523
141030301400000,NE 131,Residential,32000,146828,0,178828
141030301500000,E-40 CHURCHES,Exempt,36288,0,165616,201904
141030301600000,NE 131,Residential,32000,104639,0,136639
141030301700000,NE 131,Residential,31360,97661,0,129021
141030301800000,NE 131,Residential,30400,103968,0,134368
141030301900000,NE 131,Residential,32000,96193,0,128193
141030302000000,NE 131,Residential,32000,98703,0,130703
141030302100000,NE 131,Residential,32000,104035,0,136035
141030302200000,NE 131,Residential,32000,85736,0,117736
141030302300000,NE 131,Residential,24000,93336,0,117336
141030302400000,NE 131,Residential,24000,76707,0,100707
141030302500000,NE 131,Residential,16000,43658,0,59658
141030302600000,NE 131,Residential,24000,69779,0,93779
141030302700000,NE 131,Residential,35640,68914,0,104554
141030302800000,NE 131,Residential,19612,125876,0,145488
141030302900000,NE 131,Residential,19608,129802,0,149410
141030400100000,NE 131,Residential,21280,49500,0,70780
141030400200000,NE 131,Residential,32640,85464,0,118104
141030400300000,NE 131,Residential,31360,83948,0,115308
141030400400000,NE 131,Residential,21280,34961,0,56241
141030400500000,NE 131,Residential,21280,41182,0,62462
141030400600000,NE 131,Residential,21280,12160,0,33440
141030500100000,NE 131,Residential,21280,48685,0,69965
141030500200000,NE 131,Residential,28000,217333,0,245333
141030500300000,NE 131,Residential,20000,57879,0,77879
141030500400000,NE 131,Residential,16000,76638,0,92638
141030500500000,NE 131,Residential,20680,78165,0,98845
141030500600000,NE 131,Residential,20680,84424,0,105104
141030500700000,NE 131,Residential,20000,96331,0,116331
141030500800000,NE 131,Exempt,31360,0,111018,142378
141030500900000,NE 131,Residential,23520,99344,0,122864
141030501000000,NE 131,Residential,23520,82509,0,106029
141030501100000,NE 131,Residential,23520,84029,0,107549
141030501200000,NE 131,Residential,23520,73597,0,97117
141030501300000,NE 131,Residential,24000,107595,0,131595
141030501400000,NE 131,Residential,19760,71218,0,90978
141030501500000,NE 131,Residential,19600,68212,0,87812
141030501600000,NE 131,Residential,28160,90648,0,118808
141030501700000,NE 131,Residential,32000,77896,0,109896
141030501800000,NE 131,Residential,34560,49506,0,84066
141030501900000,NE 131,Residential,28160,52094,0,80254
141030502000000,NE 131,Residential,32000,54762,0,86762
141030502100000,NE 131,Residential,17280,48472,0,65752
141030502200000,NE 131,Residential,17280,38393,0,55673
141030502300000,NE 131,Residential,32640,80523,0,113163
141030502400000,NE 131,Residential,32000,62778,0,94778
141030502500000,NE 131,Residential,32640,117097,0,149737
141030502600000,NE 131,Residential,32640,93671,0,126311
141030502700000,NE 131,Residential,16320,54993,0,71313
141030502800000,NE 131,Residential,16320,45561,0,61881
141030502900000,NE 131,Residential,32640,90672,0,123312
141030503000000,NE 131,Residential,20000,95124,0,115124
141030503100000,NE 131,Residential,36960,75530,0,112490
141030503200000,NE 131,Residential,16000,34463,0,50463
141030503300000,NE 131,Residential,16000,46337,0,62337
141030503400000,NE 131,Residential,32000,59823,0,91823
141030503500000,NE 131,Residential,21280,55300,0,76580
141030503600000,NE 131,Residential,21280,32655,0,53935
141030503700000,NE 131,Residential,21280,30976,0,52256
141030600100000,NE 131,Residential,30400,107586,0,137986
141030600200000,NE 131,Residential,20800,73153,0,93953
141030600300000,NE 131,Residential,19200,29015,0,48215
141030600400000,NE 131,Residential,32000,44238,0,76238
141030700100000,NE 131,Residential,22693,64882,0,87575
141030700200000,NE 131,Residential,20400,84170,0,104570
141030700300000,NE 131,Residential,32640,106947,0,139587
141030700400000,NE 131,Residential,32640,87867,0,120507
141030700500000,NE 131,Residential,32640,111952,0,144592
141030700600000,NE 131,Residential,24480,54708,0,79188
141030700700000,NE 131,Residential,24480,54443,0,78923
141030700800000,NE 131,Residential,33605,92688,0,126293
141030700900000,NE 131,Residential,16672,39780,0,56452
141030701000000,NE 131,Residential,14280,33975,0,48255
141030701100000,NE 131,Residential,14280,61274,0,75554
141030701200000,NE 131,Residential,28560,50255,0,78815
141030701300000,NE 131,Residential,28560,49627,0,78187
141030701400000,NE 131,Residential,28560,80142,0,108702
141030701500000,NE 131,Residential,28560,60468,0,89028
141030701600000,NE 131,Residential,17850,126744,0,144594
141030701700000,NE 131,Residential,21467,90485,0,111952
141030701800000,NE 131,Residential,22080,79195,0,101275
141030701900000,NE 131,Residential,22080,86987,0,109067
141030702000000,NE 131,Residential,22080,79989,0,102069
141030800100000,NE 131,Residential,32640,77119,0,109759
141030800200000,NE 131,Residential,21746,40917,0,62663
141030800300000,NE 131,Residential,16320,41496,0,57816
141030800400000,NE 131,Residential,32640,49059,0,81699
141030800500000,NE 131,Residential,32640,66600,0,99240
141030800600000,NE 131,Residential,16320,46691,0,63011
141030800700000,NE 131,Residential,16320,26078,0,42398
141030800800000,NE 131,Residential,16320,18751,0,35071
141030800900000,NE 131,Residential,14280,43332,0,57612
141030801000000,NE 131,Residential,14280,73234,0,87514
141030801100000,NE 131,Residential,14280,35064,0,49344
141030801200000,NE 131,Residential,14280,43016,0,57296
141030801300000,NE 131,Residential,14280,47202,0,61482
141030801400000,NE 131,Residential,14280,38675,0,52955
141030801500000,NE 131,Residential,14280,57886,0,72166
141030801600000,NE 131,Residential,14280,42048,0,56328
141030801700000,NE 131,Residential,19028,54396,0,73424
141030801800000,NE 131,Residential,28560,58959,0,87519
141030900100000,NE 131,Residential,16320,46163,0,62483
141030900200000,NE 131,Residential,16320,50344,0,66664
141030900300000,NE 131,Residential,30400,110901,0,141301
141030900400000,NE 131,Residential,30240,47886,0,78126
141030900500000,NE 131,Residential,14280,63368,0,77648
141030900600000,NE 131,Residential,14280,59988,0,74268
141032600100000,NE 131,Residential,40400,109264,0,149664
141032600200000,NE 131,Residential,40000,97937,0,137937
141032600300000,NE 131,Residential,40400,103436,0,143836
141032600400000,NE 131,Residential,40000,77721,0,117721
141032600500000,NE 131,Residential,39600,97110,0,136710
141032600600000,NE 131,Residential,40800,73712,0,114512
141032600700000,NE 131,Residential,40800,87393,0,128193
141032600800000,NE 131,Residential,40800,82248,0,123048
141032600900000,NE 131,Residential,37600,55116,0,92716
141032601000000,NE 131,Residential,30400,54315,0,84715
141032601100000,NE 131,Exempt,18459,168,36655,55282
141032601200000,E-46 RELIG PARKING,Exempt,71366,0,0,71366
141032601300000,E-40 CHURCHES,Exempt,31752,0,49502,81254
141032601400000,NE 131,Residential,17675,58885,0,76560
141032601500000,NE 131,Residential,32000,92108,0,124108
141032601600000,NE 131,Residential,32800,31299,0,64099
141032601700000,NE 131,Residential,17600,70107,0,87707
141032601800000,NE 131,Residential,17600,63129,0,80729
141032601900000,NE 131,Residential,32000,65969,0,97969
141032602000000,NE 131,Residential,32000,65069,0,97069
141032602100000,NE 131,Residential,32000,100767,0,132767
141032602200000,NE 131,Residential,32960,92040,0,125000
141032602300000,NE 131,Residential,20200,56023,0,76223
141032602400000,NE 131,Residential,24240,116803,0,141043
141032602500000,NE 131,Residential,20200,53233,0,73433
141032602600000,NE 131,Residential,32640,54610,0,87250
141032602700000,NE 131,Residential,21412,61545,0,82957
141032602800000,NE 131,Residential,21412,77825,0,99237
141032700100000,NE 131,Residential,14409,82023,0,96432
141032700200000,NE 132,Residential,31652,100963,0,132615
141032700300000,NE 131,Residential,14850,55257,0,70107
141032700400000,NE 131,Residential,13500,97015,0,110515
141032700500000,NE 131,Residential,13500,57043,0,70543
141032700600000,NE 131,Residential,14799,41572,0,56371
141032700700000,NE 131,Residential,13187,83715,0,96902
141032700800000,NE 131,Residential,14292,79059,0,93351
141032800100000,NE 131,Residential,32000,96022,0,128022
141032800200000,NE 131,Residential,34000,59531,0,93531
141032800300000,NE 131,Residential,30000,41808,0,71808
141032800400000,NE 131,Residential,21200,86076,0,107276
141032800500000,NE 131,Residential,21200,82910,0,104110
141032800600000,NE 131,Residential,21600,65713,0,87313
141032800700000,NE 131,Residential,32000,74913,0,106913
141032800800000,NE 131,Residential,32000,93759,0,125759
141032800900000,NE 131,Residential,32000,82055,0,114055
141032801000000,NE 131,Residential,32000,109138,0,141138
141032801100000,NE 131,Residential,16320,47593,0,63913
141032801200000,NE 131,Residential,16320,65803,0,82123
141032801300000,NE 131,Residential,33280,81947,0,115227
141032801400000,NE 131,Residential,24640,0,0,24640
141032801500000,NE 131,Residential,16100,74000,0,90100
141032801600000,NE 131,Residential,21188,77051,0,98239
141032801700000,NE 131,Residential,18850,93847,0,112697
141032801800000,NE 131,Residential,20650,61350,0,82000
141032801900000,NE 131,Residential,30720,108698,0,139418
141032802000000,NE 131,Residential,31360,108698,0,140058
141032802100000,NE 131,Residential,16000,80291,0,96291
141032802200000,NE 131,Residential,24000,65224,0,89224
141032802300000,NE 131,Residential,24000,65710,0,89710
141032802400000,NE 131,Residential,32000,57190,0,89190
141032802500000,NE 131,Residential,32000,90881,0,122881
141032802600000,NE 131,Residential,21600,97556,0,119156
141032802700000,NE 131,Residential,21200,83518,0,104718
141032802800000,NE 131,Residential,21200,74673,0,95873
141032802900000,NE 131,Residential,24000,87167,0,111167
141032803000000,NE 131,Residential,24000,91683,0,115683
141032803100000,NE 131,Residential,24000,109860,0,133860
141032803200000,NE 131,Residential,24000,71884,0,95884
141032900100000,NE 131,Residential,13200,62381,0,75581
141032900200000,NE 131,Residential,12720,91869,0,104589
141032900300000,NE 131,Residential,12240,82513,0,94753
141032900400000,NE 131,Residential,12960,55708,0,68668
141032900500000,NE 131,Residential,9450,0,0,9450
141032900600000,COMM NE,Commercial,127008,0,556412,683420
141033000100000,NE 131,Residential,20800,97512,0,118312
141033000200000,NE 131,Residential,24000,91473,0,115473
141033000300000,NE 131,Residential,24000,103343,0,127343
141033000400000,NE 131,Residential,19640,79816,0,99456
141033000500000,NE 131,Residential,19400,55996,0,75396
141033000600000,NE 131,Residential,26320,75657,0,101977
141033000700000,NE 131,Residential,25200,67275,0,92475
141033000800000,NE 131,Residential,19000,66861,0,85861
141033000900000,NE 131,Residential,24000,78449,0,102449
141033001000000,NE 131,Residential,32000,80176,0,112176
141033001100000,NE 131,Residential,32000,97500,0,129500
141033001200000,NE 131,Residential,31360,102164,0,133524
141033001300000,NE 131,Residential,32000,104456,0,136456
141033001400000,NE 131,Residential,32000,83145,0,115145
141033001500000,NE 131,Residential,30041,19175,0,49216
141033001600000,NE 131,Residential,18025,43979,0,62004
141033001700000,NE 131,Residential,21350,46608,0,67958
141033001800000,APTS NE,Residential,17334,287666,0,305000
141033001900000,APTS NE,Residential,13176,160721,0,173897
141033002000000,APTS NE,Residential,10206,149226,0,159432
141033002100000,NE 131,Residential,14000,25065,0,39065
141033002300000,NE 131,Residential,29400,93075,0,122475
141033002500000,NE 131,Residential,14000,24315,0,38315
141033002600000,NE 131,Residential,37600,81400,0,119000
141033002700000,NE 131,Residential,26400,37661,0,64061
141033002800000,NE 131,Residential,32640,30411,0,63051
141033002900000,NE 131,Residential,32000,51405,0,83405
141033003000000,NE 131,Residential,32000,38330,0,70330
141033003100000,NE 131,Residential,24000,53276,0,77276
141033003200000,NE 131,Residential,20800,47418,0,68218
141033003300000,NE 131,Residential,22560,88717,0,111277
141033003400000,NE 131,Residential,29400,44825,0,74225
141033003500000,NE 131,Residential,32960,79691,0,112651
141033003600000,NE 131,Residential,32000,87314,0,119314
141033003700000,NE 131,Residential,32000,91152,0,123152
141033003800000,NE 131,Residential,12800,50509,0,63309
141033100100000,NE 131,Residential,30400,69916,0,100316
141033100200000,NE 131,Residential,16320,73334,0,89654
141033100300000,NE 131,Residential,16320,67275,0,83595
141033100400000,NE 131,Residential,30076,108614,0,138690
141033100500000,NE 131,Residential,16320,64723,0,81043
141033100600000,NE 131,Residential,16320,61404,0,77724
141033100700000,NE 131,Residential,33600,89746,0,123346
141033100800000,NE 131,Residential,16800,37458,0,54258
141033100900000,NE 131,Residential,16320,53721,0,70041
141033101000000,NE 131,Residential,32000,120784,0,152784
141033101100000,NE 131,Residential,33590,132625,0,166215
141033101200000,NE 131,Residential,32640,75443,0,108083
141033101300000,NE 131,Residential,32640,75484,0,108124
141033101400000,NE 131,Residential,28160,86487,0,114647
141033101501000,CONDO 500,Residential,3750,42727,0,46477
141033101501001,CONDO 500,Residential,3750,35183,0,38933
141033101501002,CONDO 500,Residential,3750,35183,0,38933
141033101501003,CONDO 500,Residential,3750,44611,0,48361
141033101501004,CONDO 500,Residential,3750,36519,0,40269
141033101501005,CONDO 500,Residential,3750,36519,0,40269
141033101501006,CONDO 500,Residential,3750,40553,0,44303
141033101501007,CONDO 500,Residential,3750,40553,0,44303
141033101501008,CONDO 500,Residential,3750,43025,0,46775
141033101501009,CONDO 500,Residential,3750,43025,0,46775
141033101501010,CONDO 500,Residential,3750,42727,0,46477
141033101501011,CONDO 500,Residential,3750,35183,0,38933
141033101501012,CONDO 500,Residential,3750,35183,0,38933
141033101501013,CONDO 500,Residential,3750,44611,0,48361
141033101501014,CONDO 500,Residential,3750,36519,0,40269
141033101501015,CONDO 500,Residential,3750,36519,0,40269
141033101600000,NE 131,Residential,24320,42343,0,66663
141033101700000,COMM NE,Commercial,554040,0,347136,901176
141033101800000,NE 131,Residential,30800,59227,0,90027
141033101901000,CONDO 500,Residential,3750,46671,0,50421
141033101901001,CONDO 500,Residential,3750,45786,0,49536
141033101901002,CONDO 500,Residential,3750,47259,0,51009
141033101901003,CONDO 500,Residential,3750,44611,0,48361
141033101901004,CONDO 500,Residential,3750,43612,0,47362
141033101901005,CONDO 500,Residential,3750,43612,0,47362
141033101901006,CONDO 500,Residential,3750,43025,0,46775
141033101901007,CONDO 500,Residential,3750,43025,0,46775
141033101901008,CONDO 500,Residential,3750,42727,0,46477
141033101901009,CONDO 500,Residential,3750,43612,0,47362
141033101901010,CONDO 500,Residential,3750,44611,0,48361
141033101901011,CONDO 500,Residential,3750,44200,0,47950
141033102000000,NE 131,Residential,31080,46089,0,77169
141033102100000,NE 131,Residential,28560,86998,0,115558
141033102200000,NE 131,Residential,28560,74145,0,102705
141033102300000,NE 131,Residential,25199,45987,0,71186
141033102400000,NE 131,Residential,29120,33868,0,62988
141033102500000,NE 131,Residential,14280,60720,0,75000
141033102600000,NE 131,Residential,28560,54098,0,82658
141033102700000,NE 131,Residential,29382,63124,0,92506
141033102800000,NE 131,Residential,28560,76676,0,105236
141033102900000,NE 131,Residential,30240,66224,0,96464
141035100100000,NE 143,Residential,23331,108987,0,132318
141035100200000,NE 143,Residential,15708,84057,0,99765
141035100300000,NE 143,Residential,15708,69437,0,85145
141035100400000,NE 143,Residential,15708,60490,0,76198
141035100500000,NE 143,Residential,27720,92955,0,120675
141035100600000,NE 143,Residential,28182,56126,0,84308
141035100700000,NE 143,Residential,35228,82560,0,117788
141035100800000,NE 143,Residential,29164,100564,0,129728
141035100900000,NE 143,Residential,29164,103821,0,132985
141035101000000,NE 143,Residential,35228,70595,0,105823
141035101100000,NE 143,Residential,28182,82132,0,110314
141035101200000,NE 143,Residential,28182,83762,0,111944
141035101300000,NE 143,Residential,24717,33836,0,58553
141035101400000,NE 143,Residential,23562,37178,0,60740
141035101500000,NE 143,Residential,23331,63491,0,86822
141035101600000,NE 143,Residential,27720,67445,0,95165
141035101700000,NE 143,Residential,28182,58403,0,86585
141035101800000,NE 143,Residential,30744,89303,0,120047
141035101900000,NE 143,Residential,4389,0,0,4389
141035102000000,NE 143,Residential,4620,0,0,4620
141035102100000,NE 143,Residential,3465,0,0,3465
141035102200000,NE 143,Residential,6064,0,0,6064
141035102300000,NE 143,Residential,6064,0,0,6064
141035102400000,NE 143,Residential,28000,213410,0,241410
141035102500000,NE 143,Residential,24800,82081,0,106881
141035102600000,NE 143,Residential,26664,102987,0,129651
141035200100000,NE 143,Residential,27428,94287,0,121715
141035200200000,NE 143,Residential,32208,66567,0,98775
141035200400000,NE 143,Residential,32208,126686,0,158894
141035200500000,NE 143,Residential,3300,0,0,3300
141035200600000,NE 143,Residential,3300,0,0,3300
141035200700000,NE 143,Residential,26840,80525,0,107365
141035200800000,NE 143,Residential,26840,87292,0,114132
141035200900000,NE 143,Residential,4620,0,0,4620
141035201000000,NE 143,Residential,6930,0,0,6930
141035201100000,NE 143,Residential,31424,77819,0,109243
141035201200000,NE 143,Residential,34560,60877,0,95437
141035201300000,NE 143,Residential,4560,0,0,4560
141035201400000,NE 143,Residential,28800,93067,0,121867
141035201500000,NE 143,Residential,30976,68468,0,99444
141035201600000,NE 143,Residential,29280,76946,0,106226
141035201700000,NE 143,Residential,29280,82355,0,111635
141035201800000,NE 143,Residential,29280,77647,0,106927
141035201900000,NE 143,Residential,28800,87027,0,115827
141035202000000,COMM NE,Commercial,53266,0,388196,441462
141035202100000,NE 143,Residential,24240,46056,0,70296
141035202200000,NE 143,Residential,24240,109631,0,133871
141035202300000,NE 143,Residential,24240,78703,0,102943
141035202400000,NE 143,Residential,33330,70165,0,103495
141035202500000,NE 143,Residential,22220,68887,0,91107
141035202600000,NE 143,Residential,16830,48456,0,65286
141035202700000,NE 143,Residential,16830,28497,0,45327
141035202800000,NE 143,Residential,34297,111728,0,146025
141035202900000,NE 143,Residential,27600,99748,0,127348
141035203000000,NE 143,Residential,7000,0,0,7000
141035203100000,NE 143,Residential,26866,54998,0,81864
141035300100000,NE 143,Residential,21223,97479,0,118702
141035300200000,NE 143,Residential,19920,99596,0,119516
141035300300000,NE 143,Residential,29293,100303,0,129596
141035300400000,NE 143,Residential,25086,100775,0,125861
141035300500000,NE 143,Residential,25931,98787,0,124718
141035300600000,NE 143,Residential,24240,72535,0,96775
141035300700000,NE 143,Residential,24240,92526,0,116766
141035300800000,NE 143,Residential,29088,92653,0,121741
141035300900000,NE 143,Residential,36026,109887,0,145913
141035301000000,NE 143,Residential,33752,111273,0,145025
141035301100000,NE 143,Residential,36225,138330,0,174555
141035301200000,NE 143,Residential,35350,115168,0,150518
141035301300000,NE 143,Residential,35350,90044,0,125394
141035301400000,NE 143,Residential,35397,86968,0,122365
141035301500000,NE 143,Residential,35350,104291,0,139641
141035301600000,NE 143,Residential,32608,136953,0,169561
141035301700000,NE 143,Residential,35288,102287,0,137575
141035301800000,NE 143,Residential,28709,96601,0,125310
141035400100000,NE 143,Residential,24981,78505,0,103486
141035400200000,NE 143,Residential,24240,108653,0,132893
141035400300000,NE 143,Residential,30704,108521,0,139225
141035400400000,NE 143,Residential,29189,77855,0,107044
141035400500000,NE 143,Residential,24240,100443,0,124683
141035400600000,NE 143,Residential,24240,70809,0,95049
141035400700000,NE 143,Residential,24240,77696,0,101936
141035400800000,NE 143,Residential,34728,104837,0,139565
141035400900000,NE 143,Residential,33559,62685,0,96244
141035401000000,NE 143,Residential,30300,57423,0,87723
141035401100000,NE 143,Residential,30300,105557,0,135857
141035401200000,NE 143,Residential,26260,54572,0,80832
141035401300000,NE 143,Residential,26260,77194,0,103454
141035401400000,NE 143,Residential,26260,46151,0,72411
141035401500000,NE 143,Residential,26765,53073,0,79838
141035401600000,NE 143,Residential,26260,57062,0,83322
141035401700000,NE 143,Residential,26765,74234,0,100999
141035401800000,NE 143,Residential,26260,61462,0,87722
141035401900000,NE 143,Residential,26193,73004,0,99197
141035500100000,NE 143,Residential,31310,86363,0,117673
141035500200000,NE 143,Residential,32825,115054,0,147879
141035500300000,NE 143,Residential,35981,90260,0,126241
141035500400000,NE 143,Residential,35981,79009,0,114990
141035500500000,NE 143,Residential,36234,101866,0,138100
141035500600000,NE 143,Residential,35981,144019,0,180000
141035500700000,NE 143,Residential,35981,111182,0,147163
141035500800000,NE 143,Residential,33330,99640,0,132970
141035500900000,NE 143,Residential,37047,141018,0,178065
141035501000000,NE 143,Residential,35087,95191,0,130278
141035501100000,NE 143,Residential,27270,79890,0,107160
141035501200000,NE 143,Residential,27270,91346,0,118616
141035501300000,NE 143,Residential,24240,46740,0,70980
141035501400000,NE 143,Residential,24240,45837,0,70077
141035501500000,NE 143,Residential,27270,72565,0,99835
141035501600000,NE 143,Residential,24240,52278,0,76518
141035501700000,NE 143,Residential,27270,64883,0,92153
141035501800000,NE 143,Residential,30300,63452,0,93752
141035501900000,NE 143,Residential,30300,60500,0,90800
141035502000000,NE 143,Residential,31226,95435,0,126661
141035502100000,NE 143,Residential,29824,96463,0,126287
141035502200000,NE 143,Residential,27270,79131,0,106401
141035502300000,NE 143,Residential,27270,90318,0,117588
141035502400000,NE 143,Residential,27270,77331,0,104601
141035502500000,NE 143,Residential,27270,76416,0,103686
141035502600000,NE 143,Residential,27270,120809,0,148079
141035502700000,NE 143,Residential,27270,82840,0,110110
141035502800000,NE 143,Residential,27270,85038,0,112308
141035502900000,NE 143,Residential,27270,89285,0,116555
141035503000000,NE 143,Residential,33224,110733,0,143957
141035503100000,NE 143,Residential,33430,93514,0,126944
141035503200000,NE 143,Residential,31815,81081,0,112896
141035503300000,NE 143,Residential,34087,150569,0,184656
141035503400000,NE 143,Residential,34087,70246,0,104333
141035503500000,NE 143,Residential,34087,117416,0,151503
141035503600000,NE 143,Residential,22725,78187,0,100912
141035503700000,NE 143,Residential,22725,59669,0,82394
141035503800000,NE 143,Residential,34951,97435,0,132386
141037600100000,NE 142,Residential,16663,104486,0,121149
141037600200000,NE 143,Residential,3430,0,0,3430
141037600300000,NE 143,Residential,6370,0,0,6370
141037600400000,NE 143,Residential,6930,0,0,6930
141037700100000,NE 143,Residential,22591,51279,0,73870
141037700200000,NE 143,Residential,21210,111845,0,133055
141037700300000,NE 143,Residential,20267,79404,0,99671
141037700400000,NE 143,Residential,28395,106654,0,135049
141037700500000,NE 143,Residential,21952,91640,0,113592
141037700600000,NE 143,Residential,21210,74994,0,96204
141037700700000,NE 143,Residential,21666,80672,0,102338
141037700800000,NE 143,Residential,25121,70677,0,95798
141037700900000,NE 143,Residential,24240,78324,0,102564
141037701000000,NE 143,Residential,24664,104600,0,129264
141037701100000,NE 143,Residential,29170,351,0,29521
141037701200000,NE 143,Residential,14088,37121,0,51209
141037701300000,NE 143,Residential,2730,29734,0,32464
141037701400000,NE 143,Residential,21420,38878,0,60298
141037701500000,NE 143,Residential,19959,83281,0,103240
141037800100000,NE 143,Residential,19615,50924,0,70539
141037800200000,NE 143,Residential,15908,57479,0,73387
141037800300000,NE 143,Residential,17675,49080,0,66755
141037800400000,NE 143,Residential,15908,51555,0,67463
141037800500000,NE 143,Residential,17675,53252,0,70927
141037800600000,NE 143,Residential,20402,50841,0,71243
141037800700000,NE 143,Residential,23853,61112,0,84965
141037800800000,NE 143,Residential,23907,79325,0,103232
141037800900000,NE 143,Residential,24960,79815,0,104775
141037801000000,NE 143,Residential,29863,58400,0,88263
141037801100000,NE 143,Residential,24426,64703,0,89129
141037801200000,NE 143,Residential,24992,66894,0,91886
141037801300000,NE 143,Residential,25164,53599,0,78763
141037801400000,NE 143,Residential,22725,45708,0,68433
141037801500000,NE 143,Residential,20453,39990,0,60443
141037801600000,NE 143,Residential,22725,61774,0,84499
141037801700000,NE 143,Residential,20453,58552,0,79005
141037801800000,NE 143,Residential,26231,55669,0,81900
141037900100000,NE 143,Residential,19718,72142,0,91860
141037900200000,NE 143,Residential,24010,54424,0,78434
141037900300000,NE 143,Residential,19400,107264,0,126664
141037900400000,NE 143,Residential,31817,71031,0,102848
141038000100000,COMM NE,Commercial,100440,0,172987,273427
141038000200000,NE 143,Residential,35075,55216,0,90291
141038000300000,NE 143,Residential,21052,96201,0,117253
141038000400000,NE 143,Residential,20200,89797,0,109997
141038000500000,NE 143,Residential,19348,92159,0,111507
141038000600000,NE 143,Residential,21052,77078,0,98130
141038000700000,NE 143,Residential,20200,65297,0,85497
141038000800000,NE 143,Residential,19348,93794,0,113142
141038000900000,E-40 CHURCHES,Exempt,7560,0,0,7560
141038100100000,NE 143,Residential,25152,73579,0,98731
141038100200000,NE 143,Residential,20453,50105,0,70558
141038100300000,NE 143,Residential,22725,46613,0,69338
141038100400000,NE 143,Residential,20453,44074,0,64527
141038100500000,NE 143,Residential,22725,46406,0,69131
141038100600000,NE 143,Residential,26197,50179,0,76376
141038100700000,NE 143,Residential,25500,53583,0,79083
141038100800000,NE 143,Residential,26100,46571,0,72671
141038100900000,NE 143,Residential,21750,46508,0,68258
141038101000000,NE 143,Residential,20680,43363,0,64043
141038101100000,NE 143,Residential,25149,52578,0,77727
141038101200000,NE 143,Residential,21856,69717,0,91573
141038101300000,NE 143,Residential,21856,72179,0,94035
141038101400000,NE 143,Residential,21856,74229,0,96085
141038101500000,NE 143,Residential,25566,142375,0,167941
141038101600000,NE 143,Residential,26506,98815,0,125321
141038101700000,NE 143,Residential,22309,53742,0,76051
141038101800000,NE 143,Residential,20200,49752,0,69952
141038101900000,NE 143,Residential,18180,44315,0,62495
141038102000000,NE 143,Residential,20200,53835,0,74035
141038102100000,NE 143,Residential,18180,45592,0,63772
141038102200000,NE 143,Residential,23287,48442,0,71729
141038200100000,NE 143,Residential,25088,160696,0,185784
141038200200000,NE 143,Residential,24240,53511,0,77751
141038200300000,NE 143,Residential,24240,98271,0,122511
141038200400000,NE 143,Residential,24240,108912,0,133152
141038200500000,NE 143,Residential,24590,65471,0,90061
141038200600000,NE 143,Residential,25088,66640,0,91728
141038200700000,NE 143,Residential,24240,66179,0,90419
141038200800000,NE 143,Residential,24240,66903,0,91143
141038200900000,NE 143,Residential,24240,67295,0,91535
141038201000000,NE 143,Residential,24590,91683,0,116273
141038201100000,NE 143,Residential,32741,63805,0,96546
141038201200000,NE 143,Residential,30300,114931,0,145231
141038201300000,NE 143,Residential,30300,74767,0,105067
141038201400000,NE 143,Residential,30300,82801,0,113101
141038201500000,NE 143,Residential,29290,107800,0,137090
141038201600000,NE 143,Residential,32741,90283,0,123024
141038201700000,NE 143,Residential,30300,88042,0,118342
141038201800000,NE 143,Residential,30300,105682,0,135982
141038201900000,NE 143,Residential,30300,83476,0,113776
141038202000000,NE 143,Residential,29290,87356,0,116646
141038300100000,NE 143,Residential,27196,68840,0,96036
141038300200000,NE 143,Residential,25048,95530,0,120578
141038300300000,NE 143,Residential,25048,75962,0,101010
141038300400000,NE 143,Residential,24240,70436,0,94676
141038300500000,NE 143,Residential,21008,63381,0,84389
141038300600000,NE 143,Residential,25086,72683,0,97769
141038300700000,NE 143,Residential,24240,70168,0,94408
141038300800000,NE 143,Residential,24240,85704,0,109944
141038300900000,NE 143,Residential,24240,60474,0,84714
141038301000000,NE 143,Residential,24542,80803,0,105345
141038301100000,NE 143,Residential,31357,103792,0,135149
141038301200000,NE 143,Residential,35350,112373,0,147723
141038301300000,NE 143,Residential,30300,93345,0,123645
141038301400000,NE 143,Residential,35981,122769,0,158750
141038301500000,NE 143,Residential,37557,96717,0,134274
141038301600000,NE 143,Residential,32825,123707,0,156532
141038301700000,NE 143,Residential,35350,105960,0,141310
141038301800000,NE 143,Residential,30300,103502,0,133802
141038301900000,NE 143,Residential,30999,83507,0,114506
141038400100000,NE 143,Residential,31310,104560,0,135870
141038400200000,NE 143,Residential,30300,111623,0,141923
141038400300000,NE 143,Residential,30300,104105,0,134405
141038400400000,NE 143,Residential,30300,80557,0,110857
141038400500000,NE 143,Residential,30637,83856,0,114493
141038400600000,NE 143,Residential,31310,75753,0,107063
141038400700000,NE 143,Residential,30300,62695,0,92995
141038400800000,NE 143,Residential,30300,101021,0,131321
141038400900000,NE 143,Residential,30300,77538,0,107838
141038401000000,NE 143,Residential,30637,71748,0,102385
141038401100000,NE 143,Residential,29361,92336,0,121697
141038401200000,NE 143,Residential,27270,107139,0,134409
141038401300000,NE 143,Residential,27270,106265,0,133535
141038401400000,NE 143,Residential,27270,95897,0,123167
141038401500000,NE 143,Residential,26331,114691,0,141022
141038401600000,NE 143,Residential,29361,99576,0,128937
141038401700000,NE 143,Residential,27270,128262,0,155532
141038401800000,NE 143,Residential,27270,145119,0,172389
141038401900000,NE 143,Residential,27270,133035,0,160305
141038402000000,NE 143,Residential,26331,137114,0,163445
141038500100000,NE 143,Residential,31310,84548,0,115858
141038500200000,NE 143,Residential,30300,100515,0,130815
141038500300000,NE 143,Residential,34340,104899,0,139239
141038500400000,NE 143,Residential,35350,98092,0,133442
141038500500000,NE 143,Residential,36213,136293,0,172506
141038500600000,NE 143,Residential,35350,94699,0,130049
141038500700000,NE 143,Residential,30300,87109,0,117409
141038500800000,NE 143,Residential,36360,109977,0,146337
141038500900000,NE 143,Residential,30586,111749,0,142335
141038501000000,NE 143,Residential,28209,89977,0,118186
141038501100000,NE 143,Residential,27270,80771,0,108041
141038501200000,NE 143,Residential,27270,100375,0,127645
141038501300000,NE 143,Residential,27270,93951,0,121221
141038501400000,NE 143,Residential,27479,89520,0,116999
141038501500000,NE 143,Residential,28179,94932,0,123111
141038501600000,NE 143,Residential,27270,78874,0,106144
141038501700000,NE 143,Residential,27270,95176,0,122446
141038501800000,NE 143,Residential,27270,119927,0,147197
141038501900000,NE 143,Residential,27944,88090,0,116034
141040100100000,NE 129,Residential,21353,79929,0,101282
141040100200000,NE 129,Residential,40660,69466,0,110126
141040100300000,NE 129,Residential,40660,34950,0,75610
141040100400000,NE 129,Residential,21400,44040,0,65440
141040100500000,NE 129,Residential,21400,40700,0,62100
141040100600000,NE 129,Residential,21400,51172,0,72572
141040100700000,NE 129,Residential,21400,78487,0,99887
141040100800000,NE 129,Residential,23005,48735,0,71740
141040100900000,NE 129,Residential,19795,42997,0,62792
141040101000000,NE 129,Residential,21400,67349,0,88749
141040101100000,NE 129,Residential,21400,66660,0,88060
141040101200000,NE 129,Residential,32800,46058,0,78858
141040101300000,NE 129,Residential,33763,64380,0,98143
141040101400000,NE 129,Residential,32100,50411,0,82511
141040101500000,NE 129,Residential,26750,64542,0,91292
141040101600000,NE 129,Residential,26750,83908,0,110658
141040101700000,NE 129,Residential,40660,91163,0,131823
141040101800000,NE 129,Residential,21400,58496,0,79896
141040101900000,NE 129,Residential,21400,65127,0,86527
141040102000000,NE 129,Residential,21400,57237,0,78637
141040102100000,NE 129,Residential,21400,51884,0,73284
141040102200000,NE 129,Residential,22470,60726,0,83196
141040102300000,NE 129,Residential,20330,66083,0,86413
141040102400000,NE 129,Residential,32100,65545,0,97645
141040102500000,CONVERSIONS,Commercial,11826,0,52405,64231
141040102600000,NE 129,Residential,23715,94185,0,117900
141040102700000,NE 129,Residential,19125,78201,0,97326
141040102800000,NE 129,Residential,19710,73389,0,93099
141040102900000,NE 129,Residential,19710,37418,0,57128
141040200100000,NE 129,Residential,22950,56636,0,79586
141040200200000,NE 129,Residential,21400,68982,0,90382
141040200300000,NE 129,Residential,21400,79428,0,100828
141040200400000,NE 129,Residential,32100,74237,0,106337
141040200500000,NE 129,Residential,42800,57690,0,100490
141040200600000,NE 129,Residential,32100,99536,0,131636
141040200700000,NE 129,Residential,24250,48996,0,73246
141040200800000,NE 129,Residential,24250,52672,0,76922
141040200900000,NE 129,Residential,21250,75753,0,97003
141040201000000,NE 129,Residential,21400,51527,0,72927
141040201100000,NE 129,Residential,21400,76390,0,97790
141040201200000,NE 129,Residential,40660,68506,0,109166
141040201300000,NE 129,Residential,37450,54363,0,91813
141040201400000,NE 129,Residential,43335,110775,0,154110
141040201500000,NE 129,Residential,40660,88683,0,129343
141040201600000,NE 129,Residential,40660,93700,0,134360
141040201700000,NE 129,Residential,35600,81265,0,116865
141040201800000,NE 129,Residential,27375,65608,0,92983
141040201900000,NE 129,Residential,22950,48642,0,71592
141040202000000,NE 129,Residential,22950,51949,0,74899
141040202100000,NE 129,Residential,25500,83609,0,109109
141040300100000,NE 129,Residential,30386,81813,0,112199
141040300200000,NE 129,Residential,21400,97972,0,119372
141040300300000,NE 129,Residential,21400,95040,0,116440
141040300400000,NE 129,Residential,21400,78063,0,99463
141040300500000,NE 129,Residential,21400,68503,0,89903
141040300600000,NE 129,Residential,21400,57525,0,78925
141040300700000,NE 129,Residential,21400,54017,0,75417
141040300800000,NE 129,Residential,32100,67194,0,99294
141040300900000,NE 129,Residential,26750,50124,0,76874
141040301000000,NE 129,Residential,26750,53654,0,80404
141040301100000,NE 129,Residential,26750,49031,0,75781
141040301200000,NE 129,Residential,23500,61101,0,84601
141040301300000,NE 129,Residential,28200,72416,0,100616
141040301500000,NE 129,Residential,33200,69053,0,102253
141040301600000,NE 129,Residential,28355,74895,0,103250
141040301700000,NE 129,Residential,28890,65710,0,94600
141040301800000,NE 129,Residential,28355,65981,0,94336
141040301900000,NE 129,Residential,21400,75005,0,96405
141040302000000,NE 129,Residential,21400,74223,0,95623
141040302100000,NE 129,Residential,40660,93944,0,134604
141040302200000,NE 129,Residential,21400,61371,0,82771
141040302300000,NE 129,Residential,21400,54714,0,76114
141040302400000,NE 129,Residential,40660,66340,0,107000
141040302500000,NE 129,Residential,24638,68358,0,92996
141040302600000,NE 129,Residential,36135,79213,0,115348
141040302700000,NE 129,Residential,30386,68389,0,98775
141040302900000,NE 129,Residential,50967,71517,0,122484
141040400100000,NE 129,Residential,35600,96516,0,132116
141040400200000,NE 129,Residential,21400,47768,0,69168
141040400300000,NE 129,Residential,21400,104934,0,126334
141040400400000,NE 129,Residential,22738,60581,0,83319
141040400500000,NE 129,Residential,20063,86502,0,106565
141040400600000,NE 129,Residential,40660,74032,0,114692
141040400700000,NE 129,Residential,21400,56834,0,78234
141040400800000,NE 129,Residential,21400,65444,0,86844
141040400900000,NE 129,Residential,21400,6383,0,27783
141040401000000,NE 129,Residential,21400,41279,0,62679
141040401100000,NE 129,Residential,21400,49701,0,71101
141040401200000,NE 129,Residential,21400,61619,0,83019
141040401300000,NE 129,Residential,31025,82234,0,113259
141040401400000,NE 129,Residential,34000,70330,0,104330
141040401500000,NE 129,Residential,26750,52268,0,79018
141040401600000,NE 129,Residential,26750,59028,0,85778
141040401700000,NE 129,Residential,32100,56670,0,88770
141040401800000,NE 129,Residential,21400,86177,0,107577
141040401900000,NE 129,Residential,21400,53145,0,74545
141040402000000,NE 129,Residential,21400,58425,0,79825
141040402100000,NE 129,Residential,21400,59837,0,81237
141040402200000,NE 129,Residential,40660,76905,0,117565
141040402300000,NE 129,Residential,34000,61978,0,95978
141040402500000,NE 129,Residential,32704,93538,0,126242
141040500100000,NE 129,Residential,34000,66994,0,100994
141040500200000,NE 129,Residential,23850,97434,0,121284
141040500300000,NE 129,Residential,18550,84243,0,102793
141040500400000,NE 129,Residential,21200,70395,0,91595
141040500500000,NE 129,Residential,21200,69320,0,90520
141040500600000,NE 129,Residential,31800,76935,0,108735
141040500700000,NE 129,Residential,42400,77663,0,120063
141040500800000,NE 129,Residential,21200,89299,0,110499
141040500900000,NE 129,Residential,31800,70898,0,102698
141040501000000,NE 129,Residential,31800,32956,0,64756
141040501100000,NE 129,Residential,40280,79406,0,119686
141040501200000,NE 129,Residential,25440,66244,0,91684
141040501300000,NE 129,Residential,25440,62343,0,87783
141040501400000,NE 129,Residential,16960,59990,0,76950
141040501500000,NE 129,Residential,16960,63643,0,80603
141040501600000,NE 129,Residential,20352,64557,0,84909
141040501700000,NE 129,Residential,30528,93306,0,123834
141040501800000,NE 129,Residential,29680,59968,0,89648
141040501900000,NE 129,Residential,21200,71491,0,92691
141040502000000,NE 129,Residential,16960,88567,0,105527
141040502100000,NE 129,Residential,33920,93908,0,127828
141040502200000,NE 129,Residential,15680,60200,0,75880
141040502300000,NE 129,Residential,15680,71671,0,87351
141040502400000,NE 129,Residential,13140,45919,0,59059
141040502500000,NE 129,Residential,26280,68372,0,94652
141040600100000,NE 129,Residential,18600,60024,0,78624
141040600200000,NE 129,Residential,18600,59887,0,78487
141040600300000,NE 129,Residential,21200,60082,0,81282
141040600400000,NE 129,Residential,21200,60599,0,81799
141040600500000,NE 129,Residential,29150,82265,0,111415
141040600600000,NE 129,Residential,23850,42297,0,66147
141040600700000,NE 129,Residential,31800,43098,0,74898
141040600800000,NE 129,Residential,40280,101302,0,141582
141040600900000,NE 129,Residential,29150,65837,0,94987
141040601000000,NE 129,Residential,27560,71982,0,99542
141040601100000,NE 129,Residential,28090,90625,0,118715
141040601200000,NE 129,Residential,33920,38995,0,72915
141040601300000,NE 129,Residential,33920,56651,0,90571
141040601400000,NE 129,Residential,33920,86930,0,120850
141040601500000,NE 129,Residential,33920,73934,0,107854
141040601600000,NE 129,Residential,33920,97897,0,131817
141040601700000,NE 129,Residential,33920,99851,0,133771
141040601800000,NE 129,Residential,25280,64230,0,89510
141040601900000,NE 129,Residential,32850,70110,0,102960
141040602000000,NE 129,Residential,21535,48233,0,69768
141042600100000,NE 129,Residential,29200,52361,0,81561
141042600200000,NE 129,Residential,40660,86625,0,127285
141042600300000,NE 129,Residential,40660,57156,0,97816
141042600400000,NE 129,Residential,28355,106636,0,134991
141042600500000,NE 129,Residential,28355,84659,0,113014
141042600600000,NE 129,Residential,28890,57020,0,85910
141042600700000,NE 129,Residential,40660,62791,0,103451
141042600800000,NE 129,Residential,40660,64155,0,104815
141042600900000,NE 129,Residential,26750,62766,0,89516
141042601000000,NE 129,Residential,29425,58897,0,88322
141042601100000,NE 129,Residential,29425,56864,0,86289
141042601200000,NE 129,Residential,34800,49138,0,83938
141042601300000,NE 129,Residential,29200,85382,0,114582
141042601400000,NE 129,Residential,38325,49932,0,88257
141042700100000,NE 129,Residential,34000,70172,0,104172
141042700200000,NE 129,Residential,40660,38679,0,79339
141042700300000,NE 129,Residential,21400,60362,0,81762
141042700400000,NE 129,Residential,21400,56888,0,78288
141042700500000,NE 129,Residential,40660,57387,0,98047
141042700600000,NE 129,Residential,40660,84063,0,124723
141042700700000,INDUSTRIAL,Industrial,636550,0,3490400,4126950
141042700800000,NE 129,Residential,21400,29002,0,50402
141042700900000,NE 129,Residential,24075,54567,0,78642
141042701000000,NE 129,Residential,40125,97158,0,137283
141042701100000,NE 129,Residential,40660,44448,0,85108
141042701200000,NE 129,Residential,34800,77486,0,112286
141042701300000,NE 129,Residential,34800,42671,0,77471
141042701400000,NE 129,Residential,40800,71694,0,112494
141042701500000,NE 129,Residential,31025,63638,0,94663
141042800100000,NE 129,Residential,34800,77358,0,112158
141042800200000,NE 129,Residential,21200,58168,0,79368
141042800300000,NE 129,Residential,21200,48241,0,69441
141042800400000,NE 129,Residential,20140,66669,0,86809
141042800500000,NE 129,Residential,22260,90677,0,112937
141042800600000,NE 129,Residential,34450,93582,0,128032
141042800700000,NE 129,Residential,37762,79817,0,117579
141042800800000,NE 129,Residential,33920,101156,0,135076
141042800900000,NE 129,Residential,33920,70478,0,104398
141042801000000,NE 129,Residential,33920,49030,0,82950
141042801100000,NE 129,Residential,16960,51711,0,68671
141042801200000,NE 129,Residential,16960,57169,0,74129
141042801300000,NE 129,Residential,27840,68755,0,96595
141042801400000,NE 129,Residential,27375,106708,0,134083
141042801500000,NE 129,Residential,27375,80096,0,107471
141045100101000,CONDO 501,Residential,16000,193098,0,209098
141045100101001,CONDO 501,Residential,13000,177833,0,190833
141045100201000,CONDO 501,Residential,15000,175714,0,190714
141045100201001,CONDO 501,Residential,13000,175896,0,188896
141045100300000,CONDO 501,Residential,600,0,0,600
141045100401000,CONDO 501,Residential,14000,174610,0,188610
141045100401001,CONDO 501,Residential,14000,172121,0,186121
141045100401002,CONDO 501,Residential,13000,178981,0,191981
141045100401003,CONDO 501,Residential,13000,166991,0,179991
141045100501000,CONDO 501,Residential,14000,162318,0,176318
141045100501001,CONDO 501,Residential,14000,160861,0,174861
141045100501002,CONDO 501,Residential,14000,176847,0,190847
141045100501003,CONDO 501,Residential,17000,166019,0,183019
141045100601000,CONDO 501,Residential,13000,139315,0,152315
141045100601001,CONDO 501,Residential,14000,164308,0,178308
141045100601002,CONDO 501,Residential,13000,160545,0,173545
141045100601003,CONDO 501,Residential,13000,172934,0,185934
141045100701000,CONDO 501,Residential,15000,201251,0,216251
141045100701001,CONDO 501,Residential,17000,205766,0,222766
141045100800000,NE 142,Residential,35628,121550,0,157178
141045100900000,NE 142,Residential,30804,120089,0,150893
141045101000000,NE 142,Residential,33413,130076,0,163489
141045101100000,NE 142,Residential,33413,126179,0,159592
141045101200000,NE 142,Residential,40095,157209,0,197304
141045101301000,CONDO 501,Residential,14000,196024,0,210024
141045101301001,CONDO 501,Residential,14000,155639,0,169639
141045101301002,CONDO 501,Residential,13000,169326,0,182326
141045101301003,CONDO 501,Residential,16000,173713,0,189713
141045101401000,CONDO 501,Residential,16000,209672,0,225672
141045101401001,CONDO 501,Residential,14000,193681,0,207681
141045101501000,CONDO 501,Residential,16000,187149,0,203149
141045101501001,CONDO 501,Residential,14000,157530,0,171530
141045101601000,CONDO 501,Residential,14000,185584,0,199584
141045101601001,CONDO 501,Residential,14000,195069,0,209069
141045101700000,CONDO 501,Residential,3500,0,0,3500
141045101801000,CONDO 501,Residential,13000,143083,0,156083
141045101801001,CONDO 501,Residential,14000,150387,0,164387
141045101801002,CONDO 501,Residential,13000,145180,0,158180
141045101801003,CONDO 501,Residential,15000,164116,0,179116
141045101901000,CONDO 501,Residential,13000,163628,0,176628
141045101901001,CONDO 501,Residential,13000,152048,0,165048
141045102001000,CONDO 501,Residential,17000,210664,0,227664
141045102001001,CONDO 501,Residential,17000,204941,0,221941
141045200100000,NE 142,Residential,19282,102876,0,122158
141045200200000,NE 142,Residential,19824,97848,0,117672
141045200300000,NE 142,Residential,29239,100491,0,129730
141045200400000,NE 142,Residential,28200,78418,0,106618
141045200500000,NE 142,Residential,28200,95349,0,123549
141045200600000,NE 142,Residential,28500,105150,0,133650
141045200700000,NE 142,Residential,28500,94988,0,123488
141045200800000,NE 142,Residential,28800,92964,0,121764
141045200900000,NE 142,Residential,28800,84147,0,112947
141045201000000,NE 142,Residential,28800,102117,0,130917
141045201100000,NE 142,Residential,33410,131771,0,165181
141045201200000,NE 142,Residential,33060,144780,0,177840
141045201300000,NE 142,Residential,30095,129149,0,159244
141045201400000,NE 142,Residential,30869,72385,0,103254
141045201500000,NE 142,Residential,28800,79227,0,108027
141045201600000,NE 142,Residential,28800,88388,0,117188
141045201700000,NE 142,Residential,28800,82057,0,110857
141045201800000,NE 142,Residential,28500,89787,0,118287
141045201900000,NE 142,Residential,27867,96838,0,124705
141045300100000,NE 142,Residential,29824,99490,0,129314
141045300200000,NE 142,Residential,29767,94415,0,124182
141045300300000,NE 142,Residential,28500,101468,0,129968
141045300400000,NE 142,Residential,28500,110177,0,138677
141045300500000,NE 142,Residential,28500,91785,0,120285
141045300600000,NE 142,Residential,28500,105545,0,134045
141045300700000,NE 142,Residential,28500,96178,0,124678
141045300800000,NE 142,Residential,26125,114325,0,140450
141045300900000,NE 142,Residential,30875,107047,0,137922
141045301000000,NE 142,Residential,22800,83126,0,105926
141045301100000,NE 142,Residential,22800,96165,0,118965
141045301200000,NE 142,Residential,22800,96681,0,119481
141045301300000,NE 142,Residential,22800,82191,0,104991
141045301400000,NE 142,Residential,28500,103889,0,132389
141045301500000,NE 142,Residential,28500,88922,0,117422
141045301600000,NE 142,Residential,28500,68142,0,96642
141045301700000,NE 142,Residential,28500,102015,0,130515
141045301800000,NE 142,Residential,28500,99742,0,128242
141045301900000,NE 142,Residential,28500,75549,0,104049
141045302000000,NE 142,Residential,28500,92116,0,120616
141045400100000,NE 142,Residential,29718,96206,0,125924
141045400200000,NE 142,Residential,33970,97798,0,131768
141045400300000,NE 142,Residential,30300,93131,0,123431
141045400400000,NE 142,Residential,30000,98624,0,128624
141045400500000,NE 142,Residential,30000,84302,0,114302
141045400600000,NE 142,Residential,29700,83426,0,113126
141045400700000,NE 142,Residential,29700,106059,0,135759
141045400800000,NE 142,Residential,29400,76548,0,105948
141045400900000,NE 142,Residential,27053,105977,0,133030
141045401000000,NE 142,Residential,23547,104602,0,128149
141045401100000,NE 142,Residential,22800,71879,0,94679
141045401200000,NE 142,Residential,22800,74406,0,97206
141045401300000,NE 142,Residential,22800,87048,0,109848
141045401400000,NE 142,Residential,28500,82134,0,110634
141045401500000,NE 142,Residential,28500,73408,0,101908
141045401600000,NE 142,Residential,28500,76565,0,105065
141045401700000,NE 142,Residential,28500,87289,0,115789
141045401800000,NE 142,Residential,28500,81644,0,110144
141045401900000,NE 142,Residential,28500,70333,0,98833
141045402000000,NE 142,Residential,28500,108195,0,136695
141045500100000,NE 142,Residential,29816,170505,0,200321
141045500200000,NE 142,Residential,30294,168588,0,198882
141045500300000,NE 142,Residential,23760,83940,0,107700
141045500400000,NE 142,Residential,27720,121785,0,149505
141045500500000,NE 142,Residential,27720,101555,0,129275
141045500600000,NE 142,Residential,27720,105038,0,132758
141045500700000,NE 142,Residential,27720,103571,0,131291
141045500800000,NE 142,Residential,23760,110873,0,134633
141045500900000,NE 142,Residential,23760,90332,0,114092
141045501000000,NE 142,Residential,23760,78571,0,102331
141045501100000,NE 142,Residential,23760,90198,0,113958
141045501200000,NE 142,Residential,28182,103760,0,131942
141045501300000,NE 142,Residential,30805,87907,0,118712
141045501400000,NE 142,Residential,29700,78667,0,108367
141045501500000,NE 142,Residential,29700,78964,0,108664
141045501600000,NE 142,Residential,29700,105139,0,134839
141045501700000,NE 142,Residential,29700,81755,0,111455
141045501800000,NE 142,Residential,34650,79263,0,113913
141045501900000,NE 142,Residential,34650,120537,0,155187
141045502000000,NE 142,Residential,34650,89645,0,124295
141045502100000,NE 142,Residential,34650,126027,0,160677
141045502200000,NE 142,Residential,29700,94070,0,123770
141045502300000,NE 142,Residential,35640,104693,0,140333
141045502400000,NE 142,Residential,38828,156639,0,195467
141045600600000,NE 142,Residential,26267,137261,0,163528
141045600700000,NE 142,Residential,31185,117822,0,149007
141045600800000,NE 142,Residential,31185,121208,0,152393
141045600900000,NE 142,Residential,29403,111842,0,141245
141045601000000,NE 142,Residential,32076,118360,0,150436
141045700100000,NE 142,Residential,38355,186532,0,224887
141045700200000,NE 142,Residential,34650,122243,0,156893
141045700300000,NE 142,Residential,35269,152147,0,187416
141045700400000,NE 142,Residential,34650,122372,0,157022
141045700500000,NE 142,Residential,29700,90513,0,120213
141045700600000,NE 142,Residential,34650,96796,0,131446
141045700700000,NE 142,Residential,34650,102267,0,136917
141045700800000,NE 142,Residential,34650,122222,0,156872
141045700900000,NE 142,Residential,29700,104006,0,133706
141045701000000,NE 142,Residential,29700,88756,0,118456
141045701100000,NE 142,Residential,26730,79522,0,106252
141045701200000,NE 142,Residential,31565,87970,0,119535
141045701300000,NE 142,Residential,35615,115066,0,150681
141045701400000,NE 142,Residential,33858,141142,0,175000
141045701500000,NE 142,Residential,28958,89386,0,118344
141045701600000,NE 142,Residential,31185,112608,0,143793
141045701700000,NE 142,Residential,31185,86272,0,117457
141045701800000,NE 142,Residential,31185,96873,0,128058
141045701900000,NE 142,Residential,31185,98381,0,129566
141045702000000,NE 142,Residential,33413,131806,0,165219
141045702100000,NE 142,Residential,33858,146334,0,180192
141045702200000,NE 142,Residential,34081,125179,0,159260
141045702300000,NE 142,Residential,33596,117167,0,150763
141045800100000,NE 142,Residential,33413,121307,0,154720
141045800200000,NE 142,Residential,33413,108427,0,141840
141045800300000,NE 142,Residential,33413,123559,0,156972
141045800400000,NE 142,Residential,33249,117671,0,150920
141045800500000,NE 142,Residential,31197,115319,0,146516
141047600100000,NE 141,Residential,15520,52231,0,67751
141047600200000,NE 141,Residential,21600,78214,0,99814
141047600300000,NE 141,Residential,21600,109396,0,130996
141047600400000,NE 141,Residential,26190,129028,0,155218
141047600500000,NE 141,Residential,26190,88977,0,115167
141047600600000,NE 141,Residential,27511,125456,0,152967
141047600700000,NE 141,Residential,24869,55410,0,80279
141047700100000,NE 141,Residential,26190,58075,0,84265
141047700200000,NE 141,Residential,15520,57805,0,73325
141047700300000,NE 141,Residential,23400,69004,0,92404
141047700400000,NE 141,Residential,19800,95125,0,114925
141047700500000,NE 141,Residential,17460,54799,0,72259
141047700600000,NE 141,Residential,17460,45668,0,63128
141047700700000,NE 141,Residential,17460,56935,0,74395
141047700800000,NE 141,Residential,26190,84600,0,110790
141047700900000,NE 141,Residential,26190,68636,0,94826
141047701000000,NE 141,Residential,17460,58289,0,75749
141047701100000,NE 141,Residential,17460,51391,0,68851
141047701200000,NE 141,Residential,17460,57202,0,74662
141047701300000,NE 141,Residential,26190,81865,0,108055
141047701400000,NE 141,Residential,26190,77899,0,104089
141047701500000,NE 141,Residential,26190,70950,0,97140
141047800100000,NE 141,Residential,24000,104339,0,128339
141047800200000,NE 141,Residential,24000,96580,0,120580
141047800300000,NE 141,Residential,28238,88014,0,116252
141047800400000,NE 141,Residential,18987,69638,0,88625
141047800500000,NE 141,Residential,22725,48404,0,71129
141047800600000,NE 141,Residential,22725,83236,0,105961
141047800700000,NE 141,Residential,22725,80148,0,102873
141047800800000,NE 141,Residential,23407,63180,0,86587
141047800900000,NE 141,Residential,26190,54980,0,81170
141047801000000,NE 141,Residential,26190,63230,0,89420
141047801100000,NE 141,Residential,26190,102756,0,128946
141047801200000,NE 141,Residential,21825,108028,0,129853
141047900100000,NE 141,Residential,22560,80806,0,103366
141047900200000,NE 141,Residential,20680,84910,0,105590
141047900300000,NE 141,Residential,21600,57334,0,78934
141047900400000,NE 141,Residential,21600,80222,0,101822
141047900500000,NE 141,Residential,21600,77305,0,98905
141047900600000,NE 141,Residential,18630,77162,0,95792
141047900700000,NE 141,Residential,17050,74049,0,91099
141047900800000,NE 141,Residential,16650,59784,0,76434
141048000101000,CONDO 501,Residential,14000,174581,0,188581
141048000101001,CONDO 501,Residential,14000,183433,0,197433
141048000201000,CONDO 501,Residential,13000,160865,0,173865
141048000201001,CONDO 501,Residential,13000,165266,0,178266
141048000201002,CONDO 501,Residential,13000,148803,0,161803
141048000201003,CONDO 501,Residential,15000,169004,0,184004
141048000301000,CONDO 501,Residential,15000,153927,0,168927
141048000301001,CONDO 501,Residential,13000,141140,0,154140
141048000301002,CONDO 501,Residential,15000,153566,0,168566
141048000301003,CONDO 501,Residential,15000,149905,0,164905
141048000401000,CONDO 501,Residential,15000,156532,0,171532
141048000401001,CONDO 501,Residential,14000,181515,0,195515
141048000401002,CONDO 501,Residential,14000,166652,0,180652
141048000401003,CONDO 501,Residential,15000,181921,0,196921
141048000501000,CONDO 501,Residential,14000,172703,0,186703
141048000501001,CONDO 501,Residential,13000,145797,0,158797
141048000501002,CONDO 501,Residential,13000,153372,0,166372
141048000501003,CONDO 501,Residential,15000,168161,0,183161
141048000601000,CONDO 501,Residential,15000,175366,0,190366
141048000601001,CONDO 501,Residential,14000,162450,0,176450
141048000700000,NE 142,Residential,37125,166474,0,203599
141048000800000,NE 142,Residential,37125,130721,0,167846
141048000900000,NE 142,Residential,33660,143900,0,177560
141048001000000,NE 142,Residential,37531,152147,0,189678
141048001101000,CONDO 501,Residential,15000,206061,0,221061
141048001101001,CONDO 501,Residential,15000,176563,0,191563
141048001201000,CONDO 501,Residential,17000,188236,0,205236
141048001201001,CONDO 501,Residential,13000,167724,0,180724
141048001301000,CONDO 501,Residential,16000,197418,0,213418
141048001301001,CONDO 501,Residential,15000,187951,0,202951
141048001401000,CONDO 501,Residential,13000,127086,0,140086
141048001401001,CONDO 501,Residential,14000,136967,0,150967
141048001501000,CONDO 501,Residential,13000,123746,0,136746
141048001501001,CONDO 501,Residential,15000,145120,0,160120
141048001601000,CONDO 501,Residential,13000,159059,0,172059
141048001601001,CONDO 501,Residential,14000,148250,0,162250
141048001601002,CONDO 501,Residential,13000,145198,0,158198
141048001601003,CONDO 501,Residential,13000,165247,0,178247
141048100100000,NE 141,Residential,16151,56678,0,72829
141048100200000,NE 141,Residential,28984,63516,0,92500
141048100300000,NE 141,Residential,22087,84448,0,106535
141048100400000,NE 141,Residential,26190,86470,0,112660
141048100500000,NE 141,Residential,26190,82213,0,108403
141048100600000,NE 141,Residential,26190,113810,0,140000
141048100700000,NE 141,Residential,26190,80605,0,106795
141048200100000,NE 141,Residential,26190,32650,0,58840
141048200200000,NE 141,Residential,17460,68093,0,85553
141048200300000,NE 141,Residential,17460,50888,0,68348
141048200400000,NE 141,Residential,17460,51289,0,68749
141048200500000,NE 141,Residential,26190,81988,0,108178
141048200600000,NE 141,Residential,26190,64736,0,90926
141048200700000,NE 141,Residential,31428,63871,0,95299
141048200800000,NE 141,Residential,26190,98067,0,124257
141048200900000,NE 141,Residential,26190,64330,0,90520
141048201000000,NE 141,Residential,26190,45447,0,71637
141048201100000,NE 141,Residential,17460,54729,0,72189
141048201200000,NE 141,Residential,15278,49736,0,65014
141048201300000,NE 141,Residential,19643,62660,0,82303
141048201400000,NE 141,Residential,26190,112550,0,138740
141048201500000,NE 141,Residential,26190,75385,0,101575
141048300100000,NE 141,Residential,26190,89100,0,115290
141048300200000,NE 141,Residential,22500,96171,0,118671
141048300300000,NE 141,Residential,22500,72496,0,94996
141048300400000,NE 141,Residential,22500,63093,0,85593
141048300500000,NE 141,Residential,22500,84650,0,107150
141048300600000,NE 141,Residential,22500,80391,0,102891
141048300700000,NE 141,Residential,22500,97450,0,119950
141048300800000,NE 141,Residential,22500,47283,0,69783
141048300900000,NE 141,Residential,16245,47811,0,64056
141048301000000,NE 141,Residential,16245,68284,0,84529
141048301100000,NE 141,Residential,26190,72945,0,99135
141048301200000,NE 141,Residential,26190,72810,0,99000
141048301300000,NE 141,Residential,26190,92167,0,118357
141048301400000,NE 141,Residential,26190,85913,0,112103
141048301500000,NE 141,Residential,26190,60987,0,87177
141048301600000,NE 141,Residential,26190,51554,0,77744
141048400100000,NE 141,Residential,21600,84358,0,105958
141048400200000,NE 141,Residential,29160,63009,0,92169
141048400300000,NE 141,Residential,29160,93267,0,122427
141048400400000,NE 141,Residential,21600,76204,0,97804
141048400500000,NE 141,Residential,21600,91389,0,112989
141048400600000,NE 141,Residential,17280,63690,0,80970
141048400700000,NE 141,Residential,17280,79539,0,96819
141048400800000,NE 141,Residential,18187,66967,0,85154
141048500100000,NE 141,Residential,14400,0,0,14400
141048500200000,NE 141,Residential,14400,12000,0,26400
141048500300000,COMM NE,Commercial,17626,0,43051,60677
141048600100000,NE 141,Residential,15520,73590,0,89110
141048600200000,NE 141,Residential,26190,107416,0,133606
141048600300000,NE 141,Residential,26190,67166,0,93356
141048600400000,NE 141,Residential,26190,99111,0,125301
141048600500000,E-40 CHURCHES,Exempt,34992,0,66617,101609
141048600600000,NE 141,Residential,24444,85315,0,109759
141048600700000,NE 141,Residential,19400,100600,0,120000
141048600800000,NE 141,Residential,15520,65473,0,80993
141048600900000,NE 141,Residential,15520,69392,0,84912
141048601000000,NE 141,Residential,15520,61666,0,77186
141048601100000,NE 141,Residential,15520,54655,0,70175
141048601200000,NE 141,Residential,15520,55204,0,70724
141048700100000,NE 141,Residential,26190,64328,0,90518
141048700200000,NE 141,Residential,21717,73395,0,95112
141048700300000,NE 141,Residential,31559,92737,0,124296
141048700400000,NE 141,Residential,22500,81892,0,104392
141048700500000,NE 141,Residential,22500,65370,0,87870
141048700600000,NE 141,Residential,22500,75382,0,97882
141048700700000,NE 141,Residential,18000,48410,0,66410
141048700800000,NE 141,Residential,16650,48774,0,65424
141048700900000,NE 141,Residential,16470,43286,0,59756
141048701000000,NE 141,Residential,26190,67544,0,93734
141048701100000,NE 141,Residential,26190,110060,0,136250
141048701200000,NE 141,Residential,26190,61320,0,87510
141048701300000,NE 141,Residential,26190,102186,0,128376
141048701400000,NE 141,Residential,26190,70527,0,96717
141048800100000,NE 141,Residential,21600,59760,0,81360
141048800200000,NE 141,Residential,21600,82822,0,104422
141048800300000,NE 141,Residential,21600,97689,0,119289
141048800400000,NE 141,Residential,21600,80216,0,101816
141048800500000,NE 141,Residential,23328,91567,0,114895
141048800600000,NE 141,Residential,27083,136995,0,164078
141048900100000,NE 142,Residential,33135,135979,0,169114
141048900200000,NE 142,Residential,32670,144563,0,177233
141048900300000,NE 142,Residential,33413,139811,0,173224
141048900400000,NE 142,Residential,33413,121895,0,155308
141048900500000,NE 142,Residential,33413,135160,0,168573
141048900600000,NE 142,Residential,28958,122814,0,151772
141048900700000,NE 142,Residential,28958,113261,0,142219
141048900800000,NE 142,Residential,31185,83677,0,114862
141048900900000,NE 142,Residential,28958,105735,0,134693
141048901000000,NE 142,Residential,29415,102716,0,132131
141110100100000,NE 115,Residential,133420,669685,0,803105
141110100200000,NE 115,Residential,110000,204439,0,314439
141110100300000,NE 115,Residential,295200,33894,0,329094
141110100400000,NE 115,Residential,15000,0,0,15000
141110100500000,NE 115,Residential,122820,429600,0,552420
141110100600000,NE 115,Residential,120800,351131,0,471931
141110100700000,NE 115,Residential,103720,321280,0,425000
141112800300000,APTS SE,Commercial,16816,0,138023,154839
141113000200000,APTS SE,Commercial,18144,0,148788,166932
141120100100000,COMM SE,Commercial,1076976,0,1718464,2795440
141120100200000,COMM SE,Commercial,123984,0,71195,195179
141120100300000,APTS SE,Commercial,17496,0,151731,169227
141120100400000,APTS SE,Commercial,17496,0,138504,156000
141120100500000,APTS SE,Commercial,17496,0,150832,168328
141120100600000,APTS SE,Commercial,17496,0,150400,167896
141120100700000,APTS SE,Commercial,17431,0,151063,168494
141120100800000,APTS SE,Commercial,17237,0,145763,163000
141120100900000,APTS SE,Commercial,17480,0,138520,156000
141120200100000,COMM NE,Commercial,473040,0,585547,1058587
141120200200000,APTS NE,Commercial,81540,0,343460,425000
141120200300000,COMM NE,Commercial,308614,0,996300,1304914
141120200400000,COMM NE,Commercial,181440,0,490299,671739
141120300100000,APTS SE,Commercial,15279,0,147479,162758
141120300200000,APTS SE,Commercial,20457,0,162950,183407
141120300301000,CONDO 501,Residential,5000,69943,0,74943
141120300301001,CONDO 501,Residential,5000,70250,0,75250
141120300301002,CONDO 501,Residential,5000,69943,0,74943
141120300301003,CONDO 501,Residential,5000,70250,0,75250
141120300301004,CONDO 501,Residential,5000,69943,0,74943
141120300301005,CONDO 501,Residential,5000,69943,0,74943
141120300401000,CONDO 501,Residential,5000,70295,0,75295
141120300401001,CONDO 501,Residential,5000,70601,0,75601
141120300401002,CONDO 501,Residential,5000,70295,0,75295
141120300401003,CONDO 501,Residential,5000,70295,0,75295
141120300500000,APTS SE,Commercial,15253,0,161131,176384
141120300600000,APTS SE,Commercial,12831,0,136720,149551
141120300700000,APTS SE,Commercial,18053,0,164006,182059
141120300800000,APTS SE,Commercial,20898,0,190122,211020
141120400101000,CONDO 501,Residential,15000,160470,0,175470
141120400101001,CONDO 501,Residential,20000,181121,0,201121
141120400101002,CONDO 501,Residential,20000,177812,0,197812
141120400101003,CONDO 501,Residential,15000,162610,0,177610
141120400200000,SE 201,Residential,365,0,0,365
141120400301000,CONDO 500,Residential,6000,59895,0,65895
141120400301001,CONDO 500,Residential,6000,55512,0,61512
141120400301002,CONDO 500,Residential,6000,56126,0,62126
141120400301003,CONDO 500,Residential,6000,50267,0,56267
141120400301004,CONDO 500,Residential,6000,52398,0,58398
141120400301005,CONDO 500,Residential,6000,56126,0,62126
141120400301006,CONDO 500,Residential,6000,62095,0,68095
141120400301007,CONDO 500,Residential,6000,59113,0,65113
141120400301008,CONDO 500,Residential,6000,59895,0,65895
141120400301009,CONDO 500,Residential,6000,55224,0,61224
141120400301010,CONDO 500,Residential,6000,61020,0,67020
141120400301011,CONDO 500,Residential,6000,61634,0,67634
141120400301012,CONDO 500,Residential,8000,73487,0,81487
141120400301013,CONDO 500,Residential,8000,72803,0,80803
141120400301014,CONDO 500,Residential,8000,73487,0,81487
141120400301015,CONDO 500,Residential,8000,65829,0,73829
141120400301016,CONDO 500,Residential,8000,72803,0,80803
141120400301017,CONDO 500,Residential,8000,73487,0,81487
141120400301018,CONDO 500,Residential,6500,64359,0,70859
141120400301019,CONDO 500,Residential,6500,62029,0,68529
141120400301020,CONDO 500,Residential,6500,63465,0,69965
141120400301021,CONDO 500,Residential,6500,62792,0,69292
141120400301022,CONDO 500,Residential,6500,63465,0,69965
141120400301023,CONDO 500,Residential,6500,64274,0,70774
141120400301024,CONDO 500,Residential,8000,74382,0,82382
141120400301025,CONDO 500,Residential,8000,75336,0,83336
141120400301026,CONDO 500,Residential,8000,75336,0,83336
141120400301027,CONDO 500,Residential,8000,74646,0,82646
141120400301028,CONDO 500,Residential,6500,63465,0,69965
141120400301029,CONDO 500,Residential,6500,64138,0,70638
141120400400000,E-73 LOW RENT HOUSE,Exempt,48546,0,1219819,1268365
141120400600000,Empty,Other,0,0,0,0
141120400700000,COMM SE,Commercial,528120,0,544738,1072858
141120400800000,COMM SE,Commercial,70567,0,63770,134337
141120400900000,COMM SE,Commercial,264600,0,113455,378055
141120400902000,COMM SE,Commercial,0,0,18614,18614
141120401000000,COMM SE,Commercial,172800,0,106388,279188
141120401100000,COMM SE,Commercial,156600,0,207323,363923
141120401200000,COMM SE,Commercial,728136,0,872800,1600936
141120401300000,COMM SE,Commercial,179280,0,315392,494672
141120401400000,COMM SE,Commercial,10109,0,0,10109
141122600100000,NE 129,Residential,35580,87627,0,123207
141122600200000,NE 129,Residential,35021,104469,0,139490
141122600300000,NE 129,Residential,35021,89058,0,124079
141122600400000,NE 129,Residential,35021,89988,0,125009
141122600500000,NE 129,Residential,35021,80228,0,115249
141122600600000,NE 129,Residential,35021,102824,0,137845
141122600700000,NE 129,Residential,34543,106557,0,141100
141122700100000,NE 129,Residential,41870,83310,0,125180
141122700200000,NE 129,Residential,36288,96374,0,132662
141122700300000,NE 129,Residential,36288,30264,0,66552
141122700400000,NE 129,Residential,34020,117102,0,151122
141122700500000,NE 129,Residential,37044,96218,0,133262
141122700600000,NE 129,Residential,41580,100934,0,142514
141122700700000,E-40 CHURCHES,Exempt,243000,0,1392738,1635738
141122700800000,NE 129,Residential,37791,124654,0,162445
141122700900000,NE 129,Residential,34338,108155,0,142493
141122701000000,NE 129,Residential,31539,94933,0,126472
141122701100000,NE 129,Residential,31464,74893,0,106357
141122701200000,NE 129,Residential,31464,75097,0,106561
141122701300000,NE 129,Residential,31464,94391,0,125855
141122701400000,NE 129,Residential,31637,92471,0,124108
141122701500000,NE 129,Residential,29602,82885,0,112487
141122701600000,NE 129,Residential,31464,107792,0,139256
141122701700000,NE 129,Residential,32568,101943,0,134511
141122701800000,NE 129,Residential,31176,62219,0,93395
141122701900000,NE 129,Residential,32703,104208,0,136911
141122702000000,NE 129,Residential,34312,66591,0,100903
141122702100000,NE 129,Residential,34398,99137,0,133535
141122800100000,COMM NE,Commercial,190179,0,90003,280182
141122800200000,COMM NE,Commercial,52100,0,357900,410000
141122800300000,NE 129,Residential,22320,0,0,22320
141122800400000,NE 129,Residential,22320,48339,0,70659
141122800500000,NE 129,Residential,22320,48580,0,70900
141122800600000,NE 129,Residential,22320,47558,0,69878
141122800700000,NE 129,Residential,26064,126764,0,152828
141122800800000,NE 129,Residential,25920,46636,0,72556
141122800900000,NE 129,Residential,25440,39969,0,65409
141122801000000,NE 129,Residential,24480,60348,0,84828
141122801100000,NE 129,Residential,24000,44981,0,68981
141122801200000,NE 129,Residential,23280,45288,0,68568
141122801300000,NE 129,Residential,23478,71787,0,95265
141122801400000,NE 129,Residential,26092,61028,0,87120
141122801500000,NE 129,Residential,27156,78127,0,105283
141122801600000,NE 129,Residential,26786,67647,0,94433
141122801700000,NE 129,Residential,25920,56274,0,82194
141122801800000,NE 129,Residential,25920,94298,0,120218
141122801900000,NE 129,Residential,25493,61032,0,86525
141122802000000,NE 129,Residential,24939,55644,0,80583
141122802100000,NE 129,Residential,26830,66067,0,92897
141122802200000,NE 129,Residential,25682,67434,0,93116
141122802300000,NE 129,Residential,26568,60096,0,86664
141122802400000,NE 129,Residential,27132,60881,0,88013
141122802500000,NE 129,Residential,26732,64782,0,91514
141122802600000,NE 129,Residential,21870,50532,0,72402
141122802700000,NE 129,Residential,22680,66741,0,89421
141122802800000,NE 129,Residential,24300,57956,0,82256
141122802900000,NE 129,Residential,29100,71173,0,100273
141122803000000,NE 129,Residential,28687,81225,0,109912
141122803100000,NE 129,Residential,26932,58796,0,85728
141122803200000,NE 129,Residential,25680,37468,0,63148
141122803300000,NE 129,Residential,25740,42128,0,67868
141122803400000,COMM NE,Commercial,43466,0,97695,141161
141122803500000,COMM NE,Commercial,181980,0,118020,300000
141122900100000,NE 130,Residential,27183,90847,0,118030
141122900200000,NE 130,Residential,29088,76504,0,105592
141122900300000,NE 130,Residential,29088,80585,0,109673
141122900400000,NE 130,Residential,25149,33611,0,58760
141122900500000,NE 130,Residential,23520,83258,0,106778
141122900600000,NE 130,Residential,23520,888,0,24408
141122900700000,NE 130,Residential,23520,45120,0,68640
141122900800000,NE 130,Residential,23520,77142,0,100662
141122900900000,NE 130,Residential,23520,59936,0,83456
141122901000000,NE 130,Residential,23520,68103,0,91623
141122901100000,NE 130,Residential,23520,57063,0,80583
141122901300000,NE 130,Residential,34776,86760,0,121536
141123000100000,NE 129,Residential,21973,71683,0,93656
141123000200000,NE 129,Residential,27977,62665,0,90642
141123000300000,NE 129,Residential,28013,55702,0,83715
141123000400000,NE 129,Residential,28633,75389,0,104022
141123000500000,NE 129,Residential,28917,61499,0,90416
141123000600000,NE 129,Residential,29200,59488,0,88688
141123000700000,NE 129,Residential,26932,75579,0,102511
141123000800000,NE 129,Residential,28620,48339,0,76959
141123000900000,NE 129,Residential,28697,58194,0,86891
141123001000000,NE 129,Residential,27753,65314,0,93067
141123001100000,NE 129,Residential,25088,62023,0,87111
141123001200000,NE 129,Residential,26190,59771,0,85961
141123001300000,NE 129,Residential,25920,63723,0,89643
141123001400000,NE 129,Residential,21056,36749,0,57805
141123001500000,NE 129,Residential,22320,57493,0,79813
141123001600000,NE 129,Residential,22080,56824,0,78904
141123001700000,NE 129,Residential,30301,69382,0,99683
141123001800000,NE 129,Residential,25272,54402,0,79674
141123001900000,NE 129,Residential,25038,56028,0,81066
141123002000000,NE 129,Residential,24610,47763,0,72373
141123002100000,NE 129,Residential,27510,52081,0,79591
141123002200000,NE 129,Residential,28016,41690,0,69706
141123002300000,NE 129,Residential,27744,68686,0,96430
141123002400000,NE 129,Residential,27540,72917,0,100457
141123002500000,NE 129,Residential,29750,90776,0,120526
141123002600000,NE 129,Residential,30720,70241,0,100961
141123002700000,NE 129,Residential,31480,11275,0,42755
141123002800000,NE 129,Residential,20747,58918,0,79665
141123002900000,COMM NE,Commercial,48762,0,51383,100145
141123100100000,COMM NE,Commercial,36491,0,58041,94532
141123100200000,NE 129,Residential,21114,66595,0,87709
141123100300000,NE 129,Residential,17712,58615,0,76327
141123100400000,NE 129,Residential,26752,51885,0,78637
141123100500000,NE 129,Residential,26642,76348,0,102990
141123100600000,NE 129,Residential,27360,65341,0,92701
141123100700000,NE 129,Residential,16008,0,0,16008
141123100800000,NE 129,Residential,21484,60284,0,81768
141123100900000,NE 129,Residential,21840,48560,0,70400
141123101000000,NE 129,Residential,24660,49318,0,73978
141123101100000,NE 129,Residential,28512,49570,0,78082
141123101200000,NE 129,Residential,29434,64251,0,93685
141123101300000,NE 129,Residential,26332,41703,0,68035
141123101400000,NE 129,Residential,33581,57313,0,90894
141123101500000,NE 129,Residential,24514,46120,0,70634
141123101600000,NE 129,Residential,29135,60975,0,90110
141123101700000,NE 129,Residential,30240,82071,0,112311
141123101800000,NE 129,Residential,16200,83834,0,100034
141123101900000,NE 129,Residential,20210,86942,0,107152
141123102000000,NE 129,Residential,19800,70060,0,89860
141123102100000,NE 129,Residential,19400,54839,0,74239
141123102200000,NE 129,Residential,22500,106530,0,129030
141123102300000,NE 129,Residential,25200,99664,0,124864
141123102400000,NE 129,Residential,20250,56995,0,77245
141123102500000,NE 129,Residential,19000,62348,0,81348
141123102600000,NE 129,Residential,14371,100229,0,114600
141123102700000,NE 129,Residential,23087,68515,0,91602
141123102800000,NE 129,Residential,24750,60276,0,85026
141123102900000,NE 129,Residential,21231,58231,0,79462
141123103000000,COMM NE,Commercial,67617,0,81105,148722
141123200100000,NE 130,Residential,23520,61397,0,84917
141123200200000,NE 130,Residential,23520,52034,0,75554
141123200300000,NE 130,Residential,30576,92111,0,122687
141123200400000,NE 130,Residential,23520,80328,0,103848
141123200500000,NE 130,Residential,23520,65716,0,89236
141123200600000,NE 130,Residential,30576,75448,0,106024
141123200700000,NE 130,Residential,28224,51086,0,79310
141123200800000,NE 130,Residential,27885,56209,0,84094
141123200900000,NE 130,Residential,24300,69573,0,93873
141123201000000,NE 130,Residential,27641,82093,0,109734
141123201100000,NE 130,Residential,27641,74375,0,102016
141123201200000,NE 130,Residential,26460,98540,0,125000
141123201300000,NE 130,Residential,28665,68647,0,97312
141123201400000,NE 130,Residential,28665,70538,0,99203
141123201500000,NE 130,Residential,23520,37567,0,61087
141123201600000,NE 130,Residential,23520,78378,0,101898
141123201700000,NE 130,Residential,23520,65737,0,89257
141123300100000,COMM SE,Commercial,165295,0,158562,323857
141125100100000,COMM SE,Commercial,837000,0,3005600,3842600
141125100200000,COMM SE,Commercial,47628,0,46569,94197
141125100300000,COMM SE,Commercial,182250,0,16788,199038
141125100400000,COMM SE,Commercial,71306,0,578625,649931
141125200100000,COMM NE,Commercial,194247,0,636766,831013
141125200200000,NE 129,Residential,24255,93833,0,118088
141125200300000,NE 129,Residential,26250,54410,0,80660
141125200400000,NE 129,Residential,26250,61567,0,87817
141125200500000,NE 129,Residential,26250,64656,0,90906
141125200600000,NE 129,Residential,26250,72364,0,98614
141125200700000,NE 129,Residential,26250,81247,0,107497
141125200800000,NE 129,Residential,26250,124362,0,150612
141125200900000,NE 129,Residential,26250,96796,0,123046
141125201000000,NE 129,Residential,26250,86523,0,112773
141125201100000,NE 129,Residential,26250,72437,0,98687
141125201200000,NE 129,Residential,26250,73217,0,99467
141125201300000,NE 129,Residential,26250,76012,0,102262
141125201400000,NE 129,Residential,26250,71547,0,97797
141125201500000,NE 129,Residential,26250,58125,0,84375
141125201600000,NE 129,Residential,25760,72106,0,97866
141125201700000,NE 129,Residential,25047,73670,0,98717
141125201800000,NE 129,Residential,22707,70579,0,93286
141125201900000,NE 129,Residential,24012,66572,0,90584
141125202000000,NE 129,Residential,26484,74556,0,101040
141125202100000,NE 129,Residential,25300,73440,0,98740
141125202200000,NE 129,Residential,26250,77513,0,103763
141125202300000,NE 129,Residential,26250,53817,0,80067
141125202400000,NE 129,Residential,26250,70462,0,96712
141125202500000,NE 129,Residential,26250,91797,0,118047
141125202600000,NE 129,Residential,26250,80505,0,106755
141125202700000,NE 129,Residential,26250,58358,0,84608
141125202800000,NE 129,Residential,26250,105065,0,131315
141125202900000,NE 129,Residential,44625,108541,0,153166
141125203000000,NE 129,Residential,42735,113388,0,156123
141125203100000,NE 129,Residential,21368,94650,0,116018
141125203200000,COMM NE,Commercial,23209,0,3305,26514
141125203300000,COMM NE,Commercial,44712,0,171667,216379
141125203400000,COMM NE,Commercial,61965,0,99500,161465
141125203500000,COMM NE,Commercial,65636,0,127327,192963
141125300100000,E-40 CHURCHES,Exempt,164700,0,370297,534997
141125300200000,APTS NE,Commercial,39042,0,823462,862504
141125300300000,NE 129,Residential,26250,81348,0,107598
141125300400000,NE 129,Residential,42000,84623,0,126623
141125300500000,NE 129,Residential,42000,66598,0,108598
141125300600000,NE 129,Residential,42000,70675,0,112675
141125300700000,NE 129,Residential,42000,77271,0,119271
141125300800000,NE 129,Residential,35600,78866,0,114466
141125300900000,NE 129,Residential,21353,77225,0,98578
141125301000000,NE 129,Residential,21353,91524,0,112877
141125301100000,NE 129,Residential,24475,59290,0,83765
141125301200000,NE 129,Residential,24475,92673,0,117148
141125301300000,NE 129,Residential,6400,0,0,6400
141125301400000,NE 129,Residential,22250,89787,0,112037
141125301500000,NE 129,Residential,31500,81711,0,113211
141125301600000,NE 129,Residential,44625,126526,0,171151
141125301700000,NE 129,Residential,42000,135304,0,177304
141125301800000,NE 129,Residential,42000,143856,0,185856
141125301900000,APTS NE,Commercial,25515,0,139758,165273
141125302000000,E-46 RELIG PARKING,Exempt,0,0,0,65160
141125302100000,COMM NE,Commercial,156803,0,684782,841585
141125302400000,E-46 RELIG PARKING,Exempt,0,0,0,97942
141125400100000,SE 201,Residential,16425,96520,0,112945
141125400200000,SE 201,Residential,16425,77575,0,94000
141125400300000,SE 201,Residential,13140,71832,0,84972
141125400400000,COMM SE,Commercial,136080,0,266126,402206
141125400500000,COMM SE,Commercial,108864,0,401704,510568
141125400600000,COMM SE,Commercial,36288,0,7430,43718
141125400700000,SE 201,Residential,15680,57585,0,73265
141125400800000,SE 201,Residential,19600,78606,0,98206
141125400900000,COMM SE,Commercial,73362,0,68360,141722
141125401000000,SE 201,Residential,16470,74400,0,90870
141125401100000,SE 201,Residential,17568,88778,0,106346
141125401200000,SE 201,Residential,17640,83358,0,100998
141125401300000,SE 201,Residential,17640,60949,0,78589
141125401400000,SE 201,Residential,17640,52059,0,69699
141125401500000,SE 201,Residential,17640,68805,0,86445
141125401600000,SE 201,Residential,17640,74134,0,91774
141125401700000,SE 201,Residential,17640,85669,0,103309
141125401800000,SE 201,Residential,17640,75579,0,93219
141125401900000,SE 201,Residential,17640,83516,0,101156
141125500100000,COMM NE,Commercial,359100,0,429824,788924
141125500200000,NE 129,Residential,36750,102110,0,138860
141125500300000,NE 129,Residential,31500,75078,0,106578
141125500400000,NE 129,Residential,26250,94694,0,120944
141125500500000,NE 129,Residential,26250,90668,0,116918
141125500600000,CONVERSIONS,Commercial,16330,0,43109,59439
141125500700000,NE 129,Residential,42000,83834,0,125834
141125500800000,NE 129,Residential,27825,82709,0,110534
141125500900000,NE 129,Residential,28350,79657,0,108007
141125501000000,NE 129,Residential,27825,88490,0,116315
141125501100000,NE 129,Residential,21000,57037,0,78037
141125501200000,NE 129,Residential,21000,64743,0,85743
141125501300000,NE 129,Residential,18630,69710,0,88340
141125501400000,NE 129,Residential,17280,82948,0,100228
141125501500000,NE 129,Residential,26676,61613,0,88289
141125501600000,NE 129,Residential,25380,74968,0,100348
141125501700000,NE 129,Residential,18900,37936,0,56836
141125501800000,NE 129,Residential,18900,80163,0,99063
141125501900000,NE 129,Residential,28350,77600,0,105950
141125502000000,NE 129,Residential,18900,55894,0,74794
141125502100000,NE 129,Residential,26932,70827,0,97759
141125502200000,NE 129,Residential,23625,79058,0,102683
141125502300000,NE 129,Residential,21263,63487,0,84750
141125502400000,NE 129,Residential,21263,76116,0,97379
141125502500000,NE 129,Residential,16538,69866,0,86404
141125502600000,NE 129,Residential,16538,73225,0,89763
141127600101000,CONDO 505,Residential,12000,80277,0,92277
141127600101001,CONDO 505,Residential,12000,81524,0,93524
141127600101002,CONDO 505,Residential,12000,84622,0,96622
141127600101003,CONDO 505,Residential,12000,81524,0,93524
141127600101004,CONDO 505,Residential,12000,81524,0,93524
141127600101005,CONDO 505,Residential,12000,80276,0,92276
141127600101006,CONDO 505,Residential,12000,80276,0,92276
141127600101007,CONDO 505,Residential,12000,84622,0,96622
141127600101008,CONDO 505,Residential,12000,81524,0,93524
141127600101009,CONDO 505,Residential,12000,81524,0,93524
141127600101010,CONDO 505,Residential,12000,83375,0,95375
141127600101011,CONDO 505,Residential,12000,82678,0,94678
141127600101012,CONDO 505,Residential,12000,80276,0,92276
141127600101013,CONDO 505,Residential,12000,81524,0,93524
141127600101014,CONDO 505,Residential,12000,81524,0,93524
141127600101015,CONDO 505,Residential,12000,81524,0,93524
141127600101016,CONDO 505,Residential,12000,81524,0,93524
141127600101017,CONDO 505,Residential,12000,80276,0,92276
141127600101018,CONDO 505,Residential,12000,0,0,12000
141127600101019,CONDO 505,Residential,12000,0,0,12000
141127600101020,CONDO 505,Residential,12000,0,0,12000
141127600101021,CONDO 505,Residential,12000,0,0,12000
141127600200000,APTS SE,Residential,32940,102060,0,135000
141127600300000,SE 201,Residential,18200,81516,0,99716
141127600400000,COMM SE,Commercial,10395,0,0,10395
141127600500000,COMM SE,Commercial,44604,0,0,44604
141127600600000,SE 201,Residential,33796,62396,0,96192
141127600700000,SE 201,Residential,22816,47154,0,69970
141127600800000,SE 201,Residential,20281,84578,0,104859
141127600900000,SE 201,Residential,20281,68028,0,88309
141127601000000,SE 201,Residential,20281,51766,0,72047
141127601100000,SE 201,Residential,20091,81554,0,101645
141127601200000,SE 201,Residential,20091,63236,0,83327
141127601300000,SE 201,Residential,20091,71205,0,91296
141127601400000,SE 201,Residential,20369,83570,0,103939
141127601501000,CONDO 501,Residential,10000,96603,0,106603
141127601501001,CONDO 501,Residential,10000,95495,0,105495
141127601501002,CONDO 501,Residential,10000,112373,0,122373
141127601501003,CONDO 501,Residential,10000,116002,0,126002
141127601501004,CONDO 501,Residential,10000,113480,0,123480
141127601501005,CONDO 501,Residential,10000,112865,0,122865
141127601501006,CONDO 501,Residential,10000,112373,0,122373
141127601501007,CONDO 501,Residential,10000,143517,0,153517
141127601501008,CONDO 501,Residential,10000,113480,0,123480
141127601501009,CONDO 501,Residential,10000,112373,0,122373
141127601501010,CONDO 501,Residential,10000,95495,0,105495
141127601501011,CONDO 501,Residential,10000,96603,0,106603
141127601700000,SE 201,Residential,31471,114090,0,145561
141127601800000,SE 201,Residential,27918,81291,0,109209
141127601900000,SE 201,Residential,25245,79568,0,104813
141127602000000,SE 201,Residential,25245,60946,0,86191
141127602100000,SE 201,Residential,25245,83671,0,108916
141127602200000,SE 201,Residential,32447,99124,0,131571
141127602400000,APTS SE,Residential,473580,3738605,0,4212185
141127602500000,SE 201,Residential,26978,69676,0,96654
141127602600000,SE 201,Residential,28890,58678,0,87568
141127602700000,SE 201,Residential,32168,79549,0,111717
141127602800000,SE 201,Residential,36835,69489,0,106324
141127602900000,SE 201,Residential,31298,70384,0,101682
141127603000000,SE 201,Residential,26483,54517,0,81000
141127603100000,SE 201,Residential,31298,109929,0,141227
141127603200000,E-15 CITY,Exempt,0,0,0,0
141127603300000,SE 201,Residential,23064,81547,0,104611
141127603400000,SE 201,Residential,29104,80896,0,110000
141127603500000,COMM SE,Commercial,4687,0,0,4687
141127603600000,APTS SE,Commercial,262980,0,3518992,3781972
141127603700000,CONDO 505,Residential,216000,0,0,216000
141130100100000,SE 201,Residential,29376,96946,0,126322
141130100200000,SE 201,Residential,29376,139453,0,168829
141130100300000,SE 201,Residential,29376,134104,0,163480
141130100400000,SE 201,Residential,29376,84756,0,114132
141130100500000,SE 201,Residential,18360,53214,0,71574
141130100600000,SE 201,Residential,18360,36055,0,54415
141130100700000,SE 201,Residential,29376,86396,0,115772
141130100800000,SE 201,Residential,29376,60199,0,89575
141130100900000,SE 201,Residential,18360,82816,0,101176
141130101000000,SE 201,Residential,18360,57235,0,75595
141130101100000,SE 201,Residential,29376,82317,0,111693
141130101200000,SE 201,Residential,29376,76461,0,105837
141130101300000,SE 201,Residential,29376,79452,0,108828
141130101400000,SE 201,Residential,29376,99633,0,129009
141130101500000,SE 201,Residential,29376,144858,0,174234
141130101600000,SE 201,Residential,32130,94792,0,126922
141130101700000,SE 201,Residential,27540,84460,0,112000
141130101800000,SE 201,Residential,29376,64507,0,93883
141130101900000,SE 201,Residential,29376,95624,0,125000
141130102000000,SE 201,Residential,29376,110500,0,139876
141130102100000,SE 201,Residential,29376,83727,0,113103
141130102200000,SE 201,Residential,29376,62815,0,92191
141130102300000,SE 201,Residential,29376,94873,0,124249
141130102400000,SE 201,Residential,32130,101227,0,133357
141130102500000,SE 201,Residential,27540,57560,0,85100
141130102600000,SE 201,Residential,23328,79791,0,103119
141130102700000,SE 201,Residential,22995,86326,0,109321
141130200100000,COMM NE,Commercial,8068,0,0,8068
141130200201000,CONDO 500,Residential,4000,58132,0,62132
141130200201001,CONDO 500,Residential,4000,58132,0,62132
141130200201002,CONDO 500,Residential,4000,58580,0,62580
141130200201003,CONDO 500,Residential,4000,58580,0,62580
141130200201004,CONDO 500,Residential,4000,58580,0,62580
141130200201005,CONDO 500,Residential,4000,58580,0,62580
141130200300000,SE 201,Residential,28458,95821,0,124279
141130200400000,SE 201,Residential,40392,134866,0,175258
141130300100000,APTS SE,Commercial,22239,0,224618,246857
141130300200000,SE 201,Residential,19089,77686,0,96775
141130300300000,SE 201,Residential,18711,81211,0,99922
141130300400000,SE 201,Residential,30240,82010,0,112250
141130300500000,SE 201,Residential,30240,115708,0,145948
141130300600000,SE 201,Residential,30240,113010,0,143250
141130300700000,SE 201,Residential,18900,49252,0,68152
141130300800000,SE 201,Residential,18900,65258,0,84158
141130300900000,SE 201,Residential,30240,53060,0,83300
141130301000000,SE 201,Residential,18900,38966,0,57866
141130301100000,SE 201,Residential,18900,56782,0,75682
141130301200000,SE 201,Residential,30240,76963,0,107203
141130301300000,SE 201,Residential,30240,93262,0,123502
141130301400000,SE 201,Residential,30240,73768,0,104008
141130301500000,SE 201,Residential,30240,78622,0,108862
141130301600000,COMM SE,Commercial,152550,0,207672,360222
141130301700000,COMM SE,Commercial,68429,0,205876,274305
141130301800000,COMM SE,Commercial,173671,0,351329,525000
141130400100000,COMM NE,Commercial,5443,0,0,5443
141130400200000,COMM SE,Commercial,82755,0,65491,148246
141130400300000,APTS SE,Commercial,13904,0,123215,137119
141130400400000,CONVERSIONS,Commercial,3266,0,114007,117273
141130400600000,COMM SE,Commercial,8942,0,0,8942
141130500100000,Empty,Exempt,0,0,0,0
141130500200000,Empty,Other,0,0,0,0
141130500300000,COMM SE,Commercial,53604,0,151396,205000
141130500400000,COMM SE,Commercial,241758,0,808716,1050474
141130500500000,COMM SE,Commercial,8473,0,4640,13113
141130500600000,E-15 CITY,Exempt,0,0,0,0
141130500700000,E-15 CITY,Exempt,0,0,0,0
141130500800000,E-15 CITY,Exempt,0,0,0,0
141130500900000,SE 201,Residential,34668,112316,0,146984
141132600100000,SE 201,Residential,18360,61684,0,80044
141132600200000,SE 201,Residential,18360,77710,0,96070
141132600300000,SE 201,Residential,18360,55021,0,73381
141132600400000,SE 201,Residential,18360,55764,0,74124
141132600500000,COMM SE,Commercial,279288,0,598742,878030
141132600600000,APTS SE,Commercial,20536,0,114698,135234
141132600700000,APTS SE,Commercial,20340,0,108016,128356
141132600800000,SE 201,Residential,18360,42768,0,61128
141132600900000,APTS SE,Commercial,31493,0,539775,571268
141132601000000,SE 201,Residential,29376,116929,0,146305
141132700100000,COMM NE,Commercial,308772,0,490497,799269
141132700200000,NE 129,Residential,38520,79526,0,118046
141132700300000,NE 129,Residential,38520,83759,0,122279
141132700400000,NE 129,Residential,19260,70295,0,89555
141132700500000,NE 129,Residential,19260,84130,0,103390
141132700600000,NE 129,Residential,38520,51128,0,89648
141132700700000,E-40 CHURCHES,Exempt,77220,0,515669,592889
141132700800000,NE 129,Residential,24030,71212,0,95242
141132700900000,NE 129,Residential,25380,55194,0,80574
141132701000000,NE 129,Residential,21150,68014,0,89164
141132701100000,NE 129,Residential,24075,62135,0,86210
141132701200000,NE 129,Residential,24075,86737,0,110812
141132701300000,NE 129,Residential,21150,71881,0,93031
141132701400000,NE 129,Residential,24075,56675,0,80750
141132701500000,NE 129,Residential,24075,73911,0,97986
141132701600000,NE 129,Residential,24075,71731,0,95806
141132701700000,NE 129,Residential,24075,73067,0,97142
141132701800000,NE 129,Residential,24075,55407,0,79482
141132701900000,NE 129,Residential,24075,68148,0,92223
141132702000000,NE 129,Residential,18297,62025,0,80322
141132702100000,CONVERSIONS,Commercial,12587,0,90262,102849
141132702200000,NE 129,Residential,15991,52756,0,68747
141132702300000,NE 129,Residential,14896,62983,0,77879
141132702400000,NE 129,Residential,14112,0,0,14112
141132702500000,COMM NE,Commercial,91109,0,84020,175129
141132800100000,SE 201,Residential,18540,52189,0,70729
141132800200000,SE 201,Residential,27810,105684,0,133494
141132800300000,SE 201,Residential,27810,0,50289,78099
141132800400000,SE 201,Residential,18540,62180,0,80720
141132800500000,SE 201,Residential,18540,71259,0,89799
141132800600000,COMM SE,Commercial,108199,0,50260,158459
141132800700000,COMM SE,Commercial,66099,0,54827,120926
141132800702000,COMM SE,Commercial,0,0,17092,17092
141132800800000,COMM SE,Commercial,62001,0,157696,219697
141132800900000,COMM SE,Commercial,97978,0,126587,224565
141132801000000,SE 201,Residential,16560,0,0,16560
141132801100000,SE 201,Residential,28890,22910,0,51800
141132801200000,SE 201,Residential,28890,34456,0,63346
141132801300000,SE 201,Residential,19260,70987,0,90247
141132801400000,SE 201,Residential,19260,76016,0,95276
141132801500000,SE 201,Residential,19260,79610,0,98870
141132900100000,COMM NE,Commercial,47552,0,39673,87225
141132900200000,COMM NE,Commercial,4196,0,69510,73706
141132900300000,COMM NE,Commercial,1619,0,0,1619
141132900400000,NE 129,Residential,18630,71615,0,90245
141132900500000,NE 129,Residential,38520,45889,0,84409
141132900600000,NE 129,Residential,38520,95432,0,133952
141132900700000,NE 129,Residential,24075,74464,0,98539
141132900800000,NE 129,Residential,24075,48108,0,72183
141132900900000,E-40 CHURCHES,Exempt,78840,0,554943,633783
141132901000000,NE 129,Residential,30977,73834,0,104811
141132901100000,NE 129,Residential,38520,113199,0,151719
141132901200000,NE 129,Residential,33120,85685,0,118805
141132901300000,NE 129,Residential,22338,57726,0,80064
141132901400000,NE 129,Residential,18068,79384,0,97452
141132901500000,NE 129,Residential,34560,59901,0,94461
141132901600000,NE 129,Residential,25520,77701,0,103221
141132901700000,NE 129,Exempt,9180,0,2791,11971
141132901800000,NE 129,Exempt,19260,0,66254,85514
141132901900000,NE 129,Residential,38520,57311,0,95831
141132902000000,E-70 CHARITY OTHER,Exempt,47952,0,17631,65583
141132902100000,NE 129,Residential,27720,55580,0,83300
141132902200000,CONVERSIONS,Commercial,12960,0,58734,71694
141132902600000,COMM NE,Commercial,174960,0,172976,347936
141132902602000,COMM NE,Commercial,0,0,35061,35061
141132902700000,COMM NE,Commercial,259200,0,405133,664333
141133000100000,SE 201,Residential,28890,37423,0,66313
141133000200000,COMM SE,Commercial,35770,0,3052,38822
141133000300000,COMM SE,Commercial,35770,0,2317,38087
141133000400000,COMM SE,Commercial,23328,0,19627,42955
141133000500000,COMM SE,Commercial,131090,0,195782,326872
141133000600000,COMM SE,Commercial,108770,0,167414,276184
141133000700000,COMM SE,Commercial,63206,0,50359,113565
141133000800000,COMM SE,Commercial,87483,0,90391,177874
141133000900000,COMM SE,Commercial,39074,0,167590,206664
141133001000000,COMM SE,Commercial,39074,0,110145,149219
141133001100000,COMM SE,Commercial,53654,0,65003,118657
141133001200000,COMM SE,Commercial,20801,0,106699,127500
141133001300000,COMM SE,Commercial,220050,0,405269,625319
141133100100000,COMM NE,Commercial,60329,0,116138,176467
141133100200000,COMM NE,Commercial,22453,0,68984,91437
141133100300000,COMM NE,Commercial,15034,0,76729,91763
141133100400000,NE 129,Residential,18428,74178,0,92606
141133100500000,NE 129,Residential,18630,79414,0,98044
141133100600000,NE 129,Residential,40986,118998,0,159984
141133100700000,CONVERSIONS,Commercial,15293,0,49165,64458
141133100800000,NE 129,Residential,17883,69575,0,87458
141133100900000,NE 129,Residential,22896,58467,0,81363
141133101000000,NE 129,Residential,24804,107318,0,132122
141133101100000,NE 129,Residential,35775,114647,0,150422
141133101200000,NE 129,Residential,39123,85913,0,125036
141133101300000,NE 129,Residential,23490,68407,0,91897
141133101400000,NE 129,Residential,20367,76761,0,97128
141133101500000,NE 129,Residential,29440,62555,0,91995
141133101600000,APTS NE,Commercial,16038,0,131433,147471
141133101700000,NE 129,Residential,21200,98987,0,120187
141133101800000,APTS NE,Commercial,16038,0,147106,163144
141133101900000,APTS NE,Commercial,17788,0,415540,433328
141133102000000,APTS NE,Commercial,19391,0,201704,221095
141133102100000,APTS NE,Commercial,18517,0,215731,234248
141133102200000,NE 129,Residential,20520,69902,0,90422
141133102300000,NE 129,Residential,25080,122401,0,147481
141133102400000,NE 129,Residential,22800,85758,0,108558
141133102500000,APTS NE,Commercial,37364,0,372636,410000
141133102600000,COMM NE,Commercial,284256,0,388245,672501
141133102700000,COMM NE,Commercial,80190,0,206187,286377
141133102800000,E-70 CHARITY OTHER,Exempt,52618,0,145979,198597
141135100100000,COMM SE,Commercial,147150,0,126454,273604
141135100200000,COMM SE,Commercial,154023,0,209064,363087
141135100300000,COMM SE,Commercial,358705,0,272011,630716
141135100400000,COMM SE,Commercial,117074,0,205799,322873
141135200100000,COMM NE,Commercial,82717,0,65600,148317
141135200200000,NE 141,Residential,36000,72624,0,108624
141135200300000,NE 141,Residential,22000,77991,0,99991
141135200400000,NE 141,Residential,22000,65638,0,87638
141135200500000,NE 141,Residential,22000,75675,0,97675
141135200600000,NE 141,Residential,22000,49615,0,71615
141135200700000,NE 141,Residential,22000,87435,0,109435
141135200800000,NE 141,Residential,22000,63307,0,85307
141135200900000,NE 141,Residential,22000,55356,0,77356
141135201000000,NE 141,Residential,22000,53542,0,75542
141135201100000,NE 141,Residential,22000,82177,0,104177
141135201200000,APTS NE,Commercial,11236,0,117004,128240
141135201300000,APTS NE,Commercial,11402,0,129606,141008
141135201400000,APTS NE,Commercial,18643,0,343138,361781
141135201500000,APTS NE,Commercial,26215,0,291660,317875
141135201600000,NE 141,Residential,24750,54343,0,79093
141135201700000,NE 141,Residential,24750,54338,0,79088
141135201800000,NE 141,Residential,24750,84237,0,108987
141135201900000,NE 141,Residential,24750,65514,0,90264
141135202000000,NE 141,Residential,24750,66081,0,90831
141135202100000,NE 141,Residential,24750,76177,0,100927
141135202200000,COMM NE,Commercial,8505,0,66904,75409
141135202300000,COMM NE,Commercial,21627,0,175929,197556
141135202400000,COMM NE,Commercial,62208,0,122010,184218
141135202500000,NE 141,Residential,17460,76410,0,93870
141135202600000,NE 141,Residential,21825,95573,0,117398
141135202700000,COMM NE,Commercial,40824,0,44217,85041
141135202800000,COMM NE,Commercial,40824,0,41628,82452
141135202802000,COMM NE,Commercial,0,0,20205,20205
141135202900000,COMM NE,Commercial,175214,0,59435,234649
141135203000000,COMM NE,Commercial,143273,0,6969,150242
141135300100000,COMM NE,Commercial,141588,0,281824,423412
141135300200000,COMM NE,Commercial,43546,0,907096,950642
141135300300000,E-15 CITY,Exempt,0,0,0,0
141135300400000,COMM NE,Commercial,17147,0,34353,51500
141135300500000,E-15 CITY,Exempt,0,0,0,0
141135300600000,COMM NE,Commercial,25272,0,85842,111114
141135300700000,COMM NE,Commercial,145411,0,128267,273678
141135300800000,COMM NE,Commercial,510975,0,0,510975
141135300900000,COMM NE,Commercial,19845,0,0,19845
141135301000000,COMM NE,Commercial,24435,0,0,24435
141135301100000,COMM NE,Commercial,7560,0,0,7560
141135301102000,COMM NE,Commercial,0,0,26152,26152
141135301200000,COMM NE,Commercial,432486,0,1053904,1486390
141135301300000,COMM NE,Commercial,86400,0,0,86400
141135400100000,COMM SE,Commercial,34182,0,147777,181959
141135400200000,COMM SE,Commercial,27540,0,119140,146680
141135400300000,COMM SE,Commercial,12830,0,90282,103112
141135400400000,SE 201,Residential,5950,29407,0,35357
141135400500000,COMM SE,Commercial,41990,0,64804,106794
141135400600000,COMM SE,Commercial,50388,0,1605,51993
141135400700000,COMM SE,Commercial,17496,0,93313,110809
141135400800000,INDUSTRIAL,Industrial,30780,0,31533,62313
141135400900000,INDUSTRIAL,Industrial,38880,0,175375,214255
141135401000000,COMM SE,Commercial,129470,0,142091,271561
141137600100000,E-35 CEMETARY ASSN,Exempt,39690,0,64219,103909
141137600200000,SE 201,Residential,14700,44300,0,59000
141137600300000,Empty,Exempt,0,0,0,0
141137600400000,E-15 CITY,Exempt,0,0,0,0
141137600500000,E-15 CITY,Exempt,0,0,0,0
141137600600000,E-15 CITY,Exempt,0,0,0,0
141137600700000,SE 201,Residential,14400,70656,0,85056
141137600800000,SE 201,Residential,14400,61945,0,76345
141137600900000,SE 201,Residential,14400,55170,0,69570
141137601000000,SE 201,Residential,14400,85651,0,100051
141137601100000,SE 201,Residential,14400,50325,0,64725
141137601200000,SE 201,Residential,14400,87489,0,101889
141137601300000,SE 201,Residential,14400,80761,0,95161
141137601400000,SE 201,Residential,14400,80830,0,95230
141137601500000,SE 201,Residential,18864,58990,0,77854
141137601600000,SE 201,Residential,18405,76610,0,95015
141137601700000,SE 201,Residential,16950,78549,0,95499
141137700100000,SE 201,Residential,11979,88582,0,100561
141137700200000,SE 201,Residential,12900,57691,0,70591
141137700300000,SE 201,Residential,18648,42968,0,61616
141137700400000,COMM SE,Commercial,374652,0,575348,950000
141137700500000,COMM SE,Commercial,20736,0,69821,90557
141137701500000,SE 201,Residential,18934,92389,0,111323
141137800100000,SE 201,Residential,10278,23808,0,34086
141137800200000,SE 201,Residential,14118,78723,0,92841
141137800300000,SE 201,Residential,14250,40933,0,55183
141137800400000,SE 201,Residential,14400,38610,0,53010
141137800500000,SE 201,Residential,14400,62152,0,76552
141137800600000,SE 201,Residential,14400,62276,0,76676
141137800700000,SE 201,Residential,14400,33172,0,47572
141137800800000,SE 201,Residential,14400,80748,0,95148
141137800900000,SE 201,Residential,15341,76316,0,91657
141137801000000,SE 201,Residential,15501,81895,0,97396
141137801100000,SE 201,Residential,9600,37645,0,47245
141137801200000,SE 201,Residential,9600,41389,0,50989
141137801300000,SE 201,Residential,16320,70146,0,86466
141137801400000,SE 201,Residential,19844,76862,0,96706
141137801500000,SE 201,Residential,9828,0,0,9828
141137801600000,SE 201,Residential,10368,89503,0,99871
141137801700000,SE 201,Residential,8820,0,0,8820
141137801800000,SE 201,Residential,14550,53542,0,68092
141137801900000,SE 201,Residential,14400,94081,0,108481
141137802000000,SE 201,Residential,14400,67100,0,81500
141137802100000,SE 201,Residential,14400,40333,0,54733
141137802200000,SE 201,Residential,14400,73567,0,87967
141137802300000,SE 201,Residential,14400,65136,0,79536
141137802400000,SE 201,Residential,14400,48217,0,62617
141137802500000,SE 201,Residential,14400,73204,0,87604
141137802600000,SE 201,Residential,11808,57897,0,69705
141137802700000,SE 201,Residential,16815,22740,0,39555
141137802800000,SE 201,Residential,16405,29522,0,45927
141137900100000,SE 201,Residential,14280,71731,0,86011
141137900200000,SE 201,Residential,14400,50478,0,64878
141137900300000,SE 201,Residential,14400,55896,0,70296
141137900400000,SE 201,Residential,14400,32763,0,47163
141137900500000,SE 201,Residential,14400,68547,0,82947
141137900600000,SE 201,Residential,14400,56425,0,70825
141137900700000,SE 201,Residential,14400,98548,0,112948
141137900800000,SE 201,Residential,14400,83968,0,98368
141137900900000,SE 201,Residential,14400,59053,0,73453
141137901000000,SE 201,Residential,14400,98751,0,113151
141137901100000,SE 201,Residential,14400,89353,0,103753
141137901200000,SE 201,Residential,14400,64232,0,78632
141137901300000,SE 201,Residential,14400,45514,0,59914
141137901400000,SE 201,Residential,14400,69631,0,84031
141137901500000,SE 201,Residential,14100,40015,0,54115
141137901600000,SE 201,Residential,12750,40989,0,53739
141137901700000,SE 201,Residential,8640,45604,0,54244
141137901800000,SE 201,Residential,8640,20851,0,29491
141137901900000,SE 201,Residential,8640,42715,0,51355
141137902000000,SE 201,Residential,11383,60211,0,71594
141137902100000,SE 201,Residential,8986,29479,0,38465
141137902200000,SE 201,Residential,8040,35736,0,43776
141137902300000,SE 201,Residential,17388,7780,0,25168
141137902400000,SE 201,Residential,13663,105810,0,119473
141137902500000,SE 201,Residential,18137,75682,0,93819
141137902600000,SE 201,Residential,22260,83974,0,106234
141137902700000,SE 201,Residential,16854,92174,0,109028
141137902800000,SE 201,Residential,12720,65509,0,78229
141137902900000,SE 201,Residential,15900,68977,0,84877
141137903000000,SE 201,Residential,18126,63164,0,81290
141137903100000,SE 201,Residential,15821,129750,0,145571
141137903200000,SE 201,Residential,15980,52918,0,68898
141137903300000,SE 201,Residential,22260,73266,0,95526
141137903400000,SE 201,Residential,16059,57178,0,73237
141137903500000,SE 201,Residential,16059,61324,0,77383
141137903600000,SE 201,Residential,16059,69681,0,85740
141137903700000,SE 201,Residential,16059,78483,0,94542
141137903800000,SE 201,Residential,19109,79098,0,98207
141137903900000,SE 201,Residential,13134,69844,0,82978
141137904000000,SE 201,Residential,13650,60778,0,74428
141137904100000,SE 201,Residential,13361,71234,0,84595
141137904200000,SE 201,Residential,15300,91887,0,107187
141138000100000,APTS SE,Commercial,35802,0,377905,413707
141138000200000,SE 201,Residential,17955,64165,0,82120
141138000300000,SE 201,Residential,17325,92725,0,110050
141138000400000,SE 201,Residential,11970,75870,0,87840
141138000500000,SE 201,Residential,20004,73944,0,93948
141138000600000,SE 201,Residential,14489,83724,0,98213
141138000700000,SE 201,Residential,14156,82916,0,97072
141138000800000,SE 201,Residential,14339,81073,0,95412
141138000900000,SE 201,Residential,18900,80100,0,99000
141138001000000,APTS SE,Commercial,13851,0,209386,223237
141138001100000,SE 201,Residential,15600,87010,0,102610
141138001200000,APTS SE,Commercial,38341,0,476659,515000
141138001300000,SE 201,Residential,22048,36950,0,58998
141138001400000,SE 201,Residential,20800,50912,0,71712
141138001500000,SE 201,Residential,20800,65696,0,86496
141138001601000,CONDO 500,Residential,2500,47933,0,50433
141138001601001,CONDO 500,Residential,2500,32050,0,34550
141138001601002,CONDO 500,Residential,2500,32050,0,34550
141138001601003,CONDO 500,Residential,2500,32050,0,34550
141138001601004,CONDO 500,Residential,2500,32050,0,34550
141138001601005,CONDO 500,Residential,2500,32050,0,34550
141138001601006,CONDO 500,Residential,2500,32050,0,34550
141138001601007,CONDO 500,Residential,2500,47933,0,50433
141138001601008,CONDO 500,Residential,2500,46090,0,48590
141138001601009,CONDO 500,Residential,2500,32351,0,34851
141138001601010,CONDO 500,Residential,2500,32050,0,34550
141138001601011,CONDO 500,Residential,2500,32351,0,34851
141138001601012,CONDO 500,Residential,2500,32050,0,34550
141138001601013,CONDO 500,Residential,2500,32351,0,34851
141138001601014,CONDO 500,Residential,2500,32050,0,34550
141138001601015,CONDO 500,Residential,2500,46090,0,48590
141138001601016,CONDO 500,Residential,2500,47933,0,50433
141138001601017,CONDO 500,Residential,2500,32351,0,34851
141138001601018,CONDO 500,Residential,2500,32050,0,34550
141138001601019,CONDO 500,Residential,2500,32351,0,34851
141138001601020,CONDO 500,Residential,2500,32050,0,34550
141138001601021,CONDO 500,Residential,2500,32351,0,34851
141138001601022,CONDO 500,Residential,2500,32050,0,34550
141138001601023,CONDO 500,Residential,2500,47933,0,50433
141138001601024,CONDO 500,Residential,2500,43551,0,46051
141138001601025,CONDO 500,Residential,2500,42847,0,45347
141138001601026,CONDO 500,Residential,2500,43551,0,46051
141138001601027,CONDO 500,Residential,2500,42847,0,45347
141138001601028,CONDO 500,Residential,2500,43551,0,46051
141138001601029,CONDO 500,Residential,2500,43551,0,46051
141138001601030,CONDO 500,Residential,2500,43551,0,46051
141138001601031,CONDO 500,Residential,2500,43551,0,46051
141138001601032,CONDO 500,Residential,2500,43551,0,46051
141138001601033,CONDO 500,Residential,2500,43551,0,46051
141138001601034,CONDO 500,Residential,2500,43551,0,46051
141138001601035,CONDO 500,Residential,2500,43551,0,46051
141138001700000,E-15 CITY,Exempt,0,0,0,0
141138001800000,E-15 CITY,Exempt,0,0,0,0
141138100100000,SE 201,Residential,11700,61142,0,72842
141138100200000,COMM SE,Commercial,55404,0,193363,248767
141138100300000,COMM SE,Commercial,30472,0,144367,174839
141138100400000,COMM SE,Commercial,49864,0,167500,217364
141138100500000,SE 201,Residential,10400,0,0,10400
141138100600000,COMM SE,Commercial,185760,0,575103,760863
141138100700000,COMM SE,Commercial,19699,0,92798,112497
141138100800000,COMM SE,Commercial,18733,0,51729,70462
141138100900000,APTS SE,Commercial,31436,0,268564,300000
141140200600000,SE 202,Residential,34578,242292,0,276870
141142601200000,Empty,Exempt,0,0,0,0
141142601300000,Empty,Exempt,0,0,0,0
141145100100000,SE 202,Residential,37638,64310,0,101948
141145100200000,SE 202,Residential,30240,46430,0,76670
141145100300000,SE 202,Residential,30000,82565,0,112565
141145100400000,SE 202,Residential,46390,167797,0,214187
141145100500000,SE 202,Residential,38812,113230,0,152042
141145100600000,SE 202,Residential,45575,119426,0,165001
141145100700000,SE 202,Residential,45393,146298,0,191691
141145100800000,SE 202,Residential,30895,92528,0,123423
141145100900000,SE 202,Residential,29499,90280,0,119779
141145101000000,SE 202,Residential,42322,136491,0,178813
141145101100000,SE 202,Residential,23310,101646,0,124956
141145101200000,SE 202,Residential,32400,111369,0,143769
141145200100000,Empty,Exempt,0,0,0,0
141145200200000,SE 202,Residential,35568,70478,0,106046
141145200300000,SE 202,Residential,25536,81088,0,106624
141145200400000,SE 202,Residential,25833,93759,0,119592
141145200700000,SE 202,Residential,15840,105116,0,120956
141145200800000,SE 202,Residential,25440,115350,0,140790
141145300100000,SE 202,Residential,39991,114384,0,154375
141145300500000,SE 202,Residential,20384,130280,0,150664
141145300600000,SE 202,Residential,19260,122648,0,141908
141145400100000,SE 202,Residential,16252,0,0,16252
141145400200000,SE 202,Residential,11880,59653,0,71533
141145500100000,SE 202,Residential,105200,199884,0,305084
141145500200000,SE 244,Residential,46404,431626,0,478030
141145500300000,SE 244,Residential,58114,329156,0,387270
141145500400000,SE 244,Residential,111751,298249,0,410000
141145500500000,SE 244,Residential,88574,393448,0,482022
141145500600000,SE 244,Residential,81735,388265,0,470000
141145500700000,SE 244,Residential,66202,312709,0,378911
141145500800000,SE 244,Residential,67952,306688,0,374640
141145600100000,SE 202,Residential,85902,122229,0,208131
141145700100000,SE 202,Residential,16800,0,0,16800
141145700200000,SE 202,Residential,23520,45883,0,69403
141145700300000,SE 202,Residential,16800,66841,0,83641
141145700400000,SE 202,Residential,31500,58636,0,90136
141145700500000,SE 202,Residential,25200,45973,0,71173
141145700600000,SE 202,Residential,17098,49192,0,66290
141145700700000,E-15 CITY,Exempt,0,0,0,0
141145700801000,CONDO 500,Residential,7000,71157,0,78157
141145700801001,CONDO 500,Residential,6000,63807,0,69807
141145700801002,CONDO 500,Residential,6000,63807,0,69807
141145700801003,CONDO 500,Residential,6000,63807,0,69807
141145700801004,CONDO 500,Residential,6000,64173,0,70173
141145700801005,CONDO 500,Residential,6000,64173,0,70173
141145700801006,CONDO 500,Residential,6000,64173,0,70173
141145700801007,CONDO 500,Residential,6000,64601,0,70601
141145700801008,CONDO 500,Residential,6000,63807,0,69807
141145700801009,CONDO 500,Residential,7000,73921,0,80921
141145700801010,CONDO 500,Residential,7000,71440,0,78440
141145700801011,CONDO 500,Residential,6000,64076,0,70076
141145700801012,CONDO 500,Residential,6000,64076,0,70076
141145700801013,CONDO 500,Residential,6000,64442,0,70442
141145700801014,CONDO 500,Residential,6000,64442,0,70442
141145700801015,CONDO 500,Residential,6000,64442,0,70442
141145700801016,CONDO 500,Residential,6000,64076,0,70076
141145700801017,CONDO 500,Residential,6000,64504,0,70504
141145700801018,CONDO 500,Residential,6000,64076,0,70076
141145700801019,CONDO 500,Residential,7000,73754,0,80754
141145700801020,CONDO 500,Residential,200,2902,0,3102
141145700801021,CONDO 500,Residential,200,2902,0,3102
141145700801022,CONDO 500,Residential,200,2902,0,3102
141145700801023,CONDO 500,Residential,200,2902,0,3102
141145700801024,CONDO 500,Residential,200,2902,0,3102
141145700801025,CONDO 500,Residential,200,2902,0,3102
141145700801026,CONDO 500,Residential,200,2902,0,3102
141145700801027,CONDO 500,Residential,200,2902,0,3102
141145700801028,CONDO 500,Residential,200,2902,0,3102
141145700801029,CONDO 500,Residential,200,2902,0,3102
141145700801030,CONDO 500,Residential,200,2902,0,3102
141145700801031,CONDO 500,Residential,200,2902,0,3102
141145700801032,CONDO 500,Residential,200,2902,0,3102
141145700801033,CONDO 500,Residential,200,2902,0,3102
141145700801034,CONDO 500,Residential,200,2902,0,3102
141145700801035,CONDO 500,Residential,200,2902,0,3102
141145700801036,CONDO 500,Residential,200,2902,0,3102
141145700801037,CONDO 500,Residential,200,2902,0,3102
141145700801038,CONDO 500,Residential,200,2902,0,3102
141145700801039,CONDO 500,Residential,200,2902,0,3102
141145700801040,CONDO 500,Residential,200,2902,0,3102
141145700801041,CONDO 500,Residential,200,2902,0,3102
141145700801042,CONDO 500,Residential,200,2902,0,3102
141145700801043,CONDO 500,Residential,200,3026,0,3226
141145700801044,CONDO 500,Residential,200,3026,0,3226
141147600100000,SE 202,Residential,6509,57778,0,64287
141147600200000,SE 202,Residential,24000,109621,0,133621
141147600300000,SE 202,Residential,24000,92849,0,116849
141147600400000,SE 202,Residential,24480,76537,0,101017
141147600500000,SE 202,Residential,24960,97698,0,122658
141147600600000,SE 202,Residential,24960,149539,0,174499
141147600700000,SE 202,Residential,30600,101905,0,132505
141147600800000,SE 202,Residential,3905,0,0,3905
141147600900000,SE 202,Residential,24000,69414,0,93414
141147700100000,SE 202,Residential,12000,107766,0,119766
141147700200000,SE 202,Residential,30600,113179,0,143779
141147700300000,SE 202,Residential,32148,140246,0,172394
141147700400000,SE 202,Residential,28080,182022,0,210102
141147700500000,SE 202,Residential,23712,222546,0,246258
141147700600000,SE 202,Residential,2033,3100,0,5133
141147800100000,SE 202,Residential,35139,166021,0,201160
141147800200000,SE 202,Residential,18000,79056,0,97056
141147800300000,SE 202,Residential,18000,81114,0,99114
141147800400000,SE 202,Residential,24000,89423,0,113423
141147800500000,SE 202,Residential,41730,121097,0,162827
141147800600000,Empty,Other,0,0,0,0
141147800700000,Empty,Other,0,0,0,0
141147800800000,Empty,Other,0,0,0,0
141147900100000,SE 202,Residential,27183,103395,0,130578
141147900200000,SE 202,Residential,15600,77234,0,92834
141147900300000,SE 202,Residential,15600,79872,0,95472
141147900400000,SE 202,Residential,24000,108984,0,132984
141147900500000,SE 202,Residential,16800,106009,0,122809
141147900600000,SE 202,Residential,16800,0,0,16800
141147900700000,SE 202,Residential,28341,57935,0,86276
141147900800000,SE 202,Residential,30994,120504,0,151498
141147900900000,SE 202,Residential,18624,62150,0,80774
141147901000000,SE 202,Residential,23280,125562,0,148842
141147901100000,SE 202,Residential,9894,0,0,9894
141147901200000,SE 202,Residential,19788,91820,0,111608
141147901300000,SE 202,Residential,5202,1460,0,6662
141147901400000,SE 202,Residential,24480,118246,0,142726
141147901500000,SE 202,Residential,34473,85423,0,119896
141147901600000,SE 202,Residential,16368,124026,0,140394
141147901700000,SE 202,Residential,21756,94269,0,116025
141147901800000,SE 202,Residential,25029,74382,0,99411
141147901900000,SE 202,Residential,20800,107949,0,128749
141147902000000,SE 202,Residential,16720,47500,0,64220
141147902100000,SE 202,Residential,15828,99860,0,115688
141147902200000,SE 202,Residential,7661,0,0,7661
141147902300000,SE 202,Residential,4219,0,0,4219
141147902400000,SE 202,Residential,8624,0,0,8624
141147902500000,SE 202,Residential,4402,0,0,4402
141147902600000,SE 202,Residential,8811,137258,0,146069
141147903000000,SE 202,Residential,8323,0,0,8323
141147903100000,SE 202,Residential,12441,0,0,12441
141147903200000,SE 202,Residential,16965,181070,0,198035
141147903400000,SE 202,Residential,3600,0,0,3600
141147903500000,SE 202,Residential,3600,0,0,3600
141147903600000,SE 202,Residential,23400,68953,0,92353
141147903700000,SE 202,Residential,23478,92652,0,116130
141148000100000,SE 202,Residential,28160,118352,0,146512
141148000200000,SE 202,Residential,51271,87744,0,139015
141148000300000,SE 202,Residential,39858,159687,0,199545
141148000400000,SE 202,Residential,24480,116361,0,140841
141148000500000,SE 202,Residential,15624,0,0,15624
141148000600000,SE 202,Residential,29012,92575,0,121587
141148100100000,SE 202,Residential,45650,68850,0,114500
141148100200000,SE 244,Residential,40220,0,0,40220
141148100300000,SE 244,Residential,100280,250720,0,351000
141148100400000,SE 244,Residential,46995,0,0,46995
141148100600000,SE 244,Residential,103520,445217,0,548737
141148100700000,SE 244,Residential,39196,0,0,39196
141148100800000,SE 244,Residential,31038,0,0,31038
141148100900000,SE 244,Residential,50797,1771,0,52568
141148101000000,SE 244,Residential,55345,401489,0,456834
141148101100000,SE 244,Residential,71214,317010,0,388224
141148101200000,SE 244,Residential,89081,406090,0,495171
141148101300000,SE 244,Residential,93685,351315,0,445000
141148101400000,SE 244,Residential,87664,390135,0,477799
141148101500000,SE 244,Residential,84047,285661,0,369708
141148101600000,SE 244,Residential,101214,367567,0,468781
141148101700000,SE 244,Residential,77195,258174,0,335369
141148101800000,SE 244,Residential,102566,492434,0,595000
141148101900000,SE 244,Residential,39220,301763,0,340983
141148102000000,SE 244,Residential,69370,409634,0,479004
141148102100000,SE 244,Residential,60452,313493,0,373945
141148102400000,SE 244,Residential,91260,364090,0,455350
141148102500000,SE 244,Residential,47950,0,0,47950
141148102600000,SE 244,Residential,45753,375120,0,420873
141235100600000,SE 202,Residential,34704,137665,0,172369
141235100800000,SE 202,Residential,28595,132079,0,160674
141235100900000,SE 202,Residential,27692,91172,0,118864
141235101000000,SE 202,Residential,43926,150025,0,193951
141235200600000,SE 202,Residential,42405,97595,0,140000
141235200700000,SE 202,Residential,42330,127112,0,169442
141235200800000,SE 202,Residential,53550,139828,0,193378
141235200900000,SE 202,Residential,74600,121635,0,196235
141235201000000,SE 202,Residential,59940,120515,0,180455
141322601500000,SE 202,Residential,159200,479371,0,638571
141322601600000,SE 202,Residential,152900,560373,0,713273
141330102100000,SE 211,Residential,100650,246312,0,346962
141332600900000,E-15 CITY,Exempt,0,0,0,0
141332601000000,E-40 CHURCHES,Exempt,389394,0,2161516,2550910
141332601100000,E-40 CHURCHES,Exempt,302400,0,1480333,1782733
141335100100000,SE 211,Residential,49000,0,0,49000
141335100200000,SE 211,Residential,48853,338831,0,387684
141335100300000,SE 211,Residential,51362,244689,0,296051
141335100400000,SE 211,Residential,65220,0,0,65220
141335100500000,SE 211,Residential,64770,434609,0,499379
141335100600000,SE 211,Residential,61958,0,0,61958
141335100700000,SE 211,Residential,48853,0,0,48853
141335100800000,SE 211,Residential,49000,235184,0,284184
141335100900000,SE 211,Residential,59042,165965,0,225007
141335101000000,SE 211,Residential,59051,192086,0,251137
141335101100000,E-40 CHURCHES,Exempt,139507,0,356359,495866
141335101600000,SE 211,Residential,105150,206404,0,311554
141335101800000,SE 211,Residential,99850,364317,0,464167
141335101900000,SE 211,Residential,62417,238779,0,301196
141335102000000,SE 211,Residential,145907,260800,0,406707
141335102100000,SE 211,Residential,137679,429051,0,566730
141335102200000,SE 211,Residential,141680,317363,0,459043
141335102300000,SE 211,Residential,145288,402193,0,547481
141335102400000,SE 211,Residential,136447,352118,0,488565
141335102500000,SE 211,Residential,141824,168176,0,310000
141335200100000,SE 211,Residential,55400,165913,0,221313
141335200400000,SE 211,Residential,55400,181585,0,236985
141335200500000,SE 211,Residential,58717,162783,0,221500
141335200600000,SE 211,Residential,51400,151681,0,203081
141335200700000,SE 211,Residential,59400,167470,0,226870
141337600100000,SE 210,Residential,131200,365655,0,496855
141337600200000,SE 210,Residential,100800,76115,0,176915
141337600300000,SE 210,Residential,101500,46965,0,148465
141337600500000,SE 210,Residential,198600,622875,0,821475
141337600600000,SE 210,Residential,191800,508232,0,700032
141337600700000,SE 210,Residential,192900,639783,0,832683
141337601000000,SE 210,Residential,39235,213342,0,252577
141337601100000,SE 210,Residential,38528,229689,0,268217
141337601200000,SE 210,Residential,40637,206173,0,246810
141337601300000,SE 210,Residential,42299,221818,0,264117
141337601400000,SE 210,Residential,43353,209036,0,252389
141337601500000,SE 210,Residential,44965,230317,0,275282
141337601600000,SE 210,Residential,39350,177947,0,217297
141337601700000,SE 210,Residential,43697,264599,0,308296
141337601800000,SE 210,Residential,45711,231112,0,276823
141337601900000,SE 210,Residential,40534,231778,0,272312
141337602000000,E-15 CITY,Exempt,0,0,0,0
141337602100000,E-15 CITY,Exempt,0,0,0,0
141337700100000,SE 210,Residential,37892,190480,0,228372
141337700200000,SE 210,Residential,35998,195949,0,231947
141337700300000,SE 210,Residential,35864,188313,0,224177
141337700400000,SE 210,Residential,38745,213604,0,252349
141337700500000,SE 210,Residential,41944,179188,0,221132
141337700600000,SE 210,Residential,44356,236195,0,280551
141340100300000,SE 244,Residential,5900,0,0,5900
141340200300000,SE 209,Residential,94870,217616,0,312486
141340200400000,SE 209,Residential,94420,347539,0,441959
141345100100000,SE 209,Residential,58077,154168,0,212245
141345100200000,SE 209,Residential,59430,176393,0,235823
141345100300000,SE 209,Residential,81515,167372,0,248887
141345100500000,SE 209,Residential,84567,175999,0,260566
141345100600000,SE 209,Residential,90050,150263,0,240313
141345100700000,SE 209,Residential,84908,156550,0,241458
141345100800000,SE 209,Residential,56500,146582,0,203082
141345100900000,SE 209,Residential,56500,166494,0,222994
141345101000000,SE 209,Residential,56500,137723,0,194223
141345101100000,SE 209,Residential,48000,130431,0,178431
141345101200000,SE 209,Residential,48000,152097,0,200097
141345101300000,SE 209,Residential,54500,141713,0,196213
141345200100000,SE 209,Residential,45281,175909,0,221190
141345200200000,SE 209,Residential,42000,159618,0,201618
141345200300000,SE 209,Residential,42000,152671,0,194671
141345200400000,SE 209,Residential,42500,185794,0,228294
141345200500000,SE 209,Residential,40500,125516,0,166016
141345200600000,SE 209,Residential,40000,117749,0,157749
141345200700000,SE 209,Residential,40000,132112,0,172112
141345200800000,SE 209,Residential,44467,111680,0,156147
141345300100000,SE 209,Residential,62900,242053,0,304953
141345300200000,SE 209,Residential,82694,212189,0,294883
141345300300000,SE 209,Residential,65120,183014,0,248134
141345300400000,SE 209,Residential,67833,153398,0,221231
141345300500000,SE 209,Residential,64302,133417,0,197719
141345300600000,SE 209,Residential,65625,179358,0,244983
141345300700000,SE 209,Residential,67678,193045,0,260723
141345300800000,SE 209,Residential,63600,157964,0,221564
141345300900000,SE 209,Residential,64474,191819,0,256293
141345301000000,SE 209,Residential,61997,145620,0,207617
141345301100000,SE 209,Residential,49853,176339,0,226192
141345301200000,SE 209,Residential,52155,170199,0,222354
141345301300000,SE 209,Residential,37270,205728,0,242998
141345301400000,SE 209,Residential,42004,159447,0,201451
141345301500000,SE 209,Residential,42676,207903,0,250579
141345301600000,SE 209,Residential,41638,177605,0,219243
141345301700000,SE 209,Residential,43426,146926,0,190352
141345301800000,SE 209,Residential,42613,135681,0,178294
141345301900000,SE 209,Residential,45210,212227,0,257437
141345302000000,SE 209,Residential,45450,175034,0,220484
141345302100000,SE 209,Residential,41034,140609,0,181643
141345302200000,SE 209,Residential,38962,139666,0,178628
141345302300000,SE 209,Residential,38950,189594,0,228544
141345302400000,SE 209,Residential,42450,152416,0,194866
141345302500000,SE 209,Residential,48925,167047,0,215972
141345302600000,SE 209,Residential,38442,160174,0,198616
141345302700000,SE 209,Residential,39527,128793,0,168320
141345302800000,SE 209,Residential,41410,157548,0,198958
141345302900000,SE 209,Residential,41650,162098,0,203748
141345303000000,SE 209,Residential,43262,141626,0,184888
141345303100000,SE 209,Residential,41000,181142,0,222142
141345303200000,SE 209,Residential,45933,187495,0,233428
141345303300000,SE 209,Residential,49300,203964,0,253264
141345303400000,SE 209,Residential,44083,178580,0,222663
141345303500000,SE 209,Residential,58672,213147,0,271819
141345303600000,SE 209,Residential,56990,190442,0,247432
141345303700000,SE 209,Residential,59274,214263,0,273537
141345400100000,E-15 CITY,Exempt,0,0,0,0
141347700100000,SE 209,Residential,88767,205415,0,294182
141347700200000,SE 209,Residential,81822,231184,0,313006
141347700300000,SE 209,Residential,90000,89052,0,179052
141347700400000,SE 209,Residential,91300,120111,0,211411
141347700500000,SE 209,Residential,90800,152162,0,242962
141347700600000,SE 209,Residential,84612,153185,0,237797
141347700700000,SE 209,Residential,58036,172957,0,230993
141347700800000,SE 209,Residential,90005,204760,0,294765
141347700900000,SE 209,Residential,90050,138325,0,228375
141347701000000,SE 209,Residential,90800,167721,0,258521
141347701100000,SE 209,Residential,91050,210829,0,301879
141347701200000,SE 209,Residential,73445,133079,0,206524
141347701300000,SE 209,Residential,68413,135006,0,203419
141347701400000,SE 209,Residential,61414,149085,0,210499
141347701500000,SE 209,Residential,68425,170594,0,239019
141347701600000,SE 209,Residential,82331,113677,0,196008
141347701700000,SE 209,Residential,90150,139542,0,229692
141347701800000,SE 209,Residential,90400,200668,0,291068
141347701900000,SE 209,Residential,96350,259305,0,355655
141347702000000,SE 209,Residential,54385,116821,0,171206
141347800100000,SE 209,Residential,90250,169774,0,260024
141347800200000,SE 209,Residential,86254,188746,0,275000
141347800300000,SE 209,Residential,90050,200144,0,290194
141347800400000,SE 209,Residential,61050,217420,0,278470
141347800500000,SE 209,Residential,55981,218555,0,274536
141410100100000,COMM SE,Commercial,1352095,0,3968010,5320105
141420100100000,E-15 CITY,Exempt,0,0,0,0
141420100200000,E-15 CITY,Exempt,0,0,0,0
141420100300000,SE 201,Residential,24603,75546,0,100149
141420100400000,SE 201,Residential,30282,89185,0,119467
141420100500000,SE 201,Residential,26265,83460,0,109725
141420100600000,SE 201,Residential,20600,60337,0,80937
141420100700000,SE 201,Residential,20600,143031,0,163631
141420100800000,APTS NE,Commercial,13182,0,106774,119956
141420100900000,SE 201,Residential,22400,112076,0,134476
141420101000000,SE 201,Residential,30000,94342,0,124342
141420101100000,SE 201,Residential,33250,117423,0,150673
141420101200000,SE 201,Residential,27500,67989,0,95489
141420101300000,SE 201,Residential,31725,98236,0,129961
141420101400000,SE 201,Residential,37879,148828,0,186707
141420200100000,SE 201,Residential,12114,81211,0,93325
141420200200000,APTS SE,Commercial,49680,0,886044,935724
141420200300000,APTS SE,Commercial,43047,0,456953,500000
141420200400000,SE 201,Residential,20000,104875,0,124875
141420200500000,SE 201,Residential,23520,78565,0,102085
141420200600000,SE 201,Residential,23520,65155,0,88675
141420200700000,APTS SE,Commercial,33696,0,590304,624000
141420200800000,SE 201,Residential,20000,126591,0,146591
141420200900000,SE 201,Residential,23840,117054,0,140894
141420201000000,SE 201,Residential,17800,82509,0,100309
141420201100000,SE 201,Residential,13400,82504,0,95904
141420300100000,COMM SE,Commercial,2743,0,0,2743
141420300200000,SE 203,Residential,148500,622141,0,770641
141420300300000,SE 201,Residential,31798,139402,0,171200
141420300400000,SE 201,Residential,24250,110418,0,134668
141420300500000,SE 201,Residential,25500,113133,0,138633
141420300600000,SE 201,Residential,23460,122060,0,145520
141420300700000,CONVERSIONS,Commercial,15282,0,50481,65763
141420300800000,SE 201,Residential,20400,106838,0,127238
141420300900000,SE 201,Residential,21278,95516,0,116794
141420301000000,SE 201,Residential,26873,93799,0,120672
141420301100000,SE 201,Residential,29154,74730,0,103884
141420301200000,SE 201,Residential,22644,145068,0,167712
141420301300000,SE 201,Residential,16072,124920,0,140992
141420301400000,SE 201,Residential,15680,106699,0,122379
141420301500000,SE 201,Residential,15680,123936,0,139616
141420301600000,SE 201,Residential,23912,142393,0,166305
141420301700000,SE 201,Residential,23912,66345,0,90257
141420301800000,SE 201,Residential,19600,92811,0,112411
141420301900000,SE 201,Residential,20384,122851,0,143235
141420302000000,SE 201,Residential,16072,80484,0,96556
141420302100000,SE 201,Residential,15680,85788,0,101468
141420302200000,SE 201,Residential,32548,119564,0,152112
141420302300000,SE 201,Residential,21702,76450,0,98152
141420302400000,SE 203,Residential,66960,151084,0,218044
141420302500000,SE 203,Residential,75888,189492,0,265380
141420302600000,SE 203,Residential,95100,289357,0,384457
141420302700000,SE 203,Residential,131100,247900,0,379000
141420302800000,SE 203,Residential,139300,538456,0,677756
141420400100000,SE 203,Residential,65025,127446,0,192471
141420400200000,SE 203,Residential,41580,83401,0,124981
141420400300000,SE 203,Residential,51540,0,0,51540
141420400400000,SE 203,Residential,44520,136004,0,180524
141420400500000,SE 203,Residential,42000,129244,0,171244
141420400600000,SE 203,Residential,33120,151910,0,185030
141420400700000,SE 203,Residential,73842,130878,0,204720
141420400800000,SE 203,Residential,55965,147258,0,203223
141420400900000,SE 203,Residential,54203,120454,0,174657
141420401000000,SE 203,Residential,51675,128990,0,180665
141420401100000,SE 203,Residential,51675,122391,0,174066
141420401200000,SE 203,Residential,52163,113610,0,165773
141420401300000,SE 203,Residential,51188,109612,0,160800
141420401400000,SE 203,Residential,61100,136345,0,197445
141420401500000,SE 203,Residential,60435,126104,0,186539
141420500100000,SE 203,Residential,44980,100949,0,145929
141420500200000,SE 203,Residential,46375,124661,0,171036
141420500300000,SE 203,Residential,49050,96671,0,145721
141420500400000,SE 203,Residential,49500,147984,0,197484
141420500500000,SE 203,Residential,46350,92525,0,138875
141420500600000,SE 203,Residential,47424,94780,0,142204
141420500700000,SE 203,Residential,29963,98836,0,128799
141420500800000,SE 203,Residential,30260,91625,0,121885
141420500900000,SE 203,Residential,22440,90460,0,112900
141420501000000,SE 203,Residential,22440,83877,0,106317
141422600100000,COMM SE,Commercial,39739,0,7258,46997
141422600200000,COMM SE,Commercial,78246,0,15445,93691
141422600300000,COMM SE,Commercial,430920,0,717930,1148850
141422600400000,COMM SE,Commercial,140616,0,24930,165546
141422600500000,SE 201,Residential,26160,96109,0,122269
141422600600000,COMM SE,Commercial,12474,0,3312,15786
141422700100000,COMM NE,Commercial,203634,0,220602,424236
141422700200000,COMM NE,Commercial,13738,0,1832,15570
141422700300000,COMM NE,Commercial,11081,0,54006,65087
141422700400000,COMM NE,Commercial,17788,0,0,17788
141422700700000,APTS NE,Commercial,34398,0,500797,535195
141422700800000,COMM NE,Commercial,391500,0,2092779,2484279
141422700900000,COMM NE,Commercial,190350,0,591704,782054
141422701000000,COMM NE,Commercial,410400,0,839600,1250000
141422701100000,NE 141,Residential,15792,62059,0,77851
141422701200000,NE 141,Residential,18432,66792,0,85224
141422701300000,NE 141,Residential,31752,89990,0,121742
141422701400000,COMM NE,Commercial,25272,0,133933,159205
141422701500000,COMM NE,Commercial,52920,0,3419,56339
141422701600000,COMM NE,Commercial,58590,0,123655,182245
141422701700000,COMM NE,Commercial,48600,0,135663,184263
141422701800000,COMM NE,Commercial,121500,0,83522,205022
141422800200000,NE 141,Residential,31200,101284,0,132484
141422800300000,NE 141,Residential,31200,57662,0,88862
141422800400000,NE 141,Residential,31200,77706,0,108906
141422800500000,NE 141,Residential,31200,114690,0,145890
141422800600000,NE 141,Residential,31200,74041,0,105241
141422800700000,NE 141,Residential,31200,70130,0,101330
141422800800000,NE 141,Residential,31200,95204,0,126404
141422800900000,NE 141,Residential,31200,92800,0,124000
141422801000000,NE 141,Residential,30900,61876,0,92776
141422801100000,NE 141,Residential,30900,68680,0,99580
141422801200000,NE 141,Residential,30900,60672,0,91572
141422801300000,NE 141,Residential,29664,42739,0,72403
141422801400000,NE 141,Residential,30282,81404,0,111686
141422801500000,NE 141,Residential,30194,67772,0,97966
141422801600000,NE 141,Residential,25650,60615,0,86265
141422801700000,NE 141,Residential,30323,79777,0,110100
141422801800000,APTS NE,Commercial,11820,0,112999,124819
141422801900000,NE 141,Residential,36239,75924,0,112163
141422802000000,COMM NE,Commercial,46537,0,163463,210000
141422802200000,APTS NE,Commercial,21870,0,109286,131156
141422802300000,APTS NE,Commercial,25920,0,125782,151702
141422802400000,APTS NE,Commercial,25920,0,397803,423723
141422802500000,APTS NE,Commercial,25920,0,230448,256368
141422802601000,COMM NE,Commercial,77760,0,332476,410236
141422802601001,COMM NE,Commercial,77760,0,340132,417892
141422802701000,CONDO 500,Residential,3600,34115,0,37715
141422802701001,CONDO 500,Residential,3600,34115,0,37715
141422802701002,CONDO 500,Residential,3600,34115,0,37715
141422802701003,CONDO 500,Residential,3600,34115,0,37715
141422802701004,CONDO 500,Residential,3600,34115,0,37715
141422802701005,CONDO 500,Residential,3600,34115,0,37715
141422802701006,CONDO 500,Residential,3600,34115,0,37715
141422802701007,CONDO 500,Residential,3600,34115,0,37715
141422802701008,CONDO 500,Residential,3600,34115,0,37715
141422802701009,CONDO 500,Residential,3600,34115,0,37715
141422802701010,CONDO 500,Residential,3600,34115,0,37715
141422802701011,CONDO 500,Residential,3600,34115,0,37715
141422802701012,CONDO 500,Residential,3600,34115,0,37715
141422802701013,CONDO 500,Residential,3600,34115,0,37715
141422802701014,CONDO 500,Residential,3600,34115,0,37715
141422802701015,CONDO 500,Residential,3600,34115,0,37715
141422802701016,CONDO 500,Residential,3600,34115,0,37715
141422802701017,CONDO 500,Residential,3600,34115,0,37715
141422802701018,CONDO 500,Residential,3600,34115,0,37715
141422802701019,CONDO 500,Residential,3600,34115,0,37715
141422802701020,CONDO 500,Residential,3600,34115,0,37715
141422802701021,CONDO 500,Residential,3600,34115,0,37715
141422802701022,CONDO 500,Residential,3600,34115,0,37715
141422802701023,CONDO 500,Residential,3600,34115,0,37715
141422900100000,SE 201,Residential,24024,97618,0,121642
141422900200000,SE 201,Residential,11088,73758,0,84846
141422900300000,SE 201,Residential,19404,64394,0,83798
141422900400000,COMM SE,Commercial,128045,0,245029,373074
141422900700000,COMM SE,Commercial,220320,0,134680,355000
141422900900000,SE 201,Residential,10080,69745,0,79825
141422901000000,SE 201,Residential,10080,0,0,10080
141422901100000,SE 201,Residential,6405,0,0,6405
141422901200000,SE 201,Residential,8685,0,0,8685
141422901300000,SE 201,Residential,18643,85660,0,104303
141422901400000,SE 201,Residential,17600,97203,0,114803
141422901500000,SE 201,Residential,17600,81326,0,98926
141422901600000,SE 201,Residential,22400,81678,0,104078
141422901700000,COMM SE,Commercial,143100,0,405245,548345
141422901800000,COMM SE,Commercial,205200,0,363967,569167
141422901900000,COMM SE,Commercial,77760,0,6255,84015
141423000100000,SE 204,Residential,7350,65425,0,72775
141423000200000,SE 204,Residential,7350,55466,0,62816
141423000300000,SE 204,Residential,6300,41579,0,47879
141423000400000,SE 204,Residential,8400,63055,0,71455
141423000500000,SE 204,Residential,12669,57955,0,70624
141423000600000,SE 204,Residential,7933,69527,0,77460
141423000700000,SE 204,Residential,14592,58250,0,72842
141423000800000,SE 204,Residential,16168,66397,0,82565
141423000900000,SE 204,Residential,21320,86320,0,107640
141423001000000,SE 204,Residential,22200,44288,0,66488
141423001100000,SE 204,Residential,26272,85558,0,111830
141423001200000,SE 204,Residential,24000,80008,0,104008
141423001300000,SE 204,Residential,24000,99348,0,123348
141423001400000,SE 204,Residential,14880,82856,0,97736
141423001500000,SE 204,Residential,24000,108780,0,132780
141423001600000,SE 204,Residential,320,0,0,320
141423001700000,SE 204,Residential,12000,25098,0,37098
141423001800000,SE 204,Residential,16000,64795,0,80795
141423100200000,NE 154,Residential,22618,65288,0,87906
141423100300000,NE 154,Residential,20592,87970,0,108562
141423100400000,NE 154,Residential,20377,74402,0,94779
141423100500000,NE 154,Residential,27288,71558,0,98846
141423100600000,NE 154,Residential,23760,72948,0,96708
141423100700000,NE 154,Residential,23760,71217,0,94977
141423100800000,NE 154,Residential,23760,101563,0,125323
141423100900000,NE 154,Residential,23760,91804,0,115564
141423101000000,NE 154,Residential,23760,90606,0,114366
141423101100000,NE 154,Residential,20400,91816,0,112216
141423101200000,NE 154,Residential,20400,61744,0,82144
141423101300000,CONVERSIONS,Commercial,12312,0,90586,102898
141423101400000,COMM NE,Commercial,99462,0,99020,198482
141423200100000,NE 154,Residential,30672,76478,0,107150
141423200200000,NE 154,Residential,15246,68091,0,83337
141423200300000,NE 154,Residential,14640,66483,0,81123
141423200400000,NE 154,Residential,32640,98124,0,130764
141423200500000,NE 154,Residential,31533,80532,0,112065
141423200600000,NE 154,Residential,30600,83567,0,114167
141423200700000,NE 154,Residential,30600,98623,0,129223
141423200800000,NE 154,Residential,30600,81963,0,112563
141423200900000,NE 154,Residential,30600,77625,0,108225
141423201000000,NE 154,Residential,30600,96160,0,126760
141423201100000,NE 154,Residential,30600,104072,0,134672
141423201200000,NE 154,Residential,30600,119646,0,150246
141423201300000,NE 154,Residential,30600,108206,0,138806
141423201400000,NE 154,Residential,30600,112249,0,142849
141423201500000,NE 154,Residential,30600,105500,0,136100
141425100100000,SE 204,Residential,18240,91347,0,109587
141425100200000,SE 204,Residential,20400,79703,0,100103
141425100300000,SE 204,Residential,14880,57092,0,71972
141425100400000,SE 204,Residential,19920,82807,0,102727
141425200100000,NE 154,Residential,20400,108727,0,129127
141425200200000,NE 154,Residential,23760,82368,0,106128
141425200300000,NE 154,Residential,23760,75905,0,99665
141425200400000,NE 154,Residential,23760,91143,0,114903
141425200500000,NE 154,Residential,23760,88874,0,112634
141425200600000,NE 154,Residential,23950,70329,0,94279
141425200700000,NE 154,Residential,23950,130330,0,154280
141425200800000,NE 154,Residential,23760,96608,0,120368
141425200900000,NE 154,Residential,23950,98313,0,122263
141425201000000,NE 154,Residential,26872,111916,0,138788
141425201100000,NE 154,Residential,27015,104944,0,131959
141425201200000,NE 154,Residential,23760,71502,0,95262
141425201300000,NE 154,Residential,23760,83721,0,107481
141425201400000,NE 154,Residential,23760,69964,0,93724
141425201500000,NE 154,Residential,23760,106052,0,129812
141425201600000,NE 154,Residential,25200,79834,0,105034
141425201700000,NE 154,Residential,26242,100110,0,126352
141425201800000,NE 154,Residential,16560,90459,0,107019
141425201900000,NE 154,Residential,23268,89484,0,112752
141425202000000,NE 154,Residential,10389,83330,0,93719
141425202100000,NE 154,Residential,14304,94273,0,108577
141425202200000,NE 154,Residential,20400,121779,0,142179
141425202300000,NE 154,Residential,20400,112900,0,133300
141425202400000,NE 154,Residential,20400,108812,0,129212
141425202500000,NE 154,Residential,20400,93396,0,113796
141425202600000,NE 154,Residential,24480,91092,0,115572
141425202700000,NE 154,Residential,16320,66777,0,83097
141425202800000,NE 154,Residential,20547,144896,0,165443
141425202900000,NE 154,Residential,20547,123878,0,144425
141425203000000,NE 154,Residential,20400,113277,0,133677
141425203100000,NE 154,Residential,20400,77649,0,98049
141425203200000,NE 154,Residential,20400,90193,0,110593
141425300100000,NE 154,Residential,24480,111804,0,136284
141425300200000,NE 154,Residential,30600,84440,0,115040
141425300300000,NE 154,Residential,30600,83652,0,114252
141425300400000,NE 154,Residential,30600,73143,0,103743
141425300500000,NE 154,Residential,30600,68060,0,98660
141425300600000,NE 154,Residential,30600,101177,0,131777
141425300700000,NE 154,Residential,30600,107913,0,138513
141425300800000,NE 154,Residential,30600,104012,0,134612
141425300900000,NE 154,Residential,30600,93064,0,123664
141425301000000,NE 154,Residential,30600,90991,0,121591
141425301100000,NE 154,Residential,15840,64796,0,80636
141425301200000,NE 154,Residential,16080,68628,0,84708
141425301300000,NE 154,Residential,28773,98402,0,127175
141425301400000,NE 154,Residential,24480,86970,0,111450
141425301500000,NE 154,Residential,24480,106069,0,130549
141425301600000,NE 154,Residential,24480,78381,0,102861
141425301700000,NE 154,Residential,24480,81375,0,105855
141425301800000,NE 154,Residential,24480,70238,0,94718
141425301900000,NE 154,Residential,24480,83736,0,108216
141425302000000,NE 154,Residential,24480,83535,0,108015
141425302100000,NE 154,Residential,24480,79540,0,104020
141425302200000,NE 154,Residential,24480,93717,0,118197
141425302300000,NE 154,Residential,24480,111494,0,135974
141425302400000,NE 154,Residential,24480,66936,0,91416
141425302500000,NE 154,Residential,24480,92320,0,116800
141425400100000,SE 204,Residential,19200,115371,0,134571
141425400200000,SE 204,Residential,24000,83831,0,107831
141425400300000,SE 204,Residential,24000,111619,0,135619
141425400400000,SE 204,Residential,28000,102259,0,130259
141425400500000,SE 204,Residential,20000,102214,0,122214
141425400600000,SE 204,Residential,18000,83864,0,101864
141425400700000,SE 204,Residential,15580,48167,0,63747
141425400800000,SE 204,Residential,15800,41712,0,57512
141425400900000,SE 204,Residential,19403,60748,0,80151
141425401000000,SE 204,Residential,19600,78402,0,98002
141425401100000,SE 204,Residential,23520,56210,0,79730
141425401200000,SE 204,Residential,30000,67779,0,97779
141425401300000,SE 204,Residential,30000,68295,0,98295
141425401400000,SE 204,Residential,30000,80060,0,110060
141425401500000,SE 204,Residential,30000,92229,0,122229
141425401600000,SE 204,Residential,30000,73181,0,103181
141425401700000,SE 204,Residential,20000,67132,0,87132
141425401800000,SE 204,Residential,32000,77817,0,109817
141425401900000,SE 204,Residential,17050,74619,0,91669
141425500100000,SE 204,Residential,30000,112876,0,142876
141425500200000,SE 204,Residential,30000,122593,0,152593
141425500300000,SE 204,Residential,15000,89111,0,104111
141425500400000,SE 204,Residential,15000,59164,0,74164
141425500500000,SE 204,Residential,30000,65502,0,95502
141425500600000,SE 204,Residential,30000,73362,0,103362
141425500700000,SE 204,Residential,30000,106592,0,136592
141425500800000,SE 204,Residential,32000,102420,0,134420
141425500900000,SE 204,Residential,20000,54612,0,74612
141425501000000,SE 204,Residential,16512,82691,0,99203
141425501100000,SE 204,Residential,16093,71341,0,87434
141425501200000,SE 204,Residential,14075,47076,0,61151
141425501300000,SE 204,Residential,13440,63176,0,76616
141425501400000,SE 204,Residential,14615,67470,0,82085
141425501500000,SE 204,Residential,16104,72228,0,88332
141425501600000,SE 204,Residential,30000,78165,0,108165
141425501700000,SE 204,Residential,30000,82397,0,112397
141425501800000,SE 204,Residential,30000,85137,0,115137
141425501900000,SE 204,Residential,30000,86503,0,116503
141425502000000,SE 204,Residential,30000,89839,0,119839
141425502100000,SE 204,Residential,30000,95401,0,125401
141425502200000,SE 204,Residential,30000,76729,0,106729
141425502300000,SE 204,Residential,20000,37780,0,57780
141425502400000,SE 204,Residential,20000,54623,0,74623
141425502500000,SE 204,Residential,20000,73415,0,93415
141425600100000,SE 204,Residential,20000,61618,0,81618
141425600200000,SE 204,Residential,20000,85803,0,105803
141425600300000,SE 204,Residential,20000,27859,0,47859
141425600400000,SE 204,Residential,30000,79011,0,109011
141425600500000,SE 204,Residential,30000,85708,0,115708
141425600600000,SE 204,Residential,31500,132541,0,164041
141425600700000,SE 204,Residential,25000,73521,0,98521
141425600800000,SE 204,Residential,30000,77354,0,107354
141425600900000,SE 204,Residential,30000,75125,0,105125
141425601000000,SE 204,Residential,30000,43260,0,73260
141425601100000,SE 204,Residential,25000,105638,0,130638
141425601200000,SE 204,Residential,23965,104975,0,128940
141425601300000,SE 204,Residential,14551,67285,0,81836
141425601400000,SE 204,Residential,13184,42795,0,55979
141425601500000,SE 204,Residential,19240,61893,0,81133
141425601600000,SE 204,Residential,22185,99715,0,121900
141425601700000,SE 204,Residential,22500,80884,0,103384
141425601800000,SE 204,Residential,22500,87284,0,109784
141425601900000,SE 204,Residential,22500,126279,0,148779
141425602000000,SE 204,Residential,25000,88789,0,113789
141425602100000,SE 204,Residential,27500,92683,0,120183
141425602200000,SE 204,Residential,30000,81091,0,111091
141425602300000,SE 204,Residential,30000,123718,0,153718
141425602400000,SE 204,Residential,31025,77147,0,108172
141425602500000,SE 204,Residential,23500,105820,0,129320
141425602600000,SE 204,Residential,22500,94183,0,116683
141425602700000,SE 204,Residential,22500,85739,0,108239
141425602800000,SE 204,Residential,22500,93652,0,116152
141425602900000,SE 204,Residential,22500,93335,0,115835
141425700600000,E-40 CHURCHES,Exempt,727488,0,2857355,3584843
141425800100000,NE 154,Residential,22848,108708,0,131556
141425800200000,NE 154,Residential,15840,62983,0,78823
141425800300000,NE 154,Residential,19800,60423,0,80223
141425800400000,NE 154,Residential,24480,81189,0,105669
141425800500000,NE 154,Residential,24480,96382,0,120862
141425800600000,NE 154,Residential,24480,76277,0,100757
141425800700000,NE 154,Residential,24480,123532,0,148012
141425800800000,NE 154,Residential,24480,92793,0,117273
141425800900000,NE 154,Residential,24480,63535,0,88015
141427600100000,SE 203,Residential,63345,176308,0,239653
141427700100000,SE 203,Residential,40915,134577,0,175492
141427700200000,SE 203,Residential,43350,107557,0,150907
141427700300000,SE 203,Residential,79891,171072,0,250963
141427700400000,SE 203,Residential,40400,75954,0,116354
141427700500000,SE 203,Residential,39600,88761,0,128361
141427700600000,SE 203,Residential,39847,122743,0,162590
141427700700000,SE 203,Residential,39600,106429,0,146029
141427700800000,SE 203,Residential,40800,101097,0,141897
141427700900000,SE 203,Residential,44693,201605,0,246298
141427701000000,SE 203,Residential,43500,138132,0,181632
141427701100000,SE 203,Residential,44188,141089,0,185277
141427701200000,SE 203,Residential,44115,129952,0,174067
141427701300000,SE 203,Residential,44548,141751,0,186299
141427701400000,SE 203,Residential,20,0,0,20
141427800100000,SE 203,Residential,55900,127105,0,183005
141427800200000,SE 203,Residential,52593,106665,0,159258
141427800300000,SE 203,Residential,49350,134422,0,183772
141427800400000,SE 203,Residential,49899,130915,0,180814
141427800500000,SE 203,Residential,54625,119495,0,174120
141427800600000,SE 203,Residential,56745,158963,0,215708
141427800700000,SE 203,Residential,59045,153425,0,212470
141427800800000,SE 203,Residential,62258,164319,0,226577
141427800900000,SE 203,Residential,65178,229281,0,294459
141427801000000,SE 203,Residential,56375,168070,0,224445
141427801100000,SE 203,Residential,56325,135139,0,191464
141427801200000,SE 203,Residential,56250,192924,0,249174
141427801300000,SE 203,Residential,56250,144792,0,201042
141427801400000,SE 203,Residential,56250,209269,0,265519
141427801500000,SE 203,Residential,56250,116796,0,173046
141427900100000,SE 203,Residential,54270,147175,0,201445
141427900200000,SE 203,Residential,61155,153779,0,214934
141427900300000,SE 203,Residential,41160,163531,0,204691
141427900400000,SE 203,Residential,40800,109154,0,149954
141427900500000,SE 203,Residential,40824,146317,0,187141
141427900600000,SE 203,Residential,40776,155266,0,196042
141427900700000,SE 203,Residential,36960,118749,0,155709
141427900800000,SE 203,Residential,38800,106060,0,144860
141427900900000,SE 203,Residential,38160,116232,0,154392
141427901000000,SE 203,Residential,41400,101647,0,143047
141427901100000,SE 203,Residential,49339,113293,0,162632
141427901200000,SE 203,Residential,40740,123381,0,164121
141427901300000,SE 203,Residential,39950,116876,0,156826
141427901400000,SE 203,Residential,46313,96895,0,143208
141427901500000,SE 203,Residential,46800,108150,0,154950
141427901600000,SE 203,Residential,47288,171046,0,218334
141427901700000,SE 203,Residential,45293,69307,0,114600
141427901800000,SE 203,Residential,44625,87190,0,131815
141427901900000,SE 203,Residential,45063,86076,0,131139
141427902000000,SE 203,Residential,45500,91319,0,136819
141427902100000,SE 203,Residential,45938,113160,0,159098
141427902200000,SE 203,Residential,46375,92354,0,138729
141427902300000,SE 203,Residential,46375,131191,0,177566
141428000100000,SE 203,Residential,75153,225533,0,300686
141428000200000,SE 203,Residential,51752,223329,0,275081
141428000300000,SE 203,Residential,52475,119953,0,172428
141428000400000,SE 203,Residential,52500,101687,0,154187
141428000500000,SE 203,Residential,51200,167526,0,218726
141428000600000,SE 203,Residential,53700,208288,0,261988
141428000700000,SE 203,Residential,78712,237074,0,315786
141428000800000,SE 203,Residential,84084,190225,0,274309
141428000900000,SE 203,Residential,84262,181479,0,265741
141428100100000,SE 203,Residential,51700,123299,0,174999
141428100200000,SE 203,Residential,43165,109989,0,153154
141428100300000,SE 203,Residential,39525,97938,0,137463
141428100400000,SE 203,Residential,38827,83878,0,122705
141428100500000,SE 203,Residential,39013,109502,0,148515
141428100600000,SE 203,Residential,36895,93745,0,130640
141428100700000,SE 203,Residential,38465,100243,0,138708
141428100800000,SE 203,Residential,37588,100110,0,137698
141428100900000,SE 203,Residential,33120,99513,0,132633
141428101000000,SE 203,Residential,32305,124475,0,156780
141428101100000,SE 203,Residential,32660,85641,0,118301
141428101200000,SE 203,Residential,36720,134774,0,171494
141428101300000,SE 203,Residential,23650,103124,0,126774
141428101400000,SE 203,Residential,25850,73606,0,99456
141428101500000,SE 203,Residential,42542,102924,0,145466
141428101600000,SE 203,Residential,46802,93112,0,139914
141428101700000,SE 203,Residential,43937,115583,0,159520
141428101800000,SE 203,Residential,37835,108428,0,146263
141428101900000,SE 203,Residential,37288,114342,0,151630
141428102000000,SE 203,Residential,37680,91684,0,129364
141428102100000,SE 203,Residential,37200,106704,0,143904
141428102200000,SE 203,Residential,36813,101551,0,138364
141428102300000,SE 203,Residential,37600,86232,0,123832
141428102400000,SE 203,Residential,51700,106144,0,157844
141428102500000,SE 203,Residential,38775,116006,0,154781
141428102600000,SE 203,Residential,38775,116213,0,154988
141428200100000,SE 203,Residential,66150,331321,0,397471
141428200200000,SE 203,Residential,73848,242979,0,316827
141428200300000,SE 203,Residential,97402,362753,0,460155
141428200400000,SE 203,Residential,93480,192689,0,286169
141428200500000,SE 203,Residential,83967,196098,0,280065
141428200600000,SE 203,Residential,108360,264943,0,373303
141428200700000,SE 203,Residential,75600,196400,0,272000
141428200800000,SE 203,Residential,75600,266129,0,341729
141428200900000,SE 203,Residential,48600,184522,0,233122
141428201000000,SE 203,Residential,46710,160019,0,206729
141428201100000,SE 203,Residential,55105,167200,0,222305
141428201200000,SE 203,Residential,43725,132595,0,176320
141428201300000,SE 203,Residential,42263,124072,0,166335
141428201400000,SE 203,Residential,38480,118582,0,157062
141428201500000,SE 203,Residential,37740,63961,0,101701
141428201600000,SE 203,Residential,37370,96989,0,134359
141428201700000,SE 203,Residential,37240,104443,0,141683
141428201800000,SE 203,Residential,37050,77430,0,114480
141428201900000,SE 203,Residential,42300,108655,0,150955
141428300100000,SE 203,Residential,41600,86969,0,128569
141428300200000,SE 203,Residential,28665,59083,0,87748
141428300300000,SE 203,Residential,34010,73003,0,107013
141428300400000,SE 203,Residential,37620,100810,0,138430
141428300500000,SE 203,Residential,37588,99650,0,137238
141428300600000,SE 203,Residential,49743,107113,0,156856
141428300700000,SE 203,Residential,41860,86005,0,127865
141428300800000,SE 203,Residential,30708,77519,0,108227
141430100100000,SE 203,Residential,111900,353283,0,465183
141430100200000,Empty,Exempt,0,0,0,0
141432600100000,SE 208,Residential,32700,88480,0,121180
141432600200000,SE 208,Residential,32700,111944,0,144644
141432600201000,CONDO 502,Residential,3000,82225,0,85225
141432600201001,CONDO 502,Residential,7500,126363,0,133863
141432600201002,CONDO 502,Residential,4500,93990,0,98490
141432600201003,CONDO 502,Residential,4500,91537,0,96037
141432600201004,CONDO 502,Residential,4500,89610,0,94110
141432600201005,CONDO 502,Residential,7500,105021,0,112521
141432600201006,CONDO 502,Residential,4500,93990,0,98490
141432600201007,CONDO 502,Residential,1500,64693,0,66193
141432600201008,CONDO 502,Residential,4500,90567,0,95067
141432600201009,CONDO 502,Residential,4500,92756,0,97256
141432600201010,CONDO 502,Residential,4500,93990,0,98490
141432600201011,CONDO 502,Residential,4500,90128,0,94628
141432600201012,CONDO 502,Residential,4500,89610,0,94110
141432600201013,CONDO 502,Residential,4500,92740,0,97240
141432600201014,CONDO 502,Residential,4500,93990,0,98490
141432600201015,CONDO 502,Residential,4500,89157,0,93657
141432600201016,CONDO 502,Residential,4500,90567,0,95067
141432600201017,CONDO 502,Residential,4500,92740,0,97240
141432600201018,CONDO 502,Residential,4500,93990,0,98490
141432600201019,CONDO 502,Residential,4500,91537,0,96037
141432600201020,CONDO 502,Residential,4500,88200,0,92700
141432600201021,CONDO 502,Residential,4500,92740,0,97240
141432600201022,CONDO 502,Residential,4500,93990,0,98490
141432600201023,CONDO 502,Residential,4500,91354,0,95854
141432600201024,CONDO 502,Residential,4500,90567,0,95067
141432600201025,CONDO 502,Residential,4500,93428,0,97928
141432600201026,CONDO 502,Residential,6000,107100,0,113100
141432600201027,CONDO 502,Residential,3000,75450,0,78450
141432600201028,CONDO 502,Residential,4500,89610,0,94110
141432600201029,CONDO 502,Residential,4500,94149,0,98649
141432600201030,CONDO 502,Residential,4500,93990,0,98490
141432600201031,CONDO 502,Residential,4500,89157,0,93657
141432600201032,CONDO 502,Residential,4500,90567,0,95067
141432600201033,CONDO 502,Residential,4500,94149,0,98649
141432600201034,CONDO 502,Residential,6000,112902,0,118902
141432600201035,CONDO 502,Residential,3000,76860,0,79860
141432600201036,CONDO 502,Residential,4500,62078,0,66578
141432600201037,CONDO 502,Residential,4500,93428,0,97928
141432600201038,CONDO 502,Residential,4500,97137,0,101637
141432600201039,CONDO 502,Residential,4500,90567,0,95067
141432600201040,CONDO 502,Residential,4500,94336,0,98836
141432600201041,CONDO 502,Residential,4500,100003,0,104503
141432600201042,CONDO 502,Residential,4500,93990,0,98490
141432600201043,CONDO 502,Residential,4500,94691,0,99191
141432600201044,CONDO 502,Residential,4500,97335,0,101835
141432600201045,CONDO 502,Residential,4500,99296,0,103796
141432600201046,CONDO 502,Residential,4500,92580,0,97080
141432600201047,CONDO 502,Residential,4500,90567,0,95067
141432600201048,CONDO 502,Residential,4500,90567,0,95067
141432600201049,CONDO 502,Residential,4500,92740,0,97240
141432600201050,CONDO 502,Residential,6000,112936,0,118936
141432600201051,CONDO 502,Residential,3000,79221,0,82221
141432600201052,CONDO 502,Residential,4500,89610,0,94110
141432600201053,CONDO 502,Residential,4500,94149,0,98649
141432600201054,CONDO 502,Residential,4500,92580,0,97080
141432600201055,CONDO 502,Residential,4500,90567,0,95067
141432600201056,CONDO 502,Residential,7500,150990,0,158490
141432600201057,CONDO 502,Residential,4500,101523,0,106023
141432600201058,CONDO 502,Residential,9000,167162,0,176162
141432600201059,CONDO 502,Residential,4500,104964,0,109464
141432600201060,CONDO 502,Residential,3000,89309,0,92309
141432600201061,CONDO 502,Residential,6000,127521,0,133521
141432600201062,CONDO 502,Residential,7500,155722,0,163222
141432600201063,CONDO 502,Residential,4500,108941,0,113441
141432600201064,CONDO 502,Residential,6000,178667,0,184667
141432600201066,CONDO 502,Residential,4500,105263,0,109763
141432600201067,CONDO 502,Residential,4500,110597,0,115097
141432600201068,CONDO 502,Residential,6000,137543,0,143543
141432600201069,CONDO 502,Residential,9000,200546,0,209546
141432600201070,CONDO 502,Residential,9000,210784,0,219784
141432600201071,CONDO 502,Residential,7500,204693,0,212193
141432600201072,CONDO 502,Residential,7500,180224,0,187724
141432600300000,SE 208,Residential,32700,75981,0,108681
141432600400000,SE 208,Residential,32700,84151,0,116851
141432600500000,SE 208,Residential,34360,128350,0,162710
141432600600000,SE 208,Residential,35000,116902,0,151902
141432600700000,SE 208,Residential,35640,140070,0,175710
141432600800000,SE 208,Residential,40131,126068,0,166199
141432600900000,SE 208,Residential,39600,102518,0,142118
141432601000000,SE 208,Residential,39069,121329,0,160398
141432601100000,SE 208,Residential,34360,80618,0,114978
141432601200000,SE 208,Residential,35000,82083,0,117083
141432601300000,SE 208,Residential,35640,112341,0,147981
141432700100000,SE 208,Residential,35633,154400,0,190033
141432700200000,SE 208,Residential,31500,88863,0,120363
141432700300000,SE 208,Residential,31500,68255,0,99755
141432700401000,CONDO 500,Residential,4500,80879,0,85379
141432700401001,CONDO 500,Residential,4500,77161,0,81661
141432700401002,CONDO 500,Residential,3000,56082,0,59082
141432700401003,CONDO 500,Residential,4500,77161,0,81661
141432700401004,CONDO 500,Residential,6000,93349,0,99349
141432700401005,CONDO 500,Residential,4500,73334,0,77834
141432700401006,CONDO 500,Residential,6000,95539,0,101539
141432700401007,CONDO 500,Residential,4500,77161,0,81661
141432700401008,CONDO 500,Residential,4500,77161,0,81661
141432700401009,CONDO 500,Residential,3000,56557,0,59557
141432700401010,CONDO 500,Residential,4500,73334,0,77834
141432700401011,CONDO 500,Residential,6000,93349,0,99349
141432700401012,CONDO 500,Residential,6000,100208,0,106208
141432700401013,CONDO 500,Residential,4500,77747,0,82247
141432700401014,CONDO 500,Residential,3000,56610,0,59610
141432700401015,CONDO 500,Residential,4500,77747,0,82247
141432700401016,CONDO 500,Residential,6000,93960,0,99960
141432700401017,CONDO 500,Residential,4500,73892,0,78392
141432700401018,CONDO 500,Residential,6000,95602,0,101602
141432700401019,CONDO 500,Residential,6000,96151,0,102151
141432700401020,CONDO 500,Residential,4500,77747,0,82247
141432700401021,CONDO 500,Residential,3000,56610,0,59610
141432700401022,CONDO 500,Residential,4500,73892,0,78392
141432700401023,CONDO 500,Residential,6000,94508,0,100508
141432700401024,CONDO 500,Residential,6000,95602,0,101602
141432700401025,CONDO 500,Residential,4500,77747,0,82247
141432700401026,CONDO 500,Residential,3000,56610,0,59610
141432700401027,CONDO 500,Residential,4500,77747,0,82247
141432700401028,CONDO 500,Residential,6000,93960,0,99960
141432700401029,CONDO 500,Residential,4500,73892,0,78392
141432700401030,CONDO 500,Residential,7500,95602,0,103102
141432700401031,CONDO 500,Residential,6000,95602,0,101602
141432700401032,CONDO 500,Residential,4500,78274,0,82774
141432700401033,CONDO 500,Residential,3000,56611,0,59611
141432700401034,CONDO 500,Residential,4500,73892,0,78392
141432700401035,CONDO 500,Residential,6000,96196,0,102196
141432700501000,CONDO 500,Residential,6000,73167,0,79167
141432700501001,CONDO 500,Residential,10500,106661,0,117161
141432700501002,CONDO 500,Residential,7500,94023,0,101523
141432700501003,CONDO 500,Residential,4500,55925,0,60425
141432700501004,CONDO 500,Residential,9000,110125,0,119125
141432700501005,CONDO 500,Residential,12000,113030,0,125030
141432700501006,CONDO 500,Residential,6000,72666,0,78666
141432700501007,CONDO 500,Residential,6000,73167,0,79167
141432700501008,CONDO 500,Residential,7500,94023,0,101523
141432700501009,CONDO 500,Residential,7500,94023,0,101523
141432700501010,CONDO 500,Residential,9000,105285,0,114285
141432700501011,CONDO 500,Residential,9000,101156,0,110156
141432700501012,CONDO 500,Residential,9000,94662,0,103662
141432700501013,CONDO 500,Residential,9000,94662,0,103662
141432700501014,CONDO 500,Residential,7500,95210,0,102710
141432700501015,CONDO 500,Residential,6000,74251,0,80251
141432700501016,CONDO 500,Residential,9000,104329,0,113329
141432700501017,CONDO 500,Residential,12000,119274,0,131274
141432700501018,CONDO 500,Residential,9000,95210,0,104210
141432700501019,CONDO 500,Residential,6000,73750,0,79750
141432700501020,CONDO 500,Residential,7500,94662,0,102162
141432700501021,CONDO 500,Residential,7500,94662,0,102162
141432700501022,CONDO 500,Residential,9000,104329,0,113329
141432700501023,CONDO 500,Residential,9000,105454,0,114454
141432700501024,CONDO 500,Residential,9000,94662,0,103662
141432700501025,CONDO 500,Residential,9000,95210,0,104210
141432700501026,CONDO 500,Residential,9000,94662,0,103662
141432700501027,CONDO 500,Residential,6000,75468,0,81468
141432700501028,CONDO 500,Residential,9000,104329,0,113329
141432700501029,CONDO 500,Residential,12000,131429,0,143429
141432700501030,CONDO 500,Residential,9000,98243,0,107243
141432700501031,CONDO 500,Residential,6000,73750,0,79750
141432700501032,CONDO 500,Residential,9000,98243,0,107243
141432700501033,CONDO 500,Residential,7500,94662,0,102162
141432700501034,CONDO 500,Residential,9000,104329,0,113329
141432700501035,CONDO 500,Residential,9000,104329,0,113329
141432700601000,CONDO 500,Residential,3000,56837,0,59837
141432700601001,CONDO 500,Residential,6000,92224,0,98224
141432700601002,CONDO 500,Residential,4500,77828,0,82328
141432700601003,CONDO 500,Residential,6000,92255,0,98255
141432700601004,CONDO 500,Residential,3000,71678,0,74678
141432700601005,CONDO 500,Residential,6000,92224,0,98224
141432700601006,CONDO 500,Residential,4500,71641,0,76141
141432700601007,CONDO 500,Residential,3000,56837,0,59837
141432700601008,CONDO 500,Residential,4500,71678,0,76178
141432700601009,CONDO 500,Residential,4500,82171,0,86671
141432700601010,CONDO 500,Residential,6000,92224,0,98224
141432700601011,CONDO 500,Residential,4500,71678,0,76178
141432700601012,CONDO 500,Residential,4500,93282,0,97782
141432700601013,CONDO 500,Residential,4500,71678,0,76178
141432700601014,CONDO 500,Residential,4500,78407,0,82907
141432700601015,CONDO 500,Residential,6000,93369,0,99369
141432700601016,CONDO 500,Residential,4500,78407,0,82907
141432700601017,CONDO 500,Residential,6000,92827,0,98827
141432700601018,CONDO 500,Residential,4500,72229,0,76729
141432700601019,CONDO 500,Residential,6000,92827,0,98827
141432700601020,CONDO 500,Residential,4500,72229,0,76729
141432700601021,CONDO 500,Residential,4500,78407,0,82907
141432700601022,CONDO 500,Residential,4500,72229,0,76729
141432700601023,CONDO 500,Residential,4500,78407,0,82907
141432700601024,CONDO 500,Residential,6000,92852,0,98852
141432700601025,CONDO 500,Residential,4500,72229,0,76729
141432700601026,CONDO 500,Residential,6000,92827,0,98827
141432700601027,CONDO 500,Residential,4500,71003,0,75503
141432700601028,CONDO 500,Residential,4500,78407,0,82907
141432700601029,CONDO 500,Residential,6000,92827,0,98827
141432700601030,CONDO 500,Residential,4500,78407,0,82907
141432700601031,CONDO 500,Residential,6000,92827,0,98827
141432700601032,CONDO 500,Residential,4500,72229,0,76729
141432700601033,CONDO 500,Residential,6000,93344,0,99344
141432700601034,CONDO 500,Residential,4500,72229,0,76729
141432700601035,CONDO 500,Residential,4500,78407,0,82907
141432700601036,CONDO 500,Residential,4500,72229,0,76729
141432700601037,CONDO 500,Residential,4500,78407,0,82907
141432700601038,CONDO 500,Residential,6000,92827,0,98827
141432700601039,CONDO 500,Residential,4500,72229,0,76729
141432700601040,CONDO 500,Residential,6000,92827,0,98827
141432700601041,CONDO 500,Residential,4500,72229,0,76729
141432800100000,NE 154,Residential,40000,0,0,40000
141432800300000,COMM NE,Commercial,218700,0,80300,299000
141432800400000,COMM NE,Commercial,54540,0,0,54540
141432800500000,COMM NE,Commercial,120031,0,174558,294589
141432900100000,E-48 RELIG BLDG SITE,Exempt,32724,0,22883,55607
141432900200000,SE 208,Exempt,70200,0,149456,219656
141432900300000,SE 208,Residential,70200,175364,0,245564
141432900400000,SE 208,Residential,70200,169175,0,239375
141432900500000,SE 208,Residential,70200,190329,0,260529
141432900600000,SE 208,Residential,69000,0,0,69000
141432900700000,SE 208,Residential,109200,192023,0,301223
141432900800000,SE 208,Residential,43307,0,0,43307
141432900900000,COMM SE,Commercial,19029,0,0,19029
141432901000000,RES VALUED COMM,Residential,517320,18395217,0,18912537
141432901301000,CONDO 500,Residential,7500,84326,0,91826
141432901301001,CONDO 500,Residential,7500,84326,0,91826
141432901301002,CONDO 500,Residential,6000,76088,0,82088
141432901301003,CONDO 500,Residential,6000,76088,0,82088
141432901301004,CONDO 500,Residential,6000,76088,0,82088
141432901301005,CONDO 500,Residential,6000,76088,0,82088
141432901301006,CONDO 500,Residential,7500,84326,0,91826
141432901301007,CONDO 500,Residential,7500,84326,0,91826
141432901301008,CONDO 500,Residential,6000,76088,0,82088
141432901301009,CONDO 500,Residential,6000,76088,0,82088
141432901301010,CONDO 500,Residential,6000,76088,0,82088
141432901301011,CONDO 500,Residential,6000,76088,0,82088
141432901301012,CONDO 500,Residential,9000,102944,0,111944
141432901301013,CONDO 500,Residential,7500,85041,0,92541
141432901301014,CONDO 500,Residential,6000,76841,0,82841
141432901301015,CONDO 500,Residential,6000,76841,0,82841
141432901301016,CONDO 500,Residential,6000,76841,0,82841
141432901301017,CONDO 500,Residential,6000,76841,0,82841
141432901301018,CONDO 500,Residential,7500,85541,0,93041
141432901301019,CONDO 500,Residential,7500,85041,0,92541
141432901301020,CONDO 500,Residential,6000,76841,0,82841
141432901301021,CONDO 500,Residential,6000,76841,0,82841
141432901301022,CONDO 500,Residential,6000,76841,0,82841
141432901301023,CONDO 500,Residential,6000,76841,0,82841
141432901301024,CONDO 500,Residential,9000,102944,0,111944
141432901301025,CONDO 500,Residential,7500,85041,0,92541
141432901301026,CONDO 500,Residential,6000,76841,0,82841
141432901301027,CONDO 500,Exempt,6000,0,76841,82841
141432901301028,CONDO 500,Residential,6000,76841,0,82841
141432901301029,CONDO 500,Residential,6000,76841,0,82841
141432901301030,CONDO 500,Residential,7500,85041,0,92541
141432901301031,CONDO 500,Residential,7500,85041,0,92541
141432901301032,CONDO 500,Residential,6000,76841,0,82841
141432901301033,CONDO 500,Residential,6000,76841,0,82841
141432901301034,CONDO 500,Residential,6000,76841,0,82841
141432901301035,CONDO 500,Residential,6000,76841,0,82841
141432901400000,E-40 CHURCHES,Exempt,101520,0,1155426,1256946
141432901501000,COMM SE,Commercial,18808,0,0,18808
141432901501001,CONDO 500,Residential,6000,83357,0,89357
141432901501002,CONDO 500,Residential,6000,83357,0,89357
141432901501003,CONDO 500,Residential,4500,75214,0,79714
141432901501004,CONDO 500,Residential,4500,75732,0,80232
141432901501005,CONDO 500,Residential,6000,83357,0,89357
141432901501006,CONDO 500,Residential,6000,83357,0,89357
141432901501007,CONDO 500,Residential,4500,75214,0,79714
141432901501008,CONDO 500,Residential,4500,75214,0,79714
141432901501009,CONDO 500,Residential,9000,101760,0,110760
141432901501010,CONDO 500,Residential,6000,84063,0,90063
141432901501011,CONDO 500,Residential,4500,75957,0,80457
141432901501012,CONDO 500,Residential,4500,80033,0,84533
141432901501013,CONDO 500,Residential,6000,84063,0,90063
141432901501014,CONDO 500,Residential,6000,84063,0,90063
141432901501015,CONDO 500,Residential,4500,76476,0,80976
141432901501016,CONDO 500,Residential,4500,75957,0,80457
141432901501017,CONDO 500,Residential,9000,102899,0,111899
141432901501018,CONDO 500,Residential,6000,84063,0,90063
141432901501019,CONDO 500,Residential,6000,75957,0,81957
141432901501020,CONDO 500,Residential,4500,75957,0,80457
141432901501021,CONDO 500,Residential,6000,84063,0,90063
141432901501022,CONDO 500,Residential,6000,84063,0,90063
141432901501023,CONDO 500,Residential,6000,75957,0,81957
141432901501024,CONDO 500,Residential,4500,75957,0,80457
141432901501025,CONDO 500,Residential,7500,83851,0,91351
141432901501026,CONDO 500,Residential,7500,83357,0,90857
141432901501027,CONDO 500,Residential,6000,75214,0,81214
141432901501028,CONDO 500,Residential,6000,75732,0,81732
141432901501029,CONDO 500,Residential,7500,83357,0,90857
141432901501030,CONDO 500,Residential,7500,83357,0,90857
141432901501031,CONDO 500,Residential,6000,75214,0,81214
141432901501032,CONDO 500,Residential,6000,75214,0,81214
141432901501033,CONDO 500,Residential,7500,84557,0,92057
141432901501034,CONDO 500,Residential,4500,84063,0,88563
141432901501035,CONDO 500,Residential,6000,75957,0,81957
141432901501036,CONDO 500,Residential,6000,75957,0,81957
141432901501037,CONDO 500,Residential,9000,101760,0,110760
141432901501038,CONDO 500,Residential,7500,84557,0,92057
141432901501039,CONDO 500,Residential,6000,75957,0,81957
141432901501040,CONDO 500,Residential,6000,75957,0,81957
141432901501041,CONDO 500,Residential,7500,84063,0,91563
141432901501042,CONDO 500,Residential,7500,84063,0,91563
141432901501043,CONDO 500,Residential,6000,75957,0,81957
141432901501044,CONDO 500,Residential,6000,75957,0,81957
141432901501045,CONDO 500,Residential,9000,103418,0,112418
141432901501046,CONDO 500,Residential,7500,86788,0,94288
141432901501047,CONDO 500,Residential,6000,76476,0,82476
141432901501048,CONDO 500,Residential,6000,75957,0,81957
141435100100000,CONDO 504,Residential,30000,296647,0,326647
141435100200000,CONDO 504,Residential,30000,200760,0,230760
141435100300000,CONDO 504,Residential,30000,191565,0,221565
141435100400000,CONDO 504,Residential,30000,241281,0,271281
141435100500000,CONDO 504,Residential,30000,261681,0,291681
141435100600000,CONDO 504,Residential,30000,202376,0,232376
141435100701000,CONDO 504,Residential,30000,147669,0,177669
141435100701001,CONDO 504,Residential,30000,167669,0,197669
141435100801000,CONDO 504,Residential,30000,141770,0,171770
141435100801001,CONDO 504,Residential,30000,190772,0,220772
141435100901000,CONDO 504,Residential,30000,188484,0,218484
141435100901001,CONDO 504,Residential,30000,169647,0,199647
141435101001000,CONDO 504,Residential,30000,162390,0,192390
141435101001001,CONDO 504,Residential,30000,166986,0,196986
141435101100000,CONDO 504,Residential,30000,178946,0,208946
141435101200000,CONDO 504,Residential,30000,346315,0,376315
141435101300000,CONDO 504,Residential,30000,214485,0,244485
141435101401000,CONDO 504,Residential,30000,158957,0,188957
141435101401001,CONDO 504,Residential,30000,168721,0,198721
141435101501000,CONDO 504,Residential,30000,208874,0,238874
141435101501001,CONDO 504,Residential,30000,186820,0,216820
141435101601000,CONDO 504,Residential,30000,236279,0,266279
141435101601001,CONDO 504,Residential,30000,248069,0,278069
141435101701000,CONDO 504,Residential,30000,213222,0,243222
141435101701001,CONDO 504,Residential,30000,234821,0,264821
141435101800000,CONDO 504,Residential,30000,261825,0,291825
141435101900000,CONDO 504,Residential,30000,223511,0,253511
141435102000000,CONDO 504,Residential,30000,207013,0,237013
141435102100000,CONDO 504,Residential,30000,213861,0,243861
141435102200000,CONDO 504,Residential,30000,283307,0,313307
141435102300000,CONDO 504,Residential,30000,255246,0,285246
141435200100000,CONDO 504,Residential,30000,199646,0,229646
141435200201000,CONDO 504,Residential,30000,164066,0,194066
141435200201001,CONDO 504,Residential,30000,152235,0,182235
141435200301000,CONDO 504,Residential,30000,163057,0,193057
141435200301001,CONDO 504,Residential,30000,150100,0,180100
141435200400000,CONDO 504,Residential,30000,164031,0,194031
141435200500000,CONDO 504,Residential,30000,218123,0,248123
141435200600000,CONDO 504,Residential,30000,186042,0,216042
141435200700000,CONDO 504,Residential,30000,188770,0,218770
141435200800000,CONDO 504,Residential,30000,194863,0,224863
141435200900000,CONDO 504,Residential,30000,184219,0,214219
141435201001000,CONDO 504,Residential,30000,258456,0,288456
141435201001001,CONDO 504,Residential,30000,222622,0,252622
141435201001002,CONDO 504,Residential,30000,232020,0,262020
141435201100000,CONDO 504,Residential,30000,244460,0,274460
141435201201000,CONDO 504,Residential,30000,219885,0,249885
141435201201001,CONDO 504,Residential,30000,195357,0,225357
141435201301000,CONDO 504,Residential,30000,219015,0,249015
141435201301001,CONDO 504,Residential,30000,150357,0,180357
141435201400000,CONDO 504,Residential,30000,2021,0,32021
141435201500000,SE 218,Residential,116000,220365,0,336365
141435201600000,CONDO 504,Residential,30000,209197,0,239197
141435201700000,CONDO 504,Residential,30000,247588,0,277588
141435201800000,CONDO 504,Residential,30000,301791,0,331791
141435201900000,CONDO 504,Residential,30000,193636,0,223636
141435202000000,CONDO 504,Residential,30000,262419,0,292419
141435202100000,CONDO 504,Residential,30000,245120,0,275120
141435202200000,CONDO 504,Residential,30000,249519,0,279519
141435202300000,CONDO 504,Residential,30000,251870,0,281870
141435202400000,CONDO 504,Residential,30000,215791,0,245791
141435202500000,CONDO 504,Residential,30000,280640,0,310640
141435202600000,CONDO 504,Residential,30000,247767,0,277767
141435300100000,CONDO 504,Residential,30000,295579,0,325579
141435300200000,CONDO 504,Residential,30000,264639,0,294639
141435300300000,CONDO 504,Residential,30000,195932,0,225932
141435400100000,SE 207,Residential,26500,44470,0,70970
141435400200000,SE 207,Residential,24000,97482,0,121482
141435400300000,SE 207,Residential,38987,77563,0,116550
141435400400000,SE 207,Residential,42613,84760,0,127373
141435400500000,SE 207,Residential,43200,81180,0,124380
141435500100000,SE 218,Residential,88000,220250,0,308250
141435500200000,SE 218,Residential,49711,236824,0,286535
141435500300000,SE 218,Residential,58432,169650,0,228082
141437600100000,SE 207,Residential,90050,105999,0,196049
141437600200000,SE 207,Residential,82350,133829,0,216179
141437600300000,SE 207,Residential,64050,139612,0,203662
141437600400000,SE 207,Residential,64050,194786,0,258836
141437600500000,SE 207,Residential,56682,148822,0,205504
141437600600000,SE 207,Residential,25300,79236,0,104536
141437600700000,SE 207,Residential,31815,101484,0,133299
141437600800000,SE 207,Residential,28280,69524,0,97804
141437600900000,SE 207,Residential,32825,113386,0,146211
141437601000000,SE 207,Residential,33132,112798,0,145930
141437601100000,SE 207,Residential,31415,72766,0,104181
141437601200000,SE 207,Residential,31415,100084,0,131499
141437601300000,SE 207,Residential,37698,158814,0,196512
141437601400000,SE 207,Residential,35342,117007,0,152349
141437601500000,SE 207,Residential,34776,188309,0,223085
141437700100000,SE 207,Residential,23397,144584,0,167981
141437700200000,SE 207,Residential,48111,106915,0,155026
141437700300000,SE 207,Residential,38174,116980,0,155154
141437700400000,SE 207,Residential,25000,96826,0,121826
141437700500000,SE 207,Residential,20000,63618,0,83618
141437700600000,SE 207,Residential,20000,71123,0,91123
141437700700000,SE 207,Residential,20000,71698,0,91698
141437700800000,SE 207,Residential,20000,63826,0,83826
141437700900000,SE 207,Residential,20000,78493,0,98493
141437701000000,SE 207,Residential,25000,55999,0,80999
141437701100000,SE 207,Residential,25000,89290,0,114290
141437701200000,SE 207,Residential,25000,77667,0,102667
141437701300000,SE 207,Residential,20000,76689,0,96689
141437701400000,SE 207,Residential,20000,74174,0,94174
141437701500000,SE 207,Residential,25000,62797,0,87797
141437701600000,SE 207,Residential,28000,51583,0,79583
141437800100000,SE 207,Residential,70190,155699,0,225889
141437800200000,SE 207,Residential,25000,61771,0,86771
141437800400000,SE 207,Residential,35000,81673,0,116673
141437800500000,SE 207,Residential,25000,75409,0,100409
141437800600000,SE 207,Residential,35000,116864,0,151864
141437800700000,SE 207,Residential,18200,55388,0,73588
141437800800000,SE 207,Residential,21750,60072,0,81822
141437800900000,SE 207,Residential,21750,60999,0,82749
141437801000000,SE 207,Residential,25000,69110,0,94110
141437801100000,SE 207,Residential,25000,71253,0,96253
141437801200000,SE 207,Residential,25000,74651,0,99651
141437801300000,SE 207,Residential,27000,95060,0,122060
141437900100000,SE 207,Residential,36720,116925,0,153645
141437900200000,SE 207,Residential,30300,90031,0,120331
141437900300000,SE 207,Residential,30300,71633,0,101933
141437900400000,SE 207,Residential,31200,61751,0,92951
141437900500000,SE 207,Residential,41003,70874,0,111877
141437900600000,SE 207,Residential,36360,188244,0,224604
141437900700000,SE 207,Residential,52380,88140,0,140520
141437900800000,SE 207,Residential,33950,81766,0,115716
141437900900000,SE 207,Residential,34821,125170,0,159991
141438000100000,SE 207,Residential,31101,101514,0,132615
141438000200000,SE 207,Residential,31101,119446,0,150547
141438000300000,SE 207,Residential,25250,82984,0,108234
141438000400000,SE 207,Residential,25250,86059,0,111309
141438000500000,SE 207,Residential,35350,85446,0,120796
141438000600000,SE 207,Residential,25250,94744,0,119994
141438000700000,SE 207,Residential,25250,50972,0,76222
141438000800000,SE 207,Residential,25250,105848,0,131098
141438000900000,SE 207,Residential,34340,81246,0,115586
141438001000000,SE 207,Residential,37875,145582,0,183457
141438001100000,SE 207,Residential,32137,82139,0,114276
141438001200000,SE 207,Residential,32194,72697,0,104891
141438001300000,SE 207,Residential,29357,68719,0,98076
141438001400000,SE 207,Residential,29290,71321,0,100611
141438001500000,SE 207,Residential,29290,102988,0,132278
141438100100000,SE 207,Residential,25000,108886,0,133886
141438100200000,SE 207,Residential,25000,59735,0,84735
141438100300000,SE 207,Residential,25000,74004,0,99004
141438100400000,SE 207,Residential,25000,75869,0,100869
141438100500000,SE 207,Residential,25000,61168,0,86168
141438100600000,SE 207,Residential,25000,59590,0,84590
141438100700000,SE 207,Residential,25000,56524,0,81524
141438100800000,SE 207,Residential,25000,58779,0,83779
141438100900000,SE 207,Residential,25000,58684,0,83684
141438101000000,SE 207,Residential,25000,63060,0,88060
141438101100000,SE 207,Residential,35000,109113,0,144113
141438101200000,SE 207,Residential,35000,151666,0,186666
141438101300000,SE 207,Residential,25000,88403,0,113403
141438101400000,SE 207,Residential,25000,60896,0,85896
141438101500000,SE 207,Residential,25000,68432,0,93432
141438101600000,SE 207,Residential,25000,107057,0,132057
141438101700000,SE 207,Residential,25000,72371,0,97371
141438101800000,SE 207,Residential,25000,65664,0,90664
141438101900000,SE 207,Residential,25000,79408,0,104408
141438102000000,SE 207,Residential,25000,105177,0,130177
141438200100000,SE 207,Residential,25000,78708,0,103708
141438200200000,SE 207,Residential,25000,118036,0,143036
141438200300000,SE 207,Residential,32800,152717,0,185517
141438200400000,SE 207,Residential,32000,145623,0,177623
141438200500000,SE 207,Residential,32062,102423,0,134485
141438200600000,SE 207,Residential,33425,154417,0,187842
141438200700000,SE 207,Residential,28125,61900,0,90025
141438200800000,SE 207,Residential,32500,150865,0,183365
141438200900000,SE 207,Residential,27300,112246,0,139546
141438201000000,SE 207,Residential,29074,100313,0,129387
141438201100000,SE 207,Residential,25000,68487,0,93487
141438201200000,SE 207,Residential,25000,59095,0,84095
141438201300000,SE 207,Residential,25000,39267,0,64267
141438201400000,SE 207,Residential,25000,69400,0,94400
141438201500000,SE 207,Residential,25000,62771,0,87771
141438201600000,SE 207,Residential,25000,70025,0,95025
141438201700000,SE 207,Residential,25000,63357,0,88357
141438201800000,SE 207,Residential,25000,76806,0,101806
141438300100000,SE 207,Residential,100510,118961,0,219471
141438300200000,SE 207,Residential,76700,243063,0,319763
141438300300000,SE 207,Residential,100300,145844,0,246144
141438300400000,SE 207,Residential,64165,130413,0,194578
141438300500000,SE 207,Residential,56500,108080,0,164580
141438300600000,SE 207,Residential,56500,131521,0,188021
141438300700000,SE 207,Residential,56500,83035,0,139535
141438300800000,SE 207,Residential,28250,61940,0,90190
141438300900000,SE 207,Residential,28250,74290,0,102540
141438301000000,SE 207,Residential,28250,51172,0,79422
141438301100000,SE 207,Residential,28250,69289,0,97539
141438301200000,SE 207,Residential,28250,51798,0,80048
141438301300000,SE 207,Residential,32205,68191,0,100396
141438301400000,SE 207,Residential,32544,57067,0,89611
141438301500000,SE 207,Residential,26500,89347,0,115847
141440100100000,SE 211,Residential,6280,0,0,6280
141440100200000,SE 211,Residential,175500,450494,0,625994
141440100300000,SE 211,Residential,160500,356117,0,516617
141440100400000,SE 211,Residential,162000,323657,0,485657
141440100500000,SE 211,Residential,103400,288190,0,391590
141440100600000,SE 211,Residential,75075,267126,0,342201
141440100700000,SE 211,Residential,82338,295610,0,377948
141440100800000,SE 211,Residential,85020,292746,0,377766
141440100900000,SE 211,Residential,85902,383300,0,469202
141440101000000,SE 211,Residential,83046,277652,0,360698
141440101100000,SE 211,Residential,155250,244022,0,399272
141440101200000,SE 211,Residential,153900,139425,0,293325
141440101300000,SE 211,Residential,153150,181850,0,335000
141440101400000,SE 211,Residential,82800,206646,0,289446
141440101500000,SE 211,Residential,82650,237404,0,320054
141440101600000,SE 211,Residential,84150,254464,0,338614
141440101700000,SE 211,Residential,83850,262310,0,346160
141440101800000,SE 211,Residential,94050,327718,0,421768
141440101900000,SE 211,Residential,175500,253364,0,428864
141440102000000,SE 211,Residential,3600,0,0,3600
141440102100000,SE 211,Residential,20,0,0,20
141440200100000,SE 211,Residential,113295,130000,0,243295
141440200200000,SE 211,Residential,20,0,0,20
141442600100000,SE 206,Residential,52688,259241,0,311929
141442600200000,SE 206,Residential,53760,141214,0,194974
141442600300000,SE 206,Residential,85429,255210,0,340639
141442600400000,SE 206,Residential,87768,189137,0,276905
141442600500000,SE 206,Residential,77190,220042,0,297232
141442600600000,SE 206,Residential,50867,252309,0,303176
141442600700000,SE 206,Residential,49817,205397,0,255214
141442600800000,SE 206,Residential,53350,232006,0,285356
141442600900000,SE 206,Residential,45900,193636,0,239536
141442601000000,SE 206,Residential,48150,203805,0,251955
141442601100000,SE 206,Residential,48925,148346,0,197271
141442601200000,SE 206,Residential,51000,171879,0,222879
141442601300000,SE 206,Residential,51000,166604,0,217604
141442601400000,SE 206,Residential,54708,202857,0,257565
141442700100000,SE 203,Residential,99816,340293,0,440109
141442700200000,SE 203,Residential,58938,183794,0,242732
141442700300000,SE 203,Residential,61813,124755,0,186568
141442700400000,SE 203,Residential,44508,124944,0,169452
141442700500000,SE 203,Residential,39600,172253,0,211853
141442800100000,SE 206,Residential,52938,173182,0,226120
141442800200000,SE 206,Residential,79407,188561,0,267968
141442800300000,SE 206,Residential,76860,189142,0,266002
141442800400000,SE 206,Residential,82187,154238,0,236425
141442800500000,SE 206,Residential,78192,194022,0,272214
141442800600000,SE 206,Residential,52003,164799,0,216802
141442800700000,SE 206,Residential,50666,172909,0,223575
141442800800000,SE 206,Residential,50065,161497,0,211562
141442800900000,SE 206,Residential,48925,105198,0,154123
141442801000000,SE 206,Residential,49559,173401,0,222960
141442801100000,SE 206,Residential,52316,189568,0,241884
141442900100000,SE 206,Residential,56385,159390,0,215775
141442900200000,SE 206,Residential,50000,198263,0,248263
141442900300000,SE 206,Residential,50000,184924,0,234924
141442900400000,SE 206,Residential,47667,159467,0,207134
141442900500000,SE 206,Residential,48825,193501,0,242326
141442900600000,SE 206,Residential,47260,118432,0,165692
141442900700000,SE 206,Residential,45167,178895,0,224062
141442900800000,SE 206,Residential,50307,184155,0,234462
141442900900000,SE 206,Residential,50309,201609,0,251918
141442901000000,SE 206,Residential,50490,203077,0,253567
141442901100000,SE 206,Residential,52352,150063,0,202415
141442901200000,SE 206,Residential,49254,185575,0,234829
141442901300000,SE 206,Residential,52500,179411,0,231911
141442901400000,SE 206,Residential,47520,152432,0,199952
141442901500000,SE 206,Residential,50400,120748,0,171148
141442901600000,SE 206,Residential,44455,56307,0,100762
141442901700000,SE 206,Residential,42717,155632,0,198349
141442901800000,SE 206,Residential,54083,154538,0,208621
141442901900000,SE 206,Residential,47853,187797,0,235650
141442902000000,SE 206,Residential,48753,146048,0,194801
141442902100000,SE 206,Residential,46550,171024,0,217574
141442902200000,SE 206,Residential,44550,114459,0,159009
141442902300000,SE 206,Residential,56928,163213,0,220141
141442902400000,SE 206,Residential,54080,224085,0,278165
141442902500000,SE 206,Residential,56304,156377,0,212681
141442902600000,SE 206,Residential,20,0,0,20
141443000100000,SE 206,Residential,53536,236150,0,289686
141443000200000,SE 206,Residential,55200,160373,0,215573
141443000300000,SE 206,Residential,55200,225815,0,281015
141443000400000,SE 206,Exempt,53900,0,174030,227930
141443000500000,SE 206,Residential,47975,126376,0,174351
141443000600000,SE 206,Residential,51883,223662,0,275545
141443000700000,SE 206,Residential,46973,210664,0,257637
141443000800000,SE 206,Residential,52618,187222,0,239840
141443000900000,SE 206,Residential,52013,171116,0,223129
141443001000000,SE 206,Residential,54586,171792,0,226378
141443001100000,SE 206,Residential,47203,168663,0,215866
141445100100000,SE 211,Residential,160000,248747,0,408747
141445100200000,SE 211,Residential,132500,335452,0,467952
141445100300000,E-15 CITY,Exempt,0,0,0,0
141445100400000,SE 211,Residential,181100,519992,0,701092
141445200100000,E-15 CITY,Exempt,0,0,0,0
141445200200000,SE 211,Residential,96000,289078,0,385078
141445200300000,SE 211,Residential,109300,255066,0,364366
141445200400000,E-15 CITY,Exempt,0,0,0,0
141447600100000,SE 211,Residential,7300,0,0,7300
141447600200000,SE 211,Residential,76875,611302,0,688177
141447600300000,SE 211,Residential,61500,223837,0,285337
141447600400000,SE 211,Residential,62000,256408,0,318408
141447600500000,SE 211,Residential,77393,214807,0,292200
141447600600000,SE 211,Residential,178650,359887,0,538537
141447600700000,SE 211,Residential,101700,595631,0,697331
141447600800000,SE 211,Residential,103700,267420,0,371120
141447600900000,SE 211,Residential,103600,336681,0,440281
141447601000000,SE 211,Residential,105700,278969,0,384669
141447601100000,SE 211,Residential,73080,157562,0,230642
141447601200000,SE 211,Residential,10800,0,0,10800
141447601300000,SE 211,Residential,106200,263555,0,369755
141447601400000,SE 211,Residential,15000,0,0,15000
141447601500000,SE 211,Residential,100000,374710,0,474710
141447601600000,SE 211,Residential,100000,340660,0,440660
141447601700000,SE 211,Residential,80148,375859,0,456007
141447601800000,SE 211,Residential,86181,198557,0,284738
141447601900000,SE 211,Residential,76380,170687,0,247067
141447602000000,SE 211,Residential,95120,342293,0,437413
141447602100000,SE 211,Residential,101600,243435,0,345035
141447602200000,SE 211,Residential,65302,0,0,65302
141447602300000,SE 211,Residential,100100,369251,0,469351
141447602400000,SE 211,Residential,20,0,0,20
141447602500000,SE 211,Residential,20,0,0,20
141447700100000,SE 211,Residential,76046,257349,0,333395
141447700200000,SE 211,Residential,2080,0,0,2080
141447800100000,SE 211,Residential,249960,480314,0,730274
141447800200000,SE 212,Residential,126150,658302,0,784452
141447800300000,SE 212,Residential,128450,331137,0,459587
141447800400000,E-15 CITY,Exempt,0,0,0,0
141510100100000,Empty,Other,0,0,0,0
141510100200000,NE 141,Residential,26166,108207,0,134373
141510100300000,NE 141,Residential,26520,108973,0,135493
141510100400000,NE 141,Residential,26520,116625,0,143145
141510100500000,NE 141,Residential,24480,103988,0,128468
141510100600000,NE 141,Residential,24480,79135,0,103615
141510100700000,NE 141,Residential,24480,115729,0,140209
141510100800000,NE 141,Residential,24480,86259,0,110739
141510100900000,NE 141,Residential,26520,84271,0,110791
141510101000000,NE 141,Residential,26520,112747,0,139267
141510101100000,NE 141,Residential,26520,103339,0,129859
141510101200000,NE 141,Residential,26520,95274,0,121794
141510101300000,NE 141,Residential,26520,93573,0,120093
141510101400000,NE 141,Residential,25990,98440,0,124430
141510101500000,Empty,Exempt,0,0,0,0
141510200100000,NE 141,Residential,27824,99310,0,127134
141510200200000,NE 141,Residential,26150,115924,0,142074
141510200300000,NE 141,Residential,26520,104724,0,131244
141510200400000,NE 141,Residential,32681,131366,0,164047
141510200500000,NE 141,Residential,31815,97185,0,129000
141510200600000,NE 141,Residential,33705,114968,0,148673
141510200700000,NE 141,Residential,32588,135998,0,168586
141510200800000,NE 141,Residential,25248,130095,0,155343
141510200900000,NE 141,Residential,26525,131484,0,158009
141510201000000,NE 141,Residential,26525,97526,0,124051
141510201100000,NE 141,Residential,28600,137109,0,165709
141510201200000,NE 141,Residential,27300,138078,0,165378
141510201300000,NE 141,Residential,25740,109528,0,135268
141510201400000,NE 141,Residential,23660,119455,0,143115
141510201500000,NE 141,Residential,29388,117748,0,147136
141510201600000,NE 141,Residential,25813,109982,0,135795
141510201700000,NE 141,Residential,26000,125546,0,151546
141510201800000,NE 141,Residential,27560,109534,0,137094
141510201900000,NE 141,Residential,28416,129955,0,158371
141510202000000,NE 141,Residential,29648,129826,0,159474
141510202100000,NE 141,Residential,26208,134320,0,160528
141510202200000,NE 141,Residential,26520,103690,0,130210
141510300100000,NE 142,Residential,30519,124154,0,154673
141510300200000,NE 142,Residential,29056,129968,0,159024
141510300300000,NE 142,Residential,33159,127980,0,161139
141510300400000,NE 142,Residential,29648,94904,0,124552
141510300500000,NE 142,Residential,29773,108607,0,138380
141510300600000,NE 142,Residential,26928,89744,0,116672
141510300700000,NE 142,Residential,28644,108930,0,137574
141510300800000,NE 142,Residential,33184,96768,0,129952
141510300900000,NE 142,Residential,31200,113188,0,144388
141510301000000,NE 142,Residential,32100,119825,0,151925
141510301100000,NE 142,Residential,31500,125128,0,156628
141510400100000,Empty,Exempt,0,0,0,0
141510400200000,NE 154,Residential,24240,85780,0,110020
141510400300000,NE 154,Residential,24480,83858,0,108338
141510400400000,NE 154,Residential,30600,109710,0,140310
141510400500000,NE 154,Residential,30600,94342,0,124942
141510500100000,NE 154,Residential,30000,94180,0,124180
141510500200000,NE 154,Residential,26460,87158,0,113618
141510500300000,NE 154,Residential,26190,89130,0,115320
141510500400000,NE 154,Residential,9300,0,0,9300
141510500500000,NE 154,Residential,28903,128707,0,157610
141510500600000,NE 154,Residential,22080,70753,0,92833
141510500700000,NE 154,Residential,25956,61387,0,87343
141510500800000,NE 154,Residential,32136,127444,0,159580
141510500900000,NE 154,Residential,24720,105528,0,130248
141510501000000,NE 154,Residential,24720,79700,0,104420
141510501100000,NE 154,Residential,25440,97585,0,123025
141510501200000,NE 154,Residential,25440,76784,0,102224
141510501300000,NE 154,Residential,25440,75363,0,100803
141510501400000,NE 154,Residential,25440,89890,0,115330
141510501500000,NE 154,Residential,25440,89102,0,114542
141510501600000,NE 154,Residential,25440,88140,0,113580
141510501700000,NE 154,Residential,24000,88888,0,112888
141510600100000,NE 154,Residential,27621,70260,0,97881
141510700100000,NE 142,Residential,26400,87119,0,113519
141510700200000,NE 142,Residential,24000,141000,0,165000
141510700300000,NE 142,Residential,24000,128415,0,152415
141510700400000,NE 142,Residential,24000,111477,0,135477
141510700500000,NE 142,Residential,24000,91508,0,115508
141510700600000,NE 142,Residential,24000,75861,0,99861
141510700700000,NE 142,Residential,24000,94491,0,118491
141510700800000,NE 142,Residential,26000,60417,0,86417
141510700900000,NE 154,Residential,24000,114643,0,138643
141510701000000,NE 154,Residential,24000,82972,0,106972
141510701100000,NE 154,Residential,30000,63207,0,93207
141510701200000,NE 154,Residential,30000,74955,0,104955
141510701300000,NE 154,Residential,30000,53932,0,83932
141510701400000,NE 154,Residential,30000,72484,0,102484
141510701500000,NE 154,Residential,30000,79243,0,109243
141510701600000,NE 154,Residential,30000,75986,0,105986
141510701700000,NE 154,Residential,31200,97441,0,128641
141510701800000,NE 154,Residential,28302,73428,0,101730
141510701900000,NE 154,Residential,21798,86556,0,108354
141510702000000,NE 154,Residential,31790,97716,0,129506
141510800100000,NE 142,Residential,35244,102548,0,137792
141510800200000,NE 142,Residential,28959,78572,0,107531
141510800300000,NE 142,Residential,29255,76821,0,106076
141510800400000,NE 142,Residential,29255,83030,0,112285
141510800500000,NE 142,Residential,28364,86339,0,114703
141510800600000,NE 142,Residential,28364,124051,0,152415
141510800700000,NE 142,Residential,31050,58385,0,89435
141510800800000,NE 142,Residential,26000,64369,0,90369
141510800900000,NE 142,Residential,24000,115015,0,139015
141510801000000,NE 142,Residential,24000,106906,0,130906
141510801100000,NE 142,Residential,25994,89694,0,115688
141510801200000,NE 142,Residential,22368,73403,0,95771
141510900100000,NE 142,Residential,31275,57815,0,89090
141510900200000,NE 142,Residential,30000,75021,0,105021
141510900300000,NE 154,Residential,24000,70436,0,94436
141512600100000,NE 142,Residential,35269,141926,0,177195
141512600200000,NE 142,Residential,34949,114128,0,149077
141512600300000,NE 142,Residential,31104,116398,0,147502
141512600400000,NE 142,Residential,31104,111144,0,142248
141512600500000,NE 142,Residential,31104,118153,0,149257
141512600600000,NE 142,Residential,27625,105786,0,133411
141512600700000,NE 142,Residential,28768,136714,0,165482
141512600800000,NE 142,Residential,28980,112732,0,141712
141512600900000,NE 142,Residential,27560,96390,0,123950
141512601000000,NE 142,Residential,27820,109666,0,137486
141512601100000,NE 142,Residential,29520,107611,0,137131
141512700100000,NE 142,Exempt,31027,0,103758,134785
141512700200000,NE 142,Residential,34164,145455,0,179619
141512700300000,NE 142,Residential,31356,130325,0,161681
141512700400000,NE 142,Residential,28273,113339,0,141612
141512700500000,NE 142,Residential,35909,106596,0,142505
141512700600000,NE 142,Residential,33628,106527,0,140155
141512700700000,NE 142,Residential,28733,126001,0,154734
141512700800000,NE 142,Residential,26466,93371,0,119837
141512700900000,NE 142,Residential,28355,95820,0,124175
141512701000000,NE 142,Residential,29465,118537,0,148002
141512701100000,NE 142,Residential,29543,86129,0,115672
141512701200000,NE 142,Residential,29250,98066,0,127316
141512701300000,NE 142,Residential,28332,115025,0,143357
141512701400000,NE 142,Residential,33167,121219,0,154386
141512701500000,NE 142,Residential,31250,88664,0,119914
141512701600000,NE 142,Residential,31250,94654,0,125904
141512701700000,NE 142,Residential,31563,75232,0,106795
141512701800000,NE 142,Residential,30300,85927,0,116227
141512701900000,NE 142,Residential,31563,67267,0,98830
141512702000000,NE 142,Residential,31875,107168,0,139043
141512702100000,NE 142,Residential,34157,118130,0,152287
141512702200000,NE 142,Residential,27030,79752,0,106782
141512702300000,NE 142,Residential,30900,100196,0,131096
141512702400000,NE 142,Residential,30213,65640,0,95853
141512702500000,NE 142,Residential,30160,94088,0,124248
141512702600000,NE 142,Residential,30160,109096,0,139256
141512702700000,NE 142,Residential,30975,68659,0,99634
141512800100000,NE 142,Residential,28364,84328,0,112692
141512800200000,NE 142,Residential,28077,83014,0,111091
141512800300000,NE 142,Residential,35475,142684,0,178159
141512800400000,NE 142,Residential,36450,82451,0,118901
141512800500000,NE 142,Residential,28875,75034,0,103909
141512800600000,NE 142,Residential,33300,73790,0,107090
141512900100000,NE 142,Residential,28747,110159,0,138906
141512900200000,NE 142,Residential,28583,125405,0,153988
141512900300000,NE 142,Residential,28583,87703,0,116286
141512900400000,NE 142,Residential,29890,107855,0,137745
141512900500000,NE 142,Residential,28420,81581,0,110001
141512900600000,NE 142,Residential,28420,61898,0,90318
141512900700000,NE 142,Residential,28257,78487,0,106744
141512900800000,NE 142,Residential,29237,94098,0,123335
141512900900000,NE 142,Residential,26950,70451,0,97401
141512901000000,NE 142,Residential,26950,67032,0,93982
141512901100000,NE 142,Residential,26950,78744,0,105694
141512901200000,NE 142,Residential,26950,63886,0,90836
141512901300000,NE 142,Residential,26675,87458,0,114133
141512901400000,NE 142,Residential,33255,91847,0,125102
141513000100000,NE 142,Residential,32667,76526,0,109193
141513000200000,NE 142,Residential,30625,64625,0,95250
141513000300000,NE 142,Residential,30625,66810,0,97435
141513000400000,NE 142,Residential,30625,67210,0,97835
141513000500000,NE 142,Residential,29400,102076,0,131476
141513000600000,NE 142,Residential,30625,70748,0,101373
141513000700000,NE 142,Residential,30625,99148,0,129773
141513000800000,NE 142,Residential,30625,95251,0,125876
141513000900000,NE 142,Residential,29890,81799,0,111689
141513001000000,NE 142,Residential,26950,67067,0,94017
141513001100000,NE 142,Residential,26950,68835,0,95785
141513001200000,NE 142,Residential,26950,78745,0,105695
141513001300000,NE 142,Residential,26950,59560,0,86510
141513001400000,NE 142,Residential,26950,39670,0,66620
141513001500000,NE 142,Residential,26950,90077,0,117027
141513001600000,NE 142,Residential,26950,43944,0,70894
141513001700000,NE 142,Residential,26950,53556,0,80506
141513001800000,NE 142,Residential,26950,68974,0,95924
141513001900000,NE 142,Residential,32013,95469,0,127482
141513100100000,NE 142,Residential,27650,93799,0,121449
141513100200000,NE 142,Residential,27150,58859,0,86009
141513100300000,NE 142,Residential,27150,67935,0,95085
141513100400000,NE 142,Residential,27150,69729,0,96879
141513100500000,NE 142,Residential,27150,75786,0,102936
141513100600000,NE 142,Residential,27150,59366,0,86516
141513100700000,NE 142,Residential,27150,77913,0,105063
141513100800000,NE 142,Residential,27150,76393,0,103543
141513100900000,NE 142,Residential,27150,74714,0,101864
141513101000000,NE 142,Residential,27150,87638,0,114788
141513101100000,NE 142,Residential,27150,70262,0,97412
141513101200000,NE 142,Residential,27150,69281,0,96431
141513101300000,NE 142,Residential,27500,74216,0,101716
141513101400000,NE 142,Residential,27500,81342,0,108842
141513101500000,NE 142,Residential,27500,82885,0,110385
141513101600000,NE 142,Residential,27500,68925,0,96425
141513101700000,NE 142,Residential,27500,61362,0,88862
141513101800000,NE 142,Residential,27500,81537,0,109037
141513101900000,NE 142,Residential,27500,76542,0,104042
141513102000000,NE 142,Residential,27500,81437,0,108937
141513102100000,NE 142,Residential,30000,75052,0,105052
141513200100000,E-40 CHURCHES,Exempt,39425,0,190201,229626
141513200200000,NE 142,Residential,28200,66202,0,94402
141513200300000,NE 142,Residential,30065,78367,0,108432
141513200400000,NE 142,Residential,30226,81096,0,111322
141513200500000,NE 142,Residential,27500,65776,0,93276
141513200600000,NE 142,Residential,27500,66163,0,93663
141513200700000,NE 142,Residential,27500,68005,0,95505
141513200800000,NE 142,Residential,27500,71823,0,99323
141513200900000,NE 142,Residential,27500,78405,0,105905
141513201000000,NE 142,Residential,28900,45845,0,74745
141513201100000,NE 142,Residential,30300,68925,0,99225
141513201200000,NE 142,Residential,28500,81198,0,109698
141513201300000,NE 142,Residential,28500,91502,0,120002
141513201400000,NE 142,Residential,27800,106969,0,134769
141513201500000,NE 142,Residential,28650,58116,0,86766
141513201600000,NE 142,Residential,28967,67735,0,96702
141513201700000,NE 142,Residential,29633,73458,0,103091
141513201800000,NE 142,Residential,27500,69160,0,96660
141513201900000,NE 142,Residential,27500,78254,0,105754
141513202000000,NE 142,Residential,27500,83622,0,111122
141513202100000,NE 142,Residential,27500,100681,0,128181
141513202200000,NE 142,Residential,27500,62119,0,89619
141513202300000,NE 142,Residential,27388,75657,0,103045
141513202400000,NE 142,Residential,28200,67561,0,95761
141513300100000,NE 142,Residential,34584,57904,0,92488
141513300200000,NE 142,Residential,28700,58784,0,87484
141513300300000,NE 142,Residential,27730,61789,0,89519
141513300400000,NE 142,Residential,29500,81140,0,110640
141513300500000,NE 142,Residential,33150,68685,0,101835
141513300600000,NE 142,Residential,32110,64580,0,96690
141513300700000,NE 142,Residential,30300,94696,0,124996
141513300800000,NE 142,Residential,30900,39100,0,70000
141513300900000,NE 142,Residential,28800,74381,0,103181
141513301000000,NE 142,Residential,31315,91967,0,123282
141513301100000,NE 142,Residential,29655,51325,0,80980
141513301200000,NE 142,Residential,30225,97931,0,128156
141513301300000,NE 142,Residential,30000,80133,0,110133
141513301400000,NE 142,Residential,31027,79294,0,110321
141513301500000,NE 142,Residential,29733,81091,0,110824
141513301600000,NE 142,Residential,27730,76665,0,104395
141513301700000,NE 142,Residential,27867,63996,0,91863
141513400100000,NE 142,Residential,30000,79288,0,109288
141513400200000,NE 142,Residential,30000,77645,0,107645
141513400300000,NE 142,Residential,30000,66950,0,96950
141515100100000,NE 142,Residential,30000,79632,0,109632
141515100200000,NE 142,Residential,30000,71957,0,101957
141515100300000,NE 142,Residential,30000,63224,0,93224
141515100400000,NE 142,Residential,30000,69878,0,99878
141515100500000,NE 142,Residential,30000,66794,0,96794
141515100600000,NE 142,Residential,30000,84109,0,114109
141515100700000,NE 142,Residential,31550,83743,0,115293
141515100800000,NE 142,Residential,25833,70886,0,96719
141515100900000,NE 142,Residential,27500,72748,0,100248
141515101000000,NE 142,Residential,27500,66039,0,93539
141515101100000,NE 142,Residential,27500,84744,0,112244
141515101200000,NE 142,Residential,27500,79757,0,107257
141515101300000,NE 142,Residential,27500,81095,0,108595
141515101400000,NE 142,Residential,28001,92700,0,120701
141515101500000,NE 142,Residential,32082,79165,0,111247
141515101600000,NE 154,Residential,31850,78541,0,110391
141515101700000,NE 154,Residential,28200,88635,0,116835
141515101800000,NE 154,Residential,31800,89454,0,121254
141515101900000,NE 154,Residential,33495,82606,0,116101
141515102000000,NE 154,Residential,27930,46782,0,74712
141515102100000,E-15 CITY,Exempt,0,0,0,0
141515102200000,NE 154,Residential,37027,118978,0,156005
141515102300000,NE 154,Residential,31848,116100,0,147948
141515102400000,NE 154,Residential,25800,72919,0,98719
141515200100000,NE 142,Residential,27500,91662,0,119162
141515200200000,NE 142,Residential,27500,74968,0,102468
141515200300000,NE 142,Residential,27500,87346,0,114846
141515200400000,NE 142,Residential,28625,58280,0,86905
141515200500000,NE 142,Residential,28333,70232,0,98565
141515200600000,NE 142,Residential,31225,85037,0,116262
141515200700000,NE 142,Residential,31225,74534,0,105759
141515200800000,NE 142,Residential,31050,72460,0,103510
141515200900000,NE 142,Residential,32534,101333,0,133867
141515201000000,NE 142,Residential,27500,66014,0,93514
141515201100000,NE 142,Residential,27500,73479,0,100979
141515201200000,NE 142,Residential,27500,67316,0,94816
141515201300000,NE 142,Residential,28967,70953,0,99920
141515201400000,NE 142,Residential,28325,67826,0,96151
141515300100000,NE 142,Residential,28650,82135,0,110785
141515300200000,NE 142,Residential,31403,117281,0,148684
141515400100000,NE 154,Residential,30520,80160,0,110680
141515400200000,NE 154,Residential,32292,115198,0,147490
141515400300000,NE 154,Residential,31040,91099,0,122139
141515400400000,NE 154,Residential,31212,71337,0,102549
141515400500000,NE 154,Residential,32130,61305,0,93435
141515400600000,NE 154,Residential,30922,52590,0,83512
141515400700000,NE 154,Residential,29640,52341,0,81981
141515400800000,NE 154,Residential,30447,73158,0,103605
141515400900000,NE 154,Residential,26970,43515,0,70485
141515401000000,NE 154,Residential,26190,50592,0,76782
141515401100000,NE 154,Residential,28493,96934,0,125427
141515401200000,NE 154,Residential,30816,86141,0,116957
141515401300000,NE 154,Residential,30816,110955,0,141771
141515401400000,NE 154,Residential,25680,86791,0,112471
141515401500000,NE 154,Residential,25680,79629,0,105309
141515401600000,NE 154,Residential,25440,74468,0,99908
141515401700000,NE 154,Residential,25200,87102,0,112302
141515401800000,NE 154,Residential,25200,83826,0,109026
141515401900000,NE 154,Residential,24960,76034,0,100994
141515402000000,NE 154,Residential,24720,65314,0,90034
141515402100000,NE 154,Residential,24720,65029,0,89749
141515402200000,NE 154,Residential,24480,66380,0,90860
141515402300000,NE 154,Residential,24240,72440,0,96680
141515402400000,NE 154,Residential,24240,90945,0,115185
141515500100000,NE 154,Residential,26568,65320,0,91888
141515500200000,NE 154,Residential,24360,105163,0,129523
141515500300000,NE 154,Residential,25800,65200,0,91000
141515500400000,NE 154,Residential,25800,107188,0,132988
141515500500000,NE 154,Residential,25800,84756,0,110556
141515500600000,NE 154,Residential,25800,85884,0,111684
141515500700000,NE 154,Residential,26000,67868,0,93868
141515500800000,NE 154,Residential,31000,86642,0,117642
141515500900000,NE 154,Residential,28152,121916,0,150068
141515501000000,NE 154,Residential,27472,128673,0,156145
141515600100000,NE 154,Residential,27200,80797,0,107997
141515600200000,NE 154,Residential,24200,89853,0,114053
141515600300000,NE 154,Residential,24000,63676,0,87676
141515600400000,NE 154,Residential,26020,72860,0,98880
141515700100000,NE 154,Residential,31800,31087,0,62887
141515700200000,NE 154,Residential,26553,51736,0,78289
141515700300000,NE 154,Residential,26520,73582,0,100102
141515700400000,NE 154,Residential,27144,68288,0,95432
141515700500000,NE 154,Residential,24960,73954,0,98914
141515700600000,NE 154,Residential,24960,79003,0,103963
141515700700000,NE 154,Residential,27280,58023,0,85303
141515700800000,NE 154,Residential,27000,56995,0,83995
141515700900000,NE 154,Residential,29712,71714,0,101426
141515701000000,NE 154,Residential,33936,85519,0,119455
141515701100000,NE 154,Residential,24480,73996,0,98476
141515701200000,NE 154,Residential,24720,80766,0,105486
141515701300000,NE 154,Residential,24960,65336,0,90296
141515701400000,NE 154,Residential,24960,72294,0,97254
141515701500000,NE 154,Residential,25200,88260,0,113460
141517600100000,NE 154,Residential,30600,104190,0,134790
141517600200000,NE 154,Residential,24480,80720,0,105200
141517600300000,NE 154,Residential,24480,105720,0,130200
141517600400000,NE 154,Residential,24480,79070,0,103550
141517600500000,NE 154,Residential,24480,85396,0,109876
141517600600000,NE 154,Residential,24480,88909,0,113389
141517600700000,NE 154,Residential,24480,94800,0,119280
141517600800000,NE 154,Residential,24480,82934,0,107414
141517600900000,NE 154,Residential,24480,73280,0,97760
141517601000000,NE 154,Residential,24480,76434,0,100914
141517601100000,NE 154,Residential,21127,82593,0,103720
141517601200000,NE 154,Residential,16800,59149,0,75949
141517601300000,NE 154,Residential,20160,73582,0,93742
141517601400000,NE 154,Residential,20400,72751,0,93151
141517601500000,NE 154,Residential,28320,77757,0,106077
141517601600000,NE 154,Residential,24189,82164,0,106353
141517601700000,NE 154,Residential,30600,88227,0,118827
141517601800000,NE 154,Residential,30600,98647,0,129247
141517601900000,NE 154,Residential,30600,99060,0,129660
141517602000000,NE 154,Residential,30600,68511,0,99111
141517602100000,NE 154,Residential,30600,87825,0,118425
141517602200000,NE 154,Residential,30600,142432,0,173032
141517602300000,NE 154,Residential,30600,105778,0,136378
141517700100000,NE 154,Residential,25440,111732,0,137172
141517700200000,NE 154,Residential,24720,82482,0,107202
141517700300000,NE 154,Residential,24720,82281,0,107001
141517700400000,NE 154,Residential,24720,84156,0,108876
141517700500000,NE 154,Residential,24720,56216,0,80936
141517700600000,NE 154,Residential,24720,76438,0,101158
141517700700000,NE 154,Residential,24720,82435,0,107155
141517700800000,NE 154,Residential,24720,96819,0,121539
141517700900000,NE 154,Residential,24720,99391,0,124111
141517701000000,NE 154,Residential,25440,99081,0,124521
141517701100000,NE 154,Residential,25440,96007,0,121447
141517701200000,NE 154,Residential,25440,82276,0,107716
141517701300000,NE 154,Residential,25440,98452,0,123892
141517701400000,NE 154,Residential,25440,113362,0,138802
141517701500000,NE 154,Residential,25440,88533,0,113973
141517701600000,NE 154,Residential,25440,92787,0,118227
141517701700000,NE 154,Residential,25440,91941,0,117381
141517800100000,NE 154,Residential,21120,76851,0,97971
141517800200000,NE 154,Residential,23040,65172,0,88212
141517800300000,NE 154,Residential,24402,101144,0,125546
141517800400000,NE 154,Residential,20640,60181,0,80821
141517800500000,NE 154,Residential,18960,73288,0,92248
141517800600000,NE 154,Residential,29640,66980,0,96620
141517800700000,NE 154,Residential,25020,108146,0,133166
141517800800000,NE 154,Residential,21120,67418,0,88538
141517800900000,NE 154,Residential,19920,77926,0,97846
141517900100000,NE 154,Residential,24000,52788,0,76788
141517900200000,NE 154,Residential,30000,65176,0,95176
141517900300000,NE 154,Residential,30000,80299,0,110299
141517900400000,NE 154,Residential,30000,76130,0,106130
141517900500000,NE 154,Residential,30000,77202,0,107202
141517900600000,NE 154,Residential,24000,86990,0,110990
141518000100000,NE 154,Residential,30600,84081,0,114681
141518000200000,NE 154,Residential,23107,68331,0,91438
141518000300000,NE 154,Residential,23940,51424,0,75364
141518100100000,NE 154,Residential,21600,78110,0,99710
141518100200000,NE 154,Residential,19496,63169,0,82665
141518100300000,NE 154,Residential,20064,64502,0,84566
141518100400000,NE 154,Residential,30600,61056,0,91656
141518100500000,NE 154,Residential,30600,83312,0,113912
141518100600000,NE 154,Residential,24480,85675,0,110155
141518100700000,NE 154,Residential,24480,62707,0,87187
141518100800000,NE 154,Residential,30600,91593,0,122193
141518100900000,NE 154,Residential,30600,150568,0,181168
141518101000000,NE 154,Residential,30600,115299,0,145899
141518101100000,NE 154,Residential,30600,93591,0,124191
141518101200000,NE 154,Residential,31375,97143,0,128518
141518101300000,NE 154,Residential,26255,65007,0,91262
141518101400000,NE 154,Residential,24480,61742,0,86222
141518101500000,NE 154,Residential,24480,62253,0,86733
141518101600000,NE 154,Residential,24480,63573,0,88053
141518101700000,NE 154,Residential,24480,62942,0,87422
141518200100000,NE 154,Residential,26567,83086,0,109653
141518200200000,NE 154,Residential,25854,65114,0,90968
141518200300000,NE 154,Residential,22410,63071,0,85481
141518200400000,NE 154,Residential,17640,65025,0,82665
141518200500000,NE 154,Residential,22383,70725,0,93108
141518200600000,NE 154,Residential,16800,60754,0,77554
141518200700000,NE 154,Residential,24480,80154,0,104634
141518200800000,NE 154,Residential,24480,79970,0,104450
141518200900000,NE 154,Residential,24480,85615,0,110095
141518201000000,NE 154,Residential,24480,97939,0,122419
141518201100000,NE 154,Residential,24480,84370,0,108850
141518201200000,NE 154,Residential,24480,77059,0,101539
141518201300000,NE 154,Residential,24480,103243,0,127723
141518201400000,NE 154,Residential,24480,79497,0,103977
141518201500000,NE 154,Residential,24480,94336,0,118816
141518201600000,NE 154,Residential,25650,84460,0,110110
141518201700000,NE 154,Residential,26373,74256,0,100629
141518201800000,NE 154,Residential,21240,88401,0,109641
141518201900000,NE 154,Residential,28595,79828,0,108423
141518202000000,NE 154,Residential,30600,97520,0,128120
141518202100000,NE 154,Residential,30600,110586,0,141186
141518202200000,NE 154,Residential,30600,121392,0,151992
141518202300000,NE 154,Residential,30600,101995,0,132595
141518202400000,NE 154,Residential,27540,0,0,27540
141518202500000,NE 154,Residential,27540,62430,0,89970
141518202600000,NE 154,Residential,30600,96994,0,127594
141518202700000,NE 154,Residential,30600,117573,0,148173
141518300100000,NE 154,Residential,21742,70427,0,92169
141518300200000,NE 154,Residential,21840,86103,0,107943
141518300300000,NE 154,Residential,23970,70266,0,94236
141518300400000,NE 154,Residential,24939,71838,0,96777
141518300500000,NE 154,Residential,23970,79417,0,103387
141518300600000,NE 154,Residential,24000,91558,0,115558
141518300700000,NE 154,Residential,24000,67290,0,91290
141518300800000,NE 154,Residential,24000,63151,0,87151
141518300900000,NE 154,Residential,24000,82670,0,106670
141518301000000,NE 154,Residential,24000,72232,0,96232
141518301100000,NE 154,Residential,24000,82626,0,106626
141518301200000,NE 154,Residential,24000,97466,0,121466
141518301300000,NE 154,Residential,24000,111433,0,135433
141518301400000,NE 154,Residential,29880,95281,0,125161
141518301500000,NE 154,Residential,20160,101209,0,121369
141518301600000,NE 154,Residential,20160,99446,0,119606
141518301700000,NE 154,Residential,18468,79483,0,97951
141518301800000,NE 154,Residential,26861,97568,0,124429
141518301900000,NE 154,Residential,24000,94101,0,118101
141518302000000,NE 154,Residential,24000,75880,0,99880
141518302100000,NE 154,Residential,24000,72597,0,96597
141518302200000,NE 154,Residential,24000,77343,0,101343
141518302300000,NE 154,Residential,24000,97159,0,121159
141518302400000,NE 154,Residential,24000,98912,0,122912
141518302500000,NE 154,Residential,24000,71523,0,95523
141518302600000,NE 154,Residential,24000,82506,0,106506
141518302700000,NE 154,Residential,24000,74851,0,98851
141518302800000,NE 154,Residential,24000,95893,0,119893
141518400100000,NE 154,Residential,30840,103620,0,134460
141518400200000,NE 154,Residential,23117,64036,0,87153
141518400300000,NE 154,Residential,31298,104336,0,135634
141518400400000,NE 154,Residential,24000,105048,0,129048
141518400500000,NE 154,Residential,24000,64432,0,88432
141518400600000,NE 154,Residential,24000,91677,0,115677
141518400700000,NE 154,Residential,24000,82383,0,106383
141518400800000,NE 154,Residential,24000,109278,0,133278
141518400900000,NE 154,Residential,24000,105825,0,129825
141518401000000,NE 154,Residential,24000,97746,0,121746
141518401100000,NE 154,Residential,24000,102925,0,126925
141518401200000,NE 154,Residential,24720,85792,0,110512
141518401300000,NE 154,Residential,25440,89095,0,114535
141518401400000,NE 154,Residential,33600,113155,0,146755
141518401500000,NE 154,Residential,24000,75308,0,99308
141518401600000,NE 154,Residential,24000,101426,0,125426
141518401700000,NE 154,Residential,24000,75495,0,99495
141518401800000,NE 154,Residential,24000,88563,0,112563
141518401900000,NE 154,Residential,24000,114304,0,138304
141518402000000,NE 154,Residential,24000,70750,0,94750
141518402100000,NE 154,Residential,24000,72711,0,96711
141518402200000,NE 154,Residential,24000,91651,0,115651
141518500100000,NE 154,Residential,44741,110854,0,155595
141518500200000,NE 154,Residential,27560,117487,0,145047
141518500300000,NE 154,Residential,26529,118910,0,145439
141518500400000,NE 154,Residential,29552,103476,0,133028
141518500500000,NE 154,Residential,21489,118826,0,140315
141518500600000,NE 154,Residential,20453,98311,0,118764
141518600100000,NE 154,Residential,25472,90369,0,115841
141518600200000,NE 154,Residential,27090,72390,0,99480
141518600300000,NE 154,Residential,26832,104518,0,131350
141518600400000,NE 154,Residential,26574,94329,0,120903
141518600500000,NE 154,Residential,26316,102194,0,128510
141518600600000,NE 154,Residential,27149,76512,0,103661
141518600700000,NE 154,Residential,36000,120093,0,156093
141518600800000,NE 154,Residential,23760,97111,0,120871
141518600900000,NE 154,Residential,23520,103105,0,126625
141518601000000,NE 154,Residential,23280,82755,0,106035
141518601100000,NE 154,Residential,23040,92967,0,116007
141518601200000,NE 154,Residential,22560,53012,0,75572
141518601300000,NE 154,Residential,22320,76326,0,98646
141518601400000,NE 154,Residential,23114,71545,0,94659
141518601500000,NE 154,Residential,25392,78684,0,104076
141518601600000,NE 154,Residential,22320,74077,0,96397
141518601700000,NE 154,Residential,22560,73210,0,95770
141518601800000,NE 154,Residential,23040,71004,0,94044
141518601900000,NE 154,Residential,23280,77024,0,100304
141518602000000,NE 154,Residential,35280,110070,0,145350
141518602100000,NE 154,Residential,26057,76176,0,102233
141518602200000,NE 154,Residential,28600,74740,0,103340
141518602300000,NE 154,Residential,25452,76130,0,101582
141518602400000,NE 154,Residential,25704,83620,0,109324
141518602500000,NE 154,Residential,26208,126412,0,152620
141518602600000,NE 154,Residential,25620,137052,0,162672
141518602700000,NE 154,Residential,27600,95516,0,123116
141518602800000,NE 154,Residential,23280,94328,0,117608
141518602900000,NE 154,Residential,29410,128820,0,158230
141518603000000,NE 154,Residential,23435,93618,0,117053
141518700100000,NE 154,Residential,23400,84226,0,107626
141518700200000,NE 154,Residential,21060,70740,0,91800
141518700300000,NE 154,Residential,21330,66661,0,87991
141518700400000,NE 154,Residential,19656,74289,0,93945
141518700500000,NE 154,Residential,19656,82303,0,101959
141518700600000,NE 154,Residential,24000,87132,0,111132
141518700700000,NE 154,Residential,26400,95668,0,122068
141518700800000,NE 154,Residential,27200,127540,0,154740
141518700900000,NE 154,Residential,27472,75820,0,103292
141518701000000,NE 154,Residential,27472,77059,0,104531
141518701100000,NE 154,Residential,27472,120366,0,147838
141518701200000,NE 154,Residential,27472,85119,0,112591
141518800100000,NE 154,Residential,22886,61531,0,84417
141518800200000,NE 154,Residential,22645,108494,0,131139
141518800300000,NE 154,Residential,22404,86460,0,108864
141518800400000,NE 154,Residential,22108,66657,0,88765
141518800500000,NE 154,Residential,28210,95554,0,123764
141520100101000,CONDO 501,Residential,8000,46804,0,54804
141520100101001,CONDO 501,Residential,8000,46225,0,54225
141520100101002,CONDO 501,Residential,8000,48931,0,56931
141520100101003,CONDO 501,Residential,8000,46804,0,54804
141520100200000,NE 142,Residential,33169,106821,0,139990
141520100300000,NE 142,Residential,34497,106511,0,141008
141520100400000,NE 142,Residential,28785,96528,0,125313
141520100500000,NE 142,Residential,23912,76617,0,100529
141520200100000,NE 142,Residential,33417,97052,0,130469
141520200200000,NE 142,Residential,25622,82505,0,108127
141520200300000,NE 142,Residential,27000,97114,0,124114
141520200400000,NE 142,Residential,27270,81866,0,109136
141520200500000,NE 142,Residential,27810,85168,0,112978
141520200600000,NE 142,Residential,28350,108752,0,137102
141520200700000,NE 142,Residential,28620,91209,0,119829
141520200800000,NE 142,Residential,29160,103649,0,132809
141520200900000,NE 142,Residential,29430,84725,0,114155
141520201000000,NE 142,Residential,29700,74836,0,104536
141520201100000,NE 142,Residential,32468,80862,0,113330
141520201200000,NE 142,Residential,32760,113565,0,146325
141520201300000,NE 142,Residential,32106,112614,0,144720
141520201400000,NE 142,Residential,32640,141687,0,174327
141520201500000,NE 142,Residential,34682,124230,0,158912
141520201600000,NE 142,Residential,30738,153414,0,184152
141520201700000,NE 142,Residential,26532,74351,0,100883
141520201800000,NE 142,Residential,28080,95076,0,123156
141520201900000,NE 142,Residential,28860,138474,0,167334
141520202000000,NE 142,Residential,29067,62445,0,91512
141520202100000,NE 142,Residential,28656,98816,0,127472
141520202200000,NE 142,Residential,28125,132580,0,160705
141520202300000,NE 142,Residential,27595,109892,0,137487
141520202400000,NE 142,Residential,27064,136221,0,163285
141520202500000,NE 142,Residential,26799,116065,0,142864
141520202600000,NE 142,Residential,26799,75310,0,102109
141520202700000,NE 142,Residential,26533,88167,0,114700
141520202800000,NE 142,Residential,24533,86390,0,110923
141520202900000,NE 142,Residential,24779,89769,0,114548
141520203000000,NE 142,Residential,28346,103378,0,131724
141520300100000,NE 142,Residential,32259,88992,0,121251
141520300200000,NE 142,Residential,22997,77849,0,100846
141520300300000,NE 142,Residential,22997,81722,0,104719
141520300400000,NE 142,Residential,22971,96823,0,119794
141520300500000,NE 142,Residential,26717,81941,0,108658
141520300600000,NE 142,Residential,23467,75828,0,99295
141520300700000,NE 142,Residential,23701,81210,0,104911
141520300800000,NE 142,Residential,23701,84125,0,107826
141520300900000,NE 142,Residential,23701,110775,0,134476
141520301000000,NE 142,Residential,23701,112914,0,136615
141520301100000,NE 142,Residential,23467,109781,0,133248
141520301200000,NE 142,Residential,23467,119478,0,142945
141520301300000,NE 142,Residential,26970,123546,0,150516
141520301400000,NE 142,Residential,27440,87645,0,115085
141520301500000,NE 142,Residential,25349,92275,0,117624
141520301600000,NE 142,Residential,24957,123020,0,147977
141520301700000,NE 142,Residential,25991,126083,0,152074
141520301800000,NE 142,Residential,31555,105338,0,136893
141520301900000,NE 142,Residential,22420,103058,0,125478
141520302000000,NE 142,Residential,22848,97066,0,119914
141520302100000,NE 142,Residential,23940,97671,0,121611
141520302200000,NE 142,Residential,31622,151035,0,182657
141520302300000,NE 142,Residential,33884,98750,0,132634
141520302400000,NE 142,Residential,31388,102110,0,133498
141520302500000,NE 142,Residential,25587,80603,0,106190
141520302600000,NE 142,Residential,25476,86787,0,112263
141520302700000,NE 142,Residential,25740,73949,0,99689
141520302800000,NE 142,Residential,25220,78349,0,103569
141520302900000,NE 142,Residential,23680,103164,0,126844
141520303000000,NE 142,Residential,23280,76459,0,99739
141520303100000,NE 142,Residential,23280,82661,0,105941
141520303200000,NE 142,Residential,23520,85614,0,109134
141520303300000,NE 142,Residential,22633,68118,0,90751
141520400100000,NE 142,Residential,29813,112602,0,142415
141520400200000,NE 142,Residential,24480,104593,0,129073
141520400300000,NE 142,Residential,23760,141471,0,165231
141520400400000,NE 142,Residential,23040,98129,0,121169
141520400500000,NE 142,Residential,23903,87207,0,111110
141520400600000,NE 142,Residential,23520,103240,0,126760
141520400700000,NE 142,Residential,20814,58184,0,78998
141520400800000,NE 142,Residential,29580,121720,0,151300
141520400900000,NE 142,Residential,26000,97605,0,123605
141520401000000,NE 142,Residential,25480,133659,0,159139
141520401100000,NE 142,Residential,22800,77752,0,100552
141520401200000,NE 142,Residential,23520,85476,0,108996
141520401300000,NE 142,Residential,24240,86660,0,110900
141520401400000,NE 142,Residential,24720,92602,0,117322
141520401500000,NE 142,Residential,29344,95908,0,125252
141522600100000,NE 145,Residential,36857,124756,0,161613
141522600200000,NE 145,Residential,39780,115226,0,155006
141522600300000,NE 145,Residential,27353,87078,0,114431
141522600400000,NE 145,Residential,32724,122276,0,155000
141522600500000,NE 145,Residential,36000,125393,0,161393
141522600600000,NE 145,Residential,36000,158354,0,194354
141522600700000,NE 145,Residential,36000,143543,0,179543
141522600800000,NE 145,Residential,35100,159857,0,194957
141522600900000,NE 145,Residential,34632,132328,0,166960
141522601000000,NE 145,Residential,34425,106931,0,141356
141522601100000,NE 145,Residential,30750,116236,0,146986
141522601300000,NE 145,Residential,37800,106901,0,144701
141522601400000,NE 145,Residential,37979,98175,0,136154
141522601500000,NE 145,Residential,25110,78544,0,103654
141522601600000,NE 145,Residential,32100,69218,0,101318
141522601700000,NE 145,Residential,36413,132116,0,168529
141522601800000,NE 145,Residential,27500,108406,0,135906
141522601900000,NE 145,Residential,27500,89448,0,116948
141522602100000,NE 144,Residential,35013,114315,0,149328
141522602200000,NE 144,Residential,33475,68364,0,101839
141522602300000,NE 144,Residential,35157,101034,0,136191
141522602400000,NE 144,Residential,29500,65828,0,95328
141522602500000,NE 144,Residential,32833,109196,0,142029
141522602600000,NE 144,Residential,32165,111283,0,143448
141522602700000,NE 144,Residential,30600,138854,0,169454
141522602800000,NE 144,Residential,34707,91942,0,126649
141522602900000,NE 144,Residential,33528,122319,0,155847
141522603000000,NE 144,Residential,28400,136600,0,165000
141522603100000,NE 144,Residential,26395,116424,0,142819
141522603200000,NE 145,Residential,43775,174812,0,218587
141522700100000,NE 145,Residential,37745,131675,0,169420
141522700200000,NE 144,Residential,28644,108862,0,137506
141522700300000,NE 144,Residential,31552,96808,0,128360
141522700400000,NE 144,Residential,31916,130641,0,162557
141522700500000,NE 144,Residential,35094,110497,0,145591
141522700600000,NE 144,Residential,33500,75848,0,109348
141522700700000,NE 144,Residential,32167,89273,0,121440
141522700800000,NE 144,Residential,32167,105376,0,137543
141522700900000,NE 144,Residential,32167,78895,0,111062
141522701000000,NE 144,Residential,30850,75525,0,106375
141522701100000,NE 144,Residential,34751,92408,0,127159
141522701200000,NE 145,Residential,32069,135302,0,167371
141522701300000,NE 145,Residential,31601,172330,0,203931
141522701400000,NE 145,Residential,27160,134012,0,161172
141522701500000,NE 145,Residential,28000,157792,0,185792
141522701600000,NE 145,Residential,30267,84808,0,115075
141522800100000,NE 145,Residential,45333,117558,0,162891
141522800200000,NE 144,Residential,43875,89279,0,133154
141522800300000,NE 144,Residential,43307,97988,0,141295
141522800400000,NE 144,Residential,35075,90398,0,125473
141522800500000,NE 144,Residential,35018,108928,0,143946
141522800600000,NE 144,Residential,33630,101430,0,135060
141522800700000,NE 144,Residential,40470,65565,0,106035
141522800800000,NE 144,Residential,19575,87572,0,107147
141522800900000,NE 145,Residential,21600,86945,0,108545
141522801000000,NE 145,Residential,24250,80215,0,104465
141522801100000,NE 145,Residential,25398,82080,0,107478
141522801200000,NE 145,Residential,25500,101937,0,127437
141522801300000,NE 145,Residential,25500,89465,0,114965
141522801400000,NE 145,Residential,25500,74584,0,100084
141522801500000,NE 145,Residential,29073,75973,0,105046
141522801600000,NE 145,Residential,28000,84422,0,112422
141522801700000,NE 145,Residential,25500,89521,0,115021
141522801800000,NE 145,Residential,25500,90635,0,116135
141522801900000,NE 145,Residential,25500,86518,0,112018
141522802000000,NE 145,Residential,25500,97949,0,123449
141522802100000,NE 145,Residential,25500,72709,0,98209
141522802200000,NE 145,Residential,25500,69463,0,94963
141522802300000,NE 145,Residential,24750,97148,0,121898
141522802400000,NE 145,Residential,30947,80319,0,111266
141522802700000,NE 145,Residential,27986,112562,0,140548
141522802800000,NE 145,Residential,33825,97517,0,131342
141522802900000,NE 145,Residential,21800,87707,0,109507
141522803000000,NE 145,Residential,21600,76908,0,98508
141522803100000,NE 145,Residential,32400,94333,0,126733
141522803400000,NE 145,Residential,29613,101797,0,131410
141522803500000,NE 145,Residential,31100,82615,0,113715
141522900100000,NE 145,Residential,36048,85768,0,121816
141522900200000,NE 145,Residential,20800,78714,0,99514
141522900300000,NE 145,Residential,20800,67957,0,88757
141522900400000,NE 145,Residential,20800,86799,0,107599
141522900500000,NE 145,Residential,26000,120646,0,146646
141522900600000,NE 145,Residential,26000,86156,0,112156
141522900700000,NE 145,Residential,26000,75324,0,101324
141522900800000,NE 145,Residential,26000,77953,0,103953
141522900900000,NE 145,Residential,26000,97539,0,123539
141522901000000,NE 145,Residential,26000,108448,0,134448
141523000100000,NE 145,Residential,38916,97169,0,136085
141523000200000,NE 145,Residential,19817,76156,0,95973
141523000300000,NE 145,Residential,22475,35797,0,58272
141523000400000,NE 145,Residential,25740,44131,0,69871
141523000500000,NE 145,Residential,25922,73660,0,99582
141523000600000,NE 145,Residential,26640,106074,0,132714
141523000700000,NE 145,Residential,27685,114841,0,142526
141523000800000,NE 145,Residential,27930,76868,0,104798
141523000900000,NE 145,Residential,33820,128760,0,162580
141523001000000,NE 145,Residential,23850,57335,0,81185
141523001100000,NE 145,Residential,28730,113784,0,142514
141523001200000,NE 145,Residential,25500,69283,0,94783
141523001300000,NE 145,Residential,36375,107781,0,144156
141523001400000,NE 145,Residential,27950,61361,0,89311
141523100100000,NE 145,Residential,26000,75287,0,101287
141523100200000,NE 145,Residential,26000,57632,0,83632
141523100300000,NE 145,Residential,26000,110639,0,136639
141523100400000,NE 145,Residential,26000,70339,0,96339
141523100500000,NE 145,Residential,26000,52895,0,78895
141523100600000,NE 145,Residential,26000,66502,0,92502
141523100700000,NE 145,Residential,31200,60781,0,91981
141523100800000,NE 145,Residential,26000,55308,0,81308
141525100100000,NE 146,Residential,22725,81138,0,103863
141525100200000,NE 146,Residential,25425,93610,0,119035
141525100300000,NE 146,Residential,18180,77688,0,95868
141525100400000,NE 146,Residential,25812,81513,0,107325
141525200100000,NE 145,Residential,35295,100671,0,135966
141525200200000,NE 145,Residential,26540,61812,0,88352
141525200300000,NE 145,Residential,25186,108855,0,134041
141525200400000,NE 145,Residential,22950,74872,0,97822
141525200500000,NE 145,Exempt,29290,0,66150,95440
141525200600000,NE 145,Residential,27540,71204,0,98744
141525200700000,NE 145,Residential,26928,90363,0,117291
141525200800000,NE 145,Residential,26000,79255,0,105255
141525200900000,NE 145,Residential,25317,98340,0,123657
141525201000000,NE 145,Residential,33957,85965,0,119922
141525201100000,NE 145,Residential,30777,77859,0,108636
141525201200000,NE 145,Residential,26404,64806,0,91210
141525201300000,NE 145,Exempt,27582,0,93590,121172
141525201400000,NE 145,Residential,30816,87082,0,117898
141525300100000,NE 145,Residential,27250,65417,0,92667
141525300200000,NE 145,Residential,33820,66438,0,100258
141525300300000,NE 145,Residential,34883,103219,0,138102
141525300400000,NE 145,Residential,35295,73133,0,108428
141525300500000,NE 145,Residential,35597,75053,0,110650
141525300600000,NE 145,Residential,35685,107220,0,142905
141525300700000,NE 145,Residential,36733,81858,0,118591
141525300800000,NE 145,Residential,36480,67711,0,104191
141525300900000,NE 145,Residential,32205,67902,0,100107
141525301000000,NE 145,Residential,32745,36824,0,69569
141525301100000,NE 145,Residential,32230,57580,0,89810
141525301200000,NE 145,Residential,32700,66394,0,99094
141525301300000,NE 145,Residential,36551,79493,0,116044
141525301400000,NE 145,Residential,33600,115437,0,149037
141525301500000,NE 145,Residential,30179,69719,0,99898
141525301600000,NE 145,Residential,29585,77317,0,106902
141525301700000,NE 145,Residential,24250,85237,0,109487
141525301800000,NE 145,Residential,24250,27553,0,51803
141525301900000,NE 145,Residential,41040,69055,0,110095
141525302000000,NE 145,Residential,23200,72739,0,95939
141525302100000,NE 145,Residential,39200,106895,0,146095
141525302200000,NE 145,Residential,36822,124405,0,161227
141525302300000,NE 145,Residential,30940,85426,0,116366
141525302400000,NE 145,Residential,35227,59751,0,94978
141525302500000,NE 145,Residential,33600,109915,0,143515
141525302600000,NE 145,Residential,24935,54682,0,79617
141525302700000,NE 145,Residential,25200,26940,0,52140
141525302800000,NE 145,Residential,27750,51404,0,79154
141525302900000,NE 145,Residential,23375,59989,0,83364
141525303000000,NE 145,Residential,26160,63790,0,89950
141525303100000,NE 145,Residential,32436,143382,0,175818
141525303200000,NE 145,Residential,38520,98516,0,137036
141525303300000,NE 145,Residential,30240,66204,0,96444
141525303400000,NE 145,Residential,27500,100772,0,128272
141525303500000,NE 145,Residential,29150,157613,0,186763
141525303600000,NE 145,Residential,29680,60085,0,89765
141525303700000,NE 145,Residential,27750,67587,0,95337
141525400100000,NE 145,Residential,32985,54488,0,87473
141525400200000,NE 145,Residential,30611,37002,0,67613
141525400300000,NE 145,Residential,31200,51017,0,82217
141525400400000,NE 145,Residential,31373,57833,0,89206
141525400500000,NE 145,Residential,33820,28512,0,62332
141525400600000,NE 145,Residential,26767,59114,0,85881
141525400700000,NE 145,Residential,28560,87233,0,115793
141525400800000,NE 145,Residential,36489,72013,0,108502
141525400900000,Empty,Exempt,0,0,0,0
141525401000000,NE 145,Residential,33799,84138,0,117937
141525401100000,NE 145,Residential,25380,101095,0,126475
141525401200000,NE 145,Residential,28253,82009,0,110262
141525401300000,NE 145,Residential,26500,98288,0,124788
141525401400000,NE 145,Residential,29280,95323,0,124603
141525401500000,NE 145,Residential,35490,107830,0,143320
141525500100000,NE 146,Residential,22500,123182,0,145682
141525500200000,NE 146,Residential,14850,66863,0,81713
141525500300000,NE 146,Residential,15300,53413,0,68713
141525500400000,NE 146,Residential,14850,51267,0,66117
141525500500000,NE 146,Residential,22500,64830,0,87330
141525500600000,NE 146,Residential,22500,46221,0,68721
141525500700000,NE 146,Residential,15840,54095,0,69935
141525500800000,NE 146,Residential,23000,87924,0,110924
141525500900000,NE 146,Residential,21750,57491,0,79241
141525501000000,NE 146,Residential,19600,87787,0,107387
141525501100000,NE 146,Residential,19000,117712,0,136712
141525501200000,NE 146,Residential,23250,70010,0,93260
141525501300000,NE 146,Residential,23000,86147,0,109147
141525501400000,NE 146,Residential,22500,98632,0,121132
141525501500000,NE 146,Residential,22500,67472,0,89972
141525501600000,NE 146,Residential,22500,128978,0,151478
141525501700000,NE 146,Residential,22500,83946,0,106446
141525501800000,NE 146,Residential,22500,76673,0,99173
141525600100000,NE 146,Residential,15800,64119,0,79919
141525600200000,NE 146,Residential,16600,79302,0,95902
141525600300000,NE 146,Residential,25000,73563,0,98563
141525600400000,NE 146,Residential,25000,82864,0,107864
141525600500000,NE 146,Residential,25000,100684,0,125684
141525600600000,NE 146,Residential,25000,88296,0,113296
141525600700000,NE 146,Residential,25000,81723,0,106723
141525600800000,NE 146,Residential,25000,75767,0,100767
141525600900000,NE 146,Residential,25000,76475,0,101475
141525601000000,NE 146,Residential,25000,108364,0,133364
141525601100000,NE 146,Residential,21000,57713,0,78713
141525601200000,NE 146,Residential,23250,95894,0,119144
141525601300000,NE 146,Residential,19600,74511,0,94111
141525601400000,NE 146,Residential,15200,87903,0,103103
141525601500000,NE 146,Residential,20750,80818,0,101568
141525601600000,NE 146,Residential,21750,103112,0,124862
141525601700000,NE 146,Residential,25000,79106,0,104106
141525601800000,NE 146,Residential,25000,59238,0,84238
141525601900000,NE 146,Residential,25000,55497,0,80497
141525602000000,NE 146,Residential,25000,83292,0,108292
141525602100000,NE 146,Residential,25000,78659,0,103659
141525602200000,NE 146,Residential,25000,67583,0,92583
141525602300000,NE 146,Residential,25000,76489,0,101489
141525602400000,NE 146,Residential,25000,74918,0,99918
141525602500000,NE 146,Residential,25000,80512,0,105512
141525602600000,NE 146,Residential,25000,73666,0,98666
141525602700000,NE 146,Residential,25000,66689,0,91689
141525602800000,NE 146,Residential,24750,115174,0,139924
141525602900000,NE 146,Residential,19400,87111,0,106511
141525603000000,NE 146,Residential,25250,115243,0,140493
141525603100000,NE 146,Residential,21500,77629,0,99129
141527600100000,E-41 RELIG SCHOOLS,Exempt,476874,0,1010961,1487835
141527600200000,COMM NE,Commercial,2404620,0,18236338,20640958
141527601200000,NE 145,Residential,38377,136623,0,175000
141527602000000,NE 145,Residential,36758,191348,0,228106
141527700100000,NE 146,Residential,23430,72015,0,95445
141527700200000,NE 146,Residential,22500,55047,0,77547
141527700300000,NE 146,Residential,22500,64777,0,87277
141527700400000,NE 146,Residential,22500,68646,0,91146
141527700500000,NE 146,Residential,22500,69927,0,92427
141527700600000,NE 146,Residential,22500,57597,0,80097
141527700700000,NE 146,Residential,22500,69537,0,92037
141527700800000,NE 146,Residential,22500,66711,0,89211
141527700900000,NE 146,Residential,22500,72712,0,95212
141527701000000,NE 146,Residential,22500,77688,0,100188
141527701100000,NE 146,Residential,22500,77797,0,100297
141527701200000,NE 146,Residential,22500,64670,0,87170
141527701300000,NE 146,Residential,22500,44681,0,67181
141527701400000,NE 146,Residential,22500,69036,0,91536
141527701500000,NE 146,Residential,22500,48164,0,70664
141527701600000,NE 146,Residential,22500,43075,0,65575
141527701700000,NE 146,Residential,22500,62029,0,84529
141527701800000,NE 146,Residential,22500,57880,0,80380
141527701900000,NE 146,Residential,22500,53350,0,75850
141527702000000,NE 146,Residential,22500,61857,0,84357
141527702100000,NE 146,Residential,22500,29259,0,51759
141527702200000,NE 146,Residential,22500,35744,0,58244
141527702300000,NE 146,Residential,22500,57922,0,80422
141527702400000,NE 146,Residential,22500,48548,0,71048
141527702500000,NE 146,Residential,22500,34911,0,57411
141527702600000,NE 146,Residential,24799,51577,0,76376
141530100100000,INDUSTRIAL,Industrial,135915,0,27353,163268
141530100200000,COMM NE,Commercial,72900,0,65260,138160
141530100300000,INDUSTRIAL,Industrial,63000,0,108815,171815
141530100400000,COMM NE,Commercial,45360,0,23437,68797
141530100500000,COMM NE,Commercial,23220,0,0,23220
141530100600000,COMM NE,Commercial,23220,0,23596,46816
141530100700000,COMM NE,Commercial,23220,0,9844,33064
141530100800000,COMM NE,Commercial,23220,0,4440,27660
141530100900000,COMM NE,Commercial,23220,0,25987,49207
141530101000000,COMM NE,Commercial,23220,0,12314,35534
141530101100000,E-15 CITY,Exempt,0,0,0,0
141530101200000,INDUSTRIAL,Industrial,51450,0,0,51450
141530200100000,INDUSTRIAL,Industrial,584500,0,4175836,4760336
141530300100000,INDUSTRIAL,Industrial,25650,0,11443,37093
141530300200000,INDUSTRIAL,Industrial,90375,0,69837,160212
141530400100000,NE 154,Residential,25220,82092,0,107312
141530400200000,NE 154,Residential,25220,61423,0,86643
141530400300000,NE 154,Residential,26562,68821,0,95383
141530500100000,NE 155,Residential,22000,66937,0,88937
141530500200000,NE 155,Residential,25740,71322,0,97062
141530500300000,NE 155,Residential,26180,58472,0,84652
141530500400000,NE 155,Residential,22990,70049,0,93039
141530500600000,NE 155,Residential,20000,70319,0,90319
141530500700000,COMM NE,Commercial,68040,0,339318,407358
141530501000000,NE 155,Residential,20000,54898,0,74898
141530501100000,NE 155,Residential,23800,55060,0,78860
141530501200000,NE 155,Residential,13200,51059,0,64259
141530501300000,NE 155,Residential,12800,57112,0,69912
141530501400000,NE 155,Residential,20000,81799,0,101799
141530501500000,NE 155,Residential,20000,66552,0,86552
141530501600000,NE 155,Residential,20000,112873,0,132873
141530501700000,NE 155,Residential,20000,62837,0,82837
141530501800000,NE 155,Residential,20000,65031,0,85031
141530501900000,NE 155,Residential,20000,55677,0,75677
141532600100000,NE 146,Residential,22050,100996,0,123046
141532600200000,NE 146,Residential,21065,0,0,21065
141532600300000,NE 146,Residential,30000,63534,0,93534
141532600400000,NE 146,Residential,30000,65117,0,95117
141532600500000,NE 146,Residential,30000,89620,0,119620
141532600600000,NE 146,Residential,30000,61503,0,91503
141532600700000,NE 146,Residential,30000,71827,0,101827
141532600800000,NE 146,Residential,15000,58800,0,73800
141532600900000,NE 146,Residential,15000,58045,0,73045
141532601000000,NE 146,Residential,15000,63479,0,78479
141532601100000,NE 146,Residential,15000,63851,0,78851
141532601200000,NE 146,Residential,20000,66642,0,86642
141532601300000,NE 146,Residential,20000,51821,0,71821
141532601400000,NE 146,Residential,20000,72771,0,92771
141532601500000,NE 146,Residential,20000,49374,0,69374
141532601600000,NE 146,Residential,20000,51471,0,71471
141532601700000,NE 146,Residential,20000,52126,0,72126
141532601800000,COMM NE,Commercial,283608,0,254236,537844
141532700100000,NE 146,Residential,30000,67469,0,97469
141532700200000,NE 146,Residential,21193,58699,0,79892
141532700300000,NE 146,Residential,20200,69182,0,89382
141532700400000,NE 146,Residential,20200,58019,0,78219
141532700500000,NE 146,Residential,20200,93427,0,113627
141532700600000,NE 146,Residential,20200,71838,0,92038
141532700700000,NE 146,Residential,20200,70119,0,90319
141532700800000,NE 146,Residential,15982,68888,0,84870
141532700900000,NE 146,Residential,16450,65069,0,81519
141532701000000,NE 146,Residential,16200,83712,0,99912
141532701100000,NE 146,Residential,16384,83844,0,100228
141532701200000,NE 146,Residential,20200,52438,0,72638
141532701300000,NE 146,Residential,20200,81067,0,101267
141532701400000,NE 146,Residential,20200,65163,0,85363
141532701500000,NE 146,Residential,20200,63213,0,83413
141532701600000,NE 146,Residential,20200,69629,0,89829
141532701700000,NE 146,Residential,19459,71054,0,90513
141532701800000,NE 146,Residential,30000,60168,0,90168
141532701900000,NE 146,Residential,20000,59089,0,79089
141532702000000,NE 146,Residential,22500,85279,0,107779
141532702100000,NE 146,Residential,17500,72000,0,89500
141532702200000,NE 146,Residential,30000,29762,0,59762
141532800100000,NE 146,Residential,16510,69053,0,85563
141532800200000,NE 146,Residential,19000,63307,0,82307
141532800300000,NE 146,Residential,21742,84854,0,106596
141532800400000,NE 146,Residential,19000,33116,0,52116
141532800500000,NE 146,Residential,19000,68362,0,87362
141532800600000,NE 146,Residential,19000,40450,0,59450
141532800700000,NE 146,Residential,19000,68923,0,87923
141532800800000,NE 146,Residential,19000,70606,0,89606
141532800900000,NE 146,Residential,22800,53822,0,76622
141532801000000,NE 146,Residential,22800,119079,0,141879
141532801100000,NE 146,Residential,19000,76640,0,95640
141532801200000,NE 146,Residential,19000,52919,0,71919
141532801300000,NE 146,Residential,12350,108782,0,121132
141532801400000,NE 146,Residential,12350,0,0,12350
141532801500000,NE 146,Residential,26329,58671,0,85000
141532801600000,NE 146,Residential,19716,88073,0,107789
141532801700000,NE 146,Residential,15200,60469,0,75669
141532801800000,NE 146,Residential,15200,63134,0,78334
141532801900000,NE 146,Residential,15200,56582,0,71782
141532802000000,NE 146,Residential,15200,53770,0,68970
141532802100000,NE 146,Residential,15200,53830,0,69030
141532802200000,NE 146,Residential,15200,66896,0,82096
141532802300000,NE 146,Residential,15200,53281,0,68481
141532802400000,NE 146,Residential,15200,45617,0,60817
141532802500000,NE 146,Residential,15200,42729,0,57929
141532802600000,NE 146,Residential,15200,74975,0,90175
141532802700000,NE 146,Residential,15200,3323,0,18523
141532802800000,NE 146,Residential,15200,42443,0,57643
141532802900000,NE 146,Residential,15200,70312,0,85512
141532803000000,NE 146,Residential,15200,53899,0,69099
141532900100000,NE 146,Residential,25000,75645,0,100645
141532900200000,NE 146,Residential,20933,61723,0,82656
141532900300000,NE 146,Residential,20000,80557,0,100557
141532900400000,NE 146,Residential,20000,57972,0,77972
141532900500000,NE 146,Residential,20000,55071,0,75071
141532900600000,NE 146,Residential,20000,53596,0,73596
141532900700000,NE 146,Residential,20000,68738,0,88738
141532900800000,NE 146,Residential,21767,56463,0,78230
141532900900000,NE 146,Residential,21270,62087,0,83357
141532901000000,NE 146,Residential,20000,66717,0,86717
141532901100000,NE 146,Residential,20000,54724,0,74724
141532901200000,NE 146,Residential,20000,55618,0,75618
141532901300000,NE 146,Residential,20000,52612,0,72612
141532901400000,NE 146,Residential,25394,50806,0,76200
141532901500000,NE 146,Residential,30000,108847,0,138847
141532901600000,NE 146,Residential,30000,73009,0,103009
141532901700000,NE 146,Residential,20000,77311,0,97311
141532901800000,NE 146,Residential,20000,64186,0,84186
141532901900000,NE 146,Residential,25000,70105,0,95105
141533000100000,Empty,Other,0,0,0,0
141533000900000,COMM NE,Commercial,27216,0,40009,67225
141533001000000,COMM NE,Commercial,25272,0,7660,32932
141533100100000,INDUSTRIAL,Industrial,20250,0,439051,459301
141533100200000,NE 146,Residential,25092,58736,0,83828
141533100300000,NE 146,Residential,20400,44321,0,64721
141533100400000,NE 146,Residential,20400,50603,0,71003
141533100500000,NE 146,Residential,20400,80241,0,100641
141533100600000,NE 146,Residential,20400,58963,0,79363
141533100700000,NE 146,Residential,21027,58900,0,79927
141533100800000,INDUSTRIAL,Industrial,47550,0,1189447,1236997
141533200200000,NE 146,Residential,20837,74357,0,95194
141533200300000,NE 146,Residential,19000,72533,0,91533
141533200400000,NE 146,Residential,19000,85813,0,104813
141533200500000,NE 146,Residential,19000,83155,0,102155
141533200600000,NE 146,Residential,19000,88962,0,107962
141533200700000,NE 146,Residential,19000,71357,0,90357
141533200800000,NE 146,Residential,19000,87336,0,106336
141533200900000,NE 146,Residential,19000,74418,0,93418
141533201000000,NE 146,Residential,19000,69537,0,88537
141533201100000,NE 146,Residential,19000,86765,0,105765
141533201200000,NE 146,Residential,19000,73763,0,92763
141533201300000,NE 146,Residential,19000,52206,0,71206
141533201400000,NE 146,Residential,19000,58854,0,77854
141533201500000,NE 146,Residential,19000,57689,0,76689
141533300100000,NE 146,Residential,14998,65926,0,80924
141533301600000,NE 146,Residential,14040,60509,0,74549
141533301700000,NE 146,Residential,14040,27793,0,41833
141533301800000,NE 146,Residential,14917,60643,0,75560
141533301900000,NE 146,Residential,17199,66925,0,84124
141533302000000,NE 146,Residential,14040,53387,0,67427
141533302100000,NE 146,Residential,14040,48773,0,62813
141533302200000,NE 146,Residential,18252,57689,0,75941
141535100100000,COMM NE,Commercial,151200,0,62949,214149
141535100200000,COMM NE,Commercial,1944,0,463,2407
141535100300000,COMM NE,Commercial,36288,0,48217,84505
141535100400000,COMM NE,Commercial,18144,0,3086,21230
141535200200000,Empty,Other,0,0,0,0
141535200400000,COMM NE,Commercial,137565,0,919764,1057329
141535200500000,Empty,Other,0,0,0,0
141535200700000,COMM NE,Commercial,113400,0,134984,248384
141535200800000,COMM NE,Commercial,33048,0,0,33048
141535300100000,INDUSTRIAL,Industrial,9120,0,7803,16923
141535300200000,NE 146,Residential,19000,69151,0,88151
141535300300000,NE 146,Residential,19000,55430,0,74430
141535300400000,NE 146,Residential,19000,52217,0,71217
141535300500000,COMM NE,Commercial,18873,0,25633,44506
141535400100000,NE 156,Residential,7000,54163,0,61163
141535400200000,NE 156,Residential,7665,52326,0,59991
141535400300000,NE 156,Residential,7665,43480,0,51145
141535400400000,COMM NE,Commercial,45911,0,41913,87824
141535400500000,NE 156,Residential,9450,31173,0,40623
141535400800000,COMM NE,Commercial,101520,0,217473,318993
141535401000000,INDUSTRIAL,Industrial,30129,0,1109,31238
141535401100000,COMM NE,Commercial,6869,0,9231,16100
141535401200000,COMM NE,Commercial,10342,0,2277,12619
141535401300000,COMM NE,Commercial,8372,0,58521,66893
141535401400000,COMM NE,Commercial,15759,0,71691,87450
141535401500000,COMM NE,Commercial,126630,0,597893,724523
141535401600000,NE 156,Residential,13500,62230,0,75730
141535401700000,NE 156,Residential,8375,50034,0,58409
141535500100000,INDUSTRIAL,Industrial,478600,0,3521400,4000000
141535600100000,NE 156,Residential,8925,45351,0,54276
141535600200000,NE 156,Residential,9450,54611,0,64061
141535600300000,NE 156,Residential,7560,45471,0,53031
141535600400000,NE 156,Residential,7560,48894,0,56454
141535600500000,NE 156,Residential,12897,84320,0,97217
141535600600000,NE 156,Residential,12350,56714,0,69064
141535600700000,NE 156,Residential,12350,55250,0,67600
141535600800000,NE 156,Residential,10000,61623,0,71623
141535600900000,NE 156,Residential,13000,48656,0,61656
141535601000000,NE 156,Residential,12587,65714,0,78301
141535601100000,NE 156,Residential,12587,51515,0,64102
141535601200000,NE 156,Residential,12587,66488,0,79075
141535601300000,NE 156,Residential,6700,39261,0,45961
141535601400000,CONVERSIONS,Commercial,8965,0,52524,61489
141535601500000,NE 156,Residential,14290,64777,0,79067
141535601600000,NE 156,Residential,15105,54790,0,69895
141535601700000,NE 156,Residential,15105,96797,0,111902
141535601800000,NE 156,Residential,14820,37225,0,52045
141535601900000,NE 156,Residential,14820,58140,0,72960
141535602000000,NE 156,Residential,14820,71269,0,86089
141535602100000,CONVERSIONS,Commercial,11794,0,39663,51457
141535602200000,NE 156,Residential,525,0,0,525
141535700100000,INDUSTRIAL,Industrial,615,0,0,615
141535700200000,NE 156,Residential,13515,78523,0,92038
141535700300000,NE 156,Residential,13260,71520,0,84780
141535700400000,APTS NE,Commercial,14277,0,151988,166265
141535700500000,NE 156,Residential,13860,12950,0,26810
141535800100000,NE 156,Residential,14820,43928,0,58748
141535800200000,NE 156,Residential,15105,66958,0,82063
141535800300000,CONVERSIONS,Commercial,12020,0,59325,71345
141535800400000,NE 156,Residential,15105,66497,0,81602
141535800500000,NE 156,Residential,11027,42595,0,53622
141535800600000,NE 156,Exempt,4703,0,37532,42235
141535800700000,NE 156,Residential,4703,49934,0,54637
141535800800000,NE 156,Residential,2635,1707,0,4342
141535800900000,NE 156,Residential,11827,48108,0,59935
141535801000000,CONVERSIONS,Commercial,12020,0,47457,59477
141535801100000,NE 156,Residential,12587,41333,0,53920
141535900100000,COMM NE,Commercial,19440,0,0,19440
141535900102000,COMM NE,Commercial,0,0,38921,38921
141535900200000,NE 156,Residential,6200,46895,0,53095
141535900300000,NE 156,Residential,7750,39432,0,47182
141535900400000,NE 156,Residential,6975,48100,0,55075
141535900500000,NE 156,Residential,6975,60739,0,67714
141535900600000,APTS NE,Residential,13608,125758,0,139366
141535900700000,NE 156,Residential,7500,43113,0,50613
141535900800000,NE 156,Residential,7500,41243,0,48743
141535900900000,NE 156,Residential,12750,41847,0,54597
141535901000000,NE 156,Residential,12750,59556,0,72306
141535901100000,NE 156,Residential,12750,24815,0,37565
141535901200000,NE 156,Residential,7500,60698,0,68198
141535901300000,NE 156,Residential,7500,44705,0,52205
141535901400000,NE 156,Residential,7500,49238,0,56738
141535901500000,NE 156,Residential,7500,40438,0,47938
141535901600000,CONVERSIONS,Commercial,13608,0,30030,43638
141535901700000,NE 156,Residential,11220,69779,0,80999
141535901800000,NE 156,Residential,6200,52979,0,59179
141535901900000,NE 156,Residential,7500,55588,0,63088
141535902000000,NE 156,Residential,7500,48817,0,56317
141535902100000,NE 156,Residential,7500,59206,0,66706
141535902200000,NE 156,Residential,7500,59851,0,67351
141535902300000,NE 156,Residential,7500,57969,0,65469
141535902400000,NE 156,Residential,12750,63510,0,76260
141535902500000,NE 156,Residential,10000,17002,0,27002
141535902600000,NE 156,Residential,10000,49337,0,59337
141535902700000,NE 156,Residential,8000,52955,0,60955
141535902800000,NE 156,Residential,13600,72191,0,85791
141536000100000,NE 156,Residential,6200,52198,0,58398
141536000200000,COMM NE,Commercial,3888,0,50981,54869
141536000300000,NE 156,Residential,4050,58223,0,62273
141536000400000,NE 156,Residential,8750,52367,0,61117
141536000500000,NE 156,Residential,7200,61533,0,68733
141536000600000,NE 156,Residential,12500,48145,0,60645
141536000700000,NE 156,Residential,10000,75462,0,85462
141537600100000,NE 155,Residential,20000,62253,0,82253
141537600200000,NE 155,Residential,20000,73985,0,93985
141537600300000,NE 155,Residential,20000,59913,0,79913
141537600400000,NE 155,Residential,24000,95249,0,119249
141537600500000,NE 155,Residential,20000,93257,0,113257
141537600600000,NE 155,Residential,20000,83552,0,103552
141537600700000,NE 155,Residential,26400,129221,0,155621
141537600800000,NE 155,Residential,16000,84600,0,100600
141537600900000,NE 155,Residential,9240,59739,0,68979
141537601000000,NE 155,Residential,9240,49304,0,58544
141537601100000,NE 155,Residential,9240,83366,0,92606
141537601200000,NE 155,Residential,9240,70641,0,79881
141537601300000,APTS NE,Commercial,16403,0,251117,267520
141537601400000,CONVERSIONS,Commercial,11948,0,99267,111215
141537601500000,NE 155,Residential,15000,49073,0,64073
141537601600000,NE 155,Residential,15000,76182,0,91182
141537601700000,NE 155,Residential,20000,71051,0,91051
141537601800000,NE 155,Residential,16000,79238,0,95238
141537601900000,NE 155,Residential,18000,79373,0,97373
141537602000000,NE 155,Residential,22100,100475,0,122575
141537602100000,NE 155,Residential,20000,61708,0,81708
141537700100000,NE 155,Residential,20000,80367,0,100367
141537700200000,NE 155,Residential,20000,55757,0,75757
141537700300000,NE 155,Residential,20000,76114,0,96114
141537700400000,NE 155,Residential,20000,78031,0,98031
141537700500000,NE 155,Residential,20000,48835,0,68835
141537700600000,NE 155,Residential,18028,64457,0,82485
141537700700000,NE 155,Residential,16600,56640,0,73240
141537700800000,NE 155,Residential,11400,53393,0,64793
141537700900000,NE 155,Residential,20000,70552,0,90552
141537701000000,NE 155,Residential,20000,71431,0,91431
141537701100000,NE 155,Residential,20000,76292,0,96292
141537800100000,NE 155,Residential,16560,117875,0,134435
141537800200000,NE 155,Residential,10560,24367,0,34927
141537800300000,NE 155,Residential,10560,41461,0,52021
141537800400000,NE 155,Residential,9240,52457,0,61697
141537800500000,NE 155,Residential,9125,39174,0,48299
141537800600000,NE 155,Residential,9125,40749,0,49874
141537800700000,NE 155,Residential,12500,43767,0,56267
141537800800000,NE 155,Residential,12500,41523,0,54023
141537800900000,NE 155,Residential,12750,50965,0,63715
141537801000000,NE 155,Residential,12750,78767,0,91517
141537801100000,NE 155,Residential,13200,69356,0,82556
141537801200000,NE 155,Residential,10375,44821,0,55196
141537801300000,NE 155,Residential,10375,83625,0,94000
141537801400000,NE 155,Residential,13200,75054,0,88254
141537801500000,APTS NE,Commercial,8100,0,112369,120469
141537801600000,NE 155,Residential,13200,62900,0,76100
141537801700000,CONVERSIONS,Commercial,21870,0,55152,77022
141537801800000,APTS NE,Commercial,9720,0,105540,115260
141537801900000,APTS NE,Commercial,34020,0,424389,458409
141537802100000,NE 155,Residential,18360,102300,0,120660
141537802200000,NE 155,Residential,18720,145157,0,163877
141537802300000,NE 155,Residential,9997,0,0,9997
141537802400000,NE 155,Residential,9997,0,0,9997
141537900100000,COMM NE,Commercial,105300,0,279411,384711
141537900200000,COMM NE,Commercial,38880,0,80439,119319
141537900300000,COMM NE,Commercial,2430,0,0,2430
141537900400000,COMM NE,Commercial,75330,0,192917,268247
141538000100000,NE 155,Residential,20400,74631,0,95031
141538000200000,NE 155,Residential,20400,65935,0,86335
141538000300000,NE 155,Residential,20400,64402,0,84802
141538000400000,NE 155,Residential,20400,69477,0,89877
141538000500000,NE 155,Residential,17600,39957,0,57557
141538000600000,NE 155,Residential,17600,53386,0,70986
141538000700000,APTS NE,Commercial,13446,0,97738,111184
141538000800000,CONVERSIONS,Commercial,18954,0,114710,133664
141538000900000,NE 155,Residential,24480,158259,0,182739
141538100100000,NE 155,Residential,19500,128557,0,148057
141538100200000,NE 155,Residential,18000,140045,0,158045
141538100300000,NE 155,Residential,15000,64413,0,79413
141538100400000,NE 155,Residential,15000,67633,0,82633
141538100500000,NE 155,Residential,15000,84039,0,99039
141538100600000,NE 155,Residential,15000,72951,0,87951
141538100700000,NE 156,Residential,15000,66575,0,81575
141538100800000,CONVERSIONS,Commercial,11340,0,38059,49399
141538100900000,CONVERSIONS,Commercial,11340,0,72886,84226
141538101000000,NE 155,Residential,15000,69639,0,84639
141538101100000,NE 155,Residential,14100,59733,0,73833
141538101200000,NE 155,Residential,10500,54620,0,65120
141538101300000,NE 155,Residential,6510,56079,0,62589
141538101400000,NE 155,Residential,6510,57316,0,63826
141538101500000,NE 155,Residential,7980,68437,0,76417
141538101600000,NE 156,Residential,10695,72484,0,83179
141538101700000,NE 155,Residential,8040,64756,0,72796
141538101800000,NE 155,Residential,8040,69617,0,77657
141538101900000,NE 155,Residential,11010,79893,0,90903
141538102000000,NE 155,Residential,15595,82691,0,98286
141538102100000,APTS NE,Commercial,14580,0,202181,216761
141538102200000,NE 155,Residential,15000,83631,0,98631
141538102300000,NE 155,Residential,15300,102942,0,118242
141538102400000,NE 155,Residential,15000,106705,0,121705
141538102500000,NE 155,Residential,15000,85495,0,100495
141538102600000,NE 155,Residential,15000,80144,0,95144
141538200100000,NE 156,Residential,8778,62112,0,70890
141538200200000,NE 156,Residential,8778,37758,0,46536
141538200300000,NE 156,Residential,5040,38981,0,44021
141538200400000,NE 156,Residential,14820,74797,0,89617
141538300100000,NE 155,Residential,10650,101242,0,111892
141538300200000,NE 155,Residential,8813,91078,0,99891
141538300300000,NE 155,Residential,6480,52284,0,58764
141538300400000,NE 155,Residential,6480,70310,0,76790
141538300500000,NE 155,Residential,9300,77302,0,86602
141538300600000,NE 155,Residential,9000,66052,0,75052
141538300700000,NE 155,Residential,10500,58078,0,68578
141538300800000,NE 155,Residential,10500,67930,0,78430
141538300900000,NE 155,Residential,15000,99328,0,114328
141538301000000,CONVERSIONS,Commercial,11340,0,56750,68090
141538301100000,NE 155,Residential,15000,74130,0,89130
141538301200000,NE 155,Residential,9900,73827,0,83727
141538301300000,NE 155,Residential,9900,67917,0,77817
141538301400000,NE 155,Residential,10200,57146,0,67346
141538301500000,APTS NE,Commercial,11340,0,156846,168186
141538301600000,NE 155,Residential,15000,59415,0,74415
141538301700000,NE 155,Residential,9300,70317,0,79617
141538301800000,NE 155,Residential,9300,61738,0,71038
141538301900000,NE 155,Residential,13200,67198,0,80398
141538302000000,NE 155,Residential,7920,86026,0,93946
141538302100000,E-40 CHURCHES,Exempt,45144,0,475254,520398
141538302200000,NE 155,Residential,12000,68035,0,80035
141538302300000,NE 155,Residential,12000,69923,0,81923
141538302400000,NE 155,Residential,15300,132965,0,148265
141538302500000,NE 155,Residential,15000,79169,0,94169
141538302600000,CONVERSIONS,Commercial,11340,0,56279,67619
141538302700000,NE 155,Residential,15000,55480,0,70480
141538400100000,NE 156,Residential,10250,45282,0,55532
141538400200000,NE 156,Residential,8400,67142,0,75542
141538400300000,NE 156,Residential,8400,48219,0,56619
141538400400000,NE 156,Residential,7560,30946,0,38506
141538400500000,NE 156,Residential,7560,50396,0,57956
141538400600000,NE 156,Residential,14820,62449,0,77269
141538400700000,NE 156,Residential,14820,59917,0,74737
141538400800000,NE 156,Residential,10500,56646,0,67146
141538400900000,NE 156,Residential,10500,71631,0,82131
141538401000000,NE 156,Residential,10200,51246,0,61446
141538401100000,NE 156,Residential,12587,44527,0,57114
141538401200000,NE 156,Residential,12350,77170,0,89520
141538401300000,NE 156,Residential,13000,10488,0,23488
141538401400000,NE 156,Residential,12350,60157,0,72507
141538401500000,NE 156,Residential,12350,61391,0,73741
141538401600000,NE 156,Residential,12350,10922,0,23272
141538500100000,APTS NE,Commercial,22680,0,242391,265071
141538500200000,CONVERSIONS,Commercial,5103,0,66660,71763
141538500300000,NE 155,Residential,11250,87439,0,98689
141538500400000,NE 155,Residential,9900,84592,0,94492
141538500500000,NE 155,Residential,10200,79278,0,89478
141538500600000,NE 155,Residential,9900,83736,0,93636
141538500700000,NE 155,Residential,15000,60363,0,75363
141538500800000,NE 155,Residential,15000,76970,0,91970
141538500900000,NE 155,Residential,15000,91310,0,106310
141538501000000,NE 155,Residential,15000,100668,0,115668
141538501100000,NE 155,Residential,15000,85113,0,100113
141538501200000,NE 155,Residential,15000,72819,0,87819
141538501300000,NE 155,Residential,15000,63155,0,78155
141538501400000,NE 155,Residential,15000,49250,0,64250
141538501500000,NE 155,Residential,12500,88539,0,101039
141538501600000,NE 155,Residential,12500,52303,0,64803
141538501700000,NE 155,Residential,12500,16298,0,28798
141538501800000,NE 155,Residential,10000,48610,0,58610
141538501900000,NE 155,Residential,12750,57471,0,70221
141538600100000,NE 156,Residential,10374,78156,0,88530
141538600200000,NE 156,Residential,8232,49523,0,57755
141538600300000,NE 156,Residential,9408,71891,0,81299
141538600400000,NE 156,Residential,8645,56656,0,65301
141538600500000,NE 156,Residential,12350,58306,0,70656
141538600600000,NE 156,Residential,12350,64602,0,76952
141538600700000,NE 156,Residential,12350,48217,0,60567
141538600800000,NE 156,Residential,12350,53608,0,65958
141538600900000,NE 156,Residential,12350,52136,0,64486
141538601000000,NE 156,Residential,13000,49675,0,62675
141540100100000,NE 154,Residential,23800,91076,0,114876
141540100200000,NE 154,Residential,26176,72858,0,99034
141540100300000,NE 154,Residential,23825,111089,0,134914
141540100400000,NE 154,Residential,31256,174274,0,205530
141540100500000,NE 154,Residential,28776,147648,0,176424
141540100600000,NE 154,Residential,9275,47168,0,56443
141540100700000,NE 154,Residential,30240,78667,0,108907
141540100800000,NE 154,Residential,39258,200709,0,239967
141540100900000,NE 154,Residential,25627,103753,0,129380
141540200100000,NE 154,Residential,24240,109904,0,134144
141540200200000,NE 154,Residential,30652,103351,0,134003
141540200300000,NE 154,Residential,27000,76971,0,103971
141540200400000,NE 154,Residential,30192,116761,0,146953
141540300100000,NE 154,Residential,27257,143557,0,170814
141540300200000,NE 154,Residential,27918,113455,0,141373
141540300300000,NE 154,Residential,27876,88240,0,116116
141540300400000,NE 154,Residential,30576,90156,0,120732
141540300500000,NE 154,Residential,26162,80499,0,106661
141540300600000,NE 154,Residential,26038,82861,0,108899
141540300700000,NE 154,Residential,30282,115576,0,145858
141540300800000,NE 154,Residential,26945,62200,0,89145
141540300900000,NE 154,Residential,24720,68997,0,93717
141540301000000,NE 154,Residential,34608,152127,0,186735
141540301100000,NE 154,Residential,24240,75348,0,99588
141540301200000,NE 154,Residential,24000,73000,0,97000
141540301300000,NE 154,Residential,24000,69920,0,93920
141540301400000,NE 154,Residential,23775,102224,0,125999
141540301500000,NE 154,Residential,23367,86308,0,109675
141540301600000,NE 154,Residential,23126,81061,0,104187
141540301700000,NE 154,Residential,27918,97998,0,125916
141540301800000,NE 154,Residential,22080,66978,0,89058
141540301900000,NE 154,Residential,22320,55999,0,78319
141540302000000,NE 154,Residential,22560,75162,0,97722
141540302100000,NE 154,Residential,31104,94250,0,125354
141540302200000,NE 154,Residential,31428,126195,0,157623
141540302300000,NE 154,Residential,26264,73569,0,99833
141540302400000,NE 154,Residential,24532,87052,0,111584
141540302500000,NE 154,Residential,24592,54086,0,78678
141540302600000,NE 154,Residential,25160,62065,0,87225
141540302700000,NE 154,Residential,25360,112482,0,137842
141540302800000,NE 154,Residential,25614,130551,0,156165
141540302900000,NE 154,Residential,26220,94310,0,120530
141540303000000,NE 154,Residential,26275,70221,0,96496
141540303100000,NE 154,Residential,24720,65360,0,90080
141540303200000,NE 154,Residential,25584,93572,0,119156
141540303300000,NE 154,Residential,25584,56990,0,82574
141540303400000,NE 154,Residential,25132,56822,0,81954
141540303500000,NE 154,Residential,25704,54309,0,80013
141540400100000,Empty,Exempt,0,0,0,0
141540400200000,NE 154,Residential,29128,78650,0,107778
141540400300000,NE 154,Residential,28200,64274,0,92474
141540500100000,NE 154,Residential,25286,52290,0,77576
141540500200000,NE 154,Residential,15000,15000,0,30000
141540500300000,NE 154,Residential,32818,98124,0,130942
141540500400000,NE 154,Residential,36115,111694,0,147809
141540500500000,E-70 CHARITY OTHER,Exempt,382644,0,504208,886852
141540500600000,NE 154,Residential,19600,92336,0,111936
141540500700000,NE 154,Residential,20667,74938,0,95605
141540500800000,NE 154,Residential,24444,78740,0,103184
141540600100000,NE 154,Residential,18239,69525,0,87764
141540600200000,NE 154,Residential,20400,81094,0,101494
141540600300000,NE 154,Residential,20400,67264,0,87664
141540600400000,NE 154,Residential,17640,62615,0,80255
141540600500000,NE 154,Residential,17430,61808,0,79238
141540600600000,NE 154,Residential,19680,65596,0,85276
141540600700000,NE 154,Residential,19200,64773,0,83973
141540600800000,NE 154,Residential,31663,89060,0,120723
141540600900000,NE 154,Residential,30962,107952,0,138914
141540601000000,NE 154,Residential,32076,115714,0,147790
141540601100000,NE 154,Residential,33174,111319,0,144493
141540601200000,NE 154,Residential,33600,119396,0,152996
141540601300000,NE 154,Residential,22221,113374,0,135595
141540601400000,NE 154,Residential,31080,85689,0,116769
141540601500000,NE 154,Residential,31080,100938,0,132018
141540601600000,NE 154,Residential,40680,136544,0,177224
141540601700000,NE 154,Residential,36960,140936,0,177896
141540601800000,NE 154,Residential,26400,88158,0,114558
141540601900000,NE 154,Residential,26400,105216,0,131616
141540602000000,NE 154,Residential,24480,103510,0,127990
141540602100000,NE 154,Residential,35964,111019,0,146983
141540602200000,NE 154,Residential,23232,72261,0,95493
141540602300000,NE 154,Residential,23232,90091,0,113323
141540602400000,NE 154,Residential,23232,88729,0,111961
141540602500000,NE 154,Residential,23232,73234,0,96466
141540602700000,APTS NE,Commercial,40932,0,10789,51721
141540602800000,APTS NE,Residential,39042,760958,0,800000
141540602900000,NE 154,Residential,28728,94801,0,123529
141540603000000,NE 154,Residential,23158,83631,0,106789
141540603100000,NE 154,Residential,22284,83420,0,105704
141540603200000,NE 154,Residential,19508,52141,0,71649
141540603300000,APTS NE,Commercial,67338,0,1591964,1659302
141540603400000,NE 154,Residential,17600,55125,0,72725
141540700100000,NE 154,Residential,24624,137834,0,162458
141540700200000,NE 154,Residential,18240,72111,0,90351
141540700300000,NE 154,Residential,28500,80020,0,108520
141540700400000,NE 154,Residential,30600,70185,0,100785
141540700500000,NE 154,Residential,22950,72446,0,95396
141540700600000,NE 154,Residential,19800,55026,0,74826
141540700700000,NE 154,Residential,26928,90238,0,117166
141540700800000,NE 154,Residential,21120,78718,0,99838
141540700900000,NE 154,Residential,24480,80726,0,105206
141540701000000,NE 154,Residential,24480,106132,0,130612
141540701100000,NE 154,Residential,21120,93355,0,114475
141540800100000,SE 218,Residential,45540,155304,0,200844
141542600100000,NE 154,Residential,30388,84213,0,114601
141542600200000,NE 154,Residential,30096,117019,0,147115
141542600300000,NE 154,Residential,28000,82773,0,110773
141542600400000,NE 154,Residential,32150,75949,0,108099
141542600500000,NE 154,Residential,24000,82018,0,106018
141542600600000,NE 154,Residential,30000,86089,0,116089
141542600700000,NE 154,Residential,32130,74312,0,106442
141542600800000,NE 154,Residential,25200,74494,0,99694
141542600900000,NE 154,Residential,24480,66409,0,90889
141542601000000,NE 154,Residential,24480,71730,0,96210
141542601100000,NE 154,Residential,32699,60730,0,93429
141542700100000,Empty,Exempt,0,0,0,0
141542800100000,NE 154,Residential,31772,88843,0,120615
141542800200000,NE 154,Residential,30258,121332,0,151590
141542800300000,NE 154,Residential,24480,62992,0,87472
141542800400000,NE 154,Residential,24480,88957,0,113437
141542800500000,NE 154,Residential,24480,81909,0,106389
141542800600000,NE 154,Residential,25217,76171,0,101388
141542800700000,NE 154,Residential,22800,71104,0,93904
141542800800000,NE 154,Residential,20520,71394,0,91914
141542900100000,NE 154,Residential,30904,67725,0,98629
141542900200000,NE 154,Residential,30197,170640,0,200837
141542900300000,NE 154,Residential,29016,72040,0,101056
141542900400000,NE 154,Residential,29016,70857,0,99873
141542900500000,NE 154,Residential,29016,82902,0,111918
141542900600000,NE 154,Residential,29016,75224,0,104240
141542900700000,NE 154,Residential,29016,100546,0,129562
141542900800000,NE 154,Residential,29016,86151,0,115167
141542900900000,NE 154,Residential,29016,81508,0,110524
141542901000000,NE 154,Residential,29016,124278,0,153294
141542901100000,NE 154,Residential,29016,77354,0,106370
141542901200000,NE 154,Residential,29016,88905,0,117921
141542901300000,NE 154,Residential,29016,88719,0,117735
141542901400000,NE 154,Residential,31107,120174,0,151281
141542901500000,NE 154,Residential,30325,80493,0,110818
141542901600000,NE 154,Residential,29016,97704,0,126720
141542901700000,NE 154,Residential,29016,92065,0,121081
141542901800000,NE 154,Residential,29016,61665,0,90681
141542901900000,NE 154,Residential,29016,94747,0,123763
141542902000000,NE 154,Residential,29016,81581,0,110597
141542902100000,NE 154,Residential,29016,89880,0,118896
141542902200000,NE 154,Residential,29016,66808,0,95824
141542902300000,NE 154,Residential,29016,115724,0,144740
141542902400000,NE 154,Residential,29016,68086,0,97102
141542902500000,NE 154,Residential,29016,62495,0,91511
141542902600000,NE 154,Residential,29016,88050,0,117066
141543000100000,NE 154,Residential,31071,105966,0,137037
141543000200000,NE 154,Residential,30365,69644,0,100009
141543000300000,NE 154,Residential,29016,75213,0,104229
141543000400000,NE 154,Residential,29016,79900,0,108916
141543000500000,NE 154,Residential,29016,84876,0,113892
141543000600000,NE 154,Residential,29016,91912,0,120928
141543000700000,NE 154,Residential,29016,93216,0,122232
141543000800000,NE 154,Residential,29016,105788,0,134804
141543000900000,NE 154,Residential,29016,96780,0,125796
141543001000000,NE 154,Residential,29016,96447,0,125463
141543001100000,NE 154,Residential,29016,105797,0,134813
141543001200000,NE 154,Residential,29016,78249,0,107265
141543001300000,NE 154,Residential,29016,84466,0,113482
141543001400000,NE 154,Residential,31109,100560,0,131669
141543001500000,NE 154,Residential,30327,72686,0,103013
141543001600000,NE 154,Residential,29016,84862,0,113878
141543001700000,NE 154,Residential,29016,88641,0,117657
141543001800000,NE 154,Residential,29016,82276,0,111292
141543001900000,NE 154,Residential,29066,67926,0,96992
141543002000000,NE 154,Residential,29016,86220,0,115236
141543002100000,NE 154,Residential,29016,72120,0,101136
141543002200000,NE 154,Residential,29016,77077,0,106093
141543002300000,NE 154,Residential,29016,95012,0,124028
141543002400000,NE 154,Residential,29016,91550,0,120566
141543002500000,NE 154,Residential,29016,74409,0,103425
141543002600000,NE 154,Residential,29016,110984,0,140000
141543100100000,NE 154,Residential,36133,80058,0,116191
141543100200000,NE 154,Residential,30502,86586,0,117088
141543100300000,NE 154,Residential,29016,72890,0,101906
141543100400000,NE 154,Residential,29016,78628,0,107644
141543100500000,NE 154,Residential,29016,94528,0,123544
141543100600000,NE 154,Residential,29016,66747,0,95763
141543100700000,NE 154,Residential,29016,91120,0,120136
141543100800000,NE 154,Residential,29016,80139,0,109155
141543100900000,NE 154,Residential,29016,81480,0,110496
141543101000000,NE 154,Residential,29016,90782,0,119798
141543101100000,NE 154,Residential,29016,80614,0,109630
141543101200000,NE 154,Residential,29016,78440,0,107456
141543101300000,NE 154,Residential,29016,66621,0,95637
141543101400000,NE 154,Residential,31109,92527,0,123636
141543101500000,NE 154,Residential,30327,81555,0,111882
141543101600000,NE 154,Residential,29016,72013,0,101029
141543101700000,NE 154,Residential,29016,87225,0,116241
141543101800000,NE 154,Residential,29016,69495,0,98511
141543101900000,NE 154,Residential,29016,95878,0,124894
141543102000000,NE 154,Residential,29016,77918,0,106934
141543102100000,NE 154,Residential,29016,47488,0,76504
141543102200000,NE 154,Residential,29016,100052,0,129068
141543102300000,NE 154,Residential,29016,79581,0,108597
141543102400000,NE 154,Residential,29016,81085,0,110101
141543102500000,NE 154,Residential,29016,104553,0,133569
141543200100000,NE 154,Residential,29774,79852,0,109626
141543200200000,NE 154,Residential,25220,82116,0,107336
141543200300000,NE 154,Residential,25220,81943,0,107163
141543200400000,NE 154,Residential,25220,95090,0,120310
141543200500000,NE 154,Residential,25220,76204,0,101424
141543200600000,NE 154,Residential,25220,96136,0,121356
141543200700000,NE 154,Residential,25220,82564,0,107784
141543200800000,NE 154,Residential,25220,98462,0,123682
141543200900000,NE 154,Residential,25220,102040,0,127260
141543201000000,NE 154,Residential,25220,94887,0,120107
141543201100000,NE 154,Residential,27108,116366,0,143474
141543201200000,NE 154,Residential,30333,90592,0,120925
141543201300000,NE 154,Residential,29016,91689,0,120705
141543201400000,NE 154,Residential,29016,75393,0,104409
141543201500000,NE 154,Residential,29016,83679,0,112695
141543201600000,NE 154,Residential,29016,94741,0,123757
141543201700000,NE 154,Residential,29016,90424,0,119440
141543201800000,NE 154,Residential,29016,91998,0,121014
141543201900000,NE 154,Residential,29016,67233,0,96249
141543202000000,NE 154,Residential,29016,70352,0,99368
141543202100000,NE 154,Residential,29016,79117,0,108133
141543202200000,NE 154,Residential,29016,96686,0,125702
141543202300000,NE 154,Residential,29016,88825,0,117841
141543300100000,NE 154,Residential,30600,104664,0,135264
141543300200000,NE 154,Residential,30600,77416,0,108016
141543300300000,NE 154,Residential,30600,86370,0,116970
141543300400000,NE 154,Residential,30600,83354,0,113954
141543300500000,NE 154,Residential,30600,71715,0,102315
141543300600000,NE 154,Residential,30600,129777,0,160377
141543300700000,NE 154,Residential,30600,96214,0,126814
141543300800000,NE 154,Residential,30600,86871,0,117471
141543300900000,NE 154,Residential,30600,98498,0,129098
141543301000000,NE 154,Residential,30600,92794,0,123394
141543301100000,NE 154,Residential,30600,98908,0,129508
141543301200000,NE 154,Residential,24480,81594,0,106074
141543301300000,NE 154,Residential,24480,64892,0,89372
141543301400000,NE 154,Residential,24480,76130,0,100610
141543301500000,NE 154,Residential,24480,88034,0,112514
141543301600000,NE 154,Residential,24480,79980,0,104460
141543301700000,NE 154,Residential,30600,83782,0,114382
141543301800000,NE 154,Residential,30600,81516,0,112116
141543301900000,NE 154,Residential,33813,157585,0,191398
141543302000000,NE 154,Residential,34272,126260,0,160532
141543302100000,NE 154,Residential,33813,138169,0,171982
141543302200000,NE 154,Residential,39780,121238,0,161018
141543302300000,NE 154,Residential,30600,109934,0,140534
141543302400000,NE 154,Residential,30600,97518,0,128118
141543302500000,NE 154,Residential,27540,136083,0,163623
141543302600000,NE 154,Residential,31977,120023,0,152000
141543302700000,NE 154,Residential,30600,129754,0,160354
141543302800000,NE 154,Residential,30600,96111,0,126711
141543302900000,NE 154,Residential,29988,90516,0,120504
141543303000000,NE 154,Residential,31212,84300,0,115512
141543400100000,NE 155,Residential,22990,62468,0,85458
141543400200000,NE 155,Residential,15400,58221,0,73621
141543400300000,NE 155,Residential,22000,66059,0,88059
141543500100000,NE 154,Residential,32400,72350,0,104750
141543500200000,NE 154,Residential,32400,191572,0,223972
141543500300000,NE 154,Residential,30600,82827,0,113427
141543500400000,NE 154,Residential,30600,100212,0,130812
141545100100000,NE 154,Residential,18360,80730,0,99090
141545100200000,NE 154,Residential,18360,60979,0,79339
141545100300000,NE 154,Residential,18360,62462,0,80822
141545100400000,NE 154,Residential,30600,106080,0,136680
141545100500000,NE 154,Residential,30600,57042,0,87642
141545100600000,NE 154,Residential,30600,129759,0,160359
141545100700000,NE 154,Residential,30600,129339,0,159939
141545100800000,NE 154,Residential,32700,91519,0,124219
141545100900000,NE 154,Residential,30600,146863,0,177463
141545101000000,NE 154,Residential,30600,136380,0,166980
141545101100000,NE 154,Residential,30600,93430,0,124030
141545101200000,NE 154,Residential,30600,140245,0,170845
141545101300000,NE 154,Residential,30600,64654,0,95254
141545101400000,APTS NE,Commercial,36558,0,363442,400000
141545101500000,APTS NE,Residential,36558,363442,0,400000
141545101600000,APTS NE,Commercial,11745,0,126337,138082
141545101700000,CONVERSIONS,Commercial,13041,0,55579,68620
141545101800000,NE 154,Residential,14398,53486,0,67884
141545101900000,NE 154,Residential,15298,53199,0,68497
141545102000000,NE 154,Residential,19888,57211,0,77099
141545102100000,NE 154,Residential,18360,94740,0,113100
141545102200000,NE 154,Residential,20700,92476,0,113176
141545102300000,NE 154,Residential,22950,98162,0,121112
141545102400000,NE 154,Residential,22950,70352,0,93302
141545102500000,NE 154,Residential,18360,72321,0,90681
141545102600000,NE 154,Residential,18360,63694,0,82054
141545200100000,NE 154,Residential,30600,101851,0,132451
141545200200000,NE 154,Residential,30600,98703,0,129303
141545200300000,NE 154,Residential,30600,76683,0,107283
141545200400000,NE 154,Residential,30600,73836,0,104436
141545200500000,NE 154,Residential,30600,84019,0,114619
141545200600000,NE 154,Residential,26400,67864,0,94264
141545200700000,NE 154,Residential,22000,95422,0,117422
141545200800000,NE 154,Residential,22000,88762,0,110762
141545200900000,NE 154,Residential,25500,82094,0,107594
141545201000000,NE 154,Residential,38250,112567,0,150817
141545201100000,NE 154,Residential,30600,87922,0,118522
141545201200000,NE 154,Residential,30600,82351,0,112951
141545300100000,NE 155,Residential,28125,127044,0,155169
141545300200000,NE 155,Residential,22500,82259,0,104759
141545300300000,NE 155,Residential,20000,74584,0,94584
141545300400000,NE 155,Residential,20000,73929,0,93929
141545400100000,NE 155,Residential,79443,140342,0,219785
141545400200000,NE 155,Residential,24120,64727,0,88847
141545400300000,NE 155,Residential,22356,106243,0,128599
141545400400000,NE 155,Residential,18468,83612,0,102080
141545400500000,NE 155,Residential,19125,91245,0,110370
141545400600000,NE 155,Residential,18768,100436,0,119204
141545400700000,NE 155,Residential,20400,69391,0,89791
141545400800000,NE 155,Residential,22848,59855,0,82703
141545400900000,NE 155,Residential,22848,107750,0,130598
141545401000000,NE 155,Residential,21318,99257,0,120575
141545401100000,NE 155,Residential,22760,181329,0,204089
141545401200000,NE 155,Residential,26796,114402,0,141198
141545500400000,COMM NE,Commercial,11178,0,12863,24041
141545500500000,Empty,Other,0,0,0,0
141545500600000,COMM NE,Commercial,16414,0,7427,23841
141545500700000,COMM NE,Commercial,10799,0,0,10799
141545500800000,COMM NE,Commercial,10799,0,0,10799
141545500900000,COMM NE,Commercial,10799,0,0,10799
141545501000000,COMM NE,Commercial,14364,0,2413,16777
141545501100000,COMM NE,Commercial,14364,0,577,14941
141545501200000,E-68 FRATERNAL ORG,Exempt,24300,0,46575,70875
141545501300000,COMM NE,Commercial,24857,0,4752,29609
141545501400000,COMM NE,Commercial,316872,0,1000780,1317652
141545501500000,COMM NE,Commercial,142560,0,0,142560
141545501600000,COMM NE,Commercial,82080,0,1628509,1710589
141545600100000,NE 155,Residential,22000,97266,0,119266
141545600200000,NE 155,Residential,22000,75664,0,97664
141545600300000,NE 155,Residential,28314,114982,0,143296
141545600400000,NE 155,Residential,19992,105044,0,125036
141545600500000,NE 155,Residential,15680,64084,0,79764
141545600700000,NE 155,Residential,13800,65911,0,79711
141545600800000,NE 155,Residential,20400,71975,0,92375
141545600900000,NE 155,Residential,21600,66981,0,88581
141545601000000,NE 155,Residential,20400,76656,0,97056
141545601100000,NE 155,Residential,21000,115348,0,136348
141545601200000,APTS NE,Commercial,13365,0,93258,106623
141545601300000,NE 155,Residential,20800,112557,0,133357
141545601400000,APTS NE,Commercial,12960,0,111475,124435
141545601500000,CONVERSIONS,Commercial,13365,0,88953,102318
141545601600000,CONVERSIONS,Commercial,10935,0,58592,69527
141545601700000,NE 155,Residential,18400,50269,0,68669
141545601800000,NE 155,Residential,12400,59538,0,71938
141545601900000,NE 155,Residential,8424,51061,0,59485
141545602000000,NE 155,Residential,10032,33719,0,43751
141545602100000,NE 155,Residential,15840,45082,0,60922
141545602200000,NE 155,Residential,13464,58796,0,72260
141545602300000,CONVERSIONS,Commercial,9720,0,63685,73405
141545602400000,APTS NE,Commercial,29160,0,209902,239062
141545602500000,APTS NE,Commercial,27540,0,303086,330626
141545602700000,APTS NE,Commercial,13365,0,139455,152820
141545602800000,APTS NE,Commercial,14580,0,138614,153194
141545603100000,APTS NE,Commercial,21222,0,181941,203163
141545603200000,NE 155,Residential,25500,58828,0,84328
141545603300000,NE 155,Residential,26010,69120,0,95130
141545603400000,NE 155,Residential,25500,73595,0,99095
141545603500000,COMM NE,Commercial,220320,0,115602,335922
141545603600000,COMM NE,Commercial,102330,0,21826,124156
141545603700000,COMM NE,Commercial,204660,0,201591,406251
141545603800000,APTS NE,Commercial,40932,0,412640,453572
141545603900000,COMM NE,Commercial,507600,0,2392400,2900000
141545604000000,NE 155,Residential,6600,83196,0,89796
141545604100000,NE 155,Residential,7700,70170,0,77870
141545604200000,NE 155,Residential,7700,85970,0,93670
141545604300000,NE 155,Residential,8800,81656,0,90456
141545604501000,CONDO 500,Residential,3750,34836,0,38586
141545604501001,CONDO 500,Residential,3750,34292,0,38042
141545604501002,CONDO 500,Residential,3750,35885,0,39635
141545604501003,CONDO 500,Residential,3750,35885,0,39635
141545604601000,CONDO 500,Residential,3750,36586,0,40336
141545604601001,CONDO 500,Residential,3750,36042,0,39792
141545604601002,CONDO 500,Residential,3750,37635,0,41385
141545604601003,CONDO 500,Residential,3750,37635,0,41385
141545604701000,CONDO 500,Residential,3750,34836,0,38586
141545604701001,CONDO 500,Residential,3750,34292,0,38042
141545604701002,CONDO 500,Residential,3750,35885,0,39635
141545604701003,CONDO 500,Residential,3750,35885,0,39635
141545700100000,SE 218,Residential,18492,69454,0,87946
141545700200000,SE 218,Residential,16542,90006,0,106548
141545700300000,E-40 CHURCHES,Exempt,40327,0,51036,91363
141545700400000,COMM SE,Commercial,252720,0,539704,792424
141545700500000,SE 218,Residential,44000,174412,0,218412
141545700600000,SE 218,Residential,18000,92343,0,110343
141545700700000,SE 218,Residential,18000,73000,0,91000
141545800100000,SE 218,Residential,12450,40269,0,52719
141545800200000,SE 218,Residential,10800,30549,0,41349
141545800300000,COMM SE,Commercial,120960,0,198606,319566
141545800400000,CONVERSIONS,Commercial,32886,0,152032,184918
141545800500000,COMM SE,Commercial,13365,0,97388,110753
141545800600000,CONVERSIONS,Commercial,13365,0,79606,92971
141545800700000,SE 218,Residential,15000,105000,0,120000
141547600100000,SE 218,Residential,51367,123633,0,175000
141547600200000,SE 218,Residential,172497,0,0,172497
141547600301000,CONDO 502,Residential,6000,99346,0,105346
141547600301001,CONDO 502,Residential,10500,81275,0,91775
141547600301002,CONDO 502,Residential,10500,182354,0,192854
141547600301003,CONDO 502,Residential,10500,171732,0,182232
141547600301004,CONDO 502,Residential,10500,178747,0,189247
141547600301005,CONDO 502,Residential,10500,184424,0,194924
141547600301006,CONDO 502,Residential,10500,75673,0,86173
141547600301007,CONDO 502,Residential,10500,172543,0,183043
141547600301008,CONDO 502,Residential,10500,175024,0,185524
141547600301009,CONDO 502,Residential,10500,177308,0,187808
141547600301010,CONDO 502,Residential,10500,173536,0,184036
141547600301011,CONDO 502,Residential,10500,178301,0,188801
141547600301012,CONDO 502,Residential,10500,177853,0,188353
141547600301013,CONDO 502,Residential,10500,173138,0,183638
141547600301014,CONDO 502,Residential,10500,177308,0,187808
141547600301015,CONDO 502,Residential,10500,177308,0,187808
141547600301016,CONDO 502,Residential,22500,296142,0,318642
141547600301017,CONDO 502,Residential,10500,178301,0,188801
141547600400000,COMM SE,Commercial,294300,0,1987861,2282161
141547600500000,COMM SE,Commercial,345600,0,741506,1087106
141547600600000,COMM SE,Commercial,60238,0,139964,200202
141547600700000,COMM SE,Commercial,37391,0,6648,44039
141547600800000,SE 218,Residential,20858,114799,0,135657
141547600900000,SE 218,Residential,18675,90907,0,109582
141547601000000,SE 218,Residential,18675,90068,0,108743
141547601100000,SE 218,Residential,14525,79623,0,94148
141547601200000,SE 218,Residential,16600,77107,0,93707
141547601300000,SE 218,Residential,14525,90475,0,105000
141547601400000,SE 218,Residential,17637,101650,0,119287
141547700100000,COMM NE,Commercial,99792,0,360125,459917
141547800100000,NE 154,Residential,18400,95428,0,113828
141547800200000,NE 154,Residential,26928,123349,0,150277
141547800300000,NE 154,Residential,26928,85278,0,112206
141547800400000,NE 154,Residential,21120,101791,0,122911
141547800500000,NE 154,Residential,26928,100966,0,127894
141547800600000,COMM NE,Commercial,198450,0,389588,588038
141547800700000,COMM NE,Commercial,165780,0,245630,411410
141547800800000,NE 154,Residential,24651,59346,0,83997
141547800900000,COMM NE,Commercial,477630,0,1063818,1541448
141547801000000,NE 154,Residential,18400,96349,0,114749
141547900100000,NE 154,Residential,20925,69672,0,90597
141547900200000,NE 154,Residential,21375,108980,0,130355
141548000100000,SE 218,Residential,119250,327471,0,446721
141548000200000,E-70 CHARITY OTHER,Exempt,1420200,0,1266167,2686367
141548000300000,SE 218,Residential,16600,108608,0,125208
141548000400000,SE 218,Residential,16600,70990,0,87590
141548000500000,SE 218,Residential,16310,76268,0,92578
141548000600000,SE 218,Residential,16600,91298,0,107898
141548000700000,SE 218,Residential,16600,67522,0,84122
141548000800000,SE 218,Residential,16600,79222,0,95822
141548000900000,SE 218,Residential,17742,82640,0,100382
141548001000000,SE 218,Residential,21442,100443,0,121885
141548001100000,SE 218,Residential,99150,331020,0,430170
141548001200000,SE 218,Exempt,60000,0,216889,276889
141548100100000,SE 218,Residential,18576,86274,0,104850
141548100200000,SE 218,Residential,14424,84205,0,98629
141548100300000,SE 218,Residential,15840,90762,0,106602
141548100400000,SE 218,Residential,16200,82296,0,98496
141548100500000,SE 218,Residential,16821,91237,0,108058
141548100600000,SE 218,Residential,16821,105794,0,122615
141548100700000,SE 218,Residential,18058,101827,0,119885
141548200100000,SE 218,Residential,84171,165829,0,250000
141548200200000,SE 218,Residential,43055,355479,0,398534
141548200300000,SE 218,Residential,41558,215835,0,257393
141548200400000,SE 218,Residential,17621,101814,0,119435
141548200500000,SE 218,Residential,17149,102510,0,119659
141548200600000,SE 218,Residential,30784,209216,0,240000
141548200700000,SE 218,Residential,54496,181299,0,235795
141610100100000,E-40 CHURCHES,Exempt,31565,0,102871,134436
141610100200000,NE 145,Residential,33592,143177,0,176769
141610100300000,NE 145,Residential,33915,92754,0,126669
141610100400000,NE 145,Residential,33920,84196,0,118116
141610100500000,NE 145,Residential,31376,95442,0,126818
141610100600000,NE 145,Residential,36653,47977,0,84630
141610100700000,NE 145,Residential,25250,61694,0,86944
141610100800000,NE 145,Residential,25250,87675,0,112925
141610100900000,NE 145,Residential,25250,83808,0,109058
141610101000000,NE 145,Residential,25250,78275,0,103525
141610101100000,NE 145,Residential,25250,73400,0,98650
141610101200000,NE 145,Residential,25250,42860,0,68110
141610101300000,NE 145,Residential,25688,59364,0,85052
141610200200000,NE 145,Residential,20600,77219,0,97819
141610200300000,NE 145,Residential,20600,105700,0,126300
141610200400000,NE 145,Residential,20518,82610,0,103128
141610200500000,NE 145,Residential,20600,50922,0,71522
141610200600000,NE 145,Residential,20600,60537,0,81137
141610200700000,NE 145,Residential,31360,66054,0,97414
141610200800000,NE 145,Residential,31360,57086,0,88446
141610200900000,NE 145,Residential,33792,93158,0,126950
141610201000000,NE 145,Residential,28979,80940,0,109919
141610201100000,NE 145,Residential,29767,47172,0,76939
141610201200000,NE 145,Residential,31765,97024,0,128789
141610201300000,NE 145,Residential,25440,109673,0,135113
141610201400000,NE 145,Residential,19953,45349,0,65302
141610201500000,NE 145,Residential,19861,86797,0,106658
141610201600000,NE 145,Residential,19861,82810,0,102671
141610201700000,NE 145,Residential,24625,97331,0,121956
141610201800000,NE 145,Residential,25179,138282,0,163461
141610201900000,NE 145,Residential,23520,97456,0,120976
141610202000000,NE 145,Residential,23520,79742,0,103262
141610202100000,NE 145,Residential,35282,96759,0,132041
141610202200000,NE 145,Residential,27744,72052,0,99796
141610202300000,NE 145,Residential,29120,0,0,29120
141610300100000,NE 145,Residential,20600,43316,0,63916
141610300200000,NE 145,Residential,20600,57591,0,78191
141610300300000,NE 145,Residential,20600,86907,0,107507
141610300400000,NE 145,Residential,20600,65188,0,85788
141610300500000,NE 145,Residential,21012,57609,0,78621
141610300600000,NE 145,Residential,17400,40629,0,58029
141610300700000,NE 145,Residential,15400,47965,0,63365
141610300800000,NE 145,Residential,19968,65902,0,85870
141610300900000,NE 145,Residential,20384,65631,0,86015
141610301000000,COMM NE,Commercial,110295,0,45901,156196
141610301100000,NE 145,Residential,28560,83507,0,112067
141610301200000,NE 145,Residential,32256,42205,0,74461
141610301300000,NE 145,Residential,30720,80220,0,110940
141610301400000,NE 145,Residential,30720,84280,0,115000
141610301500000,NE 145,Residential,32890,102787,0,135677
141610301600000,NE 145,Residential,24480,92436,0,116916
141610301700000,NE 145,Residential,24480,87860,0,112340
141610301800000,NE 145,Residential,24480,69998,0,94478
141610301900000,NE 145,Residential,20400,73201,0,93601
141610302000000,NE 145,Residential,25039,97437,0,122476
141610302100000,NE 145,Residential,26052,86397,0,112449
141610302200000,NE 145,Residential,25920,84182,0,110102
141610302300000,NE 145,Residential,22540,82361,0,104901
141610302400000,NE 145,Residential,21149,85420,0,106569
141610302600000,NE 145,Residential,30184,123186,0,153370
141610303100000,NE 145,Residential,24000,74651,0,98651
141610400100000,NE 145,Residential,26024,74085,0,100109
141610400200000,NE 145,Residential,25250,87045,0,112295
141610400300000,NE 145,Residential,25250,45796,0,71046
141610400400000,NE 145,Residential,25250,84010,0,109260
141610400500000,NE 145,Residential,25250,100349,0,125599
141610400600000,NE 145,Residential,25250,74794,0,100044
141610400700000,NE 145,Residential,25250,81193,0,106443
141610400800000,NE 145,Residential,25250,71993,0,97243
141610400900000,NE 145,Residential,33974,68603,0,102577
141610401000000,NE 145,Residential,27840,74111,0,101951
141610401100000,APTS NE,Commercial,18225,0,271775,290000
141610401200000,NE 145,Residential,27376,57624,0,85000
141610401300000,NE 145,Residential,31821,77861,0,109682
141610401400000,NE 145,Residential,23460,88528,0,111988
141610401500000,NE 145,Residential,23460,56921,0,80381
141610401600000,NE 145,Residential,17800,83323,0,101123
141610401700000,APTS NE,Commercial,197640,0,1201866,1399506
141610500100000,NE 145,Residential,33207,79182,0,112389
141610500200000,NE 145,Residential,35316,59582,0,94898
141610500301000,CONDO 500,Residential,2000,24971,0,26971
141610500301001,CONDO 500,Residential,2000,24971,0,26971
141610500301002,CONDO 500,Residential,2000,24971,0,26971
141610500301003,CONDO 500,Residential,2000,24971,0,26971
141610500301004,CONDO 500,Residential,2000,24971,0,26971
141610500301005,CONDO 500,Residential,2000,24971,0,26971
141610500301006,CONDO 500,Residential,2000,24971,0,26971
141610500301007,CONDO 500,Residential,2000,24971,0,26971
141610500301008,CONDO 500,Residential,2000,24971,0,26971
141610500301009,CONDO 500,Residential,2000,24971,0,26971
141610500301010,CONDO 500,Residential,2000,24971,0,26971
141610500301011,CONDO 500,Residential,2000,24971,0,26971
141610500301012,CONDO 500,Residential,2000,24971,0,26971
141610500301013,CONDO 500,Residential,2000,24971,0,26971
141610500301014,CONDO 500,Residential,2000,24971,0,26971
141610500301015,CONDO 500,Residential,2000,24971,0,26971
141610500401000,CONDO 500,Residential,2000,29191,0,31191
141610500401001,CONDO 500,Residential,2000,25991,0,27991
141610500401002,CONDO 500,Residential,2000,25991,0,27991
141610500401003,CONDO 500,Residential,2000,25991,0,27991
141610500401004,CONDO 500,Residential,2000,25991,0,27991
141610500401005,CONDO 500,Residential,2000,25991,0,27991
141610500401006,CONDO 500,Residential,2000,25991,0,27991
141610500401007,CONDO 500,Residential,2000,29191,0,31191
141610500401008,CONDO 500,Residential,2000,29191,0,31191
141610500401009,CONDO 500,Residential,2000,25991,0,27991
141610500401010,CONDO 500,Residential,2000,25991,0,27991
141610500401011,CONDO 500,Residential,2000,25991,0,27991
141610500401012,CONDO 500,Residential,2000,25991,0,27991
141610500401013,CONDO 500,Residential,2000,25991,0,27991
141610500401014,CONDO 500,Residential,2000,25991,0,27991
141610500401015,CONDO 500,Residential,2000,29191,0,31191
141610500501000,CONDO 500,Residential,2000,25590,0,27590
141610500501001,CONDO 500,Residential,2000,25590,0,27590
141610500501002,CONDO 500,Residential,2000,25590,0,27590
141610500501003,CONDO 500,Residential,2000,25590,0,27590
141610500501004,CONDO 500,Residential,2000,25590,0,27590
141610500501005,CONDO 500,Residential,2000,25590,0,27590
141610500501006,CONDO 500,Residential,2000,25590,0,27590
141610500501007,CONDO 500,Residential,2000,25590,0,27590
141610500501008,CONDO 500,Residential,2000,25590,0,27590
141610500501009,CONDO 500,Residential,2000,25590,0,27590
141610500501010,CONDO 500,Residential,2000,25590,0,27590
141610500501011,CONDO 500,Residential,2000,25590,0,27590
141610500501012,CONDO 500,Residential,2000,25590,0,27590
141610500501013,CONDO 500,Residential,2000,25590,0,27590
141610500501014,CONDO 500,Residential,2000,25590,0,27590
141610500501015,CONDO 500,Residential,2000,25590,0,27590
141610500501016,CONDO 500,Residential,2000,25590,0,27590
141610500501017,CONDO 500,Residential,2000,25590,0,27590
141610500501018,CONDO 500,Residential,2000,25590,0,27590
141610500501019,CONDO 500,Residential,2000,25590,0,27590
141610500501020,CONDO 500,Residential,2000,25590,0,27590
141610500501021,CONDO 500,Residential,2000,25590,0,27590
141610500501022,CONDO 500,Residential,2000,25590,0,27590
141610500501023,CONDO 500,Residential,2000,25590,0,27590
141610500501024,CONDO 500,Residential,2000,25590,0,27590
141610500501025,CONDO 500,Residential,2000,25590,0,27590
141610500501026,CONDO 500,Residential,2000,25590,0,27590
141610500501027,CONDO 500,Residential,2000,25590,0,27590
141610500501028,CONDO 500,Residential,2000,25590,0,27590
141610500501029,CONDO 500,Residential,2000,25590,0,27590
141610500501030,CONDO 500,Residential,2000,25590,0,27590
141610500501031,CONDO 500,Residential,2000,25590,0,27590
141610500600000,NE 145,Residential,23450,56032,0,79482
141610600100000,NE 145,Residential,25075,111349,0,136424
141610600200000,NE 145,Residential,22447,101817,0,124264
141610600300000,NE 145,Residential,19600,86168,0,105768
141610600400000,NE 145,Residential,19600,71552,0,91152
141610600500000,NE 145,Residential,19600,83814,0,103414
141610600600000,NE 145,Residential,24960,90881,0,115841
141610600700000,NE 145,Residential,26400,48593,0,74993
141610600800000,NE 145,Residential,30940,89086,0,120026
141610600900000,NE 145,Residential,28829,84331,0,113160
141610601100000,NE 145,Residential,42669,66899,0,109568
141610601200000,NE 145,Residential,24720,64642,0,89362
141610601300000,NE 145,Residential,23520,71313,0,94833
141610601400000,NE 145,Residential,23520,84646,0,108166
141610700100000,NE 145,Residential,22176,75615,0,97791
141610700200000,NE 145,Residential,18432,75238,0,93670
141610700300000,NE 145,Residential,17040,84609,0,101649
141610700400000,NE 145,Residential,24304,69680,0,93984
141610700500000,NE 145,Residential,21948,89108,0,111056
141610700600000,NE 145,Residential,28570,49555,0,78125
141610700700000,APTS NE,Commercial,72900,0,742450,815350
141610700800000,NE 145,Residential,22120,86168,0,108288
141610700900000,NE 145,Residential,22120,82163,0,104283
141610701000000,NE 145,Residential,23700,91731,0,115431
141610701100000,NE 145,Residential,19800,78486,0,98286
141612600100000,COMM NE,Commercial,67081,0,34582,101663
141612600200000,COMM NE,Commercial,202824,0,344493,547317
141612600300000,COMM NE,Commercial,78365,0,104509,182874
141612600400000,NE 146,Residential,35109,117767,0,152876
141612600900000,NE 146,Residential,33800,144683,0,178483
141612601100000,COMM NE,Commercial,159408,0,235801,395209
141612601200000,NE 146,Residential,28682,55371,0,84053
141612601300000,NE 146,Residential,29654,53256,0,82910
141612601400000,APTS NE,Commercial,9720,0,154805,164525
141612601500000,APTS NE,Commercial,19818,0,304901,324719
141612601601000,CONDO 501,Residential,7000,40779,0,47779
141612601601001,CONDO 501,Residential,7000,40779,0,47779
141612601601002,CONDO 501,Residential,7000,43127,0,50127
141612601601003,CONDO 501,Residential,7000,40779,0,47779
141612601700000,NE 146,Residential,13320,29038,0,42358
141612601800000,APTS NE,Commercial,48600,0,640959,689559
141612601900000,COMM NE,Commercial,28080,0,73591,101671
141612602000000,COMM NE,Commercial,30240,0,63671,93911
141612700100000,NE 147,Residential,31226,116937,0,148163
141612700200000,NE 147,Residential,30202,140709,0,170911
141612700300000,NE 147,Residential,31266,121524,0,152790
141612700400000,NE 147,Residential,31266,126855,0,158121
141612700500000,NE 147,Residential,31266,124174,0,155440
141612700600000,NE 147,Residential,31824,155013,0,186837
141612800100000,APTS NE,Commercial,16794,0,138575,155369
141612800200000,NE 146,Residential,36325,43039,0,79364
141612800300000,NE 146,Residential,27477,0,0,27477
141612800400000,NE 146,Residential,29022,0,0,29022
141615100100000,NE 146,Residential,25800,0,0,25800
141615100200000,NE 146,Residential,25800,0,0,25800
141615100300000,COMM NE,Commercial,143100,0,799,143899
141615100400000,NE 146,Residential,26054,80695,0,106749
141615100600000,COMM NE,Commercial,101628,0,240980,342608
141615100800000,NE 146,Residential,35208,103934,0,139142
141615100900000,CONVERSIONS,Commercial,28989,0,67906,96895
141615200100000,E-15 CITY,Exempt,0,0,0,0
141615300100000,NE 146,Residential,18389,55828,0,74217
141615300200000,NE 146,Residential,16000,32343,0,48343
141615300300000,NE 146,Residential,16000,74362,0,90362
141615300400000,NE 146,Residential,16000,72716,0,88716
141615300500000,NE 146,Residential,28800,54482,0,83282
141615300600000,NE 146,Residential,15078,79922,0,95000
141615300700000,NE 146,Residential,16834,64791,0,81625
141615300800000,NE 146,Residential,16000,67637,0,83637
141615300900000,NE 146,Residential,16000,82096,0,98096
141615301000000,NE 146,Residential,16000,42936,0,58936
141615301100000,NE 146,Residential,16000,47924,0,63924
141615301200000,NE 146,Residential,16000,56215,0,72215
141615301300000,NE 146,Residential,16000,45060,0,61060
141615301400000,NE 146,Residential,16000,64264,0,80264
141615301500000,NE 146,Residential,16000,61628,0,77628
141615301600000,NE 146,Residential,13200,44649,0,57849
141615301700000,NE 146,Residential,15066,34750,0,49816
141615301800000,NE 146,Residential,23250,53182,0,76432
141615301900000,COMM NE,Commercial,27216,0,68243,95459
141615302000000,COMM NE,Commercial,24192,0,48018,72210
141615302100000,COMM NE,Commercial,24192,0,23664,47856
141615302200000,NE 146,Residential,16000,56736,0,72736
141615302300000,NE 146,Residential,13200,55974,0,69174
141615302400000,NE 146,Residential,13600,56530,0,70130
141615302500000,NE 146,Residential,13200,38679,0,51879
141615302600000,NE 146,Residential,24000,89346,0,113346
141615302700000,NE 146,Residential,16000,54078,0,70078
141615500200000,NE 146,Residential,24400,46599,0,70999
141615500300000,NE 146,Residential,30192,41792,0,71984
141615500400000,NE 146,Residential,21312,50456,0,71768
141615500500000,NE 146,Residential,17760,70284,0,88044
141615500600000,NE 146,Residential,17920,29034,0,46954
141615500700000,NE 146,Residential,21504,85255,0,106759
141615500800000,NE 146,Residential,21696,62055,0,83751
141615500900000,NE 146,Residential,7000,0,0,7000
141615501000000,NE 146,Residential,14360,48086,0,62446
141615501100000,NE 146,Residential,16800,75053,0,91853
141615501200000,NE 146,Residential,27244,52107,0,79351
141615501300000,NE 146,Residential,26790,0,0,26790
141615501400000,NE 146,Residential,32318,0,0,32318
141617600100000,NE 145,Residential,34362,49716,0,84078
141617600200000,COMM NE,Commercial,1134,0,151,1285
141617600300000,NE 145,Residential,34720,55759,0,90479
141617600400000,APTS NE,Commercial,202500,0,1313810,1516310
141617600500000,NE 145,Residential,29265,49533,0,78798
141617600600000,NE 145,Residential,5105,66320,0,71425
141617600701000,CONDO 501,Residential,5000,74686,0,79686
141617600701001,CONDO 501,Residential,5000,70645,0,75645
141617600701002,CONDO 501,Residential,5000,70214,0,75214
141617600701003,CONDO 501,Residential,5000,70214,0,75214
141617600701004,CONDO 501,Residential,5000,71269,0,76269
141617600701005,CONDO 501,Residential,5000,71551,0,76551
141617600800000,NE 145,Residential,22000,72698,0,94698
141617600900000,NE 145,Residential,22000,90348,0,112348
141617601000000,NE 145,Residential,22000,58327,0,80327
141617601200000,NE 145,Residential,24480,84559,0,109039
141617601300000,NE 145,Residential,24480,58575,0,83055
141617601400000,NE 145,Residential,32640,79576,0,112216
141617601500000,APTS NE,Commercial,42768,0,646899,689667
141617601600000,NE 145,Residential,25320,75324,0,100644
141617601700000,NE 145,Residential,29760,102225,0,131985
141617601800000,CONVERSIONS,Commercial,14885,0,70290,85175
141617601900000,NE 145,Residential,24065,97764,0,121829
141617602000000,NE 145,Residential,24813,81348,0,106161
141617602100000,E-10 COUNTY,Exempt,0,0,0,0
141617602200000,Empty,Exempt,0,0,0,0
141617700100000,NE 145,Residential,23460,101719,0,125179
141617700200000,NE 145,Residential,33685,101637,0,135322
141617700300000,NE 145,Residential,19002,87547,0,106549
141617700400000,CONVERSIONS,Commercial,16211,0,58541,74752
141617700500000,NE 145,Residential,25536,70710,0,96246
141617800100000,NE 145,Residential,21334,53246,0,74580
141617800200000,NE 145,Residential,15246,47506,0,62752
141617800300000,NE 145,Residential,16112,70786,0,86898
141617800400000,NE 145,Residential,14380,47033,0,61413
141617800500000,NE 145,Residential,15246,42736,0,57982
141617800600000,NE 145,Residential,15246,92031,0,107277
141617800700000,NE 145,Residential,18043,60568,0,78611
141617900100000,NE 145,Residential,23760,78466,0,102226
141617900300000,NE 145,Residential,18176,66884,0,85060
141617900400000,APTS NE,Commercial,32292,0,411841,444133
141617900500000,COMM NE,Commercial,36044,0,85090,121134
141617900600000,NE 145,Residential,27216,69972,0,97188
141617900700000,APTS NE,Commercial,35370,0,543588,578958
141618000100000,NE 145,Residential,16719,55150,0,71869
141618000200000,NE 145,Residential,15554,67036,0,82590
141618000300000,NE 145,Residential,15554,62382,0,77936
141618000400000,NE 145,Residential,15554,48213,0,63767
141618000500000,NE 145,Residential,15554,50874,0,66428
141618000600000,NE 145,Residential,15554,29413,0,44967
141618000700000,NE 145,Residential,21437,110590,0,132027
141618000800000,NE 145,Residential,19264,60960,0,80224
141618000900000,NE 145,Residential,22097,73025,0,95122
141618001000000,NE 145,Residential,15554,52200,0,67754
141618001100000,NE 145,Residential,15554,46628,0,62182
141618001200000,NE 145,Residential,15554,39972,0,55526
141618001300000,NE 145,Residential,15554,39858,0,55412
141618001400000,NE 145,Residential,15554,51439,0,66993
141618001500000,NE 145,Residential,14777,51786,0,66563
141618100100000,NE 145,Residential,27242,62736,0,89978
141618100200000,APTS NE,Commercial,77220,0,1145451,1222671
141618100300000,NE 145,Residential,25498,81443,0,106941
141618100400000,NE 145,Residential,31320,76491,0,107811
141618100500000,NE 145,Residential,21600,80194,0,101794
141618200100000,NE 145,Residential,15986,60718,0,76704
141618200200000,NE 145,Residential,15554,37944,0,53498
141618200300000,NE 145,Residential,15554,69200,0,84754
141618200400000,NE 145,Residential,15554,73051,0,88605
141618200500000,NE 145,Residential,15554,48874,0,64428
141618200600000,NE 145,Residential,15554,40263,0,55817
141618200700000,NE 145,Residential,15554,43423,0,58977
141618200800000,NE 145,Residential,16909,49825,0,66734
141618200900000,NE 145,Residential,19981,30937,0,50918
141618201000000,NE 145,Residential,14014,53551,0,67565
141618201100000,NE 145,Residential,15554,48086,0,63640
141618201200000,NE 145,Residential,15554,53217,0,68771
141618201300000,NE 145,Residential,15554,56829,0,72383
141618201400000,NE 145,Residential,15554,60213,0,75767
141618201500000,NE 145,Residential,10888,59931,0,70819
141618201600000,NE 145,Residential,9829,0,0,9829
141618300100000,NE 145,Residential,26006,93716,0,119722
141618300200000,NE 145,Residential,18403,40899,0,59302
141618300300000,NE 145,Residential,34248,51699,0,85947
141618300400000,NE 145,Residential,30000,60161,0,90161
141618300500000,NE 145,Residential,27667,86899,0,114566
141618300600000,NE 145,Residential,27076,70836,0,97912
141618300700000,NE 145,Residential,26482,84198,0,110680
141618300800000,NE 145,Residential,22289,96427,0,118716
141618300900000,NE 145,Residential,20976,85475,0,106451
141618301000000,NE 145,Residential,20976,54174,0,75150
141618301100000,NE 145,Residential,20976,92363,0,113339
141618301200000,E-40 CHURCHES,Exempt,16686,0,54016,70702
141618301300000,NE 145,Residential,23112,114869,0,137981
141618301400000,NE 145,Residential,23654,66236,0,89890
141618301500000,NE 145,Residential,22464,70385,0,92849
141618400100000,NE 145,Residential,15262,56677,0,71939
141618400200000,NE 145,Residential,15554,35416,0,50970
141618400300000,NE 145,Residential,15554,75806,0,91360
141618400400000,NE 145,Residential,15554,89790,0,105344
141618400500000,NE 145,Residential,15554,72868,0,88422
141618400600000,NE 145,Residential,15554,22241,0,37795
141618400700000,NE 145,Residential,15554,35434,0,50988
141618400800000,NE 145,Residential,13636,47783,0,61419
141618400900000,NE 145,Residential,11440,37056,0,48496
141618401000000,APTS NE,Commercial,25650,0,613812,639462
141618401100000,APTS NE,Commercial,26460,0,408520,434980
141618401200000,COMM NE,Commercial,71996,0,127994,199990
141618401300000,COMM NE,Commercial,28091,0,33106,61197
141618401400000,NE 145,Residential,20532,70869,0,91401
141618401500000,NE 145,Residential,10025,0,0,10025
141618401600000,NE 145,Residential,20281,88024,0,108305
141618401700000,NE 145,Residential,20720,51046,0,71766
141618401800000,NE 145,Residential,20655,72143,0,92798
141618401900000,NE 145,Residential,20976,63486,0,84462
141620100100000,NE 147,Residential,28248,90925,0,119173
141620100200000,NE 147,Residential,28928,71719,0,100647
141620100300000,NE 147,Residential,28928,102535,0,131463
141620100400000,NE 147,Residential,28928,115054,0,143982
141620100500000,NE 147,Residential,28928,79625,0,108553
141620100600000,NE 147,Residential,28928,100667,0,129595
141620100700000,NE 147,Residential,29024,106060,0,135084
141620100800000,NE 147,Residential,29920,83070,0,112990
141620100900000,NE 147,Residential,29232,128251,0,157483
141620101000000,NE 147,Residential,31559,139301,0,170860
141620101100000,NE 147,Residential,39312,115442,0,154754
141620101200000,APTS NE,Commercial,20684,0,134486,155170
141620200100000,NE 147,Residential,27259,125125,0,152384
141620200200000,NE 147,Residential,18432,103026,0,121458
141620200300000,NE 147,Residential,20544,96489,0,117033
141620200400000,NE 147,Residential,19968,112674,0,132642
141620200500000,NE 147,Residential,19008,79475,0,98483
141620200600000,NE 147,Residential,18432,90126,0,108558
141620200700000,NE 147,Residential,20116,106228,0,126344
141620200800000,NE 147,Residential,8602,0,0,8602
141620200900000,NE 147,Residential,32413,88226,0,120639
141620201000000,NE 147,Residential,27783,78299,0,106082
141620201100000,NE 147,Residential,27783,88459,0,116242
141620201200000,NE 147,Residential,27783,82150,0,109933
141620201300000,NE 147,Residential,27783,88297,0,116080
141620201400000,NE 147,Residential,27783,75875,0,103658
141620201500000,NE 147,Residential,27783,84991,0,112774
141620201600000,NE 147,Residential,28067,93788,0,121855
141620201700000,NE 147,Residential,28917,84329,0,113246
141620201800000,NE 147,Residential,28776,82214,0,110990
141620201900000,NE 147,Residential,32301,125925,0,158226
141620202000000,NE 147,Residential,30495,109241,0,139736
141620202100000,NE 147,Residential,32781,103321,0,136102
141620202200000,NE 147,Residential,31930,116360,0,148290
141620202300000,NE 147,Residential,31200,90572,0,121772
141620202400000,NE 147,Residential,30282,99847,0,130129
141620202500000,NE 147,Residential,30991,106548,0,137539
141620202600000,NE 147,Residential,31680,93128,0,124808
141620202700000,NE 147,Residential,31680,95698,0,127378
141620202800000,NE 147,Residential,31719,118568,0,150287
141620202900000,NE 147,Residential,33430,89306,0,122736
141620203000000,NE 147,Residential,34627,98563,0,133190
141620203100000,NE 147,Residential,32752,114395,0,147147
141620203200000,NE 147,Residential,33060,113258,0,146318
141620203300000,NE 147,Residential,31741,95661,0,127402
141620203400000,NE 147,Residential,32566,82560,0,115126
141620203500000,NE 147,Residential,28841,88411,0,117252
141620203600000,NE 147,Residential,24056,103339,0,127395
141620203700000,NE 147,Residential,24056,83613,0,107669
141620203800000,NE 147,Residential,26720,82181,0,108901
141620300100000,E-41 RELIG SCHOOLS,Exempt,192429,0,537316,729745
141620400100000,NE 147,Residential,26624,95359,0,121983
141620400200000,NE 147,Residential,36300,97857,0,134157
141620400300000,NE 147,Residential,33705,117938,0,151643
141620400400000,NE 147,Residential,35316,115993,0,151309
141620400500000,NE 147,Residential,39404,126028,0,165432
141620400600000,NE 147,Residential,36873,106061,0,142934
141620400700000,NE 147,Residential,37942,129519,0,167461
141620400800000,NE 147,Residential,39390,99642,0,139032
141620400900000,NE 147,Residential,37872,99228,0,137100
141620401000000,NE 147,Residential,35880,113616,0,149496
141620401100000,NE 147,Residential,34304,105913,0,140217
141620401200000,NE 147,Residential,35788,100797,0,136585
141620401300000,NE 147,Residential,39658,99498,0,139156
141620401400000,NE 147,Residential,40025,109652,0,149677
141620401500000,NE 147,Residential,39220,129104,0,168324
141620401600000,NE 147,Residential,39981,116435,0,156416
141620401700000,NE 147,Residential,31485,117539,0,149024
141620401800000,NE 147,Residential,29488,98581,0,128069
141620401900000,NE 147,Residential,33174,103642,0,136816
141620500100000,NE 147,Residential,31104,112094,0,143198
141620500200000,NE 147,Residential,39867,119817,0,159684
141620500300000,NE 147,Residential,40763,106574,0,147337
141620500400000,NE 147,Residential,42019,107099,0,149118
141620500500000,NE 147,Residential,42942,107205,0,150147
141620500600000,NE 147,Residential,40392,148398,0,188790
141620500700000,NE 147,Residential,40838,98063,0,138901
141620500800000,NE 147,Residential,39615,109739,0,149354
141620500900000,NE 147,Residential,40500,145293,0,185793
141620501000000,NE 147,Residential,39204,131836,0,171040
141620501100000,NE 147,Residential,40014,132200,0,172214
141620501200000,NE 147,Residential,35955,115370,0,151325
141620501300000,NE 147,Residential,32972,106644,0,139616
141620501400000,NE 147,Residential,32634,108710,0,141344
141620501500000,NE 147,Residential,36450,116591,0,153041
141620501600000,NE 147,Residential,39828,111874,0,151702
141620501700000,NE 147,Residential,35789,109450,0,145239
141620501800000,NE 147,Residential,21512,160118,0,181630
141620501900000,NE 147,Residential,24696,5714,0,30410
141620502000000,NE 147,Residential,39690,142144,0,181834
141620502100000,NE 147,Residential,37926,148802,0,186728
141620502200000,NE 147,Residential,39300,170525,0,209825
141620502300000,NE 147,Residential,38862,139526,0,178388
141620502400000,NE 147,Residential,41059,141134,0,182193
141620502500000,NE 147,Residential,35496,140388,0,175884
141620502600000,NE 147,Residential,31815,138661,0,170476
141620502700000,NE 147,Residential,34500,135177,0,169677
141620502800000,NE 147,Residential,37508,128460,0,165968
141620502900000,NE 147,Residential,37026,119956,0,156982
141620503000000,NE 147,Residential,33152,144180,0,177332
141620503100000,NE 147,Residential,29488,126723,0,156211
141620503200000,NE 147,Residential,29488,144696,0,174184
141620600100000,NE 147,Residential,30080,121176,0,151256
141620600200000,NE 147,Residential,27788,121171,0,148959
141620600300000,NE 147,Residential,29520,111516,0,141036
141620600400000,NE 147,Residential,29700,109351,0,139051
141620600500000,NE 147,Residential,32040,141472,0,173512
141620600600000,NE 147,Residential,40767,127812,0,168579
141620600700000,NE 147,Residential,34742,148113,0,182855
141620600800000,NE 147,Residential,40698,161741,0,202439
141620600900000,NE 147,Residential,41409,145239,0,186648
141620601000000,NE 147,Residential,40630,127272,0,167902
141620601100000,NE 147,Residential,38543,127990,0,166533
141620601200000,NE 147,Residential,40644,104356,0,145000
141620601300000,NE 148,Residential,40637,153208,0,193845
141622600100000,NE 147,Residential,32100,125275,0,157375
141622600200000,NE 147,Residential,32400,104198,0,136598
141622600300000,NE 147,Residential,32700,178077,0,210777
141622600400000,NE 147,Residential,33136,132968,0,166104
141622600500000,NE 147,Residential,35992,164490,0,200482
141622600600000,NE 147,Residential,31603,99969,0,131572
141622600700000,NE 147,Residential,34314,126123,0,160437
141622600800000,NE 147,Residential,34238,125813,0,160051
141622600900000,NE 147,Residential,29700,131629,0,161329
141622601000000,NE 147,Residential,35616,120310,0,155926
141622601100000,NE 147,Residential,27913,146262,0,174175
141622601200000,NE 147,Residential,30995,96313,0,127308
141622601300000,NE 147,Residential,33120,146433,0,179553
141622601400000,NE 147,Residential,37890,124724,0,162614
141622601500000,NE 147,Residential,52250,95062,0,147312
141622601600000,NE 147,Residential,40938,160762,0,201700
141622601700000,NE 147,Residential,41992,110800,0,152792
141622601800000,NE 147,Residential,48413,119040,0,167453
141622601900000,NE 147,Residential,39520,220857,0,260377
141622602000000,NE 147,Residential,33427,157239,0,190666
141622602100000,NE 147,Residential,30084,116253,0,146337
141622602200000,NE 147,Residential,31240,167497,0,198737
141622602300000,NE 147,Residential,31497,129299,0,160796
141622602400000,NE 147,Residential,30280,128144,0,158424
141622602500000,NE 147,Residential,26438,98078,0,124516
141622602600000,NE 147,Residential,26977,91867,0,118844
141622602700000,NE 147,Residential,26977,94148,0,121125
141622602800000,NE 147,Residential,26794,87966,0,114760
141622602900000,NE 147,Residential,28320,69612,0,97932
141622603000000,NE 147,Residential,24099,91624,0,115723
141622603100000,NE 147,Residential,200,0,0,200
141622603200000,NE 147,Residential,29,0,0,29
141623100100000,NE 147,Residential,35515,110550,0,146065
141623100200000,NE 147,Residential,33197,132197,0,165394
141623100300000,NE 147,Residential,33163,112847,0,146010
141623100400000,NE 147,Residential,34211,145623,0,179834
141623100500000,NE 147,Residential,37485,149740,0,187225
141623100600000,NE 147,Residential,37926,132899,0,170825
141625100100000,NE 147,Residential,37842,135292,0,173134
141625100200000,E-15 CITY,Exempt,0,0,0,0
141625100301000,CONDO 500,Residential,5000,69588,0,74588
141625100301001,CONDO 500,Residential,5000,69588,0,74588
141625100301002,CONDO 500,Residential,5000,69321,0,74321
141625100301003,CONDO 500,Residential,5000,69321,0,74321
141625100301004,CONDO 500,Residential,5000,70605,0,75605
141625100301005,CONDO 500,Residential,5000,70605,0,75605
141625100301006,CONDO 500,Residential,5000,70605,0,75605
141625100301007,CONDO 500,Residential,5000,70605,0,75605
141625100301008,CONDO 500,Residential,5000,70605,0,75605
141625100301009,CONDO 500,Residential,5000,70605,0,75605
141625100301010,CONDO 500,Residential,5000,70605,0,75605
141625100301011,CONDO 500,Residential,5000,70605,0,75605
141625100301012,CONDO 500,Residential,5000,69588,0,74588
141625100301013,CONDO 500,Residential,5000,69588,0,74588
141625100301014,CONDO 500,Residential,5000,69321,0,74321
141625100301015,CONDO 500,Residential,5000,69321,0,74321
141625100301016,CONDO 500,Residential,5000,70605,0,75605
141625100301017,CONDO 500,Residential,5000,70605,0,75605
141625100301018,CONDO 500,Residential,5000,70605,0,75605
141625100301019,CONDO 500,Residential,5000,70605,0,75605
141625100301020,CONDO 500,Residential,5000,70605,0,75605
141625100301021,CONDO 500,Residential,5000,70605,0,75605
141625100301022,CONDO 500,Residential,5000,70605,0,75605
141625100301023,CONDO 500,Residential,5000,70605,0,75605
141625100400000,COMM NE,Commercial,65262,0,68308,133570
141625100500000,COMM NE,Commercial,79110,0,136480,215590
141627600100000,APTS NE,Commercial,20897,0,140981,161878
141627600400000,COMM NE,Commercial,74520,0,0,74520
141627600500000,COMM NE,Commercial,247752,0,842228,1089980
141627600601000,CONDO 500,Residential,5000,33138,0,38138
141627600601001,CONDO 500,Residential,5000,37025,0,42025
141627600601002,CONDO 500,Residential,5000,33138,0,38138
141627600601003,CONDO 500,Residential,5000,33138,0,38138
141627600601004,CONDO 500,Residential,5000,37582,0,42582
141627600601005,CONDO 500,Residential,5000,37582,0,42582
141627600601006,CONDO 500,Residential,5000,33138,0,38138
141627600601007,CONDO 500,Residential,5000,33138,0,38138
141627600601008,CONDO 500,Residential,5000,37582,0,42582
141627600601009,CONDO 500,Residential,5000,37582,0,42582
141627600601010,CONDO 500,Residential,5000,37025,0,42025
141627600601011,CONDO 500,Residential,5000,33138,0,38138
141627600601012,CONDO 500,Residential,5000,37582,0,42582
141627600601013,CONDO 500,Residential,5000,37582,0,42582
141627600601014,CONDO 500,Residential,5000,33138,0,38138
141627600601015,CONDO 500,Residential,5000,33138,0,38138
141627600601016,CONDO 500,Residential,5000,37582,0,42582
141627600601017,CONDO 500,Residential,5000,38857,0,43857
141627600601018,CONDO 500,Residential,5000,33138,0,38138
141627600601019,CONDO 500,Residential,5000,33138,0,38138
141627600601020,CONDO 500,Residential,5000,44614,0,49614
141627600601021,CONDO 500,Residential,5000,44614,0,49614
141627600601022,CONDO 500,Residential,5000,47450,0,52450
141627600601023,CONDO 500,Residential,5000,47450,0,52450
141627600601024,CONDO 500,Residential,5000,47450,0,52450
141627600601025,CONDO 500,Residential,5000,47450,0,52450
141627600601026,CONDO 500,Residential,5000,44065,0,49065
141627600601027,CONDO 500,Residential,5000,44065,0,49065
141627600601028,CONDO 500,Residential,5000,46870,0,51870
141627600601029,CONDO 500,Residential,5000,46870,0,51870
141627600601030,CONDO 500,Residential,5000,46870,0,51870
141627600601031,CONDO 500,Residential,5000,46870,0,51870
141627600601032,CONDO 500,Residential,5000,44065,0,49065
141627600601033,CONDO 500,Residential,5000,44065,0,49065
141627600601034,CONDO 500,Residential,5000,46870,0,51870
141627600601035,CONDO 500,Residential,5000,46870,0,51870
141627600601036,CONDO 500,Residential,5000,46870,0,51870
141627600601037,CONDO 500,Residential,5000,46870,0,51870
141627600701000,CONDO 500,Residential,5000,36801,0,41801
141627600701001,CONDO 500,Residential,5000,36918,0,41918
141627600701002,CONDO 500,Residential,5000,36801,0,41801
141627600701003,CONDO 500,Residential,5000,36918,0,41918
141627600701004,CONDO 500,Residential,5000,37364,0,42364
141627600701005,CONDO 500,Residential,5000,38694,0,43694
141627600701006,CONDO 500,Residential,5000,37364,0,42364
141627600701007,CONDO 500,Residential,5000,38694,0,43694
141627600701008,CONDO 500,Residential,5000,37364,0,42364
141627600701009,CONDO 500,Residential,5000,38694,0,43694
141627600701010,CONDO 500,Residential,5000,37364,0,42364
141627600701011,CONDO 500,Residential,5000,38694,0,43694
141627600701012,CONDO 500,Residential,5000,45145,0,50145
141627600701013,CONDO 500,Residential,5000,45145,0,50145
141627600701014,CONDO 500,Residential,5000,48015,0,53015
141627600701015,CONDO 500,Residential,5000,48015,0,53015
141627600701016,CONDO 500,Residential,5000,48015,0,53015
141627600701017,CONDO 500,Residential,5000,47452,0,52452
141627600701018,CONDO 500,Residential,5000,33533,0,38533
141627600701019,CONDO 500,Residential,5000,33533,0,38533
141627600701020,CONDO 500,Residential,5000,37465,0,42465
141627600701021,CONDO 500,Residential,5000,37465,0,42465
141627600701022,CONDO 500,Residential,5000,33533,0,38533
141627600701023,CONDO 500,Residential,5000,33533,0,38533
141627600701024,CONDO 500,Residential,5000,38123,0,43123
141627600701025,CONDO 500,Residential,5000,38123,0,43123
141627600701026,CONDO 500,Residential,5000,33533,0,38533
141627600701027,CONDO 500,Residential,5000,33533,0,38533
141627600701028,CONDO 500,Residential,5000,38123,0,43123
141627600701029,CONDO 500,Residential,5000,38123,0,43123
141627700100000,NE 147,Residential,27440,128413,0,155853
141627700200000,NE 147,Residential,33681,134500,0,168181
141627700300000,NE 147,Residential,29253,126926,0,156179
141627700400000,NE 147,Residential,25507,139793,0,165300
141627700500000,NE 147,Residential,41176,137923,0,179099
141627700600000,NE 147,Residential,39847,124112,0,163959
141627700700000,NE 147,Residential,43890,130903,0,174793
141627700800000,NE 147,Residential,36288,135954,0,172242
141627700900000,NE 147,Residential,35550,146267,0,181817
141627701000000,NE 148,Residential,45389,188596,0,233985
141627701100000,NE 148,Residential,34098,0,0,34098
141627701200000,NE 148,Residential,37950,161867,0,199817
141627701300000,NE 148,Residential,33120,156616,0,189736
141627701400000,NE 148,Residential,38936,191870,0,230806
141627701500000,NE 148,Residential,35511,175400,0,210911
141627701600000,NE 148,Residential,18540,151978,0,170518
141627701700000,NE 148,Residential,18720,153021,0,171741
141627701800000,APTS NE,Commercial,18066,0,122532,140598
141627701900000,APTS NE,Commercial,19313,0,155665,174978
141627702200000,APTS NE,Commercial,13732,0,148434,162166
141627702301000,CONDO 500,Residential,5000,36368,0,41368
141627702301001,CONDO 500,Residential,5000,36484,0,41484
141627702301002,CONDO 500,Residential,5000,36368,0,41368
141627702301003,CONDO 500,Residential,5000,36368,0,41368
141627702301004,CONDO 500,Residential,5000,36925,0,41925
141627702301005,CONDO 500,Residential,5000,37582,0,42582
141627702301006,CONDO 500,Residential,5000,36925,0,41925
141627702301007,CONDO 500,Residential,5000,37582,0,42582
141627702301008,CONDO 500,Residential,5000,36925,0,41925
141627702301009,CONDO 500,Residential,5000,37582,0,42582
141627702301010,CONDO 500,Residential,5000,36925,0,41925
141627702301011,CONDO 500,Residential,5000,37582,0,42582
141627702301012,CONDO 500,Residential,5000,44614,0,49614
141627702301013,CONDO 500,Residential,5000,44614,0,49614
141627702301014,CONDO 500,Residential,5000,47450,0,52450
141627702301015,CONDO 500,Residential,5000,47450,0,52450
141627702301016,CONDO 500,Residential,5000,47450,0,52450
141627702301017,CONDO 500,Residential,5000,47450,0,52450
141627702401000,CONDO 500,Residential,5000,44707,0,49707
141627702401001,CONDO 500,Residential,5000,44707,0,49707
141627702401002,CONDO 500,Residential,5000,52636,0,57636
141627702401003,CONDO 500,Residential,5000,39953,0,44953
141627702401004,CONDO 500,Residential,5000,46842,0,51842
141627702401005,CONDO 500,Residential,5000,46842,0,51842
141627702401006,CONDO 500,Residential,5000,39953,0,44953
141627702401007,CONDO 500,Residential,5000,39389,0,44389
141627702401008,CONDO 500,Residential,5000,39506,0,44506
141627702401009,CONDO 500,Residential,5000,39389,0,44389
141627702401010,CONDO 500,Residential,5000,42220,0,47220
141627702401011,CONDO 500,Residential,5000,42220,0,47220
141627702401012,CONDO 500,Residential,5000,42220,0,47220
141627702401013,CONDO 500,Residential,5000,42220,0,47220
141627702401014,CONDO 500,Residential,5000,42220,0,47220
141627702401015,CONDO 500,Residential,5000,42220,0,47220
141627702401016,CONDO 500,Residential,5000,42220,0,47220
141627702401017,CONDO 500,Residential,5000,42220,0,47220
141627702401018,CONDO 500,Residential,5000,44707,0,49707
141627702401019,CONDO 500,Residential,5000,44707,0,49707
141627702401020,CONDO 500,Residential,5000,45153,0,50153
141627702401021,CONDO 500,Residential,5000,45153,0,50153
141627702401022,CONDO 500,Residential,5000,44707,0,49707
141627702401023,CONDO 500,Residential,5000,45153,0,50153
141627702401024,CONDO 500,Residential,5000,45849,0,50849
141627702401025,CONDO 500,Residential,5000,45849,0,50849
141627702401026,CONDO 500,Residential,5000,48601,0,53601
141627702401027,CONDO 500,Residential,5000,48601,0,53601
141627702401028,CONDO 500,Residential,5000,50869,0,55869
141627702401029,CONDO 500,Residential,5000,50869,0,55869
141627702401030,CONDO 500,Residential,5000,45263,0,50263
141627702401031,CONDO 500,Residential,5000,45263,0,50263
141627702401032,CONDO 500,Residential,5000,48015,0,53015
141627702401033,CONDO 500,Residential,5000,48015,0,53015
141627702401034,CONDO 500,Residential,5000,50283,0,55283
141627702401035,CONDO 500,Residential,5000,50283,0,55283
141627702401036,CONDO 500,Residential,5000,50055,0,55055
141627702401037,CONDO 500,Residential,5000,50055,0,55055
141627702401038,CONDO 500,Residential,5000,52450,0,57450
141627702401039,CONDO 500,Residential,5000,52450,0,57450
141627702401040,CONDO 500,Residential,5000,52450,0,57450
141627702401041,CONDO 500,Residential,5000,52450,0,57450
141627702401042,CONDO 500,Residential,5000,40827,0,45827
141627702401043,CONDO 500,Residential,5000,41321,0,46321
141627702401044,CONDO 500,Residential,5000,40827,0,45827
141627702401045,CONDO 500,Residential,5000,40827,0,45827
141627702401046,CONDO 500,Residential,5000,41321,0,46321
141627702401047,CONDO 500,Residential,5000,41432,0,46432
141627702401048,CONDO 500,Residential,5000,41321,0,46321
141627702401049,CONDO 500,Residential,5000,41432,0,46432
141627702401050,CONDO 500,Residential,5000,41321,0,46321
141627702401051,CONDO 500,Residential,5000,42056,0,47056
141627702401052,CONDO 500,Residential,5000,41321,0,46321
141627702401053,CONDO 500,Residential,5000,42056,0,47056
141627800200000,NE 148,Residential,19392,136878,0,156270
141627800300000,NE 148,Residential,20196,140000,0,160196
141627800400000,NE 148,Residential,19125,136607,0,155732
141627800500000,NE 148,Residential,18695,133947,0,152642
141627800600000,NE 148,Residential,17680,137537,0,155217
141627800700000,NE 148,Residential,19032,134807,0,153839
141627800800000,NE 148,Residential,38934,143422,0,182356
141627800900000,NE 148,Residential,40086,168535,0,208621
141627801000000,NE 148,Residential,43512,213359,0,256871
141627801100000,NE 148,Residential,42923,188474,0,231397
141627801200000,NE 148,Residential,40013,164861,0,204874
141627801300000,NE 148,Residential,44550,148761,0,193311
141627801400000,NE 148,Residential,43605,140654,0,184259
141627801500000,NE 148,Residential,41658,147928,0,189586
141627801600000,COMM NE,Commercial,261000,0,0,261000
141627801700000,COMM NE,Commercial,1663,0,0,1663
141627801800000,COMM NE,Commercial,303588,0,1744779,2048367
141627801901000,CONDO 500,Residential,5000,33533,0,38533
141627801901001,CONDO 500,Residential,5000,33533,0,38533
141627801901002,CONDO 500,Residential,5000,36918,0,41918
141627801901003,CONDO 500,Residential,5000,36801,0,41801
141627801901004,CONDO 500,Residential,5000,33533,0,38533
141627801901005,CONDO 500,Residential,5000,33533,0,38533
141627801901006,CONDO 500,Residential,5000,37364,0,42364
141627801901007,CONDO 500,Residential,5000,38029,0,43029
141627801901008,CONDO 500,Residential,5000,33533,0,38533
141627801901009,CONDO 500,Residential,5000,33533,0,38533
141627801901010,CONDO 500,Residential,5000,37364,0,42364
141627801901011,CONDO 500,Residential,5000,39319,0,44319
141627801901012,CONDO 500,Residential,5000,37465,0,42465
141627801901013,CONDO 500,Residential,5000,37583,0,42583
141627801901014,CONDO 500,Residential,5000,33533,0,38533
141627801901015,CONDO 500,Residential,5000,33533,0,38533
141627801901016,CONDO 500,Residential,5000,38029,0,43029
141627801901017,CONDO 500,Residential,5000,38029,0,43029
141627801901018,CONDO 500,Residential,5000,33533,0,38533
141627801901019,CONDO 500,Residential,5000,33533,0,38533
141627801901020,CONDO 500,Residential,5000,38029,0,43029
141627801901021,CONDO 500,Residential,5000,38756,0,43756
141627801901022,CONDO 500,Residential,5000,33533,0,38533
141627801901023,CONDO 500,Residential,5000,34173,0,39173
141630100100000,E-15 CITY,Exempt,0,0,0,0
141630100200000,COMM NE,Commercial,345168,0,974594,1319762
141630100300000,COMM NE,Commercial,320544,0,1652481,1973025
141630100400000,E-15 CITY,Exempt,0,0,0,0
141630100500000,INDUSTRIAL,Industrial,411030,0,3028859,3439889
141630100600000,Empty,Other,0,0,0,0
141630200100000,Empty,Other,0,0,0,0
141632600100000,E-15 CITY,Exempt,0,0,0,0
141632600400000,E-15 CITY,Exempt,0,0,0,0
141632600600000,E-15 CITY,Exempt,0,0,0,0
141632600700000,E-15 CITY,Exempt,0,0,0,0
141632600900000,Empty,Other,0,0,0,0
141632601400000,INDUSTRIAL,Industrial,125000,0,820025,945025
141632601500000,INDUSTRIAL,Industrial,214850,0,871283,1086133
141632601600000,COMM NE,Commercial,443988,0,798546,1242534
141635100100000,INDUSTRIAL,Industrial,93750,0,0,93750
141635100200000,E-15 CITY,Exempt,0,0,0,0
141635100400000,Empty,Other,0,0,0,0
141637600100000,COMM NE,Commercial,16961,0,23328,40289
141637600102000,COMM NE,Commercial,0,0,8442,8442
141637600200000,Empty,Other,0,0,0,0
141637700100000,E-15 CITY,Exempt,0,0,0,0
141637700200000,COMM NE,Commercial,34143,0,171486,205629
141637700600000,COMM NE,Commercial,160986,0,434482,595468
141637700700000,Empty,Other,0,0,0,0
141637700800000,Empty,Other,0,0,0,0
141637700900000,COMM NE,Commercial,228258,0,481325,709583
141640100100000,E-15 CITY,Exempt,0,0,0,0
141640200100000,NE 145,Residential,24480,97349,0,121829
141640200200000,APTS NE,Commercial,9819,0,78193,88012
141640200300000,NE 145,Residential,18180,65535,0,83715
141640200400000,NE 145,Residential,19089,56722,0,75811
141640200500000,NE 145,Residential,19089,43881,0,62970
141640200600000,NE 145,Residential,30011,51538,0,81549
141640200700000,NE 145,Residential,30011,40613,0,70624
141640200800000,NE 145,Residential,29695,77716,0,107411
141640200900000,NE 145,Residential,25272,84230,0,109502
141640201000000,NE 145,Residential,24300,48856,0,73156
141640201100000,NE 145,Residential,31882,61013,0,92895
141640201200000,NE 145,Residential,30278,40649,0,70927
141640201300000,NE 145,Residential,16674,82138,0,98812
141640201400000,NE 145,Residential,18360,58744,0,77104
141640201500000,NE 145,Residential,23520,74328,0,97848
141640201600000,NE 145,Residential,19600,88856,0,108456
141640201700000,NE 145,Residential,15680,69411,0,85091
141640201800000,NE 145,Residential,15680,68928,0,84608
141640201900000,NE 145,Residential,25056,208433,0,233489
141640202000000,NE 145,Residential,17400,77063,0,94463
141640202100000,NE 145,Residential,26914,92249,0,119163
141640202200000,NE 145,Residential,26417,57100,0,83517
141640202300000,NE 145,Residential,26417,65951,0,92368
141640202400000,NE 145,Residential,27907,82170,0,110077
141640202500000,NE 145,Residential,23803,62072,0,85875
141640202600000,NE 145,Residential,26676,84840,0,111516
141640202700000,NE 145,Residential,26676,84595,0,111271
141640202800000,NE 145,Residential,26112,115184,0,141296
141640300100000,NE 145,Residential,27540,72775,0,100315
141640300200000,COMM NE,Commercial,25056,0,36617,61673
141640300300000,NE 145,Residential,16480,38262,0,54742
141640300400000,NE 145,Residential,16480,0,0,16480
141640300500000,NE 145,Residential,16480,46522,0,63002
141640300600000,NE 145,Residential,16480,0,0,16480
141640300700000,NE 145,Residential,16480,60480,0,76960
141640300800000,NE 145,Residential,16480,89758,0,106238
141640300900000,NE 145,Residential,16480,53617,0,70097
141640301000000,NE 145,Residential,16480,71697,0,88177
141640301100000,NE 145,Residential,16480,38130,0,54610
141640301200000,NE 145,Residential,16480,54768,0,71248
141640301300000,NE 145,Residential,16480,74518,0,90998
141640301400000,NE 145,Residential,12360,57432,0,69792
141640301500000,NE 145,Residential,12360,51685,0,64045
141640301600000,NE 145,Residential,16480,63107,0,79587
141640301700000,NE 145,Residential,15360,51243,0,66603
141640301800000,NE 145,Residential,20506,65281,0,85787
141640301900000,NE 145,Residential,15800,56973,0,72773
141640302000000,NE 145,Residential,17984,47697,0,65681
141640302100000,NE 145,Residential,17984,62031,0,80015
141640302200000,NE 145,Residential,27810,92211,0,120021
141640302300000,NE 145,Residential,13905,63605,0,77510
141640302400000,NE 145,Residential,13905,53115,0,67020
141640302500000,NE 145,Residential,27810,75903,0,103713
141640302600000,NE 145,Residential,18540,38310,0,56850
141640302700000,NE 145,Residential,18540,70922,0,89462
141640302800000,NE 145,Residential,18540,49359,0,67899
141640302900000,NE 145,Residential,18540,49592,0,68132
141640303000000,NE 145,Residential,18540,94464,0,113004
141640303100000,NE 145,Residential,18540,89610,0,108150
141640303200000,NE 145,Residential,18540,50751,0,69291
141640303300000,NE 145,Residential,18540,69387,0,87927
141640303400000,NE 145,Residential,18540,63672,0,82212
141640400100000,NE 145,Residential,20731,61938,0,82669
141640400200000,NE 145,Residential,16856,125492,0,142348
141640400300000,NE 145,Residential,17091,71518,0,88609
141640400400000,NE 145,Residential,19992,66953,0,86945
141640400500000,NE 145,Residential,19680,57696,0,77376
141640400600000,NE 145,Residential,19680,58040,0,77720
141640400700000,NE 145,Residential,17460,69537,0,86997
141640400800000,NE 145,Residential,19440,55625,0,75065
141640400900000,NE 145,Residential,29792,69662,0,99454
141640401000000,NE 145,Residential,29831,66386,0,96217
141640401100000,NE 145,Residential,19620,75561,0,95181
141640401200000,NE 145,Residential,19620,93378,0,112998
141640401300000,NE 145,Residential,19620,62689,0,82309
141640401400000,NE 145,Residential,19865,67867,0,87732
141640401500000,NE 145,Residential,19620,61707,0,81327
141640401600000,NE 145,Residential,17460,60965,0,78425
141640401700000,NE 145,Residential,17460,52103,0,69563
141640401800000,NE 145,Residential,17266,52146,0,69412
141640401900000,NE 145,Residential,17072,62057,0,79129
141640402000000,COMM NE,Commercial,71397,0,160857,232254
141640402100000,NE 145,Residential,17440,39301,0,56741
141640402200000,NE 145,Residential,28050,70809,0,98859
141640402300000,NE 145,Residential,17440,36956,0,54396
141640402400000,NE 145,Residential,17440,65403,0,82843
141640402500000,NE 145,Residential,17876,78413,0,96289
141640402600000,NE 145,Residential,18007,79870,0,97877
141640402700000,NE 145,Residential,17440,102356,0,119796
141640402800000,NE 145,Residential,17440,96190,0,113630
141640402900000,NE 145,Residential,20160,48547,0,68707
141640500100000,NE 145,Residential,11610,25588,0,37198
141640500200000,NE 145,Residential,16500,66218,0,82718
141640500300000,NE 145,Residential,9720,49656,0,59376
141640500400000,NE 145,Residential,16198,61392,0,77590
141640500500000,NE 145,Residential,16480,58797,0,75277
141640500600000,NE 145,Residential,16480,59254,0,75734
141640500700000,NE 145,Residential,16480,58548,0,75028
141640500800000,NE 145,Residential,16480,82960,0,99440
141640500900000,NE 145,Residential,16480,65290,0,81770
141640501000000,NE 145,Residential,16480,62796,0,79276
141640501100000,NE 145,Residential,16480,69998,0,86478
141640501200000,NE 145,Residential,16480,60565,0,77045
141640501300000,NE 145,Residential,16480,35114,0,51594
141640501400000,NE 145,Residential,16480,56284,0,72764
141640501500000,NE 145,Residential,16480,72397,0,88877
141640501600000,NE 145,Residential,16480,75926,0,92406
141640501700000,NE 145,Residential,14560,53503,0,68063
141640501800000,NE 145,Residential,30996,66843,0,97839
141640501900000,NE 145,Residential,17784,64112,0,81896
141640502000000,NE 145,Residential,21060,108803,0,129863
141640502100000,NE 145,Residential,21060,77420,0,98480
141640502200000,NE 145,Residential,21060,69923,0,90983
141640502300000,NE 145,Residential,21060,75485,0,96545
141640502400000,NE 145,Residential,28080,116574,0,144654
141640502500000,NE 145,Residential,28080,79474,0,107554
141640502600000,NE 145,Residential,28080,59252,0,87332
141640502700000,NE 145,Residential,13352,44036,0,57388
141642600100000,COMM NE,Commercial,48384,0,73226,121610
141642600200000,NE 146,Residential,16000,59113,0,75113
141642600300000,NE 146,Residential,16000,48905,0,64905
141642600400000,NE 146,Residential,16000,47912,0,63912
141642600500000,NE 146,Residential,15040,46451,0,61491
141642600600000,NE 146,Residential,16000,60369,0,76369
141642600700000,NE 146,Residential,16000,46624,0,62624
141642600800000,NE 146,Residential,16000,49924,0,65924
141642600900000,NE 146,Residential,16000,52810,0,68810
141642601000000,NE 146,Residential,16000,43712,0,59712
141642601100000,NE 146,Residential,16000,52177,0,68177
141642601200000,NE 146,Residential,16000,53890,0,69890
141642601300000,NE 146,Residential,16000,87073,0,103073
141642601400000,NE 146,Residential,16000,29025,0,45025
141642601500000,NE 146,Residential,16000,53681,0,69681
141642601600000,NE 146,Residential,16000,46734,0,62734
141642601700000,NE 146,Residential,16000,62302,0,78302
141642601800000,NE 146,Residential,16000,65695,0,81695
141642601900000,NE 146,Residential,4800,39456,0,44256
141642602000000,NE 146,Residential,11200,47991,0,59191
141642602100000,NE 146,Residential,16000,76205,0,92205
141642602200000,NE 146,Residential,16000,56813,0,72813
141642602300000,NE 146,Residential,16000,51255,0,67255
141642602400000,NE 146,Residential,16000,62805,0,78805
141642602500000,NE 146,Residential,16000,29858,0,45858
141642602600000,NE 146,Residential,16000,58127,0,74127
141642602700000,NE 146,Residential,16000,63652,0,79652
141642602800000,NE 146,Residential,16000,54806,0,70806
141642602900000,NE 146,Residential,16000,49860,0,65860
141642603000000,NE 146,Residential,16000,48936,0,64936
141642603100000,NE 146,Residential,16000,52348,0,68348
141642603200000,NE 146,Residential,16000,50337,0,66337
141642603300000,NE 146,Residential,15040,50484,0,65524
141642603400000,NE 146,Residential,16000,48063,0,64063
141642700100000,NE 146,Residential,16000,51210,0,67210
141642700200000,INDUSTRIAL,Industrial,80750,0,631583,712333
141642700300000,NE 146,Residential,19200,28386,0,47586
141642700400000,NE 146,Residential,16000,65457,0,81457
141642700500000,NE 146,Residential,13520,58736,0,72256
141642700600000,NE 146,Residential,16000,48166,0,64166
141642700700000,NE 146,Residential,16000,103462,0,119462
141642700800000,NE 146,Residential,16000,36367,0,52367
141642800100000,COMM NE,Commercial,21873,0,0,21873
141642800200000,NE 146,Residential,16480,84983,0,101463
141642800300000,COMM NE,Commercial,20347,0,98618,118965
141642800400000,COMM NE,Commercial,18144,0,39134,57278
141642800500000,COMM NE,Commercial,48185,0,111788,159973
141642800600000,NE 146,Residential,14391,59322,0,73713
141642800700000,NE 146,Residential,12000,25603,0,37603
141642800800000,NE 146,Residential,12000,43103,0,55103
141642800900000,COMM NE,Commercial,20347,0,81237,101584
141642801000000,INDUSTRIAL,Industrial,31750,0,7216,38966
141642900100000,CONVERSIONS,Commercial,9072,0,59891,68963
141642900200000,NE 146,Residential,16686,74165,0,90851
141642900300000,NE 146,Residential,18833,65637,0,84470
141642900400000,NE 146,Residential,16557,27043,0,43600
141642900500000,NE 146,Residential,16480,58524,0,75004
141642900600000,NE 146,Residential,16686,62082,0,78768
141642900700000,NE 146,Residential,16000,44846,0,60846
141642900800000,NE 146,Residential,19200,52131,0,71331
141642900900000,NE 146,Residential,13520,40014,0,53534
141642901000000,NE 146,Residential,16000,58896,0,74896
141642901100000,NE 146,Residential,16000,73727,0,89727
141642901200000,NE 146,Residential,16000,37531,0,53531
141643000100000,COMM NE,Commercial,28003,0,53607,81610
141643000200000,NE 146,Residential,16480,48520,0,65000
141643000300000,COMM NE,Commercial,18144,0,37686,55830
141643000400000,NE 146,Residential,12000,30271,0,42271
141643000600000,COMM NE,Commercial,69764,0,177570,247334
141643000700000,NE 146,Residential,12000,27358,0,39358
141643000800000,NE 146,Residential,12000,22850,0,34850
141643000900000,COMM NE,Commercial,41559,0,108518,150077
141643100100000,NE 146,Residential,16020,94593,0,110613
141643100200000,NE 146,Residential,16020,51429,0,67449
141643100300000,NE 146,Residential,9600,0,0,9600
141643100400000,NE 146,Residential,9600,46775,0,56375
141643100500000,NE 146,Residential,16000,58918,0,74918
141643100600000,NE 146,Residential,19200,41688,0,60888
141643100700000,NE 146,Residential,16000,53946,0,69946
141643100800000,NE 146,Residential,16000,48419,0,64419
141643100900000,NE 146,Residential,16000,74555,0,90555
141643101000000,NE 146,Residential,16000,89367,0,105367
141643101100000,NE 146,Residential,19200,79064,0,98264
141643101200000,NE 146,Residential,16000,58991,0,74991
141643101300000,NE 146,Residential,16000,54125,0,70125
141643101400000,NE 146,Residential,16000,35471,0,51471
141643101500000,NE 146,Residential,16000,57832,0,73832
141643101600000,NE 146,Residential,16000,65848,0,81848
141643101700000,NE 146,Residential,2720,29683,0,32403
141643101800000,NE 146,Residential,13280,57951,0,71231
141643101900000,NE 146,Residential,16000,45170,0,61170
141643102000000,NE 146,Residential,16000,49425,0,65425
141643102100000,NE 146,Residential,16000,104429,0,120429
141643102200000,NE 146,Residential,16000,81490,0,97490
141643102300000,NE 146,Residential,16000,48134,0,64134
141643102400000,NE 146,Residential,16000,53472,0,69472
141643102500000,NE 146,Residential,16000,59336,0,75336
141643102600000,NE 146,Residential,16000,53643,0,69643
141643200100000,NE 146,Residential,18000,63192,0,81192
141643200200000,NE 146,Residential,16200,58186,0,74386
141643200300000,NE 146,Residential,16000,76792,0,92792
141643200400000,NE 146,Residential,17590,65069,0,82659
141643200500000,NE 146,Residential,19553,38702,0,58255
141643200600000,NE 146,Residential,16000,45242,0,61242
141643200700000,NE 146,Residential,16200,71336,0,87536
141643200800000,NE 146,Residential,16000,64846,0,80846
141643200900000,NE 146,Residential,16000,47998,0,63998
141643201000000,NE 146,Residential,16000,62150,0,78150
141643201100000,NE 146,Residential,14920,57421,0,72341
141643201200000,NE 146,Residential,18000,63518,0,81518
141643300100000,COMM NE,Commercial,29296,0,66367,95663
141643300200000,COMM NE,Commercial,15552,0,71882,87434
141643300300000,COMM NE,Commercial,38880,0,86411,125291
141643300400000,NE 146,Residential,11190,41270,0,52460
141643300500000,NE 146,Residential,12000,55887,0,67887
141643300600000,NE 146,Residential,15370,56114,0,71484
141643300700000,COMM NE,Commercial,96681,0,93728,190409
141643300800000,COMM NE,Commercial,7966,0,0,7966
141643300900000,COMM NE,Commercial,24274,0,0,24274
141643400100000,NE 146,Residential,19200,43088,0,62288
141643400200000,COMM NE,Commercial,155520,0,873801,1029321
141643400300000,NE 146,Residential,16000,45042,0,61042
141643400400000,NE 146,Residential,16000,0,0,16000
141643400500000,NE 146,Residential,20072,0,0,20072
141645100100000,CONVERSIONS,Commercial,8951,0,60924,69875
141645100200000,NE 146,Residential,16000,40627,0,56627
141645200100000,NE 146,Residential,16000,26102,0,42102
141645300100000,NE 146,Residential,14440,54907,0,69347
141645300200000,NE 146,Residential,14040,54213,0,68253
141645300300000,NE 146,Residential,15120,43685,0,58805
141645300400000,NE 146,Residential,14000,49106,0,63106
141645300500000,NE 146,Residential,16000,61805,0,77805
141645300600000,NE 146,Residential,16000,23774,0,39774
141645300700000,NE 146,Residential,16000,43098,0,59098
141645300800000,NE 146,Residential,16000,53394,0,69394
141645300900000,NE 146,Residential,16000,59389,0,75389
141645301000000,NE 146,Residential,16000,52385,0,68385
141645301100000,NE 146,Residential,16000,48088,0,64088
141645301200000,NE 146,Residential,16000,40828,0,56828
141645301300000,NE 146,Residential,16000,42630,0,58630
141645301400000,NE 146,Residential,16000,104284,0,120284
141645301500000,NE 146,Residential,16000,44849,0,60849
141645301600000,NE 146,Residential,16000,37292,0,53292
141645301700000,NE 146,Residential,16000,64160,0,80160
141645301800000,NE 146,Residential,14400,43985,0,58385
141645301900000,NE 146,Residential,16560,48287,0,64847
141645302000000,NE 146,Residential,5832,28599,0,34431
141645302100000,COMM NE,Commercial,30240,0,101642,131882
141645302200000,NE 146,Residential,16000,83183,0,99183
141645302300000,NE 146,Residential,16000,74449,0,90449
141645302400000,NE 146,Residential,16000,56234,0,72234
141645302500000,NE 146,Residential,16000,46018,0,62018
141645302600000,NE 146,Residential,16000,45734,0,61734
141645302700000,NE 146,Residential,16000,61580,0,77580
141645302800000,NE 146,Residential,16000,56373,0,72373
141645302900000,NE 146,Residential,16000,59733,0,75733
141645303000000,NE 146,Residential,16000,62502,0,78502
141645303100000,NE 146,Residential,16000,45195,0,61195
141645303200000,NE 146,Residential,16000,74017,0,90017
141645303300000,NE 146,Residential,16000,72549,0,88549
141645303400000,NE 146,Residential,16000,45451,0,61451
141645303500000,NE 146,Residential,16000,59955,0,75955
141645400100000,NE 146,Residential,18000,56706,0,74706
141645400200000,NE 146,Residential,18360,93832,0,112192
141645400300000,NE 146,Residential,21216,103716,0,124932
141645400400000,NE 146,Residential,21012,43863,0,64875
141645400500000,COMM NE,Commercial,19986,0,59202,79188
141645400600000,COMM NE,Commercial,10935,0,70071,81006
141645400700000,NE 146,Residential,18000,42923,0,60923
141645400800000,NE 146,Residential,18000,68660,0,86660
141645400900000,NE 146,Residential,16000,64989,0,80989
141645401000000,NE 146,Residential,16000,46265,0,62265
141645401100000,NE 146,Residential,16000,51507,0,67507
141645401200000,NE 146,Residential,18000,52851,0,70851
141645500100000,NE 146,Residential,16200,72336,0,88536
141645500200000,COMM NE,Commercial,20898,0,0,20898
141645500300000,COMM NE,Commercial,7836,0,16481,24317
141645500400000,NE 146,Residential,16200,72970,0,89170
141645500500000,NE 146,Residential,16200,57051,0,73251
141645500600000,NE 146,Residential,14400,49276,0,63676
141645500700000,CONVERSIONS,Commercial,16330,0,43579,59909
141645500800000,NE 146,Residential,8000,0,0,8000
141645600100000,COMM NE,Commercial,54432,0,32651,87083
141645600200000,NE 146,Residential,5000,0,0,5000
141645600300000,NE 146,Residential,6000,0,0,6000
141645600400000,NE 146,Residential,6000,0,0,6000
141645600500000,NE 146,Residential,6000,0,0,6000
141645600600000,NE 146,Residential,12000,25889,0,37889
141645600700000,NE 146,Residential,12000,33426,0,45426
141645600800000,NE 146,Residential,14790,39619,0,54409
141645600900000,NE 146,Residential,20880,38698,0,59578
141645601000000,NE 146,Residential,14400,36306,0,50706
141645601100000,NE 146,Residential,14400,44644,0,59044
141645601200000,NE 146,Residential,14400,47555,0,61955
141645601300000,NE 146,Residential,14400,47605,0,62005
141645700100000,NE 146,Residential,14107,32768,0,46875
141645700200000,NE 146,Residential,10832,0,0,10832
141645700300000,NE 146,Residential,5000,0,0,5000
141645700400000,NE 146,Residential,5976,18122,0,24098
141645700500000,NE 146,Residential,9878,0,0,9878
141645700600000,Empty,Other,0,0,0,0
141645800100000,COMM NE,Commercial,71398,0,58793,130191
141645800200000,COMM NE,Commercial,39366,0,45935,85301
141645900100000,E-15 CITY,Exempt,0,0,0,0
141645900200000,E-15 CITY,Exempt,0,0,0,0
141645900300000,NE 146,Residential,5000,0,0,5000
141645900400000,E-15 CITY,Exempt,0,0,0,0
141645900500000,E-15 CITY,Exempt,0,0,0,0
141645900600000,COMM NE,Commercial,31072,0,12851,43923
141645900700000,E-15 CITY,Exempt,0,0,0,0
141645900800000,NE 146,Residential,15074,0,0,15074
141645900900000,NE 146,Residential,10563,0,0,10563
141645901000000,COMM NE,Commercial,26531,0,27678,54209
141645901100000,COMM NE,Commercial,50801,0,92810,143611
141645901200000,INDUSTRIAL,Industrial,36360,0,12776,49136
141645901300000,E-15 CITY,Exempt,0,0,0,0
141645901400000,Empty,Other,0,0,0,0
141645901500000,Empty,Other,0,0,0,0
141645901600000,Empty,Other,0,0,0,0
141645901700000,Empty,Other,0,0,0,0
141647600100000,NE 146,Residential,10220,41740,0,51960
141647600200000,NE 146,Residential,10360,44111,0,54471
141647600300000,NE 146,Residential,11076,41569,0,52645
141647600400000,NE 146,Residential,7384,0,0,7384
141647600500000,NE 146,Residential,16000,44316,0,60316
141647600600000,NE 146,Residential,16000,50814,0,66814
141647600700000,NE 146,Residential,16000,42770,0,58770
141647600800000,NE 146,Residential,15840,38663,0,54503
141647600900000,NE 146,Residential,15840,50885,0,66725
141647601000000,NE 146,Residential,15840,0,0,15840
141647601100000,NE 146,Residential,19008,59373,0,78381
141647601200000,NE 146,Residential,15680,27951,0,43631
141647601300000,NE 146,Residential,15680,42417,0,58097
141647601400000,NE 146,Residential,15680,0,0,15680
141647601500000,NE 146,Residential,15520,55999,0,71519
141647601600000,NE 146,Residential,15520,42933,0,58453
141647601700000,NE 146,Residential,15360,43877,0,59237
141647601800000,NE 146,Residential,15360,50741,0,66101
141647601900000,COMM NE,Commercial,14375,0,216,14591
141647602000000,COMM NE,Commercial,13635,0,5048,18683
141647602100000,COMM NE,Commercial,12825,0,5710,18535
141647602200000,COMM NE,Commercial,11610,0,2158,13768
141647602300000,COMM NE,Commercial,126090,0,265561,391651
141647700100000,NE 146,Residential,12164,51478,0,63642
141647700200000,NE 146,Residential,11340,49955,0,61295
141647700300000,NE 146,Residential,13580,59923,0,73503
141647700400000,NE 146,Residential,21888,106141,0,128029
141647700500000,NE 146,Residential,16000,73681,0,89681
141647700600000,NE 146,Residential,16000,80810,0,96810
141647700700000,NE 146,Residential,16000,72952,0,88952
141647700800000,NE 146,Residential,16000,57902,0,73902
141647700900000,NE 146,Residential,16000,83334,0,99334
141647701000000,NE 146,Residential,16000,80349,0,96349
141647701100000,NE 146,Residential,16000,82053,0,98053
141647701200000,NE 146,Residential,16000,59636,0,75636
141647701300000,NE 146,Residential,16000,84773,0,100773
141647701400000,NE 146,Residential,16000,70446,0,86446
141647701500000,NE 146,Residential,16000,69847,0,85847
141647701600000,NE 146,Residential,16000,73592,0,89592
141647701700000,NE 146,Residential,16000,72834,0,88834
141647701800000,NE 146,Residential,16000,60741,0,76741
141647701900000,NE 146,Residential,16000,66818,0,82818
141647702000000,NE 146,Residential,16000,54321,0,70321
141647702100000,NE 146,Residential,16000,85643,0,101643
141647702200000,NE 146,Residential,16000,103434,0,119434
141647702300000,NE 146,Residential,16000,69073,0,85073
141647702400000,NE 146,Residential,14080,50608,0,64688
141647702500000,NE 146,Residential,14763,42581,0,57344
141647702600000,NE 146,Residential,12960,44366,0,57326
141647702900000,NE 146,Residential,11760,40909,0,52669
141647703000000,NE 146,Residential,15729,40827,0,56556
141647703100000,NE 146,Residential,11200,45224,0,56424
141647703200000,NE 146,Residential,16000,52412,0,68412
141647703300000,NE 146,Residential,16000,50131,0,66131
141647703400000,NE 146,Residential,16000,0,0,16000
141647703500000,NE 146,Residential,16000,26733,0,42733
141647703600000,NE 146,Residential,16000,48375,0,64375
141647703700000,NE 146,Residential,19200,57779,0,76979
141647703800000,NE 146,Residential,16000,52934,0,68934
141647703900000,NE 146,Residential,16000,41461,0,57461
141647704000000,NE 146,Residential,16000,57256,0,73256
141647704100000,NE 146,Residential,16000,55760,0,71760
141647704200000,NE 146,Residential,16000,62221,0,78221
141647704300000,NE 146,Residential,16000,64207,0,80207
141647704400000,NE 146,Residential,16000,37432,0,53432
141647704500000,NE 146,Residential,16000,58578,0,74578
141647704600000,NE 146,Residential,16000,27292,0,43292
141647704700000,NE 146,Residential,16000,49366,0,65366
141647704800000,NE 146,Residential,14400,0,0,14400
141647704900000,NE 146,Residential,11200,70301,0,81501
141647705000000,NE 146,Residential,11620,64006,0,75626
141647800100000,NE 145,Residential,17460,54452,0,71912
141647900100000,NE 145,Residential,24570,61158,0,85728
141647900200000,NE 145,Residential,14150,56794,0,70944
141647900300000,NE 145,Residential,14400,63795,0,78195
141647900400000,NE 145,Residential,14560,66577,0,81137
141648000100000,NE 146,Residential,29070,97559,0,126629
141648000200000,NE 146,Residential,16114,57340,0,73454
141648000300000,NE 146,Residential,19800,80565,0,100365
141648000400000,NE 146,Residential,23594,81573,0,105167
141648000500000,NE 146,Residential,19260,67628,0,86888
141648000600000,NE 146,Residential,19260,74927,0,94187
141648000700000,NE 146,Residential,28649,90297,0,118946
141648000800000,NE 146,Residential,28649,69832,0,98481
141648000900000,NE 146,Residential,18634,30430,0,49064
141648001000000,NE 146,Residential,28890,81537,0,110427
141648001100000,NE 146,Residential,28890,63367,0,92257
141648001200000,NE 146,Residential,19260,55108,0,74368
141648001300000,NE 146,Residential,18441,71262,0,89703
141648001400000,NE 146,Residential,18779,51904,0,70683
141648001500000,NE 146,Residential,18779,70843,0,89622
141648001600000,NE 146,Residential,19260,57973,0,77233
141648001700000,NE 146,Residential,28577,81370,0,109947
141648001800000,NE 146,Residential,28577,85871,0,114448
141648001900000,NE 146,Residential,18128,54343,0,72471
141648002000000,NE 146,Residential,19440,70591,0,90031
141648002100000,NE 146,Residential,19440,89800,0,109240
141648002200000,NE 146,Residential,22627,84937,0,107564
141648002300000,NE 146,Residential,21600,65900,0,87500
141648002400000,NE 146,Residential,21600,70294,0,91894
141648002500000,NE 146,Residential,21480,54282,0,75762
141648002600000,NE 146,Residential,16000,75817,0,91817
141648002700000,NE 146,Residential,16000,73452,0,89452
141648002800000,NE 146,Residential,24000,76359,0,100359
141648002900000,NE 146,Residential,17280,63413,0,80693
141648003000000,NE 146,Residential,17280,74032,0,91312
141648003100000,NE 146,Residential,16114,84483,0,100597
141648003200000,NE 146,Residential,25402,80294,0,105696
141648003300000,NE 146,Residential,25402,56095,0,81497
141648003400000,CONVERSIONS,Commercial,16918,0,89686,106604
141648003500000,NE 146,Residential,25252,44135,0,69387
141648003600000,NE 146,Residential,16392,90911,0,107303
141648003700000,NE 146,Residential,17120,68194,0,85314
141648003800000,NE 146,Residential,17120,46922,0,64042
141648003900000,NE 146,Residential,16136,79543,0,95679
141648004000000,NE 146,Residential,17120,55358,0,72478
141648004100000,NE 146,Residential,17120,58846,0,75966
141648004200000,NE 146,Residential,17120,75241,0,92361
141648004300000,NE 146,Residential,17120,63077,0,80197
141648004400000,NE 146,Residential,17120,64806,0,81926
141648004500000,NE 146,Residential,21400,85735,0,107135
141648004600000,NE 146,Residential,18960,66452,0,85412
141648100100000,NE 146,Residential,26420,83871,0,110291
141648100200000,NE 146,Residential,11340,58822,0,70162
141648100300000,NE 146,Residential,12480,62619,0,75099
141648100400000,NE 146,Residential,16160,59469,0,75629
141648100500000,NE 146,Residential,16160,41265,0,57425
141648100600000,NE 146,Residential,16160,66727,0,82887
141648100700000,NE 146,Residential,16160,55465,0,71625
141648100800000,NE 146,Residential,16160,78969,0,95129
141648100900000,NE 146,Residential,16160,94386,0,110546
141648101000000,NE 146,Residential,16160,54482,0,70642
141648101100000,NE 146,Residential,27149,53844,0,80993
141648101200000,NE 146,Residential,15756,51731,0,67487
141648101300000,NE 146,Residential,16160,46638,0,62798
141648101400000,NE 146,Residential,16160,69615,0,85775
141648101500000,NE 146,Residential,24240,61552,0,85792
141648101600000,NE 146,Residential,23836,75565,0,99401
141648101700000,NE 146,Residential,23755,87165,0,110920
141648101800000,NE 146,Residential,23755,89637,0,113392
141648101900000,NE 146,Residential,15594,66386,0,81980
141648102000000,COMM NE,Commercial,53610,0,3014,56624
141648102100000,NE 146,Residential,21600,37700,0,59300
141648102200000,NE 146,Residential,21600,51198,0,72798
141648102300000,NE 146,Residential,21600,86164,0,107764
141648102400000,NE 146,Residential,20400,62798,0,83198
141648102500000,NE 146,Residential,27425,44926,0,72351
141648102600000,NE 146,Residential,13712,55727,0,69439
141648102700000,NE 146,Residential,13712,66036,0,79748
141648102800000,NE 146,Residential,27518,77358,0,104876
141648102900000,NE 146,Residential,27518,78062,0,105580
141648103000000,NE 146,Residential,27612,74936,0,102548
141648103100000,NE 146,Residential,27612,117001,0,144613
141648103200000,NE 146,Residential,17784,53051,0,70835
141648103300000,NE 146,Residential,18720,21280,0,40000
141648103400000,NE 146,Residential,18720,58104,0,76824
141648103500000,NE 146,Residential,28080,90529,0,118609
141648103600000,NE 146,Residential,27810,57241,0,85051
141648103700000,NE 146,Residential,27810,69267,0,97077
141648103800000,NE 146,Residential,27810,88171,0,115981
141648103900000,NE 146,Residential,27810,57248,0,85058
141648104000000,NE 146,Residential,27810,71413,0,99223
141648200100000,NE 146,Residential,29120,53880,0,83000
141648200200000,NE 146,Residential,20628,1591,0,22219
141648200300000,NE 146,Residential,25500,96527,0,122027
141648200400000,NE 146,Residential,24000,81579,0,105579
141648200500000,COMM NE,Commercial,13025,0,58371,71396
141648200600000,NE 146,Residential,23520,0,0,23520
141648200700000,NE 146,Residential,18099,51577,0,69676
141648200800000,NE 146,Residential,16975,54951,0,71926
141648200900000,COMM NE,Commercial,32264,0,29371,61635
141710100101000,CONDO 505,Residential,10000,103925,0,113925
141710100101001,CONDO 505,Residential,10000,108572,0,118572
141710100101002,CONDO 505,Residential,10000,108208,0,118208
141710100101003,CONDO 505,Residential,10000,108119,0,118119
141710100101004,CONDO 505,Residential,10000,95726,0,105726
141710100101005,CONDO 505,Residential,10000,72525,0,82525
141710100101006,CONDO 505,Residential,10000,60787,0,70787
141710100101007,CONDO 505,Residential,10000,61038,0,71038
141710100101008,CONDO 505,Residential,10000,72518,0,82518
141710100101009,CONDO 505,Residential,10000,70514,0,80514
141710100101010,CONDO 505,Residential,10000,70514,0,80514
141710100101011,CONDO 505,Residential,10000,70514,0,80514
141710100101012,CONDO 505,Residential,10000,70514,0,80514
141710100101013,CONDO 505,Residential,10000,74593,0,84593
141710100101014,CONDO 505,Residential,10000,61515,0,71515
141710100101015,CONDO 505,Residential,10000,64859,0,74859
141710100101016,CONDO 505,Residential,10000,74593,0,84593
141710100101017,CONDO 505,Residential,10000,83306,0,93306
141710100101018,CONDO 505,Residential,10000,75969,0,85969
141710100101019,CONDO 505,Residential,10000,74787,0,84787
141710100101020,CONDO 505,Residential,10000,83793,0,93793
141710100101021,CONDO 505,Residential,10000,104798,0,114798
141710100101022,CONDO 505,Residential,10000,104114,0,114114
141710100101023,CONDO 505,Residential,10000,106623,0,116623
141710100101024,CONDO 505,Residential,10000,104685,0,114685
141710100101025,CONDO 505,Residential,10000,108460,0,118460
141710100101026,CONDO 505,Residential,10000,101800,0,111800
141710100101027,CONDO 505,Residential,10000,108038,0,118038
141710100101028,CONDO 505,Residential,10000,105710,0,115710
141710100101029,CONDO 505,Residential,10000,101556,0,111556
141710100101030,CONDO 505,Residential,10000,109239,0,119239
141710100101031,CONDO 505,Residential,10000,138963,0,148963
141710100101032,CONDO 505,Residential,10000,101763,0,111763
141710100101033,CONDO 505,Residential,10000,108507,0,118507
141710100101034,CONDO 505,Residential,10000,142659,0,152659
141710100101035,CONDO 505,Residential,10000,83288,0,93288
141710100101036,CONDO 505,Residential,10000,83288,0,93288
141710100200000,NE 135,Residential,67950,905512,0,973462
141710100300000,NE 135,Residential,43120,187258,0,230378
141710100400000,NE 135,Residential,40375,254022,0,294397
141710100500000,NE 135,Residential,35696,0,0,35696
141710100600000,NE 149,Residential,37350,0,0,37350
141710100700000,NE 149,Residential,20,0,0,20
141710100801000,CONDO 501,Residential,15000,165421,0,180421
141710100801001,CONDO 501,Residential,15000,147580,0,162580
141710100801002,CONDO 501,Residential,15000,153915,0,168915
141710100901000,CONDO 501,Residential,15000,160119,0,175119
141710100901001,CONDO 501,Residential,15000,153437,0,168437
141710100901002,CONDO 501,Residential,15000,154202,0,169202
141710100901003,CONDO 501,Residential,15000,159865,0,174865
141710101001000,CONDO 501,Residential,15000,176748,0,191748
141710101001001,CONDO 501,Residential,15000,173529,0,188529
141710101101000,CONDO 501,Residential,15000,158030,0,173030
141710101101001,CONDO 501,Residential,15000,137612,0,152612
141710101101002,CONDO 501,Residential,15000,103643,0,118643
141710101101003,CONDO 501,Residential,15000,151822,0,166822
141710101201000,CONDO 501,Residential,15000,147066,0,162066
141710101201001,CONDO 501,Residential,15000,177839,0,192839
141710101301000,CONDO 501,Residential,15000,160080,0,175080
141710101301001,CONDO 501,Residential,15000,160145,0,175145
141710101301002,CONDO 501,Residential,15000,175063,0,190063
141710101301003,CONDO 501,Residential,15000,170529,0,185529
141710101301004,CONDO 501,Residential,15000,171498,0,186498
141710101400000,NE 149,Residential,20,0,0,20
141710200101000,CONDO 500,Residential,6000,70579,0,76579
141710200101001,CONDO 500,Residential,6000,70907,0,76907
141710200101002,CONDO 500,Residential,6000,74692,0,80692
141710200101003,CONDO 500,Residential,6000,74692,0,80692
141710200101004,CONDO 500,Residential,6000,70579,0,76579
141710200101005,CONDO 500,Residential,6000,71880,0,77880
141710200101006,CONDO 500,Residential,6000,74692,0,80692
141710200101007,CONDO 500,Residential,6000,73899,0,79899
141710200201000,CONDO 500,Residential,6000,71399,0,77399
141710200201001,CONDO 500,Residential,6000,73190,0,79190
141710200201002,CONDO 500,Residential,6000,75561,0,81561
141710200201003,CONDO 500,Residential,6000,75561,0,81561
141710200201004,CONDO 500,Residential,6000,71399,0,77399
141710200201005,CONDO 500,Residential,6000,74233,0,80233
141710200201006,CONDO 500,Residential,6000,75561,0,81561
141710200201007,CONDO 500,Residential,6000,75561,0,81561
141710200300000,E-01 FEDERAL,Exempt,0,0,0,0
141710200401000,CONDO 500,Residential,8000,107966,0,115966
141710200401001,CONDO 500,Residential,8000,109750,0,117750
141710200401002,CONDO 500,Residential,8000,110040,0,118040
141710200401003,CONDO 500,Residential,8000,107966,0,115966
141710200401004,CONDO 500,Residential,8000,107966,0,115966
141710200401005,CONDO 500,Residential,8000,111375,0,119375
141710200401006,CONDO 500,Residential,8000,111375,0,119375
141710200401007,CONDO 500,Residential,8000,107966,0,115966
141710200401008,CONDO 500,Residential,8000,64418,0,72418
141710200501000,CONDO 501,Residential,18000,190701,0,208701
141710200501001,CONDO 501,Residential,18000,183760,0,201760
141710200501002,CONDO 501,Residential,18000,194271,0,212271
141710200501003,CONDO 501,Residential,8000,170816,0,178816
141710200501004,CONDO 501,Residential,18000,187804,0,205804
141710200501005,CONDO 501,Residential,18000,175431,0,193431
141710200601000,CONDO 501,Residential,18000,220300,0,238300
141710200601001,CONDO 501,Residential,18000,221714,0,239714
141710200601002,CONDO 501,Residential,18000,210693,0,228693
141710200601003,CONDO 501,Residential,18000,194157,0,212157
141710200601004,CONDO 501,Residential,18000,214501,0,232501
141710200601005,CONDO 501,Residential,18000,218780,0,236780
141710200601006,CONDO 501,Residential,18000,229152,0,247152
141710200701000,CONDO 500,Residential,6000,71511,0,77511
141710200701001,CONDO 500,Residential,6000,76496,0,82496
141710200701002,CONDO 500,Residential,6000,75719,0,81719
141710200701003,CONDO 500,Residential,6000,76198,0,82198
141710200701004,CONDO 500,Residential,6000,72506,0,78506
141710200701005,CONDO 500,Residential,6000,75910,0,81910
141710200701006,CONDO 500,Residential,6000,74907,0,80907
141710200701007,CONDO 500,Residential,6000,74907,0,80907
141710200801000,CONDO 500,Residential,6000,74100,0,80100
141710200801001,CONDO 500,Residential,6000,74435,0,80435
141710200801002,CONDO 500,Residential,6000,75719,0,81719
141710200801003,CONDO 500,Residential,6000,75719,0,81719
141710200801004,CONDO 500,Residential,6000,71511,0,77511
141710200801005,CONDO 500,Residential,6000,74435,0,80435
141710200801006,CONDO 500,Residential,6000,75719,0,81719
141710200801007,CONDO 500,Residential,6000,75719,0,81719
141712600100000,NE 135,Residential,41275,0,0,41275
141712600200000,NE 149,Residential,39957,0,0,39957
141712600300000,NE 149,Residential,40766,215796,0,256562
141712600400000,NE 149,Residential,41472,215765,0,257237
141712600500000,NE 149,Residential,43372,178493,0,221865
141712600600000,NE 149,Residential,38480,276708,0,315188
141712600700000,NE 149,Residential,63270,0,0,63270
141712600900000,NE 149,Residential,40759,296857,0,337616
141712601100000,NE 149,Residential,35853,315765,0,351618
141712601200000,NE 149,Residential,49184,232602,0,281786
141712601300000,NE 149,Residential,8150,0,0,8150
141712601400000,NE 149,Residential,487,0,0,487
141712601500000,NE 149,Residential,8287,0,0,8287
141712601600000,NE 135,Residential,36300,0,0,36300
141712700100000,NE 149,Residential,73920,406626,0,480546
141712700200000,NE 149,Residential,74970,386506,0,461476
141712700300000,NE 149,Residential,73088,218838,0,291926
141712700400000,NE 149,Residential,70560,311024,0,381584
141712700500000,NE 149,Residential,63756,352192,0,415948
141712700600000,NE 149,Residential,46453,244638,0,291091
141712700700000,NE 149,Residential,46283,224848,0,271131
141712700800000,NE 149,Residential,46283,234373,0,280656
141712700900000,NE 149,Residential,46750,262561,0,309311
141712701000000,NE 149,Residential,52773,259091,0,311864
141712701100000,NE 149,Residential,43956,269137,0,313093
141712701200000,NE 149,Residential,61180,302860,0,364040
141712701300000,NE 149,Residential,37502,0,0,37502
141712701400000,NE 149,Residential,47333,168449,0,215782
141712701500000,NE 149,Residential,90319,203876,0,294195
141712701700000,NE 149,Residential,72765,277739,0,350504
141712701800000,NE 149,Residential,72803,229560,0,302363
141712701900000,NE 149,Residential,147500,702500,0,850000
141712702000000,NE 149,Residential,58598,499402,0,558000
141712702100000,NE 149,Residential,79352,240339,0,319691
141712702200000,NE 149,Residential,6260,0,0,6260
141712702300000,NE 149,Residential,100300,412223,0,512523
141712702400000,NE 149,Residential,10870,0,0,10870
141712702500000,NE 149,Residential,75290,231520,0,306810
141712702600000,NE 149,Residential,76261,330418,0,406679
141712702800000,NE 149,Residential,50456,0,0,50456
141712702900000,NE 149,Residential,69557,223242,0,292799
141712703000000,NE 149,Residential,70331,205779,0,276110
141712703100000,NE 149,Residential,39031,252520,0,291551
141712703200000,NE 149,Residential,60515,239546,0,300061
141712703300000,NE 149,Residential,43218,273367,0,316585
141712703400000,NE 149,Residential,71176,285189,0,356365
141712703500000,NE 149,Residential,69889,259929,0,329818
141712703600000,NE 149,Residential,46750,190759,0,237509
141712703700000,NE 149,Residential,41710,218910,0,260620
141712703800000,NE 149,Residential,37632,240946,0,278578
141712703900000,NE 149,Residential,36279,192744,0,229023
141712704000000,NE 149,Residential,15881,0,0,15881
141712800100000,NE 149,Residential,49555,235944,0,285499
141712800200000,NE 149,Residential,49516,224074,0,273590
141712800300000,NE 149,Residential,73901,363771,0,437672
141712800400000,NE 149,Residential,74881,350979,0,425860
141712800500000,NE 149,Residential,77162,357087,0,434249
141715100100000,NE 149,Residential,4200,0,0,4200
141715200100000,NE 149,Residential,58557,0,0,58557
141715200200000,NE 149,Residential,78477,214488,0,292965
141715300100000,E-15 CITY,Exempt,0,0,0,0
141717600101000,CONDO 501,Residential,18000,219394,0,237394
141717600101001,CONDO 501,Residential,18000,211467,0,229467
141717600101002,CONDO 501,Residential,18000,208671,0,226671
141717600101003,CONDO 501,Residential,18000,192864,0,210864
141717600101004,CONDO 501,Residential,18000,203106,0,221106
141717600201000,CONDO 501,Residential,18000,180622,0,198622
141717600201001,CONDO 501,Residential,18000,185325,0,203325
141717600201002,CONDO 501,Residential,18000,207412,0,225412
141717600201003,CONDO 501,Residential,18000,205148,0,223148
141717600201004,CONDO 501,Residential,18000,230302,0,248302
141717600201005,CONDO 501,Residential,18000,226495,0,244495
141717600300000,NE 149,Residential,13537,0,0,13537
141717600400000,CONDO 501,Residential,72000,0,0,72000
141717600401000,CONDO 501,Residential,18000,156479,0,174479
141717600401001,CONDO 501,Residential,18000,156479,0,174479
141717600401002,CONDO 501,Residential,18000,167207,0,185207
141717600401003,CONDO 501,Residential,18000,156479,0,174479
141717700100000,COMM NE,Commercial,269879,0,155186,425065
141717700200000,COMM NE,Commercial,17820,0,0,17820
141717700300000,COMM NE,Commercial,79056,0,345975,425031
141717700400000,COMM NE,Commercial,41613,0,47534,89147
141717800100000,COMM NE,Commercial,2873,0,0,2873
141717800200000,E-15 CITY,Exempt,0,0,0,0
141720100200000,NE 149,Residential,79934,390035,0,469969
141720100300000,NE 149,Residential,69958,381318,0,451276
141720100400000,NE 149,Residential,76425,358051,0,434476
141720100600000,NE 149,Residential,118050,464828,0,582878
141720100700000,NE 149,Residential,78481,310822,0,389303
141720100900000,NE 167,Residential,67941,0,0,67941
141720101000000,NE 167,Residential,63840,0,0,63840
141720101100000,NE 167,Residential,91550,333252,0,424802
141720200100000,NE 149,Residential,38000,0,0,38000
141720200500000,NE 167,Residential,85940,0,0,85940
141720300100000,E-15 CITY,Exempt,0,0,0,0
141720300200000,E-15 CITY,Exempt,0,0,0,0
141722600100000,E-15 CITY,Exempt,0,0,0,0
141725100100000,NW 301,Residential,19153,37732,0,56885
141725100200000,NW 301,Residential,22099,45134,0,67233
141725100300000,NW 301,Residential,33320,0,0,33320
141725100400000,NW 301,Residential,23303,0,0,23303
141725100500000,NW 301,Residential,14310,59799,0,74109
141725100600000,NW 301,Residential,24804,40265,0,65069
141725100700000,NW 301,Residential,20670,48789,0,69459
141725100800000,NW 301,Residential,27904,127581,0,155485
141725100900000,NW 301,Residential,27030,96710,0,123740
141725101000000,NW 301,Residential,31164,103813,0,134977
141725101100000,NW 301,Residential,25200,132082,0,157282
141725101200000,E-15 CITY,Exempt,0,0,0,0
141725200100000,NW 301,Residential,23191,48720,0,71911
141725200200000,E-15 CITY,Exempt,0,0,0,0
141725200300000,NW 303,Residential,18075,169631,0,187706
141725200400000,NW 303,Residential,14996,199102,0,214098
141725200500000,NW 303,Residential,15016,197775,0,212791
141725200600000,NW 303,Residential,16988,200458,0,217446
141725200700000,NW 303,Residential,17200,199514,0,216714
141725200800000,NW 303,Residential,14900,169868,0,184768
141725200900000,NW 303,Residential,15000,196150,0,211150
141725201000000,NW 303,Residential,15000,200690,0,215690
141725201100000,NW 303,Residential,15000,199153,0,214153
141725201200000,NW 303,Residential,15372,198655,0,214027
141725201300000,NW 303,Residential,31496,209144,0,240640
141725201400000,NW 303,Residential,15123,193524,0,208647
141725201500000,NW 303,Residential,21493,177910,0,199403
141725201600000,NW 303,Residential,13851,194040,0,207891
141725201700000,NW 303,Residential,17136,194651,0,211787
141725201800000,NW 303,Residential,16560,169038,0,185598
141725201900000,NW 303,Residential,24400,186217,0,210617
141725202000000,NW 303,Residential,27208,219231,0,246439
141725202100000,NW 303,Residential,15120,171936,0,187056
141725202200000,NW 303,Residential,15120,169038,0,184158
141725202300000,NW 303,Residential,15120,195600,0,210720
141725202400000,NW 303,Residential,33624,228803,0,262427
141725202500000,NW 303,Residential,43241,228966,0,272207
141725202600000,NW 303,Residential,18364,184402,0,202766
141725202700000,NW 301,Residential,38619,146374,0,184993
141725202800000,NW 301,Residential,13488,1512,0,15000
141725202900000,NW 301,Residential,15000,0,0,15000
141725203000000,NW 301,Residential,4096,0,0,4096
141725203100000,NW 301,Residential,15000,0,0,15000
141725203200000,NW 301,Residential,29520,54933,0,84453
141725203300000,NW 301,Residential,38376,94184,0,132560
141725203400000,NW 301,Residential,29520,82744,0,112264
141725203500000,NW 301,Residential,29520,76190,0,105710
141725203600000,NW 301,Residential,29520,65872,0,95392
141725203700000,NW 301,Residential,19344,39679,0,59023
141725203800000,NW 301,Residential,17534,0,0,17534
141725203900000,NW 301,Residential,31200,91089,0,122289
141725204000000,NW 301,Residential,31200,56957,0,88157
141725204100000,NW 301,Residential,27000,89120,0,116120
141725204200000,NW 301,Residential,27000,70154,0,97154
141725204300000,NW 301,Residential,18000,52348,0,70348
141725204400000,NW 301,Residential,25500,52558,0,78058
141725204500000,NW 301,Residential,31512,79850,0,111362
141727600200000,NW 301,Residential,17407,46517,0,63924
141730100100000,E-15 CITY,Exempt,0,0,0,0
141732600100000,E-15 CITY,Exempt,0,0,0,0
141735100100000,NW 307,Residential,25452,196033,0,221485
141735100200000,NW 307,Residential,23040,189047,0,212087
141735100300000,NW 307,Residential,23328,188859,0,212187
141735100400000,NW 307,Residential,25200,192626,0,217826
141735100500000,NW 307,Residential,25200,162519,0,187719
141735100600000,NW 307,Residential,25249,155574,0,180823
141735100700000,NW 307,Residential,25740,195113,0,220853
141735100800000,NW 307,Residential,23232,200198,0,223430
141735100900000,NW 307,Residential,22244,235463,0,257707
141735101000000,NW 307,Residential,25800,227289,0,253089
141735101100000,NW 307,Residential,25712,204243,0,229955
141735101200000,NW 307,Residential,26316,160611,0,186927
141735101300000,NW 307,Residential,20092,182683,0,202775
141735101400000,NW 307,Residential,25200,194244,0,219444
141735101500000,NW 307,Residential,26640,191127,0,217767
141735101600000,NW 307,Residential,26220,165887,0,192107
141735101700000,NW 307,Residential,22658,207986,0,230644
141735101800000,NW 307,Residential,19952,147434,0,167386
141735101900000,NW 307,Residential,19881,199535,0,219416
141735102000000,NW 307,Residential,19811,125511,0,145322
141735102100000,NW 307,Residential,19950,147364,0,167314
141735102200000,NW 307,Residential,19950,396,0,20346
141735102300000,NW 307,Residential,21055,174811,0,195866
141735102400000,NW 307,Residential,20223,174402,0,194625
141735102500000,NW 307,Residential,19838,141737,0,161575
141735102600000,NW 307,Residential,23505,170879,0,194384
141735102700000,NW 307,Residential,24297,236042,0,260339
141735102800000,NW 307,Residential,21011,137325,0,158336
141735102900000,NW 307,Residential,21168,149162,0,170330
141735103000000,NW 307,Residential,20160,157918,0,178078
141735103100000,NW 307,Residential,21600,160425,0,182025
141735103200000,NW 307,Residential,21168,136397,0,157565
141735200100000,NW 307,Residential,21298,215627,0,236925
141735200200000,NW 307,Residential,19909,144359,0,164268
141735200300000,NW 307,Residential,19909,158457,0,178366
141735200400000,NW 307,Residential,19909,164625,0,184534
141735200500000,NW 307,Residential,19909,180744,0,200653
141735200600000,NW 307,Residential,21150,170776,0,191926
141735200700000,NW 307,Residential,21600,145066,0,166666
141735200800000,NW 307,Residential,20874,172327,0,193201
141735200900000,NW 307,Residential,23765,186534,0,210299
141735201000000,NW 307,Residential,23300,177223,0,200523
141735201100000,NW 307,Residential,25704,197000,0,222704
141735201200000,NW 307,Residential,26214,184090,0,210304
141735201300000,NW 307,Residential,24539,192416,0,216955
141735201400000,NW 307,Residential,21600,168339,0,189939
141735201500000,NW 307,Residential,20220,155281,0,175501
141735201600000,NW 307,Residential,21874,149577,0,171451
141735201700000,NW 307,Residential,23805,185850,0,209655
141735201800000,NW 307,Residential,23184,167582,0,190766
141735201900000,NW 307,Residential,22563,202513,0,225076
141735202000000,NW 307,Residential,24312,183316,0,207628
141735202100000,NW 307,Residential,23975,147662,0,171637
141735202200000,NW 307,Residential,21150,132376,0,153526
141735202300000,NW 307,Residential,19909,136056,0,155965
141735202400000,NW 307,Residential,19909,136571,0,156480
141735202500000,NW 307,Residential,19909,146098,0,166007
141735202600000,NW 307,Residential,19909,130453,0,150362
141735202700000,NW 307,Residential,21298,143886,0,165184
141735300100000,NW 307,Residential,21122,129451,0,150573
141735300200000,NW 307,Residential,20736,146411,0,167147
141735300300000,NW 307,Residential,20736,141513,0,162249
141735300400000,NW 307,Residential,21312,159496,0,180808
141735300500000,NW 307,Residential,20160,151469,0,171629
141735300600000,NW 307,Residential,20736,160730,0,181466
141735300700000,NW 307,Residential,20736,181689,0,202425
141735300800000,NW 307,Residential,20736,178151,0,198887
141735300900000,NW 307,Residential,20736,189747,0,210483
141735301000000,NW 307,Residential,20736,190427,0,211163
141735301100000,NW 307,Residential,20766,156102,0,176868
141740200200000,E-15 CITY,Exempt,0,0,0,0
141745100100000,NW 310,Residential,37005,0,0,37005
141745100200000,NW 310,Residential,38450,0,0,38450
141745100300000,NW 310,Residential,38925,0,0,38925
141745100400000,NW 310,Residential,41940,0,0,41940
141745100500000,COMM NW,Commercial,107055,0,75338,182393
141745100600000,NW 310,Residential,40800,0,0,40800
141745100700000,NW 310,Residential,39720,51114,0,90834
141745100800000,NW 310,Residential,35575,0,0,35575
141745100900000,NW 310,Residential,24840,38898,0,63738
141745101000000,NW 310,Residential,48400,78786,0,127186
141745101100000,NW 310,Residential,24200,33375,0,57575
141745101200000,NW 310,Residential,23595,40932,0,64527
141745101300000,NW 310,Residential,50500,0,0,50500
141745101400000,NW 310,Residential,51750,37804,0,89554
141745101500000,NW 310,Residential,14580,20837,0,35417
141745200100000,NW 310,Residential,13976,0,0,13976
141745200200000,NW 310,Residential,12904,0,0,12904
141745200300000,NW 310,Residential,15875,0,0,15875
141745200400000,NW 310,Residential,14725,0,0,14725
141745200700000,NW 310,Residential,18635,0,0,18635
141745200800000,NW 310,Residential,9090,0,0,9090
141745200900000,NW 310,Residential,13000,0,0,13000
141745201000000,NW 310,Residential,5000,0,0,5000
141745201100000,NW 310,Residential,9780,0,0,9780
141745201200000,NW 310,Residential,15415,0,0,15415
141745201300000,NW 310,Residential,18807,0,0,18807
141745201400000,NW 310,Residential,13547,0,0,13547
141745201500000,NW 310,Residential,12937,0,0,12937
141745201700000,NW 310,Residential,22583,0,0,22583
141745201800000,NW 310,Ag Dwelling,539,0,32598,33137
141745201900000,NW 310,Residential,16199,29466,0,45665
141745202000000,NW 310,Residential,13398,24214,0,37612
141745202100000,NW 310,Residential,10855,0,0,10855
141745202200000,NW 310,Residential,9700,33492,0,43192
141745202300000,NW 310,Residential,18846,0,0,18846
141745202400000,NW 310,Residential,10064,15992,0,26056
141745202500000,NW 310,Residential,5000,0,0,5000
141745202600000,NW 310,Residential,10738,23398,0,34136
141745202700000,NW 310,Residential,11018,0,0,11018
141745202800000,NW 310,Ag Land,142,0,0,142
141745300100000,NW 310,Residential,15667,0,0,15667
141745300200000,E-15 CITY,Exempt,0,0,0,0
141745300300000,NW 310,Residential,17500,63321,0,80821
141745300400000,NW 310,Residential,23644,72795,0,96439
141745300500000,NW 310,Residential,19787,0,0,19787
141745300600000,NW 310,Residential,16125,0,0,16125
141745300700000,NW 310,Residential,16125,0,0,16125
141745300800000,NW 310,Residential,15000,0,0,15000
141745300900000,NW 310,Residential,16125,0,0,16125
141745301000000,NW 310,Residential,16125,0,0,16125
141745301100000,NW 310,Residential,16125,0,0,16125
141745301200000,NW 310,Residential,16125,0,0,16125
141745301300000,NW 310,Residential,16125,0,0,16125
141745301400000,NW 310,Residential,16125,0,0,16125
141745301500000,NW 310,Residential,15000,0,0,15000
141745301600000,NW 310,Residential,16125,0,0,16125
141745301700000,NW 310,Residential,15000,0,0,15000
141747600100000,NW 310,Residential,45200,0,0,45200
141747600200000,NW 310,Residential,51274,0,0,51274
141747600300000,NW 310,Residential,26325,35877,0,62202
141747600400000,NW 310,Residential,32200,0,0,32200
141747600500000,NW 310,Residential,52527,0,0,52527
141747600600000,NW 310,Residential,45337,66055,0,111392
141810100100000,E-15 CITY,Exempt,0,0,0,0
141810100200000,APTS NW,Commercial,428112,0,3637968,4066080
141810300100000,APTS NW,Commercial,286200,0,3285612,3571812
141812600100000,APTS NW,Commercial,40905,0,317724,358629
141812600200000,APTS NW,Commercial,407160,0,3705180,4112340
141812600300000,APTS NW,Commercial,348840,0,3448890,3797730
141815100100000,NW 303,Residential,30240,101929,0,132169
141815100200000,NW 303,Residential,11675,72003,0,83678
141815100300000,NW 303,Residential,10917,60884,0,71801
141815100400000,NW 303,Residential,11412,70618,0,82030
141815100500000,NW 303,Residential,10785,86033,0,96818
141815100600000,NW 303,Residential,11029,98311,0,109340
141815100700000,NW 303,Residential,11123,96657,0,107780
141815100800000,NW 303,Residential,10982,96320,0,107302
141815100900000,NW 303,Residential,11170,95621,0,106791
141815101000000,NW 303,Residential,13821,102392,0,116213
141815101100000,NW 303,Residential,13614,101545,0,115159
141815101200000,NW 303,Residential,11752,112939,0,124691
141815101300000,NW 303,Residential,13597,104947,0,118544
141815101400000,NW 303,Residential,27314,140077,0,167391
141815101500000,NW 303,Residential,26760,141098,0,167858
141815101600000,NW 303,Residential,12075,134868,0,146943
141815101700000,NW 303,Residential,12165,131446,0,143611
141815101800000,NW 303,Residential,21513,105234,0,126747
141815101900000,NW 303,Residential,21513,107762,0,129275
141815102000000,NW 303,Residential,21513,64865,0,86378
141815102100000,NW 303,Residential,21513,110263,0,131776
141815102200000,NW 303,Residential,22498,103631,0,126129
141815102300000,NW 303,Residential,22824,91182,0,114006
141815102400000,NW 303,Residential,21384,113736,0,135120
141815102500000,NW 303,Residential,21384,125089,0,146473
141815102600000,NW 303,Residential,21384,114150,0,135534
141815102700000,NW 303,Residential,21384,106741,0,128125
141815102800000,NW 303,Residential,21339,120756,0,142095
141815102900000,NW 303,Residential,24512,131753,0,156265
141815103000000,NW 303,Residential,24973,139486,0,164459
141815103100000,NW 303,Residential,22603,130524,0,153127
141815103200000,NW 303,Residential,23157,118033,0,141190
141815103300000,NW 303,Residential,22095,147845,0,169940
141815103400000,NW 303,Residential,23322,122504,0,145826
141815103500000,NW 303,Residential,22049,120458,0,142507
141815103600000,NW 303,Residential,23948,67358,0,91306
141815103700000,NW 303,Residential,24948,42606,0,67554
141815103800000,NW 303,Residential,24948,33299,0,58247
141815103900000,NW 303,Residential,24300,156374,0,180674
141815104000000,NW 303,Residential,22680,164753,0,187433
141815104100000,NW 303,Residential,22680,165598,0,188278
141815104200000,NW 303,Residential,22388,180893,0,203281
141815104300000,NW 303,Residential,26302,171886,0,198188
141815104400000,NW 303,Residential,21840,24806,0,46646
141815104500000,NW 303,Residential,29008,159113,0,188121
141815104600000,NW 303,Residential,28722,271187,0,299909
141815104700000,NW 303,Residential,25890,154614,0,180504
141815104800000,NW 303,Residential,22367,169970,0,192337
141815104900000,NW 303,Residential,22680,185707,0,208387
141815105000000,NW 303,Residential,22680,153105,0,175785
141815105100000,NW 303,Residential,24300,146331,0,170631
141815105200000,NW 303,Residential,63150,69553,0,132703
141815105300000,E-15 CITY,Exempt,0,0,0,0
141817600100000,E-15 CITY,Exempt,0,0,0,0
141820100100000,COMM NW,Commercial,8942,0,18788,27730
141820100200000,E-15 CITY,Exempt,0,0,0,0
141820200100000,NW 302,Residential,1655,0,0,1655
141820200200000,NW 302,Residential,14700,0,0,14700
141820200300000,NW 302,Residential,7100,0,0,7100
141820200500000,NW 302,Residential,39119,0,0,39119
141820300100000,NW 302,Residential,63200,32118,0,95318
141822600100000,E-15 CITY,Exempt,0,0,0,0
141822600200000,NW 302,Residential,5000,0,0,5000
141822600300000,NW 302,Residential,5649,76048,0,81697
141822600400000,NW 302,Residential,5000,0,0,5000
141822600500000,NW 302,Residential,5000,0,0,5000
141822600700000,COMM NW,Commercial,43158,0,0,43158
141822700100000,NW 302,Residential,55500,0,0,55500
141822700200000,NW 302,Residential,27537,0,0,27537
141822700300000,NW 302,Residential,10593,45099,0,55692
141822700400000,NW 302,Ag Land,2043,0,0,2043
141822800100000,E-15 CITY,Exempt,0,0,0,0
141825100100000,NW 302,Residential,25000,0,0,25000
141825100200000,NW 302,Ag Dwelling,15214,43248,0,58462
141827600100000,NW 302,Residential,42728,99928,0,142656
141827600200000,NW 302,Residential,27846,136438,0,164284
141827600300000,NW 302,Residential,73850,50312,0,124162
141827600400000,NW 302,Residential,64750,57132,0,121882
141827600500000,COMM NW,Exempt,246240,0,649437,895677
141827700100000,Empty,Exempt,0,0,0,0
141827700300000,E-48 RELIG BLDG SITE,Exempt,479866,0,374478,854344
141827700400000,E-20 SCHOOLS,Exempt,0,0,0,0
141830100100000,NW 308,Residential,16913,100932,0,117845
141830100200000,NW 308,Residential,17820,109030,0,126850
141830100300000,NW 308,Residential,17531,118478,0,136009
141830100400000,NW 302,Residential,60650,57423,0,118073
141830100500000,NW 308,Residential,17093,97153,0,114246
141830100600000,NW 308,Residential,17820,128707,0,146527
141830100700000,NW 308,Residential,19883,109637,0,129520
141830100800000,NW 308,Residential,22035,104513,0,126548
141830200100000,APTS NW,Residential,304668,2874214,0,3178882
141830200200000,COMM NW,Commercial,40856,0,0,40856
141830200300000,NW 302,Residential,55000,0,0,55000
141830300100000,NW 308,Residential,22685,113066,0,135751
141830300200000,NW 308,Residential,21153,98199,0,119352
141830300301000,CONDO 500,Residential,5000,61103,0,66103
141830300301001,CONDO 500,Residential,5000,61103,0,66103
141830300301002,CONDO 500,Residential,5000,60861,0,65861
141830300301003,CONDO 500,Residential,5000,60861,0,65861
141830300301004,CONDO 500,Residential,5000,62024,0,67024
141830300301005,CONDO 500,Residential,5000,62024,0,67024
141830300301006,CONDO 500,Residential,5000,62024,0,67024
141830300301007,CONDO 500,Residential,5000,62024,0,67024
141830300301008,CONDO 500,Residential,5000,62024,0,67024
141830300301009,CONDO 500,Residential,5000,62024,0,67024
141830300301010,CONDO 500,Residential,5000,62024,0,67024
141830300301011,CONDO 500,Residential,5000,62024,0,67024
141830300301012,CONDO 500,Residential,5000,61103,0,66103
141830300301013,CONDO 500,Residential,5000,61103,0,66103
141830300301014,CONDO 500,Residential,5000,60861,0,65861
141830300301015,CONDO 500,Residential,5000,60861,0,65861
141830300301016,CONDO 500,Residential,5000,62024,0,67024
141830300301017,CONDO 500,Residential,5000,62024,0,67024
141830300301018,CONDO 500,Residential,5000,62024,0,67024
141830300301019,CONDO 500,Residential,5000,62024,0,67024
141830300301020,CONDO 500,Residential,5000,62024,0,67024
141830300301021,CONDO 500,Residential,5000,62024,0,67024
141830300301022,CONDO 500,Residential,5000,62024,0,67024
141830300301023,CONDO 500,Residential,5000,62024,0,67024
141830300301024,CONDO 500,Residential,5000,61103,0,66103
141830300301025,CONDO 500,Residential,5000,61103,0,66103
141830300301026,CONDO 500,Residential,5000,60861,0,65861
141830300301027,CONDO 500,Residential,5000,60861,0,65861
141830300301028,CONDO 500,Residential,5000,62024,0,67024
141830300301029,CONDO 500,Residential,5000,62024,0,67024
141830300301030,CONDO 500,Residential,5000,62024,0,67024
141830300301031,CONDO 500,Residential,5000,62024,0,67024
141830300301032,CONDO 500,Residential,5000,62024,0,67024
141830300301033,CONDO 500,Residential,5000,62024,0,67024
141830300301034,CONDO 500,Residential,5000,62024,0,67024
141830300301035,CONDO 500,Residential,5000,62024,0,67024
141830300301036,CONDO 500,Residential,5000,61103,0,66103
141830300301037,CONDO 500,Residential,5000,61103,0,66103
141830300301038,CONDO 500,Residential,5000,60861,0,65861
141830300301039,CONDO 500,Residential,5000,60861,0,65861
141830300301040,CONDO 500,Residential,5000,62024,0,67024
141830300301041,CONDO 500,Residential,5000,62024,0,67024
141830300301042,CONDO 500,Residential,5000,62024,0,67024
141830300301043,CONDO 500,Residential,5000,62024,0,67024
141830300301044,CONDO 500,Residential,5000,62024,0,67024
141830300301045,CONDO 500,Residential,5000,62024,0,67024
141830300301046,CONDO 500,Residential,5000,62024,0,67024
141830300301047,CONDO 500,Residential,5000,62024,0,67024
141830300301048,CONDO 500,Residential,5000,61103,0,66103
141830300301049,CONDO 500,Residential,5000,61103,0,66103
141830300301050,CONDO 500,Residential,5000,60861,0,65861
141830300301051,CONDO 500,Residential,5000,60861,0,65861
141830300301052,CONDO 500,Residential,5000,62024,0,67024
141830300301053,CONDO 500,Residential,5000,62024,0,67024
141830300301054,CONDO 500,Residential,5000,62024,0,67024
141830300301055,CONDO 500,Residential,5000,62024,0,67024
141830300301056,CONDO 500,Residential,5000,62024,0,67024
141830300301057,CONDO 500,Residential,5000,62024,0,67024
141830300301058,CONDO 500,Residential,5000,62024,0,67024
141830300301059,CONDO 500,Residential,5000,62024,0,67024
141830300301060,CONDO 500,Residential,5000,61103,0,66103
141830300301061,CONDO 500,Residential,5000,61103,0,66103
141830300301062,CONDO 500,Residential,5000,60861,0,65861
141830300301063,CONDO 500,Residential,5000,60861,0,65861
141830300301064,CONDO 500,Residential,5000,62024,0,67024
141830300301065,CONDO 500,Residential,5000,62024,0,67024
141830300301066,CONDO 500,Residential,5000,62024,0,67024
141830300301067,CONDO 500,Residential,5000,62024,0,67024
141830300301068,CONDO 500,Residential,5000,62024,0,67024
141830300301069,CONDO 500,Residential,5000,62024,0,67024
141830300301070,CONDO 500,Residential,5000,62024,0,67024
141830300301071,CONDO 500,Residential,5000,62024,0,67024
141830300301072,CONDO 500,Residential,5000,60861,0,65861
141830300301073,CONDO 500,Residential,5000,60861,0,65861
141830300301074,CONDO 500,Residential,5000,61103,0,66103
141830300301075,CONDO 500,Residential,5000,61103,0,66103
141830300301076,CONDO 500,Residential,5000,62024,0,67024
141830300301077,CONDO 500,Residential,5000,62024,0,67024
141830300301078,CONDO 500,Residential,5000,62024,0,67024
141830300301079,CONDO 500,Residential,5000,62024,0,67024
141830300301080,CONDO 500,Residential,5000,62024,0,67024
141830300301081,CONDO 500,Residential,5000,62024,0,67024
141830300301082,CONDO 500,Residential,5000,62024,0,67024
141830300301083,CONDO 500,Residential,5000,62024,0,67024
141830300301084,CONDO 500,Residential,5000,60861,0,65861
141830300301085,CONDO 500,Residential,5000,60861,0,65861
141830300301086,CONDO 500,Residential,5000,61103,0,66103
141830300301087,CONDO 500,Residential,5000,61103,0,66103
141830300301088,CONDO 500,Residential,5000,62024,0,67024
141830300301089,CONDO 500,Residential,5000,62024,0,67024
141830300301090,CONDO 500,Residential,5000,62024,0,67024
141830300301091,CONDO 500,Residential,5000,62024,0,67024
141830300301092,CONDO 500,Residential,5000,62024,0,67024
141830300301093,CONDO 500,Residential,5000,62024,0,67024
141830300301094,CONDO 500,Residential,5000,62024,0,67024
141830300301095,CONDO 500,Residential,5000,62024,0,67024
141830300301096,CONDO 500,Residential,5000,61103,0,66103
141830300301097,CONDO 500,Residential,5000,61103,0,66103
141830300301098,CONDO 500,Residential,5000,61103,0,66103
141830300301099,CONDO 500,Residential,5000,61103,0,66103
141830300301100,CONDO 500,Residential,5000,62024,0,67024
141830300301101,CONDO 500,Residential,5000,62024,0,67024
141830300301102,CONDO 500,Residential,5000,62024,0,67024
141830300301103,CONDO 500,Residential,5000,62024,0,67024
141830300301104,CONDO 500,Residential,5000,62024,0,67024
141830300301105,CONDO 500,Residential,5000,62024,0,67024
141830300301106,CONDO 500,Residential,5000,62024,0,67024
141830300301107,CONDO 500,Residential,5000,62024,0,67024
141832600100000,NW 302,Ag Land,14618,0,0,14618
141832600200000,NW 302,Residential,62500,0,0,62500
141835100100000,NW 302,Residential,62500,0,0,62500
141835100400000,NW 302,Residential,30900,79248,0,110148
141835100500000,NW 302,Residential,88000,0,0,88000
141835100600000,NW 302,Residential,112500,57891,0,170391
141835200100000,NW 308,Residential,72000,0,0,72000
141835200200000,NW 302,Residential,65250,157851,0,223101
141837600100000,NW 308,Residential,86250,0,0,86250
141837600200000,NW 336,Residential,30080,229244,0,259324
141837600300000,NW 336,Residential,34881,249800,0,284681
141837600400000,NW 336,Residential,40950,175697,0,216647
141837600500000,NW 336,Residential,37120,193516,0,230636
141837600600000,NW 336,Residential,39353,221811,0,261164
141837600700000,NW 336,Residential,42000,266233,0,308233
141837600800000,NW 336,Residential,43600,217038,0,260638
141837600900000,NW 336,Residential,41600,256863,0,298463
141837601000000,NW 336,Residential,43661,235481,0,279142
141837601100000,NW 336,Residential,41853,194831,0,236684
141837601200000,NW 336,Residential,40511,194590,0,235101
141837601300000,NW 336,Residential,40614,196578,0,237192
141837700100000,NW 336,Residential,39672,180844,0,220516
141837700200000,NW 336,Residential,35774,194722,0,230496
141837700300000,NW 336,Residential,52257,244875,0,297132
141837700400000,NW 336,Residential,20611,1333,0,21944
141837700500000,NW 336,Residential,23959,219414,0,243373
141837700600000,NW 336,Residential,31838,195064,0,226902
141837700700000,NW 336,Residential,38056,239582,0,277638
141837700800000,NW 336,Residential,37760,169335,0,207095
141837700900000,NW 336,Residential,35520,280879,0,316399
141837701000000,NW 336,Residential,36469,180108,0,216577
141837800100000,NW 302,Residential,50850,0,0,50850
141837900100000,NW 336,Residential,44182,256076,0,300258
141837900200000,NW 336,Residential,42457,254136,0,296593
141837900300000,NW 336,Residential,47092,258506,0,305598
141837900400000,NW 336,Residential,44502,0,0,44502
141837900500000,NW 336,Residential,42000,218879,0,260879
141837900600000,NW 336,Residential,40400,240198,0,280598
141837900700000,NW 336,Residential,38400,227010,0,265410
141837900800000,NW 336,Residential,35374,217640,0,253014
141837900900000,NW 336,Residential,34651,177048,0,211699
141837901000000,NW 336,Residential,33728,153881,0,187609
141837901100000,NW 308,Residential,28080,125303,0,153383
141837901200000,NW 308,Residential,29600,115232,0,144832
141837901300000,NW 308,Residential,31169,112378,0,143547
141837901400000,NW 308,Residential,31435,112789,0,144224
141837901500000,NW 308,Residential,31435,128509,0,159944
141837901600000,NW 308,Residential,31702,130805,0,162507
141837901700000,NW 308,Residential,32396,129496,0,161892
141837901800000,NW 308,Residential,34432,140380,0,174812
141837901900000,NW 308,Residential,31181,121637,0,152818
141837902000000,NW 308,Residential,33012,104739,0,137751
141838000100000,NW 336,Residential,31590,170825,0,202415
141838000200000,NW 336,Residential,36987,247452,0,284439
141838000300000,NW 336,Residential,36160,217221,0,253381
141838000400000,NW 336,Residential,35840,241783,0,277623
141838000500000,NW 336,Residential,35200,242752,0,277952
141838000600000,NW 336,Residential,34240,220364,0,254604
141838000700000,NW 308,Residential,31528,117723,0,149251
141838000800000,NW 308,Residential,31386,111467,0,142853
141838000900000,NW 308,Residential,33601,107471,0,141072
141838001000000,NW 308,Residential,31793,107242,0,139035
141838001100000,NW 308,Residential,27930,109761,0,137691
141838001200000,NW 308,Residential,27930,108113,0,136043
141838001300000,NW 308,Residential,27664,113380,0,141044
141838001400000,NW 308,Residential,27664,132120,0,159784
141838100100000,NW 308,Residential,28310,115309,0,143619
141838100200000,NW 308,Residential,27720,112492,0,140212
141838100300000,NW 308,Residential,28642,126859,0,155501
141838100400000,NW 308,Residential,27751,126898,0,154649
141838100500000,NW 308,Residential,26836,134184,0,161020
141838100600000,NW 308,Residential,27424,128525,0,155949
141838100700000,NW 308,Residential,27941,115746,0,143687
141838100800000,NW 308,Residential,26928,134974,0,161902
141840100100000,E-15 CITY,Exempt,0,0,0,0
141840100200000,NW 302,Residential,38145,59358,0,97503
141840100500000,NW 307,Residential,22783,130867,0,153650
141840100600000,NW 307,Residential,22500,152524,0,175024
141840100700000,NW 307,Residential,22500,144310,0,166810
141840100800000,NW 307,Residential,33750,124647,0,158397
141840100900000,NW 307,Residential,30,0,0,30
141840101000000,NW 307,Residential,44362,154600,0,198962
141840101100000,NW 307,Residential,52306,240562,0,292868
141840101200000,NW 307,Residential,56169,199457,0,255626
141840101300000,NW 307,Residential,49135,189141,0,238276
141840101400000,NW 307,Residential,44921,212791,0,257712
141840101500000,NW 307,Residential,45949,153561,0,199510
141840101600000,NW 307,Residential,26868,205238,0,232106
141840101700000,E-15 CITY,Exempt,0,0,0,0
141840101800000,NW 302,Residential,103520,174828,0,278348
141840101900000,NW 302,Residential,54900,109813,0,164713
141840102000000,NW 302,Residential,136572,149002,0,285574
141840200100000,NW 302,Residential,25658,149734,0,175392
141840200200000,NW 302,Residential,66500,135213,0,201713
141840200300000,NW 302,Residential,40055,85742,0,125797
141840200400000,NW 302,Residential,40700,2749,0,43449
141840200500000,NW 302,Residential,33467,23471,0,56938
141840200600000,NW 302,Residential,87900,0,0,87900
141840200700000,NW 302,Residential,64700,158963,0,223663
141840200800000,NW 302,Residential,22275,56707,0,78982
141840200900000,NW 302,Residential,22846,94187,0,117033
141840201000000,NW 302,Residential,24481,112014,0,136495
141840201100000,NW 302,Residential,24480,106062,0,130542
141840201200000,NW 302,Residential,26010,97032,0,123042
141840300100000,NW 307,Residential,27720,183164,0,210884
141840300200000,NW 307,Residential,25461,170246,0,195707
141840300300000,NW 307,Residential,24644,157714,0,182358
141840300400000,NW 307,Residential,24960,188005,0,212965
141840300500000,NW 307,Residential,26356,175714,0,202070
141840300600000,NW 307,Residential,26356,185983,0,212339
141840300700000,NW 307,Residential,24958,187228,0,212186
141840300800000,NW 307,Residential,24290,158792,0,183082
141840400100000,NW 307,Residential,23021,183438,0,206459
141840400200000,NW 307,Residential,22500,161969,0,184469
141840400300000,NW 307,Residential,21150,166128,0,187278
141840400400000,NW 307,Residential,22378,135661,0,158039
141840400500000,NW 307,Residential,25443,166075,0,191518
141840400600000,NW 307,Residential,25583,216838,0,242421
141842600100000,NW 302,Ag Dwelling,17762,63193,715,81670
141842600200000,NW 302,Residential,34560,44105,0,78665
141842600300000,NW 302,Residential,21120,0,0,21120
141842600400000,NW 302,Residential,71200,41846,0,113046
141842600500000,NW 302,Residential,35174,57827,0,93001
141842600600000,NW 302,Residential,54516,118576,0,173092
141842600700000,NW 308,Residential,30408,130554,0,160962
141842600800000,NW 308,Residential,30408,139372,0,169780
141842600900000,NW 308,Residential,33395,213734,0,247129
141842601000000,NW 308,Residential,33395,196691,0,230086
141842601100000,NW 308,Residential,33275,202896,0,236171
141842601200000,NW 308,Residential,48400,245730,0,294130
141842601300000,NW 308,Residential,72350,52622,0,124972
141845100100000,NW 302,Residential,155000,0,0,155000
141845100300000,NW 302,Residential,155000,129970,0,284970
141847600200000,NW 307,Residential,30725,144123,0,174848
141847600300000,NW 307,Residential,25372,209835,0,235207
141847600400000,NW 307,Residential,24067,174047,0,198114
141847600500000,NW 307,Residential,24878,185852,0,210730
141847600700000,NW 308,Residential,21645,95935,0,117580
141847600800000,NW 308,Residential,32350,95534,0,127884
141847600900000,NW 308,Residential,30525,85292,0,115817
141847601000000,NW 308,Residential,27540,105174,0,132714
141847601100000,NW 308,Residential,22530,127975,0,150505
141847601200000,NW 308,Residential,27631,106204,0,133835
141847601300000,NW 307,Residential,24974,165001,0,189975
141847601400000,NW 307,Residential,24480,156749,0,181229
141847601500000,NW 307,Residential,26160,162581,0,188741
141847601600000,NW 307,Residential,25041,163073,0,188114
141847601700000,NW 307,Residential,24197,165208,0,189405
141847601800000,NW 307,Residential,24800,159856,0,184656
141847601900000,NW 307,Residential,24082,170555,0,194637
141847602000000,NW 307,Residential,26040,229695,0,255735
141847602100000,NW 307,Residential,21696,164453,0,186149
141847602200000,NW 307,Residential,24943,167267,0,192210
141847602300000,NW 307,Residential,25098,154409,0,179507
141847602400000,NW 307,Residential,22842,159014,0,181856
141847602500000,NW 307,Residential,24439,233612,0,258051
141847602600000,NW 307,Residential,26198,181539,0,207737
141847602700000,NW 302,Residential,34974,280020,0,314994
141847602800000,NW 302,Residential,34974,204071,0,239045
141847602900000,NW 302,Residential,30577,109290,0,139867
141847603000000,E-15 CITY,Exempt,0,0,0,0
141847700100000,NW 302,Residential,101250,46740,0,147990
141847700300000,NW 308,Residential,24480,104214,0,128694
141847700400000,NW 308,Residential,22451,108525,0,130976
141847700500000,NW 308,Residential,22486,81088,0,103574
141847700600000,NW 308,Residential,23932,108915,0,132847
141847700700000,NW 308,Residential,21450,72244,0,93694
141847700800000,NW 308,Residential,21840,40115,0,61955
141847700900000,NW 308,Residential,22260,120201,0,142461
141847701000000,NW 308,Residential,22563,126476,0,149039
141847701100000,NW 308,Residential,20763,92553,0,113316
141847701200000,NW 308,Residential,21000,110700,0,131700
141847701300000,NW 302,Residential,94900,0,0,94900
141847701400000,NW 302,Residential,39176,245571,0,284747
141847701500000,NW 302,Residential,40878,268674,0,309552
141847701600000,NW 302,Residential,34928,264359,0,299287
141847701700000,NW 302,Residential,55997,290994,0,346991
141847701800000,NW 302,Residential,53494,233656,0,287150
141847701900000,NW 302,Residential,56364,311889,0,368253
141847702000000,NW 302,Residential,51449,0,0,51449
141847800100000,NW 307,Residential,25833,172216,0,198049
141847800200000,NW 307,Residential,25299,196397,0,221696
141847800300000,NW 307,Residential,25015,169661,0,194676
141847800400000,NW 307,Residential,25459,192103,0,217562
141847800500000,NW 307,Residential,24394,197520,0,221914
141847800600000,NW 307,Residential,26953,0,0,26953
141847800700000,NW 308,Residential,18834,90675,0,109509
141847800800000,NW 308,Residential,18600,78640,0,97240
141847800900000,NW 308,Residential,23900,127643,0,151543
141910100100000,NW 308,Residential,24444,92774,0,117218
141910100200000,NW 308,Residential,24624,112763,0,137387
141910100300000,NW 308,Residential,24624,88222,0,112846
141910100400000,NW 308,Residential,24655,109346,0,134001
141910100500000,NW 308,Residential,22800,90143,0,112943
141910100600000,NW 308,Residential,29981,88456,0,118437
141910100700000,NW 308,Residential,24716,96129,0,120845
141910100800000,NW 308,Residential,30347,80520,0,110867
141910200100000,NW 308,Residential,16600,0,0,16600
141910200300000,NW 308,Residential,13794,0,0,13794
141910200400000,NW 308,Residential,24189,108483,0,132672
141910200500000,NW 308,Residential,23688,94509,0,118197
141910200600000,NW 308,Residential,24354,91707,0,116061
141910200700000,NW 308,Residential,26072,117622,0,143694
141910200800000,NW 308,Residential,24440,79761,0,104201
141910200900000,NW 308,Residential,24407,101450,0,125857
141910201000000,NW 308,Residential,24486,73514,0,98000
141910201100000,NW 308,Residential,23688,105024,0,128712
141910201200000,NW 308,Residential,23184,101939,0,125123
141910201300000,NW 308,Residential,26800,95931,0,122731
141910201400000,NW 308,Residential,23442,192,0,23634
141910300100000,NW 308,Residential,26362,98044,0,124406
141910300200000,NW 308,Residential,26600,85335,0,111935
141910300300000,NW 308,Residential,25920,72911,0,98831
141910300400000,NW 308,Residential,24000,101564,0,125564
141910300500000,NW 308,Residential,24265,103936,0,128201
141910300600000,NW 308,Residential,26676,48665,0,75341
141910300700000,NW 308,Residential,25492,81123,0,106615
141910300800000,NW 308,Residential,24816,113946,0,138762
141910300900000,NW 308,Residential,24504,95335,0,119839
141910301000000,NW 308,Residential,25654,98832,0,124486
141910301100000,NW 308,Residential,24252,103748,0,128000
141910301200000,NW 308,Residential,24252,94905,0,119157
141910301300000,NW 308,Residential,24252,100010,0,124262
141910301400000,NW 308,Residential,24252,91341,0,115593
141910301500000,NW 308,Residential,24252,92301,0,116553
141910301600000,NW 308,Residential,25477,97270,0,122747
141910301800000,NW 308,Residential,24864,103233,0,128097
141910301900000,NW 308,Residential,36733,99501,0,136234
141910302000000,NW 308,Residential,24703,93875,0,118578
141910302100000,NW 308,Residential,28017,99901,0,127918
141910302200000,NW 308,Residential,29229,85606,0,114835
141910302300000,NW 308,Residential,25920,102027,0,127947
141910302400000,NW 308,Residential,29487,89521,0,119008
141910302500000,NW 308,Residential,26288,119109,0,145397
141910302600000,NW 308,Residential,27090,94011,0,121101
141910302700000,NW 308,Residential,24252,94324,0,118576
141910302800000,NW 308,Residential,24252,96826,0,121078
141910302900000,NW 308,Residential,24252,103507,0,127759
141910303000000,NW 308,Residential,24504,88856,0,113360
141910303100000,NW 308,Residential,28216,86327,0,114543
141910303200000,NW 308,Residential,28210,97875,0,126085
141910400100000,NW 308,Residential,23980,88474,0,112454
141910400200000,NW 308,Residential,23980,95737,0,119717
141910400300000,NW 308,Residential,24308,90175,0,114483
141910400400000,NW 308,Residential,25680,37924,0,63604
141910400500000,NW 308,Residential,27860,97399,0,125259
141910400600000,NW 308,Residential,43982,89512,0,133494
141910400700000,NW 308,Residential,27853,108806,0,136659
141910400800000,NW 308,Residential,26917,121834,0,148751
141910400900000,NW 308,Residential,24056,118756,0,142812
141910401000000,NW 308,Residential,24056,112119,0,136175
141910401100000,NW 308,Residential,24056,100884,0,124940
141910401200000,NW 308,Residential,24056,108245,0,132301
141910401300000,NW 308,Residential,24056,97926,0,121982
141910401400000,NW 308,Residential,24056,90270,0,114326
141910401500000,NW 308,Residential,24494,96000,0,120494
141910401600000,NW 308,Residential,25785,111414,0,137199
141910401700000,NW 308,Residential,24056,78282,0,102338
141910401800000,NW 308,Residential,24056,85680,0,109736
141910401900000,NW 308,Residential,24056,90854,0,114910
141910402000000,NW 308,Residential,24056,96515,0,120571
141910402100000,NW 308,Residential,24056,94089,0,118145
141910402200000,NW 308,Residential,24056,104889,0,128945
141910402300000,NW 308,Residential,24056,77359,0,101415
141910402400000,NW 308,Residential,30981,114464,0,145445
141910500100000,NW 308,Residential,39552,122639,0,162191
141910500200000,NW 308,Residential,39780,93806,0,133586
141910500300000,NW 308,Residential,8650,0,0,8650
141910500400000,NW 308,Residential,40230,106139,0,146369
141910500500000,NW 308,Residential,21210,0,0,21210
141910500600000,NW 308,Residential,54240,121390,0,175630
141910500700000,NW 308,Residential,33148,86692,0,119840
141910500800000,NW 308,Residential,25816,94808,0,120624
141910500900000,NW 308,Residential,24056,90047,0,114103
141910501000000,NW 308,Residential,24056,97004,0,121060
141910501100000,NW 308,Residential,24056,95118,0,119174
141910501200000,NW 308,Residential,24056,119078,0,143134
141910501300000,NW 308,Residential,24056,288,0,24344
141910501400000,NW 308,Residential,24056,120740,0,144796
141910501500000,NW 308,Residential,24056,118032,0,142088
141910501600000,NW 308,Residential,24056,103451,0,127507
141910501700000,NW 308,Residential,25977,112159,0,138136
141912600100000,NW 308,Residential,37009,201259,0,238268
141912600200000,NW 308,Residential,38410,222214,0,260624
141912600300000,NW 308,Residential,38410,225956,0,264366
141912600400000,NW 308,Residential,34569,185869,0,220438
141912600500000,NW 308,Residential,36186,220532,0,256718
141912600600000,NW 308,Residential,38090,248853,0,286943
141912600700000,NW 308,Residential,35881,193805,0,229686
141912600800000,NW 308,Residential,36701,176461,0,213162
141912600900000,NW 308,Residential,27898,120919,0,148817
141912601000000,NW 308,Residential,27963,114660,0,142623
141912601100000,NW 308,Residential,27727,100298,0,128025
141912601200000,NW 308,Residential,27878,85409,0,113287
141912601300000,NW 308,Residential,27793,78509,0,106302
141912601400000,NW 308,Residential,28307,96671,0,124978
141912601500000,NW 308,Residential,28275,91033,0,119308
141912601600000,NW 308,Residential,27508,62406,0,89914
141912601700000,NW 308,Residential,28177,68985,0,97162
141912601800000,NW 308,Residential,26460,82949,0,109409
141912601900000,NW 308,Residential,23429,65029,0,88458
141912700100000,NW 308,Residential,41313,180865,0,222178
141912700200000,NW 338,Residential,30866,161657,0,192523
141912700300000,NW 338,Residential,30862,132995,0,163857
141912700400000,NW 338,Residential,30862,164979,0,195841
141912700500000,NW 338,Residential,30861,122750,0,153611
141912700600000,NW 338,Residential,28414,150164,0,178578
141912700700000,NW 338,Residential,28414,124561,0,152975
141912700800000,NW 338,Residential,28413,133833,0,162246
141912700900000,NW 338,Residential,28693,136272,0,164965
141912701000000,NW 338,Residential,28693,118811,0,147504
141912701100000,NW 338,Residential,28693,158166,0,186859
141912701200000,NW 338,Residential,28693,138024,0,166717
141912701300000,NW 338,Residential,28692,151287,0,179979
141912701400000,NW 338,Residential,29127,146644,0,175771
141912701500000,NW 338,Residential,30302,145442,0,175744
141912701600000,NW 338,Residential,26400,189022,0,215422
141912701700000,NW 338,Residential,26400,150374,0,176774
141912701800000,NW 308,Residential,25536,94943,0,120479
141912701900000,NW 308,Residential,25774,89147,0,114921
141912702000000,NW 308,Residential,19627,102431,0,122058
141912702100000,NW 308,Residential,18375,88739,0,107114
141912702200000,NW 308,Residential,23152,85249,0,108401
141912702300000,NW 308,Residential,22694,86031,0,108725
141912702400000,NW 308,Residential,23893,128733,0,152626
141912702500000,NW 308,Residential,23657,86724,0,110381
141912702600000,NW 308,Residential,25705,92045,0,117750
141912702700000,NW 308,Residential,26112,92541,0,118653
141912702800000,NW 308,Residential,26520,63454,0,89974
141912702900000,NW 308,Residential,26600,94989,0,121589
141912703000000,NW 308,Residential,26785,82993,0,109778
141912703100000,NW 308,Residential,26785,84413,0,111198
141912703200000,NW 308,Residential,26022,82148,0,108170
141912703300000,NW 308,Residential,25536,61645,0,87181
141912703400000,NW 308,Residential,25976,79415,0,105391
141912703500000,NW 308,Residential,25898,84991,0,110889
141912703600000,NW 308,Residential,68350,202506,0,270856
141912703700000,NW 308,Residential,25085,100648,0,125733
141912703800000,NW 308,Residential,25556,87991,0,113547
141912703900000,NW 308,Residential,26763,102561,0,129324
141912704000000,NW 308,Residential,26347,92359,0,118706
141912704100000,NW 308,Residential,26346,83878,0,110224
141912704200000,NW 308,Residential,26509,96134,0,122643
141912704300000,NW 308,Residential,25688,84542,0,110230
141912704400000,NW 308,Residential,26346,106477,0,132823
141912704500000,NW 308,Residential,26088,83280,0,109368
141912704600000,NW 308,Residential,26519,99409,0,125928
141912704700000,NW 308,Residential,26613,98697,0,125310
141912704800000,NW 308,Residential,26710,91667,0,118377
141912704900000,NW 308,Residential,26710,69836,0,96546
141912705000000,NW 308,Residential,27160,93810,0,120970
141912705100000,NW 308,Residential,27269,84977,0,112246
141912705200000,NW 308,Residential,26457,98138,0,124595
141912705300000,NW 308,Residential,26674,95707,0,122381
141912705400000,NW 308,Residential,26965,88950,0,115915
141912705500000,NW 308,Residential,26921,87394,0,114315
141912705600000,NW 308,Residential,35966,154116,0,190082
141912705700000,NW 308,Residential,35255,197683,0,232938
141912705800000,NW 308,Residential,36777,163972,0,200749
141912705900000,NW 308,Residential,34932,181325,0,216257
141912706000000,NW 308,Residential,36453,209699,0,246152
141912706100000,NW 308,Residential,36133,181041,0,217174
141912706200000,NW 308,Residential,42210,226233,0,268443
141912800100000,NW 338,Residential,28379,125662,0,154041
141912800200000,NW 308,Residential,26344,131906,0,158250
141912800300000,NW 308,Residential,25536,109951,0,135487
141912800400000,NW 308,Residential,24960,115516,0,140476
141912800500000,NW 308,Residential,26112,128452,0,154564
141912800600000,NW 308,Residential,26320,109232,0,135552
141912800700000,NW 308,Residential,26320,89893,0,116213
141912800800000,NW 308,Residential,26320,114294,0,140614
141912800900000,NW 308,Residential,26320,96203,0,122523
141912801000000,NW 308,Residential,26320,115128,0,141448
141912801100000,NW 308,Residential,26320,105907,0,132227
141912801200000,NW 308,Residential,26320,103674,0,129994
141912801300000,NW 308,Residential,26320,117122,0,143442
141912801400000,NW 308,Residential,26320,107723,0,134043
141912801500000,NW 338,Residential,29023,126939,0,155962
141912801600000,NW 338,Residential,28376,127055,0,155431
141912801700000,NW 338,Residential,28376,143440,0,171816
141912801800000,NW 338,Residential,28376,153297,0,181673
141912801900000,NW 338,Residential,28376,147731,0,176107
141912802000000,NW 338,Residential,28376,173630,0,202006
141912802100000,NW 338,Residential,28376,160040,0,188416
141912802200000,NW 338,Residential,28376,147535,0,175911
141912802300000,NW 338,Residential,28376,154033,0,182409
141912802400000,NW 338,Residential,28376,153593,0,181969
141912802500000,NW 338,Residential,28376,139400,0,167776
141912802600000,NW 338,Residential,28376,137163,0,165539
141912900100000,NW 308,Residential,27193,129645,0,156838
141912900200000,NW 308,Residential,26730,112668,0,139398
141912900300000,NW 308,Residential,26730,112929,0,139659
141912900400000,NW 308,Residential,26730,135622,0,162352
141912900500000,NW 308,Residential,25026,127474,0,152500
141912900600000,NW 308,Residential,25026,96956,0,121982
141912900700000,NW 308,Residential,25026,90738,0,115764
141912900800000,NW 308,Residential,25026,72176,0,97202
141912900900000,NW 308,Residential,25026,96301,0,121327
141912901000000,NW 308,Residential,25026,75911,0,100937
141912901100000,NW 308,Residential,25026,101805,0,126831
141912901200000,NW 308,Residential,25026,104432,0,129458
141912901300000,NW 308,Residential,25026,82354,0,107380
141912901400000,NW 308,Residential,25026,96034,0,121060
141912901500000,NW 308,Residential,25026,84555,0,109581
141912901600000,NW 308,Residential,25026,93162,0,118188
141912901700000,NW 308,Residential,25309,105645,0,130954
141912901800000,NW 308,Residential,24275,97910,0,122185
141915100100000,NW 306,Residential,38846,123480,0,162326
141915100200000,NW 306,Residential,32304,55206,0,87510
141915100300000,NW 306,Residential,56970,127625,0,184595
141915100400000,NW 306,Residential,28018,113958,0,141976
141915100500000,NW 306,Residential,25970,118016,0,143986
141915100600000,NW 306,Residential,25970,120735,0,146705
141915100700000,NW 306,Residential,26215,115904,0,142119
141915100800000,NW 306,Residential,26460,96613,0,123073
141915100900000,NW 306,Residential,26950,105583,0,132533
141915101000000,NW 306,Residential,27685,107655,0,135340
141915101100000,NW 306,Residential,27668,107146,0,134814
141915101200000,NW 306,Residential,23219,121338,0,144557
141915101300000,NW 306,Residential,23310,92067,0,115377
141915101400000,NW 306,Residential,24780,114477,0,139257
141915101500000,NW 308,Residential,25153,91936,0,117089
141915101600000,NW 308,Residential,26705,89206,0,115911
141915101700000,NW 306,Residential,32928,121275,0,154203
141915200100000,NW 306,Residential,23938,72030,0,95968
141915200200000,NW 306,Residential,21840,77524,0,99364
141915200300000,NW 306,Residential,24938,100239,0,125177
141915200400000,NW 306,Residential,26250,80410,0,106660
141915200500000,NW 306,Residential,26250,73891,0,100141
141915200600000,NW 306,Residential,26040,64897,0,90937
141915200700000,NW 306,Residential,26040,61177,0,87217
141915200800000,NW 306,Residential,26040,65605,0,91645
141915200900000,NW 308,Residential,29363,66497,0,95860
141915201000000,NW 308,Residential,23345,90893,0,114238
141915201100000,NW 308,Residential,23042,85534,0,108576
141915201200000,NW 308,Residential,20790,83634,0,104424
141915201300000,NW 308,Residential,22349,97323,0,119672
141915201400000,NW 308,Residential,22973,115557,0,138530
141915201500000,NW 308,Residential,22973,107364,0,130337
141915201600000,NW 308,Residential,23353,98338,0,121691
141915201700000,NW 308,Residential,28342,135484,0,163826
141915201800000,NW 308,Residential,24722,102272,0,126994
141915201900000,NW 308,Residential,26957,90290,0,117247
141915202000000,NW 308,Residential,26412,86188,0,112600
141915202100000,NW 308,Residential,24768,92032,0,116800
141915202200000,NW 308,Residential,24768,94095,0,118863
141915202300000,NW 308,Residential,24445,88969,0,113414
141915202400000,NW 306,Residential,63600,205323,0,268923
141915202500000,NW 308,Residential,26362,105496,0,131858
141915202600000,NW 308,Residential,25034,112968,0,138002
141915202700000,NW 308,Residential,25478,118386,0,143864
141915202800000,NW 308,Residential,27580,122733,0,150313
141915202900000,NW 308,Residential,28485,108624,0,137109
141915203000000,NW 308,Residential,28159,118546,0,146705
141915203100000,NW 308,Residential,27160,97368,0,124528
141915203200000,NW 308,Residential,27160,89816,0,116976
141915203300000,NW 308,Residential,27160,91690,0,118850
141915203400000,NW 308,Residential,26995,103107,0,130102
141915203500000,NW 308,Residential,26880,117488,0,144368
141915203600000,NW 308,Residential,26880,107963,0,134843
141915203700000,NW 341,Residential,34182,190233,0,224415
141915203800000,NW 341,Residential,34182,145415,0,179597
141915203900000,NW 341,Residential,33648,145933,0,179581
141915204000000,NW 341,Residential,34032,141187,0,175219
141915204100000,NW 341,Residential,32560,0,0,32560
141915204200000,NW 341,Residential,40195,205023,0,245218
141915204300000,NW 341,Residential,35978,213274,0,249252
141915204400000,NW 341,Residential,33764,0,0,33764
141915204500000,NW 341,Residential,32967,241737,0,274704
141915204600000,NW 341,Residential,40061,196735,0,236796
141915204700000,NW 341,Residential,34426,0,0,34426
141915204800000,NW 341,Residential,33293,0,0,33293
141915204900000,NW 341,Residential,29723,192554,0,222277
141915205000000,NW 306,Residential,33844,91388,0,125232
141915205100000,NW 306,Residential,29055,109582,0,138637
141915205200000,NW 306,Residential,29689,112104,0,141793
141915205300000,NW 306,Residential,28476,117781,0,146257
141915205400000,NW 306,Residential,28665,110565,0,139230
141915205500000,NW 306,Residential,28910,103698,0,132608
141915205600000,NW 306,Residential,34707,85293,0,120000
141915205700000,NW 306,Residential,30637,140486,0,171123
141915205800000,NW 306,Residential,21271,92241,0,113512
141915205900000,NW 306,Residential,27283,75944,0,103227
141915206000000,NW 306,Residential,27268,79572,0,106840
141915206100000,NW 306,Residential,23373,74183,0,97556
141915300100000,NW 308,Residential,26328,92130,0,118458
141915300200000,NW 308,Residential,25544,95982,0,121526
141915300300000,NW 308,Residential,26342,92824,0,119166
141915300400000,NW 308,Residential,26994,106273,0,133267
141915400100000,NW 308,Residential,26362,93195,0,119557
141915400200000,NW 308,Residential,25735,91419,0,117154
141915400300000,NW 308,Residential,25624,92092,0,117716
141915400400000,NW 308,Residential,26352,107344,0,133696
141915400500000,NW 308,Residential,26624,110269,0,136893
141915400600000,NW 308,Residential,23761,85876,0,109637
141915400700000,NW 308,Residential,24945,95631,0,120576
141915400800000,NW 308,Residential,24444,119746,0,144190
141915400900000,NW 308,Residential,25525,127777,0,153302
141915401000000,NW 308,Residential,27455,140869,0,168324
141915401100000,NW 308,Residential,27518,125568,0,153086
141915401200000,NW 308,Residential,27535,125314,0,152849
141915401300000,NW 308,Residential,29131,122124,0,151255
141915401400000,NW 308,Residential,26531,123894,0,150425
141915401500000,NW 308,Residential,26272,92297,0,118569
141915401600000,NW 308,Residential,25034,100065,0,125099
141915500100000,NW 341,Residential,37200,197424,0,234624
141915500200000,NW 341,Residential,34235,176879,0,211114
141915500300000,NW 341,Residential,34235,163701,0,197936
141915500400000,NW 341,Residential,34235,183291,0,217526
141915500500000,NW 341,Residential,34235,162303,0,196538
141915500600000,NW 341,Residential,29375,0,0,29375
141915500700000,NW 341,Residential,30456,0,0,30456
141915500800000,NW 341,Residential,28764,187992,0,216756
141915500900000,NW 341,Residential,33840,203413,0,237253
141915501000000,NW 341,Residential,37200,166350,0,203550
141917600100000,NW 306,Residential,43190,94795,0,137985
141917600200000,NW 306,Residential,43050,193516,0,236566
141917600300000,NW 306,Residential,23949,64669,0,88618
141917600400000,NW 306,Residential,23949,93427,0,117376
141917600500000,NW 306,Residential,23949,76545,0,100494
141917600600000,NW 306,Residential,23949,82122,0,106071
141917600700000,NW 306,Residential,42665,64740,0,107405
141917600800000,NW 306,Residential,33529,91428,0,124957
141917600900000,NW 306,Residential,49805,48716,0,98521
141917601000000,NW 306,Residential,23741,96093,0,119834
141917601100000,NW 306,Residential,5233,0,0,5233
141917601200000,NW 306,Residential,24157,78356,0,102513
141917601300000,NW 306,Residential,26163,104678,0,130841
141917601400000,NW 306,Residential,26163,45273,0,71436
141917601500000,NW 306,Residential,24255,97300,0,121555
141917601600000,NW 306,Residential,22358,85512,0,107870
141917601700000,NW 306,Residential,22354,89952,0,112306
141917601800000,NW 306,Residential,22354,92385,0,114739
141917601900000,NW 306,Residential,24435,83539,0,107974
141917602000000,NW 306,Residential,63850,139650,0,203500
141917602100000,NW 306,Residential,80600,77610,0,158210
141917602200000,NW 306,Residential,74950,0,0,74950
141917602300000,NW 306,Residential,45175,154533,0,199708
141917602400000,NW 306,Residential,20700,1130,0,21830
141917602500000,NW 306,Residential,19698,95246,0,114944
141917602600000,NW 306,Residential,61950,205688,0,267638
141917602700000,NW 313,Residential,38261,231221,0,269482
141917602800000,NW 313,Residential,37800,177850,0,215650
141917602900000,NW 313,Residential,38497,178081,0,216578
141917603000000,NW 313,Residential,52819,267626,0,320445
141917603100000,NW 313,Residential,46852,231786,0,278638
141917603200000,NW 313,Residential,36248,276289,0,312537
141917603300000,NW 313,Residential,33600,244522,0,278122
141917603400000,NW 313,Residential,33600,222833,0,256433
141917603500000,NW 313,Residential,39173,265199,0,304372
141917603600000,NW 306,Residential,78750,197886,0,276636
141917603700000,NW 306,Residential,3540,0,0,3540
141917603800000,NW 306,Residential,3694,0,0,3694
141917700100000,NW 306,Residential,34468,33867,0,68335
141920100100000,NW 308,Residential,24521,105996,0,130517
141920100200000,NW 308,Residential,25088,110590,0,135678
141920100300000,NW 308,Residential,25088,108784,0,133872
141920100400000,NW 308,Residential,25088,112060,0,137148
141920100500000,NW 308,Residential,25088,115867,0,140955
141920100600000,NW 308,Residential,25088,109131,0,134219
141920100700000,NW 308,Residential,25088,116659,0,141747
141920100800000,NW 308,Residential,25062,122311,0,147373
141920100900000,NW 308,Residential,29400,116520,0,145920
141920101000000,NW 308,Residential,26460,103434,0,129894
141920101100000,NW 308,Residential,25284,85811,0,111095
141920101200000,NW 308,Residential,26460,110798,0,137258
141920101300000,NW 308,Residential,26460,83373,0,109833
141920101400000,NW 308,Residential,26177,109072,0,135249
141920101500000,NW 308,Residential,25284,98710,0,123994
141920101600000,NW 308,Residential,25284,101152,0,126436
141920101700000,NW 308,Residential,25787,90377,0,116164
141920101800000,NW 308,Residential,24751,92580,0,117331
141920101900000,NW 308,Residential,25633,96091,0,121724
141920200100000,NW 308,Residential,26147,94846,0,120993
141920200200000,NW 308,Residential,27124,118053,0,145177
141920200300000,NW 308,Residential,27234,120718,0,147952
141920200400000,NW 308,Residential,28534,104031,0,132565
141920200500000,NW 308,Residential,36870,117239,0,154109
141920200600000,NW 308,Residential,26533,111978,0,138511
141920200700000,NW 308,Residential,26775,102238,0,129013
141920200800000,NW 308,Residential,26226,125899,0,152125
141920200900000,NW 308,Residential,26226,114860,0,141086
141920201000000,NW 308,Residential,26316,109234,0,135550
141920201100000,NW 308,Residential,25284,121855,0,147139
141920201200000,NW 308,Residential,25026,109142,0,134168
141920201300000,NW 308,Residential,25026,128264,0,153290
141920201400000,NW 308,Residential,25026,94147,0,119173
141920201500000,NW 308,Residential,25026,129206,0,154232
141920201600000,NW 308,Residential,25026,118590,0,143616
141920201700000,NW 308,Residential,25026,100275,0,125301
141920201800000,NW 308,Residential,25026,101691,0,126717
141920201900000,NW 308,Residential,25026,103217,0,128243
141920202000000,NW 308,Residential,24488,95866,0,120354
141920202100000,APTS NW,Commercial,39335,0,359505,398840
141920202200000,APTS NW,Residential,38923,276077,0,315000
141920202300000,APTS NW,Residential,34452,280548,0,315000
141920202400000,APTS NW,Residential,54540,588933,0,643473
141920202600000,NW 308,Residential,20160,85897,0,106057
141920202700000,NW 308,Residential,20167,83416,0,103583
141920202800000,NW 308,Residential,25320,87698,0,113018
141920202900000,NW 308,Residential,25800,83721,0,109521
141920203000000,NW 308,Residential,25800,87519,0,113319
141920203100000,NW 308,Residential,26712,87973,0,114685
141920203200000,NW 308,Residential,27000,110614,0,137614
141920203300000,NW 308,Residential,27000,107173,0,134173
141920203400000,NW 308,Residential,25800,92031,0,117831
141920203500000,NW 308,Residential,27000,89831,0,116831
141920203600000,NW 308,Residential,27000,92743,0,119743
141920203700000,NW 308,Residential,25587,117648,0,143235
141920203800000,NW 308,Residential,25600,114630,0,140230
141920203900000,NW 308,Residential,26640,126367,0,153007
141920204000000,NW 308,Residential,33384,168632,0,202016
141920204100000,NW 308,Residential,26961,129865,0,156826
141920204200000,NW 308,Residential,29155,109942,0,139097
141920204301000,CONDO 501,Residential,14000,0,0,14000
141920204301001,CONDO 501,Residential,14000,0,0,14000
141920204301002,CONDO 501,Residential,14000,76100,0,90100
141920204301003,CONDO 501,Residential,14000,76325,0,90325
141920204301004,CONDO 501,Residential,14000,0,0,14000
141920204301005,CONDO 501,Residential,14000,0,0,14000
141920204301006,CONDO 501,Residential,14000,27164,0,41164
141920204301007,CONDO 501,Residential,14000,27164,0,41164
141920204301008,CONDO 501,Residential,14000,0,0,14000
141920204301009,CONDO 501,Residential,14000,0,0,14000
141920204301010,CONDO 501,Residential,14000,0,0,14000
141920204301011,CONDO 501,Residential,14000,0,0,14000
141920204301012,CONDO 501,Residential,14000,0,0,14000
141920204301013,CONDO 501,Residential,14000,0,0,14000
141920204301014,CONDO 501,Residential,14000,0,0,14000
141920204301015,CONDO 501,Residential,14000,0,0,14000
141920204301016,CONDO 501,Residential,14000,0,0,14000
141920204301017,CONDO 501,Residential,14000,0,0,14000
141920204301018,CONDO 501,Residential,14000,0,0,14000
141920204301019,CONDO 501,Residential,14000,0,0,14000
141920204301020,CONDO 501,Residential,14000,0,0,14000
141920204301021,CONDO 501,Residential,14000,0,0,14000
141920204301022,CONDO 501,Residential,14000,0,0,14000
141920204301023,CONDO 501,Residential,14000,0,0,14000
141920204301024,CONDO 501,Residential,14000,0,0,14000
141920204301025,CONDO 501,Residential,14000,0,0,14000
141920204301026,CONDO 501,Residential,14000,0,0,14000
141920204301027,CONDO 501,Residential,14000,0,0,14000
141920204301028,CONDO 501,Residential,14000,0,0,14000
141920204301029,CONDO 501,Residential,14000,0,0,14000
141920204301030,CONDO 501,Residential,14000,0,0,14000
141920204301031,CONDO 501,Residential,14000,0,0,14000
141920204301032,CONDO 501,Residential,14000,104461,0,118461
141920204301033,CONDO 501,Residential,14000,104461,0,118461
141920204301034,CONDO 501,Residential,1,0,0,1
141920204400000,NW 308,Residential,64650,133945,0,198595
141920300100000,NW 308,Residential,28350,111835,0,140185
141920300200000,NW 308,Residential,28984,116298,0,145282
141920300300000,NW 308,Residential,28194,104756,0,132950
141920300400000,NW 308,Residential,28638,100154,0,128792
141920300500000,NW 308,Residential,27606,103219,0,130825
141920300600000,NW 308,Residential,29807,99528,0,129335
141920300700000,NW 308,Residential,24768,100232,0,125000
141920300800000,NW 308,Residential,24768,97688,0,122456
141920300900000,NW 308,Residential,24768,100170,0,124938
141920301000000,NW 308,Residential,24768,95391,0,120159
141920301100000,NW 308,Residential,24768,110742,0,135510
141920301200000,NW 308,Residential,24768,108252,0,133020
141920301300000,NW 308,Residential,24768,72347,0,97115
141920301400000,NW 308,Residential,24768,113101,0,137869
141920301500000,NW 308,Residential,25023,98613,0,123636
141920301600000,NW 308,Residential,26042,97727,0,123769
141920301700000,NW 308,Residential,24768,100441,0,125209
141920301800000,NW 308,Residential,24768,108138,0,132906
141920301900000,NW 308,Residential,24768,108657,0,133425
141920302000000,NW 308,Residential,24768,105472,0,130240
141920302100000,NW 308,Residential,28762,112816,0,141578
141920302200000,NW 308,Residential,29131,108432,0,137563
141920302300000,NW 308,Residential,31500,111690,0,143190
141920302400000,NW 308,Residential,29181,112298,0,141479
141920302500000,NW 308,Residential,25542,105621,0,131163
141920302600000,NW 308,Residential,25542,101847,0,127389
141920302700000,NW 308,Residential,25542,105509,0,131051
141920302800000,NW 308,Residential,25542,106049,0,131591
141920302900000,NW 308,Residential,25542,99463,0,125005
141920303000000,NW 308,Residential,25542,117316,0,142858
141920303100000,NW 308,Residential,25828,110326,0,136154
141920303200000,NW 308,Residential,26729,107782,0,134511
141920303300000,NW 308,Residential,25284,101718,0,127002
141920303400000,NW 308,Residential,25284,104619,0,129903
141920303500000,NW 308,Residential,25284,102214,0,127498
141920303600000,NW 308,Residential,25284,109412,0,134696
141920303700000,NW 308,Residential,25284,118744,0,144028
141920303800000,NW 308,Residential,25284,107907,0,133191
141920303900000,NW 308,Residential,25284,106458,0,131742
141920304000000,NW 308,Residential,28953,103798,0,132751
141920304100000,NW 308,Residential,27580,145887,0,173467
141920304200000,NW 308,Residential,30742,127322,0,158064
141920304300000,NW 308,Residential,28413,116284,0,144697
141920400100000,APTS NW,Residential,39366,285634,0,325000
141920400200000,APTS NW,Residential,20669,134331,0,155000
141920400300000,APTS NW,Commercial,40303,0,363460,403763
141922600100000,NW 308,Residential,27540,97783,0,125323
141922600200000,NW 308,Residential,27632,115935,0,143567
141922600300000,NW 308,Residential,27618,109355,0,136973
141922600400000,NW 308,Residential,27832,84237,0,112069
141922600500000,NW 308,Residential,31282,95356,0,126638
141922600600000,NW 308,Residential,25284,104307,0,129591
141922600700000,NW 308,Residential,25284,110477,0,135761
141922600800000,NW 308,Residential,25284,91595,0,116879
141922600900000,NW 308,Residential,25284,97983,0,123267
141922601000000,NW 308,Residential,25284,95073,0,120357
141922601100000,NW 308,Residential,25284,79717,0,105001
141922601200000,NW 308,Residential,25284,82134,0,107418
141922601300000,NW 308,Residential,25284,94361,0,119645
141922601400000,NW 308,Residential,25284,82362,0,107646
141922601500000,NW 308,Residential,25561,87939,0,113500
141922601600000,NW 308,Residential,26405,104847,0,131252
141922601700000,NW 308,Residential,25800,105710,0,131510
141922601800000,NW 308,Residential,25800,95866,0,121666
141922601900000,NW 308,Residential,25800,103269,0,129069
141922602000000,NW 308,Residential,25800,96011,0,121811
141922602100000,NW 308,Residential,25800,104795,0,130595
141922602200000,NW 308,Residential,25800,96948,0,122748
141922602300000,NW 308,Residential,25800,96077,0,121877
141922602400000,NW 308,Residential,25800,97515,0,123315
141922602500000,NW 308,Residential,26058,96589,0,122647
141922602600000,NW 308,Residential,28832,87515,0,116347
141922602700000,NW 308,Residential,27370,102830,0,130200
141922700100000,NW 308,Residential,24530,96557,0,121087
141922700200000,NW 308,Residential,29290,110325,0,139615
141922700300000,NW 308,Residential,22372,104169,0,126541
141922700400000,NW 308,Residential,23312,88954,0,112266
141922700500000,NW 308,Residential,23312,75673,0,98985
141922700600000,NW 308,Residential,24252,102338,0,126590
141922700700000,NW 308,Residential,24252,96631,0,120883
141922700800000,NW 308,Residential,24252,80520,0,104772
141922700900000,NW 308,Residential,24510,85011,0,109521
141922701000000,NW 308,Residential,24510,77756,0,102266
141922701100000,NW 308,Residential,24510,76231,0,100741
141922701200000,NW 308,Residential,24510,94501,0,119011
141922701300000,NW 308,Residential,26220,84974,0,111194
141922701400000,NW 308,Residential,25080,90415,0,115495
141922701500000,NW 308,Residential,26170,115426,0,141596
141922701600000,NW 308,Residential,26729,110509,0,137238
141922701700000,NW 308,Residential,26320,96503,0,122823
141922701800000,NW 308,Residential,25944,107526,0,133470
141922701900000,NW 308,Residential,24252,84913,0,109165
141922702000000,NW 308,Residential,24252,90330,0,114582
141922702100000,NW 308,Residential,24252,80496,0,104748
141922702200000,NW 308,Residential,24252,96109,0,120361
141922702300000,NW 308,Residential,24252,85348,0,109600
141922702400000,NW 308,Residential,24252,85124,0,109376
141922702500000,NW 308,Residential,24252,99713,0,123965
141922702600000,NW 308,Residential,24252,90580,0,114832
141922702700000,NW 308,Residential,24252,125416,0,149668
141922702800000,NW 308,Residential,24252,101899,0,126151
141922800100000,NW 308,Residential,25634,103611,0,129245
141922800200000,NW 308,Residential,26006,93821,0,119827
141922800300000,NW 308,Residential,25439,77105,0,102544
141922800400000,NW 308,Residential,26316,92374,0,118690
141922800500000,NW 308,Residential,26755,97387,0,124142
141922800600000,NW 308,Residential,25802,112947,0,138749
141922800700000,NW 308,Residential,25026,85757,0,110783
141922800800000,NW 308,Residential,26140,99299,0,125439
141922800900000,NW 308,Residential,27744,67834,0,95578
141922801000000,NW 308,Residential,21015,91985,0,113000
141922801100000,NW 308,Residential,25181,110638,0,135819
141922801200000,NW 308,Residential,25181,104976,0,130157
141922801300000,NW 308,Residential,25181,86117,0,111298
141922801400000,NW 308,Residential,25181,81969,0,107150
141922801500000,NW 308,Residential,25026,90998,0,116024
141922801600000,NW 308,Residential,25841,89028,0,114869
141922801700000,NW 308,Residential,29145,101844,0,130989
141922801800000,NW 308,Residential,27409,98894,0,126303
141922801900000,NW 308,Residential,25830,101026,0,126856
141922802000000,NW 308,Residential,25981,95716,0,121697
141922802100000,NW 308,Residential,25981,86299,0,112280
141922802200000,NW 308,Residential,25981,87725,0,113706
141922802300000,NW 308,Residential,26264,81220,0,107484
141922802400000,NW 308,Residential,30860,78759,0,109619
141922802500000,NW 308,Residential,30736,76509,0,107245
141922802600000,NW 308,Residential,29328,80476,0,109804
141922802700000,NW 308,Residential,28388,76836,0,105224
141922802800000,NW 308,Residential,28921,101219,0,130140
141922802900000,NW 308,Residential,25988,91437,0,117425
141922803000000,NW 308,Residential,20983,94975,0,115958
141922803100000,NW 308,Residential,20668,87891,0,108559
141922803200000,NW 308,Residential,24146,70953,0,95099
141922803300000,NW 308,Residential,24416,128791,0,153207
141922803400000,NW 308,Residential,24321,78829,0,103150
141922803500000,NW 308,Residential,24321,114710,0,139031
141922803600000,NW 308,Residential,24321,96099,0,120420
141922803700000,NW 308,Residential,30520,89542,0,120062
141922803800000,E-15 CITY,Exempt,0,0,0,0
141922900101000,CONDO 500,Residential,2500,35321,0,37821
141922900101001,CONDO 500,Residential,2500,35321,0,37821
141922900101002,CONDO 500,Residential,2500,44186,0,46686
141922900101003,CONDO 500,Residential,2500,36651,0,39151
141922900101004,CONDO 500,Residential,2500,36651,0,39151
141922900101005,CONDO 500,Residential,2500,45455,0,47955
141922900101006,CONDO 500,Residential,2500,44186,0,46686
141922900101007,CONDO 500,Residential,2500,44186,0,46686
141922900101008,CONDO 500,Residential,2500,45455,0,47955
141922900101009,CONDO 500,Residential,2500,45455,0,47955
141922900201000,CONDO 500,Residential,2500,35321,0,37821
141922900201001,CONDO 500,Residential,2500,35321,0,37821
141922900201002,CONDO 500,Residential,2500,44186,0,46686
141922900201003,CONDO 500,Residential,2500,36651,0,39151
141922900201004,CONDO 500,Residential,2500,36651,0,39151
141922900201005,CONDO 500,Residential,2500,45455,0,47955
141922900201006,CONDO 500,Residential,2500,44186,0,46686
141922900201007,CONDO 500,Residential,2500,44186,0,46686
141922900201008,CONDO 500,Residential,2500,45455,0,47955
141922900201009,CONDO 500,Residential,2500,45455,0,47955
141923000100000,NW 308,Residential,25026,95836,0,120862
141923000200000,NW 308,Residential,26896,97907,0,124803
141923000300000,NW 308,Residential,25230,88688,0,113918
141923000400000,NW 308,Residential,25659,88860,0,114519
141923000500000,NW 308,Residential,26397,93513,0,119910
141923000600000,NW 308,Residential,27832,85932,0,113764
141923000700000,NW 308,Residential,25542,99765,0,125307
141923000800000,NW 308,Residential,24768,91703,0,116471
141923000900000,NW 308,Residential,24570,90562,0,115132
141923001000000,NW 308,Exempt,25026,0,99559,124585
141923001100000,NW 308,Residential,25026,91686,0,116712
141923001200000,NW 308,Residential,25026,96632,0,121658
141923001300000,NW 308,Residential,25026,90083,0,115109
141923100100000,APTS NW,Commercial,16561,0,126985,143546
141923200100000,NW 308,Residential,28500,96302,0,124802
141923200200000,NW 308,Residential,28500,92791,0,121291
141923200300000,NW 308,Residential,28500,96808,0,125308
141923200400000,NW 308,Residential,28500,93468,0,121968
141923200500000,NW 308,Residential,27072,97572,0,124644
141923200600000,NW 308,Residential,24500,62881,0,87381
141923200700000,NW 308,Residential,26162,124160,0,150322
141923200800000,NW 308,Residential,28175,73466,0,101641
141925100100000,NW 314,Residential,24358,101642,0,126000
141925100200000,NW 314,Residential,32825,88514,0,121339
141925100300000,NW 314,Residential,26166,96775,0,122941
141925100400000,NW 314,Residential,25440,109707,0,135147
141925100500000,NW 314,Residential,23310,106425,0,129735
141925100600000,NW 314,Residential,29695,105292,0,134987
141925100700000,NW 314,Residential,43380,100888,0,144268
141925100800000,NW 314,Residential,29274,97971,0,127245
141925100900000,NW 314,Residential,27904,174001,0,201905
141925101000000,NW 314,Residential,27032,115834,0,142866
141925101200000,NW 314,Residential,18100,89624,0,107724
141925101300000,NW 314,Residential,27856,59765,0,87621
141925101400000,NW 314,Residential,28114,59011,0,87125
141925101500000,NW 314,Residential,29030,110650,0,139680
141925101600000,NW 314,Residential,25833,96107,0,121940
141925101700000,NW 314,Residential,33669,101451,0,135120
141925101800000,NW 314,Residential,27132,95440,0,122572
141925101900000,NW 314,Residential,27216,51277,0,78493
141925102000000,NW 314,Residential,22000,96133,0,118133
141925102100000,NW 314,Residential,25966,79260,0,105226
141925102200000,NW 314,Residential,26703,99876,0,126579
141925102300000,NW 314,Residential,29040,71277,0,100317
141925102400000,NW 314,Residential,28800,88579,0,117379
141925102500000,NW 314,Residential,51382,52546,0,103928
141925102600000,NW 314,Residential,26790,62495,0,89285
141925102700000,NW 314,Residential,26741,127291,0,154032
141925102800000,NW 314,Residential,28560,128747,0,157307
141925102900000,NW 314,Residential,22624,84275,0,106899
141925103000000,NW 314,Residential,22624,92759,0,115383
141925103100000,NW 314,Residential,22624,89731,0,112355
141925103200000,NW 314,Residential,22624,82047,0,104671
141925103300000,NW 314,Residential,50050,77585,0,127635
141925103400000,NW 314,Residential,22776,109339,0,132115
141925200100000,NW 314,Residential,30854,144171,0,175025
141925200200000,NW 314,Residential,26302,65570,0,91872
141925200300000,NW 314,Residential,23205,101892,0,125097
141925200400000,NW 314,Exempt,23205,0,97822,121027
141925200500000,NW 314,Residential,23205,84504,0,107709
141925200600000,NW 314,Residential,23205,108883,0,132088
141925200700000,NW 314,Residential,24500,87759,0,112259
141925200800000,NW 314,Residential,24500,87500,0,112000
141925200900000,NW 314,Residential,24500,97134,0,121634
141925201000000,NW 314,Residential,22995,81007,0,104002
141925201100000,NW 314,Residential,5136,461,0,5597
141925201201000,CONDO 500,Residential,8000,48931,0,56931
141925201201001,CONDO 500,Residential,8000,49748,0,57748
141925201201002,CONDO 500,Residential,8000,48031,0,56031
141925201201003,CONDO 500,Residential,8000,48779,0,56779
141925201201004,CONDO 500,Residential,8000,48931,0,56931
141925201201005,CONDO 500,Residential,8000,47568,0,55568
141925201201006,CONDO 500,Residential,8000,53300,0,61300
141925201201007,CONDO 500,Residential,8000,48779,0,56779
141925201201008,CONDO 500,Residential,8000,48637,0,56637
141925201201009,CONDO 500,Residential,8000,48183,0,56183
141925201201010,CONDO 500,Residential,8000,47416,0,55416
141925201201011,CONDO 500,Residential,8000,47914,0,55914
141925201201012,CONDO 500,Residential,8000,48346,0,56346
141925201201013,CONDO 500,Residential,8000,48346,0,56346
141925201201014,CONDO 500,Residential,0,6603,0,6603
141925201201015,CONDO 500,Residential,0,6603,0,6603
141925201201016,CONDO 500,Residential,0,6603,0,6603
141925201201017,CONDO 500,Residential,0,6603,0,6603
141925201201018,CONDO 500,Residential,0,6603,0,6603
141925201201019,CONDO 500,Residential,0,6603,0,6603
141925201201020,CONDO 500,Residential,0,6603,0,6603
141925201201021,CONDO 500,Residential,0,6603,0,6603
141925201201022,CONDO 500,Residential,0,6603,0,6603
141925201201023,CONDO 500,Residential,0,6603,0,6603
141925201201024,CONDO 500,Residential,0,6603,0,6603
141925201300000,NW 314,Residential,47082,130090,0,177172
141925201400000,NW 314,Residential,36816,56686,0,93502
141925201500000,NW 314,Residential,24396,55655,0,80051
141925201600000,NW 314,Residential,30131,72397,0,102528
141925201700000,NW 314,Residential,31783,111003,0,142786
141925201800000,NW 314,Residential,24157,44424,0,68581
141925201900000,NW 314,Residential,30377,62249,0,92626
141925202000000,NW 314,Residential,28171,117626,0,145797
141925202100000,NW 314,Residential,31572,115205,0,146777
141925202200000,NW 314,Residential,31515,133851,0,165366
141925202300000,NW 314,Residential,35783,65763,0,101546
141925202400000,NW 314,Residential,18518,108726,0,127244
141925202500000,NW 314,Residential,17484,98047,0,115531
141925202600000,NW 314,Residential,19829,89570,0,109399
141925202700000,NW 314,Residential,19890,98823,0,118713
141925202800000,NW 314,Residential,27405,74786,0,102191
141925202900000,NW 314,Residential,53050,51824,0,104874
141925203000000,NW 314,Residential,32000,203,0,32203
141925203100000,NW 314,Residential,18900,190976,0,209876
141925203200000,NW 314,Residential,35581,97754,0,133335
141925203300000,NW 314,Residential,31879,79189,0,111068
141925203400000,NW 314,Residential,46350,68232,0,114582
141925203500000,NW 314,Residential,25915,87224,0,113139
141927600100000,NW 308,Residential,45136,46943,0,92079
141927600201000,CONDO 500,Residential,6000,39545,0,45545
141927600201001,CONDO 500,Residential,6000,39121,0,45121
141927600201002,CONDO 500,Residential,6000,43320,0,49320
141927600201003,CONDO 500,Residential,6000,42846,0,48846
141927600201004,CONDO 500,Residential,6000,40560,0,46560
141927600201005,CONDO 500,Residential,6000,44624,0,50624
141927600300000,NW 308,Residential,19845,13728,0,33573
141927600400000,NW 308,Residential,17766,63250,0,81016
141927600500000,NW 308,Residential,29016,48655,0,77671
141927600600000,NW 308,Residential,20141,111070,0,131211
141927600700000,APTS NW,Commercial,16892,0,146553,163445
141927600800000,APTS NW,Commercial,20757,0,174671,195428
141927600900000,NW 308,Residential,24890,99770,0,124660
141927601000000,NW 308,Residential,30188,80748,0,110936
141927601100000,NW 308,Residential,24675,86403,0,111078
141927601200000,NW 308,Residential,23448,88277,0,111725
141927601300000,NW 308,Residential,27245,132968,0,160213
141927601400000,NW 308,Residential,26790,92378,0,119168
141927601500000,NW 308,Residential,29431,69558,0,98989
141927601600000,NW 308,Residential,24617,103105,0,127722
141927601700000,NW 308,Residential,24888,107112,0,132000
141927700100000,NW 308,Residential,22844,85182,0,108026
141927700200000,NW 308,Residential,22747,116855,0,139602
141927700300000,NW 308,Residential,23263,91321,0,114584
141927700400000,NW 308,Residential,26340,89241,0,115581
141927700500000,NW 308,Residential,27581,85843,0,113424
141927700600000,NW 308,Residential,31824,119834,0,151658
141927700700000,NW 308,Residential,27609,83775,0,111384
141927700800000,NW 308,Residential,24508,86913,0,111421
141927700900000,NW 308,Residential,25764,92794,0,118558
141927701000000,NW 308,Residential,25748,84171,0,109919
141927701100000,NW 308,Residential,25866,79128,0,104994
141927701200000,NW 308,Residential,26135,96327,0,122462
141927701300000,NW 308,Residential,25792,94438,0,120230
141927701400000,NW 308,Residential,25792,98616,0,124408
141927701500000,NW 308,Residential,26711,92269,0,118980
141927800100000,NW 308,Residential,27083,125340,0,152423
141927800200000,NW 308,Residential,31361,131405,0,162766
141927900100000,NW 308,Residential,24608,114330,0,138938
141927900200000,NW 308,Residential,82450,0,0,82450
141927900300000,NW 308,Residential,84350,218260,0,302610
141927900400000,NW 308,Residential,22565,89050,0,111615
141927900500000,NW 308,Residential,22560,91445,0,114005
141927900600000,NW 308,Residential,22560,105804,0,128364
141927900700000,NW 308,Residential,22560,96056,0,118616
141927900800000,NW 308,Residential,22853,94611,0,117464
141927900900000,NW 308,Residential,22751,75200,0,97951
141927901000000,NW 308,Residential,22560,97365,0,119925
141927901100000,NW 308,Residential,22560,88098,0,110658
141927901200000,NW 308,Residential,22560,82856,0,105416
141927901300000,NW 308,Residential,22688,87064,0,109752
141927901400000,NW 308,Residential,25023,80565,0,105588
141927901500000,NW 308,Residential,24816,87705,0,112521
141927901600000,NW 308,Residential,24816,90960,0,115776
141927901700000,NW 308,Residential,24816,90468,0,115284
141927901800000,NW 308,Residential,24946,97596,0,122542
141927901900000,NW 308,Residential,22678,76407,0,99085
141927902000000,NW 308,Residential,22560,74877,0,97437
141927902100000,NW 308,Residential,22560,82503,0,105063
141927902200000,NW 308,Residential,22560,81957,0,104517
141927902300000,NW 308,Residential,22846,73548,0,96394
141927902400000,Empty,Exempt,0,0,0,0
141927902500000,NW 308,Residential,29425,138552,0,167977
141927902600000,NW 308,Residential,27445,168454,0,195899
141927902700000,NW 308,Residential,28566,121853,0,150419
141927902800000,NW 308,Residential,28566,138316,0,166882
141927902900000,NW 308,Residential,28566,136668,0,165234
141927903000000,NW 308,Residential,27156,117499,0,144655
141927903100000,NW 308,Residential,22955,92843,0,115798
141927903200000,NW 308,Residential,23280,99028,0,122308
141927903300000,NW 308,Residential,23280,103971,0,127251
141927903400000,NW 308,Residential,23280,102547,0,125827
141927903500000,NW 308,Residential,23280,116496,0,139776
141928000100000,NW 308,Residential,29260,139508,0,168768
141928000200000,NW 308,Residential,30589,191439,0,222028
141928100100000,NW 308,Residential,29695,168228,0,197923
141930100100000,NW 308,Residential,29743,141241,0,170984
141930100200000,NW 308,Residential,31634,144322,0,175956
141930100300000,NW 308,Residential,33322,138860,0,172182
141930100400000,NW 308,Residential,34793,173875,0,208668
141930100500000,NW 308,Residential,23520,128220,0,151740
141930100600000,NW 308,Residential,37634,83960,0,121594
141930100700000,NW 308,Residential,37961,45889,0,83850
141930100800000,NW 308,Residential,38288,55076,0,93364
141930100900000,NW 308,Residential,38288,64812,0,103100
141930101000000,NW 308,Residential,63550,216975,0,280525
141930101100000,NW 308,Residential,38288,83642,0,121930
141930101200000,NW 308,Residential,39011,104252,0,143263
141930101300000,NW 308,Residential,30683,84188,0,114871
141930101400000,NW 308,Residential,27741,125231,0,152972
141930101500000,NW 308,Residential,27300,92771,0,120071
141930101600000,NW 308,Residential,29274,107682,0,136956
141930200100000,NW 308,Residential,21132,118541,0,139673
141930200200000,NW 308,Residential,24561,89234,0,113795
141930200300000,NW 308,Residential,24561,98583,0,123144
141930200400000,NW 308,Residential,24561,98518,0,123079
141930200500000,NW 308,Residential,24561,100827,0,125388
141930200600000,NW 308,Residential,52957,84184,0,137141
141930200700000,NW 308,Residential,23086,104288,0,127374
141930200800000,NW 308,Residential,24798,108197,0,132995
141930200900000,NW 308,Residential,24931,95940,0,120871
141930201000000,NW 308,Residential,30623,119633,0,150256
141930201100000,NW 308,Residential,31864,147630,0,179494
141930201200000,NW 308,Residential,31521,47742,0,79263
141930201300000,NW 308,Residential,31621,59273,0,90894
141930201400000,NW 308,Residential,27767,101721,0,129488
141930201500000,NW 308,Residential,28747,106429,0,135176
141930201600000,NW 308,Residential,27245,103801,0,131046
141930201700000,NW 308,Residential,27443,94501,0,121944
141930201800000,NW 308,Residential,27229,114725,0,141954
141930201900000,NW 308,Residential,26166,88896,0,115062
141930202000000,NW 308,Residential,27254,102920,0,130174
141930202100000,NW 308,Residential,30192,162015,0,192207
141930202200000,NW 308,Residential,61650,56069,0,117719
141930202300000,NW 308,Residential,58425,60250,0,118675
141930202400000,NW 308,Residential,27232,51815,0,79047
141930202500000,NW 308,Residential,25148,37118,0,62266
141930202600000,NW 308,Residential,27306,87683,0,114989
141930202700000,NW 308,Residential,37730,33955,0,71685
141930202800000,NW 308,Residential,24239,111847,0,136086
141930300100000,NW 308,Residential,24807,116256,0,141063
141930300200000,NW 308,Residential,24807,114835,0,139642
141930300300000,NW 308,Residential,24807,118002,0,142809
141930300400000,NW 308,Residential,24807,107434,0,132241
141930300500000,NW 308,Residential,24807,110346,0,135153
141930300600000,NW 308,Residential,25389,118361,0,143750
141930300700000,NW 323,Residential,23959,175074,0,199033
141930300800000,NW 323,Residential,24776,168766,0,193542
141930300900000,NW 323,Residential,21163,129284,0,150447
141930301000000,NW 323,Residential,21150,0,0,21150
141930301100000,NW 323,Residential,25836,144904,0,170740
141930301200000,NW 323,Residential,24756,144306,0,169062
141930301300000,NW 323,Residential,24849,140833,0,165682
141930301400000,NW 323,Residential,23934,159887,0,183821
141930301500000,NW 323,Residential,24598,160359,0,184957
141930400100000,NW 323,Residential,24747,131809,0,156556
141930400200000,NW 308,Residential,29400,64912,0,94312
141930400300000,NW 308,Residential,29048,59343,0,88391
141930400400000,NW 308,Residential,26013,73348,0,99361
141930400500000,NW 308,Residential,26000,97743,0,123743
141930400600000,NW 308,Residential,26000,83710,0,109710
141930400700000,NW 308,Residential,26000,98336,0,124336
141930400800000,NW 308,Residential,22572,101127,0,123699
141930400900000,NW 308,Residential,22572,92451,0,115023
141930401000000,NW 308,Residential,22572,95324,0,117896
141930401100000,NW 308,Residential,22572,99288,0,121860
141930401200000,NW 308,Residential,22536,97276,0,119812
141930401300000,NW 308,Residential,30366,0,0,30366
141930401400000,NW 308,Residential,31350,0,0,31350
141930401500000,NW 323,Residential,22307,134269,0,156576
141930401600000,NW 323,Residential,22320,133350,0,155670
141930500100000,NW 323,Residential,23119,199278,0,222397
141930500200000,NW 323,Residential,22841,123416,0,146257
141930500300000,NW 323,Residential,21792,137751,0,159543
141930500400000,NW 323,Residential,22800,152444,0,175244
141930500500000,NW 323,Residential,22800,159080,0,181880
141930500600000,NW 323,Residential,22800,147609,0,170409
141930500700000,NW 323,Residential,22800,127520,0,150320
141930500800000,NW 323,Residential,22786,140208,0,162994
141930500900000,NW 308,Residential,23554,90207,0,113761
141930501000000,NW 308,Residential,24172,89351,0,113523
141930600100000,NW 308,Residential,20888,94247,0,115135
141930600200000,NW 308,Residential,21560,106118,0,127678
141932600100000,NW 308,Residential,31002,97008,0,128010
141932700100000,NW 314,Residential,26565,69937,0,96502
141932700200000,NW 314,Residential,30030,124200,0,154230
141932800100000,NW 314,Residential,31131,91631,0,122762
141932800200000,NW 314,Residential,24003,89204,0,113207
141932800300000,NW 314,Residential,28813,137572,0,166385
141932800400000,NW 314,Residential,28105,37895,0,66000
141932900100000,NW 308,Residential,27767,129374,0,157141
141932900200000,NW 314,Residential,26347,190177,0,216524
141932900300000,NW 314,Residential,27972,138690,0,166662
141932900400000,NW 314,Residential,30323,95673,0,125996
141932900500000,NW 314,Residential,29307,163298,0,192605
141932900600000,NW 314,Residential,28783,142413,0,171196
141932900700000,NW 308,Residential,39619,88635,0,128254
141932900800000,NW 308,Residential,34934,19431,0,54365
141932900900000,NW 308,Residential,31080,42595,0,73675
141933000200000,NW 314,Residential,39060,81808,0,120868
141933000300000,NW 314,Residential,35000,116513,0,151513
141933000400000,NW 314,Residential,24620,32169,0,56789
141933000500000,NW 314,Residential,26478,88962,0,115440
141933000600000,NW 314,Residential,24513,108896,0,133409
141933000700000,NW 314,Residential,35131,115927,0,151058
141933000800000,NW 314,Residential,28238,113826,0,142064
141933000900000,NW 314,Residential,26701,114010,0,140711
141933001000000,NW 314,Residential,30398,176239,0,206637
141933001100000,NW 314,Residential,32875,76639,0,109514
141933001200000,NW 314,Residential,27844,221741,0,249585
141933001300000,NW 314,Residential,24000,99951,0,123951
141933001400000,NW 314,Residential,25334,90814,0,116148
141933001500000,NW 314,Residential,24563,108290,0,132853
141933001600000,NW 314,Residential,24067,88776,0,112843
141933001700000,NW 314,Residential,25536,100421,0,125957
141933001800000,NW 314,Residential,26330,90764,0,117094
141933001900000,NW 314,Residential,5242,0,0,5242
141933002000000,NW 314,Residential,5564,0,0,5564
141933002100000,NW 314,Residential,4440,0,0,4440
141933002200000,NW 314,Residential,25763,136571,0,162334
141933002300000,NW 314,Residential,30517,97533,0,128050
141933002400000,NW 314,Residential,26676,96386,0,123062
141933002500000,NW 314,Residential,24000,107648,0,131648
141933002600000,NW 314,Residential,24000,107068,0,131068
141933002700000,NW 314,Residential,24000,88494,0,112494
141933002800000,NW 314,Residential,31640,89383,0,121023
141933003000000,NW 314,Residential,62100,105278,0,167378
141933003100000,NW 314,Residential,31191,72765,0,103956
141933003200000,NW 314,Residential,26520,112446,0,138966
141933003300000,NW 314,Residential,31378,123053,0,154431
141933003400000,NW 314,Residential,28816,101775,0,130591
141933003500000,NW 314,Residential,36453,141711,0,178164
141933003600000,NW 314,Residential,42325,61652,0,103977
141933003700000,NW 314,Residential,36000,191620,0,227620
141933003800000,NW 314,Residential,34320,55223,0,89543
141933003900000,NW 314,Residential,29400,139600,0,169000
141933100100000,NW 314,Residential,26008,95953,0,121961
141933100200000,NW 314,Residential,27152,117793,0,144945
141933100300000,NW 314,Residential,26045,95605,0,121650
141933100400000,NW 314,Residential,27540,86030,0,113570
141933100500000,NW 314,Residential,43686,0,0,43686
141933100600000,NW 314,Residential,26000,81574,0,107574
141933100700000,NW 314,Residential,26000,85592,0,111592
141933100800000,NW 314,Residential,26000,84768,0,110768
141933100900000,NW 314,Residential,26000,95510,0,121510
141933101000000,NW 314,Residential,24000,76282,0,100282
141933200100000,NW 308,Residential,26600,92581,0,119181
141933200200000,NW 308,Residential,26588,94230,0,120818
141933200300000,NW 314,Residential,29400,84822,0,114222
141933200400000,NW 314,Residential,30000,82000,0,112000
141933200500000,NW 314,Residential,42595,118262,0,160857
141933200600000,NW 314,Residential,28890,130270,0,159160
141933200700000,NW 314,Residential,26000,64344,0,90344
141933200800000,NW 314,Residential,39000,93593,0,132593
141933200900000,NW 314,Residential,42490,115313,0,157803
141933201000000,NW 314,Residential,33280,96410,0,129690
141933201100000,NW 314,Residential,39000,91357,0,130357
141933201200000,NW 314,Residential,34149,80276,0,114425
141933201300000,NW 314,Residential,24507,110272,0,134779
141933201400000,NW 314,Residential,24400,94603,0,119003
141933201500000,NW 314,Residential,24400,86235,0,110635
141933201600000,NW 314,Residential,26370,97059,0,123429
141933201700000,NW 314,Residential,25116,109019,0,134135
141933201800000,NW 314,Residential,24156,102686,0,126842
141933201900000,NW 314,Residential,24156,86589,0,110745
141933202000000,NW 314,Residential,24156,87492,0,111648
141933202100000,NW 314,Residential,24156,89672,0,113828
141933202200000,NW 314,Residential,26205,83405,0,109610
141933202300000,NW 314,Residential,28000,149160,0,177160
141933202400000,NW 314,Residential,26320,138973,0,165293
141933202500000,NW 308,Residential,22996,93771,0,116767
141933202600000,NW 308,Residential,22572,92385,0,114957
141933300100000,NW 308,Residential,21560,86278,0,107838
141933300200000,NW 308,Residential,22004,87212,0,109216
141933300300000,NW 314,Residential,27720,109303,0,137023
141933300400000,NW 314,Residential,27720,115883,0,143603
141933300500000,NW 314,Residential,25895,107429,0,133324
141933300600000,NW 314,Residential,24156,76898,0,101054
141933300700000,NW 314,Residential,24156,89216,0,113372
141933300800000,NW 314,Residential,24156,95937,0,120093
141933300900000,NW 314,Residential,24156,87525,0,111681
141933301000000,NW 314,Residential,24973,93500,0,118473
141935100300000,NW 322,Exempt,1525,0,0,1525
141935100400000,NW 322,Residential,1525,0,0,1525
141935101000000,E-40 CHURCHES,Exempt,525377,0,690808,1216185
141935101100000,COMM NW,Commercial,335340,0,369254,704594
141935101200000,NW 324,Residential,2530,0,0,2530
141935101300000,NW 324,Residential,26795,103353,0,130148
141935101400000,NW 324,Residential,25200,87777,0,112977
141935101500000,NW 324,Residential,25200,100316,0,125516
141935101600000,NW 324,Residential,25200,116092,0,141292
141935101700000,NW 324,Residential,24727,95107,0,119834
141935101800000,APTS NW,Commercial,30978,0,141173,172151
141935101900000,NW 324,Residential,24913,84938,0,109851
141935102000000,NW 324,Residential,23280,91894,0,115174
141935102100000,NW 324,Residential,23280,106569,0,129849
141935102200000,NW 324,Residential,23040,78835,0,101875
141935102300000,NW 324,Residential,24960,81431,0,106391
141935102400000,NW 324,Residential,24363,87560,0,111923
141935102500000,NW 324,Residential,23040,81565,0,104605
141935102600000,NW 324,Residential,23280,70629,0,93909
141935102700000,NW 324,Residential,23280,70833,0,94113
141935102800000,NW 324,Residential,24337,68658,0,92995
141935102900000,APTS NW,Commercial,20139,0,113552,133691
141935103000000,APTS NW,Commercial,17524,0,110782,128306
141935103100000,COMM NW,Commercial,51877,0,206178,258055
141935103200000,NW 324,Residential,23994,88057,0,112051
141935103300000,NW 324,Residential,23280,77751,0,101031
141935103400000,NW 324,Residential,23280,87451,0,110731
141935103500000,NW 324,Residential,23280,84705,0,107985
141935103600000,NW 324,Residential,24050,92591,0,116641
141935200100000,COMM NW,Commercial,307949,0,3053134,3361083
141935200200000,COMM NW,Commercial,336960,0,3243338,3580298
141935200300000,NW 324,Residential,56737,110040,0,166777
141935200400000,COMM NW,Commercial,355104,0,2316731,2671835
141935200500000,NW 324,Residential,31351,62259,0,93610
141935200600000,COMM NW,Commercial,160186,0,344746,504932
141935200700000,COMM NW,Commercial,256284,0,579909,836193
141935200800000,E-40 CHURCHES,Exempt,806760,0,397713,1204473
141935200900000,NW 324,Residential,29441,110224,0,139665
141935201000000,COMM NW,Commercial,160186,0,750430,910616
141935201100000,COMM NW,Commercial,171245,0,768755,940000
141935201200000,COMM NW,Commercial,80196,0,12331,92527
141937600100000,NW 322,Residential,25753,98237,0,123990
141937600200000,NW 323,Residential,23059,177072,0,200131
141937600300000,NW 323,Residential,23808,163063,0,186871
141937600400000,NW 323,Residential,23958,156102,0,180060
141937600500000,NW 323,Residential,24648,149598,0,174246
141937600600000,NW 323,Residential,24717,170460,0,195177
141937600700000,NW 323,Residential,28248,166834,0,195082
141937600800000,NW 323,Residential,23744,171136,0,194880
141937600900000,NW 323,Residential,26386,216093,0,242479
141937601000000,NW 323,Residential,27790,215223,0,243013
141937601100000,NW 323,Residential,22994,188222,0,211216
141937601200000,NW 323,Residential,21168,179560,0,200728
141937601300000,NW 323,Residential,25726,153210,0,178936
141937601400000,NW 323,Residential,94650,231825,0,326475
141937601500000,NW 323,Residential,25694,202829,0,228523
141937601600000,NW 323,Residential,25786,172274,0,198060
141937601700000,NW 323,Residential,25472,159005,0,184477
141937601800000,NW 323,Residential,25230,153883,0,179113
141937601900000,NW 323,Residential,24510,181230,0,205740
141937602000000,NW 323,Residential,21022,195018,0,216040
141937602100000,NW 323,Residential,22534,158075,0,180609
141937602200000,NW 323,Residential,24017,155964,0,179981
141937602300000,NW 323,Residential,21211,197450,0,218661
141937602400000,NW 322,Residential,25287,92201,0,117488
141937602500000,NW 322,Residential,25371,96819,0,122190
141937602600000,NW 323,Residential,21401,140899,0,162300
141937602700000,NW 323,Residential,24746,147438,0,172184
141937602800000,NW 323,Residential,24152,161967,0,186119
141937602900000,NW 323,Residential,24219,146854,0,171073
141937603000000,NW 323,Residential,23315,141036,0,164351
141937603100000,NW 323,Residential,23153,155116,0,178269
141937603200000,NW 323,Residential,22869,137941,0,160810
141937603300000,NW 323,Residential,23280,141144,0,164424
141937603400000,NW 323,Residential,23520,148279,0,171799
141937603500000,NW 323,Residential,23760,155322,0,179082
141937603600000,NW 323,Residential,23280,122331,0,145611
141937603700000,NW 323,Residential,23280,142801,0,166081
141937603800000,NW 323,Residential,23280,143034,0,166314
141937700100000,NW 322,Residential,23921,103897,0,127818
141937700200000,NW 322,Residential,23668,100094,0,123762
141937700300000,NW 322,Residential,25303,102765,0,128068
141937700400000,NW 322,Residential,23668,85927,0,109595
141937700500000,NW 322,Residential,25303,113423,0,138726
141937700600000,NW 322,Residential,23668,100232,0,123900
141937700700000,NW 322,Residential,23668,92472,0,116140
141937700800000,NW 322,Residential,23668,93130,0,116798
141937700900000,NW 322,Residential,26791,94153,0,120944
141937701000000,NW 322,Residential,23668,104252,0,127920
141937701100000,NW 322,Residential,24092,97104,0,121196
141937800100000,NW 323,Residential,22560,158073,0,180633
141937800200000,NW 323,Residential,21996,130272,0,152268
141937800300000,NW 323,Residential,21996,137637,0,159633
141937800400000,NW 323,Residential,22230,163309,0,185539
141937800500000,NW 323,Residential,22464,166868,0,189332
141937800600000,NW 323,Residential,22698,177291,0,199989
141937800700000,NW 323,Residential,23450,157203,0,180653
141937800800000,NW 323,Residential,23226,164296,0,187522
141937800900000,NW 323,Residential,23800,173384,0,197184
141937801000000,NW 323,Residential,24960,196223,0,221183
141937801100000,NW 323,Residential,24727,146562,0,171289
141937801200000,NW 323,Residential,25200,149515,0,174715
141937801300000,NW 323,Exempt,24205,0,164433,188638
141937801400000,NW 322,Residential,25446,94754,0,120200
141937801500000,NW 322,Residential,26673,86829,0,113502
141937900100000,NW 322,Residential,22295,74651,0,96946
141937900200000,NW 322,Residential,22295,70237,0,92532
141937900300000,NW 322,Residential,23436,84682,0,108118
141937900400000,NW 322,Residential,23436,70867,0,94303
141937900500000,NW 322,Residential,24039,85640,0,109679
141937900600000,NW 322,Residential,25443,89233,0,114676
141937900700000,NW 322,Residential,25695,119433,0,145128
141937900800000,NW 322,Residential,26460,101328,0,127788
141937900900000,NW 322,Residential,26816,117946,0,144762
141937901000000,NW 322,Residential,24710,91422,0,116132
141937901100000,NW 322,Residential,24816,101779,0,126595
141937901200000,NW 322,Residential,25128,84270,0,109398
141937901300000,NW 322,Residential,24502,91240,0,115742
141937901400000,NW 322,Residential,25792,79369,0,105161
141937901500000,NW 322,Residential,24010,80432,0,104442
141937901600000,NW 322,Residential,22295,97165,0,119460
141937901700000,NW 322,Residential,24010,89924,0,113934
141937901800000,NW 322,Residential,25725,84558,0,110283
141937901900000,NW 322,Residential,25200,87063,0,112263
141937902000000,NW 322,Residential,24570,71160,0,95730
141937902100000,NW 322,Residential,24336,73953,0,98289
141937902200000,NW 322,Residential,25143,104459,0,129602
141937902300000,NW 322,Residential,25200,123363,0,148563
141937902400000,NW 322,Residential,25365,85476,0,110841
141938000100000,NW 322,Residential,26229,107642,0,133871
141938000200000,NW 322,Residential,24570,76222,0,100792
141938000300000,NW 322,Residential,24852,77361,0,102213
141938000400000,NW 322,Residential,23206,91195,0,114401
141938000500000,NW 322,Residential,22848,110753,0,133601
141938000600000,NW 322,Residential,22901,82403,0,105304
141938000700000,NW 322,Residential,27300,89560,0,116860
141938000800000,NW 322,Residential,25944,96267,0,122211
141938000900000,NW 322,Residential,42206,116546,0,158752
141938001000000,NW 322,Residential,25920,93330,0,119250
141938001100000,NW 322,Residential,27305,98404,0,125709
141938001200000,NW 322,Residential,27359,90145,0,117504
141938001300000,NW 322,Residential,24478,97471,0,121949
141938001400000,NW 322,Residential,22560,88062,0,110622
141938001500000,NW 322,Residential,22800,81783,0,104583
141938001600000,NW 322,Residential,23520,83389,0,106909
141938001700000,NW 322,Residential,24618,87124,0,111742
141938001800000,NW 322,Residential,22295,87643,0,109938
141938001900000,NW 322,Residential,22295,60646,0,82941
141938002000000,NW 322,Residential,22295,85789,0,108084
141938002100000,NW 322,Residential,22295,69983,0,92278
141938002200000,NW 322,Residential,22295,95256,0,117551
141938002300000,NW 322,Residential,22295,79690,0,101985
141938002400000,NW 322,Residential,23330,73652,0,96982
141938002500000,NW 322,Residential,35666,70892,0,106558
141938002600000,NW 322,Residential,22862,81414,0,104276
141938002700000,NW 322,Residential,40653,109767,0,150420
141938003000000,COMM NW,Commercial,297562,0,5204801,5502363
141940100100000,E-15 CITY,Exempt,0,0,0,0
141940100200000,NW 313,Residential,38400,200530,0,238930
141940100300000,NW 313,Residential,32195,196715,0,228910
141940100400000,NW 313,Residential,31973,224790,0,256763
141940100500000,NW 313,Residential,36593,202180,0,238773
141940100600000,NW 313,Residential,40949,282096,0,323045
141940100700000,NW 313,Residential,40639,307381,0,348020
141940100800000,NW 313,Residential,41960,238906,0,280866
141940100900000,NW 313,Residential,40054,265578,0,305632
141940101000000,NW 313,Residential,39924,210845,0,250769
141940101100000,NW 313,Residential,46122,223006,0,269128
141940101200000,NW 313,Residential,45562,221509,0,267071
141940101300000,NW 313,Residential,45787,217110,0,262897
141940101400000,NW 313,Residential,47512,285205,0,332717
141940101500000,NW 313,Residential,41168,188208,0,229376
141940101600000,NW 313,Residential,35700,215957,0,251657
141940101700000,NW 313,Residential,34320,93231,0,127551
141940101800000,NW 313,Residential,45696,135740,0,181436
141940101900000,NW 313,Residential,38760,109470,0,148230
141940102000000,NW 313,Residential,67040,137811,0,204851
141940102100000,NW 313,Residential,40698,99080,0,139778
141940102200000,NW 313,Residential,29640,120662,0,150302
141940102300000,NW 313,Residential,30152,111404,0,141556
141942600100000,NW 313,Residential,38206,77984,0,116190
141942600200000,NW 313,Residential,27706,113011,0,140717
141942600300000,NW 313,Residential,23205,87139,0,110344
141942600400000,NW 313,Residential,24798,106662,0,131460
141942600500000,NW 313,Residential,25253,95797,0,121050
141942600600000,NW 313,Residential,43819,32685,0,76504
141942600700000,NW 313,Residential,24379,0,0,24379
141942600800000,NW 313,Residential,27527,127045,0,154572
141942600900000,NW 313,Residential,33385,53332,0,86717
141942601000000,NW 313,Residential,29400,110893,0,140293
141942601100000,NW 313,Residential,30975,120142,0,151117
141942601200000,NW 313,Residential,50710,79268,0,129978
141942601300000,NW 313,Residential,30085,76626,0,106711
141942601400000,NW 313,Residential,31518,98386,0,129904
141942601500000,NW 313,Residential,39039,94444,0,133483
141942700100000,NW 313,Residential,35640,44034,0,79674
141942700200000,NW 313,Residential,48200,46272,0,94472
141942700300000,NW 313,Residential,34116,66480,0,100596
141942700400000,NW 313,Residential,51600,127041,0,178641
141942700500000,NW 313,Residential,39060,550,0,39610
141942700600000,NW 313,Residential,60550,113858,0,174408
141942700700000,NW 313,Residential,60300,85343,0,145643
141942700800000,NW 313,Residential,37217,116645,0,153862
141942700900000,NW 313,Residential,34336,92302,0,126638
141942701000000,NW 313,Residential,32760,50603,0,83363
141942701100000,NW 313,Residential,31024,188724,0,219748
141942701200000,NW 313,Residential,28420,137580,0,166000
141942701300000,NW 313,Residential,28420,119673,0,148093
141942701400000,NW 308,Residential,30166,0,0,30166
141942701500000,NW 308,Residential,15162,0,0,15162
141942701600000,NW 308,Residential,33755,125211,0,158966
141942701700000,NW 313,Residential,33271,140367,0,173638
141942701800000,NW 313,Residential,25438,156784,0,182222
141942701900000,NW 313,Residential,24330,98480,0,122810
141942702000000,NW 313,Residential,20518,0,0,20518
141942702100000,NW 313,Residential,20160,0,0,20160
141942702200000,NW 308,Residential,20790,104704,0,125494
141942800100000,NW 313,Residential,41623,128264,0,169887
141942800200000,NW 313,Residential,25956,104612,0,130568
141942800300000,NW 313,Residential,45433,97361,0,142794
141942800400000,NW 313,Residential,42546,98077,0,140623
141942800500000,NW 313,Residential,31083,70711,0,101794
141942800600000,NW 313,Residential,29686,81981,0,111667
141942800700000,NW 313,Residential,30492,80615,0,111107
141942800800000,NW 313,Residential,46150,90030,0,136180
141942800900000,NW 313,Residential,43286,35691,0,78977
141942801000000,NW 313,Residential,32602,100304,0,132906
141942801100000,NW 313,Residential,30479,122070,0,152549
141942801200000,NW 313,Residential,39263,100324,0,139587
141942801300000,NW 313,Residential,31914,120054,0,151968
141942801400000,NW 313,Residential,28413,105704,0,134117
141942801500000,NW 313,Residential,29307,58780,0,88087
141942801600000,NW 313,Residential,31480,210029,0,241509
141942801700000,NW 313,Residential,27440,89505,0,116945
141942900100000,NW 313,Residential,22068,116312,0,138380
141942900200000,NW 308,Residential,20136,123242,0,143378
141942900300000,NW 308,Residential,22973,72636,0,95609
141942900400000,NW 308,Residential,25749,61399,0,87148
141942900500000,NW 313,Residential,25222,92877,0,118099
141942900600000,NW 313,Residential,21056,92288,0,113344
141942900700000,NW 313,Residential,22176,86716,0,108892
141943000100000,NW 308,Residential,26418,129774,0,156192
141943000200000,NW 308,Residential,24807,119716,0,144523
141943000300000,NW 308,Residential,24807,112564,0,137371
141943000400000,NW 323,Residential,24560,163889,0,188449
141943000500000,NW 323,Residential,24873,196400,0,221273
141943000600000,NW 323,Residential,25194,0,0,25194
141943000700000,NW 313,Residential,27506,109442,0,136948
141943000800000,NW 313,Residential,28495,96505,0,125000
141943000900000,NW 313,Residential,28994,118830,0,147824
141945100100000,NW 313,Residential,32278,98509,0,130787
141945100200000,NW 313,Residential,30361,91931,0,122292
141945100300000,NW 313,Residential,31122,89397,0,120519
141945100400000,NW 322,Residential,32257,91490,0,123747
141945100500000,NW 322,Residential,30141,113234,0,143375
141945100600000,NW 322,Residential,22400,95762,0,118162
141945100700000,NW 322,Residential,21933,110929,0,132862
141945100800000,NW 322,Residential,24811,84875,0,109686
141945100900000,NW 322,Residential,25312,77139,0,102451
141945101000000,NW 322,Residential,24663,114613,0,139276
141945101100000,NW 322,Residential,50000,185459,0,235459
141945200100000,NW 313,Residential,33784,81588,0,115372
141945200200000,NW 313,Residential,31500,88972,0,120472
141945200300000,NW 313,Residential,28093,107484,0,135577
141945200400000,NW 313,Residential,28912,147033,0,175945
141945200500000,NW 313,Residential,26849,70173,0,97022
141945200600000,NW 322,Residential,28613,151274,0,179887
141945200700000,NW 322,Residential,26215,0,0,26215
141945200800000,NW 322,Residential,41639,52907,0,94546
141945200900000,NW 322,Residential,28552,106258,0,134810
141945201000000,NW 322,Residential,29180,99883,0,129063
141945201100000,NW 313,Residential,41920,68941,0,110861
141945300100000,NW 322,Residential,30510,79879,0,110389
141945300200000,NW 322,Residential,27930,76687,0,104617
141945300300000,NW 322,Residential,28938,79417,0,108355
141945300400000,NW 322,Residential,27685,104758,0,132443
141945300500000,NW 322,Residential,27440,77588,0,105028
141945300600000,NW 322,Residential,27504,138192,0,165696
141945300700000,NW 322,Residential,31298,135498,0,166796
141945300800000,NW 322,Residential,29568,114143,0,143711
141945300900000,NW 322,Residential,26880,122392,0,149272
141945301000000,NW 322,Residential,26880,96910,0,123790
141945301100000,NW 322,Residential,28575,110148,0,138723
141945301200000,NW 323,Residential,24659,161611,0,186270
141945301300000,NW 323,Residential,23715,156637,0,180352
141945301400000,NW 323,Residential,23715,155005,0,178720
141945301500000,NW 323,Residential,23715,155397,0,179112
141945301600000,NW 323,Residential,24056,154713,0,178769
141945301700000,NW 323,Residential,27253,164174,0,191427
141945301800000,NW 323,Residential,27562,169876,0,197438
141945301900000,NW 323,Residential,29040,167626,0,196666
141945302000000,NW 323,Residential,25663,173862,0,199525
141945302100000,NW 323,Residential,25220,167788,0,193008
141945302200000,NW 323,Residential,21582,147560,0,169142
141945302300000,NW 323,Residential,21996,147642,0,169638
141945302400000,NW 323,Residential,22560,148326,0,170886
141945400100000,NW 323,Residential,23280,163624,0,186904
141945400200000,NW 323,Residential,23280,158616,0,181896
141945400300000,NW 323,Residential,23280,167282,0,190562
141945400400000,NW 323,Residential,22800,142301,0,165101
141945400500000,NW 323,Residential,22800,129153,0,151953
141945400600000,NW 323,Residential,24711,135281,0,159992
141945400700000,NW 323,Residential,25242,173779,0,199021
141945400800000,NW 323,Residential,23281,0,0,23281
141945400900000,NW 323,Residential,23280,147553,0,170833
141945401000000,NW 323,Residential,23280,128649,0,151929
141945500100000,NW 322,Residential,49240,75471,0,124711
141945500200000,NW 322,Residential,48360,0,0,48360
141945500300000,E-15 CITY,Exempt,0,0,0,0
141945500400000,NW 322,Residential,42706,112088,0,154794
141945600100000,NW 322,Residential,29978,118148,0,148126
141945600200000,NW 322,Residential,22560,117535,0,140095
141945600300000,NW 322,Residential,25004,106701,0,131705
141945600400000,NW 322,Residential,24705,87174,0,111879
141945600500000,NW 322,Residential,24864,108488,0,133352
141945600600000,NW 322,Residential,24651,100250,0,124901
141945600700000,NW 322,Residential,25133,134829,0,159962
141945600800000,NW 322,Residential,24598,130754,0,155352
141945600900000,NW 322,Residential,25088,114859,0,139947
141945601000000,NW 322,Residential,24354,110902,0,135256
141945601100000,NW 322,Residential,23558,104210,0,127768
141945601200000,NW 322,Residential,23882,112594,0,136476
141945601300000,NW 322,Residential,24624,91881,0,116505
141945601400000,NW 322,Residential,25142,84035,0,109177
141945601500000,NW 322,Residential,25142,90252,0,115394
141945601600000,NW 322,Residential,24541,93252,0,117793
141945601700000,E-15 CITY,Exempt,0,0,0,0
141945601800000,NW 322,Residential,29680,75462,0,105142
141945601900000,NW 322,Residential,22750,102240,0,124990
141945602000000,NW 322,Residential,26775,86812,0,113587
141945602100000,NW 322,Residential,38274,103945,0,142219
141945602200000,NW 322,Residential,39019,100146,0,139165
141945602300000,NW 322,Residential,28560,97206,0,125766
141945700100000,NW 322,Residential,25659,86825,0,112484
141945700200000,NW 322,Residential,24909,63431,0,88340
141945700300000,NW 322,Residential,24909,101825,0,126734
141945700400000,NW 322,Residential,34138,107302,0,141440
141945700500000,NW 322,Residential,24909,85053,0,109962
141945700600000,NW 322,Residential,22295,65381,0,87676
141945700700000,NW 322,Residential,21609,61161,0,82770
141947600100000,NW 312,Residential,26192,98629,0,124821
141947600200000,NW 312,Residential,25650,100907,0,126557
141947600300000,NW 312,Residential,26836,126828,0,153664
141947600400000,NW 312,Residential,29120,120854,0,149974
141947600500000,NW 312,Residential,26316,124945,0,151261
141947600600000,NW 312,Residential,26316,141275,0,167591
141947600700000,NW 312,Residential,29296,137576,0,166872
141947600800000,NW 312,Residential,30603,149704,0,180307
141947600900000,NW 312,Residential,28744,113181,0,141925
141947601000000,NW 312,Residential,29030,121613,0,150643
141947601100000,NW 312,Residential,29006,126345,0,155351
141947601200000,NW 312,Residential,27090,139351,0,166441
141947601300000,NW 312,Residential,27090,103950,0,131040
141947601400000,NW 312,Residential,27090,114875,0,141965
141947601500000,NW 312,Residential,27090,122036,0,149126
141947601600000,NW 312,Residential,25908,58181,0,84089
141947601700000,NW 312,Residential,26561,87334,0,113895
141947601800000,NW 322,Residential,28560,81334,0,109894
141947601900000,NW 322,Residential,28672,78895,0,107567
141947602000000,NW 322,Residential,41720,59074,0,100794
141947602100000,E-40 CHURCHES,Exempt,229500,0,203393,432893
141947700100000,NW 322,Residential,50400,119918,0,170318
141947700200000,NW 322,Residential,50400,114715,0,165115
141947700300000,E-40 CHURCHES,Exempt,416286,0,395066,811352
141947800100000,NW 322,Residential,42315,151435,0,193750
141947800200000,NW 322,Residential,35781,52553,0,88334
141947800300000,NW 322,Residential,49200,67737,0,116937
141947800400000,NW 322,Residential,28140,82838,0,110978
141947800500000,NW 322,Residential,32830,83499,0,116329
141947800600000,NW 322,Residential,26282,89067,0,115349
141947800700000,NW 322,Residential,24476,99782,0,124258
141947800800000,NW 322,Residential,25253,88768,0,114021
141947800900000,NW 322,Residential,29672,105068,0,134740
141947801000000,NW 322,Residential,26224,99540,0,125764
141947801100000,NW 322,Residential,33939,55866,0,89805
141947900100000,E-15 CITY,Exempt,0,0,0,0
141947900200000,NW 322,Residential,65250,137667,0,202917
141947900300000,NW 322,Residential,46425,144321,0,190746
141947900400000,NW 322,Residential,43750,72752,0,116502
141947900500000,NW 322,Residential,28498,107546,0,136044
141947900600000,NW 322,Residential,30412,59198,0,89610
141947900700000,NW 322,Residential,26211,143276,0,169487
141947900800000,NW 322,Residential,26211,93254,0,119465
141947900900000,NW 322,Residential,27563,145228,0,172791
141947901000000,NW 322,Residential,31237,56477,0,87714
141947901100000,NW 322,Residential,41326,90976,0,132302
142010100100000,NW 310,Residential,20950,0,0,20950
142010100200000,NW 310,Residential,12000,0,0,12000
142010100300000,NW 310,Residential,38800,0,0,38800
142010100400000,NW 310,Residential,33940,0,0,33940
142010100500000,NW 310,Residential,43470,0,0,43470
142010100600000,NW 310,Residential,24800,0,0,24800
142010100700000,NW 310,Residential,32093,0,0,32093
142010100800000,NW 310,Residential,15600,30452,0,46052
142010100900000,NW 310,Residential,11375,21076,0,32451
142010101000000,NW 310,Residential,10617,12091,0,22708
142010101100000,NW 310,Residential,13856,0,0,13856
142010101200000,NW 310,Residential,32972,42281,0,75253
142010200100000,E-15 CITY,Exempt,0,0,0,0
142010200200000,NW 310,Residential,5000,0,0,5000
142010300100000,NW 310,Residential,5000,0,0,5000
142010300200000,NW 310,Residential,7810,0,0,7810
142010300300000,NW 310,Residential,5000,0,0,5000
142010300400000,NW 310,Residential,5000,0,0,5000
142010300500000,NW 310,Residential,5000,0,0,5000
142010300600000,NW 310,Residential,9800,0,0,9800
142010300700000,NW 310,Residential,5000,0,0,5000
142010300800000,NW 310,Residential,5000,0,0,5000
142010300900000,NW 310,Residential,5000,0,0,5000
142010301000000,NW 310,Residential,5593,0,0,5593
142010301100000,NW 310,Residential,5000,0,0,5000
142010301200000,NW 310,Residential,6632,0,0,6632
142010301300000,NW 310,Residential,5000,0,0,5000
142010301400000,NW 310,Residential,7325,0,0,7325
142010301500000,NW 310,Residential,6435,0,0,6435
142010400100000,NW 310,Residential,5000,0,0,5000
142010400200000,NW 310,Residential,9900,36725,0,46625
142010400300000,NW 310,Residential,5000,0,0,5000
142010400400000,NW 310,Residential,10740,0,0,10740
142010400500000,NW 310,Residential,5000,0,0,5000
142010400600000,NW 310,Residential,5000,0,0,5000
142010400700000,NW 310,Residential,5000,0,0,5000
142010400800000,NW 310,Residential,5000,0,0,5000
142010400900000,NW 310,Residential,9800,0,0,9800
142010401000000,NW 310,Residential,10740,0,0,10740
142010401100000,NW 310,Residential,5000,0,0,5000
142010401200000,NW 310,Residential,9800,0,0,9800
142010401300000,NW 310,Residential,7820,0,0,7820
142010401400000,NW 310,Residential,7820,0,0,7820
142010401500000,NW 310,Residential,9900,0,0,9900
142010401600000,NW 310,Residential,5000,0,0,5000
142010401700000,NW 310,Residential,5000,0,0,5000
142010401800000,NW 310,Residential,9800,0,0,9800
142010401900000,NW 310,Residential,5000,0,0,5000
142010402000000,NW 310,Residential,5000,0,0,5000
142010402100000,NW 310,Residential,5000,0,0,5000
142010402200000,NW 310,Residential,13760,0,0,13760
142010402300000,NW 310,Residential,5000,0,0,5000
142010402400000,NW 310,Residential,5000,0,0,5000
142010500100000,NW 310,Residential,5000,0,0,5000
142010500200000,NW 310,Residential,9750,0,0,9750
142010500300000,NW 310,Residential,9750,0,0,9750
142010500400000,NW 310,Residential,9750,0,0,9750
142010500500000,NW 310,Residential,22125,0,0,22125
142010500600000,NW 310,Residential,14700,0,0,14700
142010500700000,NW 310,Residential,9750,0,0,9750
142010500800000,NW 310,Residential,9750,0,0,9750
142010500900000,NW 310,Residential,9750,0,0,9750
142010501000000,NW 310,Residential,9750,0,0,9750
142010501100000,NW 310,Residential,9750,0,0,9750
142010501200000,NW 310,Residential,14750,0,0,14750
142010501300000,NW 310,Residential,14750,0,0,14750
142010501400000,COMM NW,Commercial,5832,0,20410,26242
142010501500000,NW 310,Residential,5000,0,0,5000
142010501600000,NW 310,Residential,7820,0,0,7820
142010501700000,NW 310,Residential,9800,0,0,9800
142010501800000,NW 310,Residential,5000,0,0,5000
142010501900000,NW 310,Residential,5000,0,0,5000
142010502000000,NW 310,Residential,9800,0,0,9800
142010502100000,NW 310,Residential,5000,0,0,5000
142010502200000,NW 310,Residential,9800,0,0,9800
142010502300000,NW 310,Residential,5000,0,0,5000
142010502400000,NW 310,Residential,9800,0,0,9800
142010502500000,NW 310,Residential,8760,0,0,8760
142010502600000,NW 310,Residential,8760,0,0,8760
142010502700000,NW 310,Residential,5000,0,0,5000
142010502800000,NW 310,Residential,9800,0,0,9800
142012600100000,NW 310,Residential,13402,23561,0,36963
142012600200000,NW 310,Residential,10800,0,0,10800
142012600300000,NW 310,Residential,10800,0,0,10800
142012600400000,NW 310,Residential,12275,0,0,12275
142012600500000,NW 310,Residential,12275,0,0,12275
142012600600000,NW 310,Residential,12275,0,0,12275
142012600700000,NW 310,Residential,14750,0,0,14750
142012600800000,NW 310,Residential,14750,0,0,14750
142012600900000,NW 310,Residential,15800,42212,0,58012
142012601000000,NW 310,Residential,11612,0,0,11612
142012601100000,NW 310,Residential,13365,25300,0,38665
142012601200000,NW 310,Residential,9900,0,0,9900
142012601300000,NW 310,Residential,9750,0,0,9750
142012601400000,NW 310,Residential,14750,0,0,14750
142012601500000,NW 310,Residential,12375,27654,0,40029
142012601600000,NW 310,Residential,12375,35793,0,48168
142012601700000,NW 310,Residential,12375,31710,0,44085
142012700100000,NW 310,Residential,21243,52580,0,73823
142012700200000,NW 310,Residential,26762,45553,0,72315
142012700300000,NW 310,Residential,27844,42428,0,70272
142012700400000,NW 310,Residential,26135,0,0,26135
142012700500000,NW 310,Residential,27861,57964,0,85825
142012700600000,NW 310,Residential,20816,0,0,20816
142012700700000,NW 310,Residential,20720,0,0,20720
142012700800000,NW 310,Residential,14806,0,0,14806
142012700900000,NW 310,Residential,9806,0,0,9806
142012701000000,NW 310,Residential,18604,22036,0,40640
142012701100000,NW 310,Residential,14806,0,0,14806
142012701200000,NW 310,Residential,14806,0,0,14806
142012701300000,NW 310,Residential,14806,0,0,14806
142012701400000,NW 310,Residential,18604,26791,0,45395
142012800100000,NW 310,Residential,21850,0,0,21850
142012800200000,NW 310,Residential,25823,69903,0,95726
142012800300000,NW 310,Residential,33320,67284,0,100604
142012800400000,NW 310,Residential,28857,60735,0,89592
142012800500000,NW 310,Residential,26796,61297,0,88093
142012800600000,NW 310,Residential,28033,66167,0,94200
142012800700000,NW 310,Residential,28234,64538,0,92772
142012800800000,NW 310,Residential,21843,0,0,21843
142012800900000,NW 310,Residential,21375,0,0,21375
142012801000000,NW 310,Residential,21525,0,0,21525
142012801100000,NW 310,Residential,28857,62361,0,91218
142012801200000,NW 310,Residential,29155,64869,0,94024
142012900100000,NW 310,Residential,33957,101284,0,135241
142012900200000,COMM NW,Commercial,130747,0,119076,249823
142012900300000,NW 304,Residential,26400,109341,0,135741
142012900400000,NW 304,Residential,24750,84996,0,109746
142012900500000,NW 304,Residential,24750,89268,0,114018
142012900600000,NW 304,Residential,24750,99656,0,124406
142012900700000,NW 304,Residential,24750,112070,0,136820
142012900800000,NW 304,Residential,24525,106481,0,131006
142012900900000,NW 304,Residential,24300,77245,0,101545
142012901000000,NW 304,Residential,19260,75224,0,94484
142012901100000,NW 304,Residential,18762,82824,0,101586
142012901200000,NW 304,Residential,20160,103554,0,123714
142012901300000,NW 304,Residential,17784,73044,0,90828
142012901400000,NW 304,Residential,15600,50764,0,66364
142012901500000,NW 310,Residential,27525,81702,0,109227
142012901600000,NW 310,Residential,25200,77259,0,102459
142012901700000,NW 310,Residential,25200,81516,0,106716
142012901800000,NW 310,Residential,25200,78185,0,103385
142012901900000,NW 310,Residential,25200,85189,0,110389
142012902000000,NW 310,Residential,31810,67285,0,99095
142012902100000,NW 310,Residential,32742,83124,0,115866
142012902200000,NW 310,Residential,32742,71165,0,103907
142012902300000,NW 310,Residential,34448,69973,0,104421
142012902400000,NW 310,Residential,36743,70916,0,107659
142012902500000,NW 310,Residential,36743,73968,0,110711
142012902600000,NW 310,Residential,36743,73892,0,110635
142012902700000,NW 310,Residential,38870,78114,0,116984
142012902800000,NW 304,Residential,34425,98534,0,132959
142012902900000,NW 304,Residential,34762,74893,0,109655
142012903000000,NW 310,Residential,39630,92671,0,132301
142012903100000,NW 310,Residential,30000,81400,0,111400
142012903200000,NW 310,Residential,32175,77239,0,109414
142012903300000,NW 304,Residential,6760,0,0,6760
142013000100000,NW 310,Residential,16730,0,0,16730
142013000200000,NW 310,Residential,6730,0,0,6730
142013000300000,NW 310,Residential,16087,25375,0,41462
142013000400000,NW 310,Residential,14750,0,0,14750
142013000500000,NW 310,Residential,14750,0,0,14750
142013000600000,NW 310,Residential,14750,0,0,14750
142013000700000,NW 310,Residential,12375,20621,0,32996
142013000800000,NW 310,Residential,14750,0,0,14750
142013000900000,NW 310,Residential,14750,0,0,14750
142013001000000,NW 310,Residential,12375,36297,0,48672
142013001100000,NW 310,Residential,5000,0,0,5000
142013001200000,NW 310,Residential,14750,0,0,14750
142013001300000,NW 310,Residential,14750,0,0,14750
142013001400000,NW 310,Residential,16208,0,0,16208
142013001500000,NW 310,Residential,11208,0,0,11208
142013001600000,NW 310,Residential,5000,0,0,5000
142013001700000,NW 310,Residential,14750,0,0,14750
142013001800000,NW 310,Residential,9750,0,0,9750
142013001900000,NW 310,Residential,14750,0,0,14750
142013002000000,NW 310,Residential,14850,0,0,14850
142013002100000,NW 310,Residential,5000,0,0,5000
142013002200000,NW 310,Residential,5000,0,0,5000
142013002300000,NW 310,Residential,14750,0,0,14750
142013002400000,NW 310,Residential,9750,0,0,9750
142013002500000,NW 310,Residential,14750,0,0,14750
142013002600000,NW 310,Residential,9750,0,0,9750
142013002700000,NW 310,Residential,5000,0,0,5000
142013002800000,NW 310,Residential,9750,0,0,9750
142013002900000,NW 310,Residential,14750,0,0,14750
142013100100000,NW 310,Residential,16730,0,0,16730
142013100200000,NW 310,Residential,19321,0,0,19321
142013100300000,NW 310,Residential,19700,0,0,19700
142013100400000,NW 310,Residential,22275,26305,0,48580
142013100500000,NW 310,Residential,22275,56167,0,78442
142013100600000,NW 310,Residential,19700,0,0,19700
142013100700000,NW 310,Residential,22275,32873,0,55148
142013100800000,NW 310,Residential,22275,35170,0,57445
142013100900000,NW 310,Residential,27231,29271,0,56502
142013101000000,NW 310,Residential,26545,33328,0,59873
142013101100000,NW 310,Residential,19305,48032,0,67337
142013101200000,NW 310,Residential,9995,0,0,9995
142013101300000,NW 310,Residential,27695,0,0,27695
142013101400000,NW 310,Residential,18562,51711,0,70273
142013101500000,NW 310,Residential,14750,0,0,14750
142013101600000,NW 310,Residential,14750,0,0,14750
142013101700000,NW 310,Residential,18562,48133,0,66695
142013101800000,NW 310,Residential,18562,48710,0,67272
142013101900000,NW 310,Residential,14750,0,0,14750
142013102000000,NW 310,Residential,14750,0,0,14750
142013102100000,NW 310,Residential,14750,0,0,14750
142013102200000,NW 310,Residential,18562,30764,0,49326
142013102300000,NW 310,Residential,14750,0,0,14750
142013102400000,NW 310,Residential,9750,0,0,9750
142013102500000,NW 310,Residential,14750,0,0,14750
142013102600000,NW 310,Residential,14750,0,0,14750
142013102700000,NW 310,Residential,14750,0,0,14750
142013200100000,NW 310,Residential,22592,0,0,22592
142013200200000,NW 310,Residential,26187,72080,0,98267
142013200300000,NW 310,Residential,24990,72543,0,97533
142013200400000,NW 310,Residential,24990,58974,0,83964
142013200500000,NW 310,Residential,25245,65083,0,90328
142013200600000,NW 310,Residential,25245,61236,0,86481
142013200700000,NW 310,Residential,25245,57689,0,82934
142013200800000,NW 310,Residential,25500,63379,0,88879
142013200900000,NW 310,Residential,26562,66619,0,93181
142013201000000,NW 310,Residential,13865,67505,0,81370
142013201100000,NW 310,Residential,26492,83943,0,110435
142013201200000,NW 310,Residential,22950,52246,0,75196
142013201300000,NW 310,Residential,20655,54532,0,75187
142013201400000,NW 310,Residential,20655,70832,0,91487
142013201500000,NW 310,Residential,20655,52649,0,73304
142013201600000,NW 310,Residential,21050,38379,0,59429
142013201700000,NW 310,Residential,25755,58255,0,84010
142013201800000,NW 310,Residential,25500,48664,0,74164
142013201900000,NW 310,Residential,20000,0,0,20000
142013202000000,NW 310,Residential,25245,42668,0,67913
142013202100000,NW 310,Residential,19700,0,0,19700
142013202200000,NW 310,Residential,24990,52832,0,77822
142013202300000,NW 310,Residential,24735,30732,0,55467
142013202400000,NW 310,Residential,19100,0,0,19100
142015100100000,COMM NW,Commercial,55296,0,192445,247741
142015100200000,NW 310,Residential,14768,0,0,14768
142015100300000,NW 310,Residential,14768,0,0,14768
142015100400000,NW 310,Residential,12441,0,0,12441
142015100500000,NW 310,Residential,12631,0,0,12631
142015100600000,NW 310,Residential,14270,0,0,14270
142015100700000,NW 310,Residential,18577,55718,0,74295
142015100800000,NW 310,Residential,18484,68085,0,86569
142015100900000,NW 310,Residential,19753,45697,0,65450
142015101000000,E-40 CHURCHES,Exempt,162000,0,192279,354279
142015101100000,NW 310,Residential,19608,46931,0,66539
142015101200000,NW 310,Residential,11970,29806,0,41776
142015101300000,NW 310,Residential,5000,0,0,5000
142015101400000,NW 310,Residential,5000,0,0,5000
142015101500000,NW 310,Residential,15036,39394,0,54430
142015101600000,NW 310,Exempt,5000,0,0,5000
142015101700000,E-46 RELIG PARKING,Exempt,92205,0,9914,102119
142015200100000,NW 310,Residential,11013,0,0,11013
142015200200000,NW 310,Residential,17763,49092,0,66855
142015200300000,NW 310,Residential,16973,0,0,16973
142015200400000,NW 310,Residential,17763,43721,0,61484
142015200500000,NW 310,Residential,18091,30635,0,48726
142015200600000,NW 310,Residential,17977,36574,0,54551
142015200700000,NW 310,Residential,17244,34910,0,52154
142015200800000,NW 310,Residential,21150,64890,0,86040
142015200900000,NW 310,Residential,20476,58527,0,79003
142015201000000,NW 310,Residential,25003,63797,0,88800
142015201100000,NW 310,Residential,24725,65894,0,90619
142015201200000,NW 310,Residential,20396,63300,0,83696
142015201300000,NW 310,Residential,19703,54541,0,74244
142015201400000,NW 310,Residential,19703,51035,0,70738
142015201500000,NW 310,Residential,20032,64011,0,84043
142015201600000,NW 310,Residential,7955,0,0,7955
142015201700000,NW 310,Residential,8810,0,0,8810
142015201800000,NW 310,Residential,15262,58431,0,73693
142015201900000,NW 310,Residential,15262,55906,0,71168
142015202000000,NW 310,Residential,25000,74913,0,99913
142015202100000,NW 310,Residential,20334,62865,0,83199
142015202200000,NW 310,Residential,19703,64044,0,83747
142015202300000,NW 310,Residential,19703,77193,0,96896
142015202400000,NW 310,Residential,20019,48365,0,68384
142015202500000,NW 310,Residential,22252,54900,0,77152
142015202600000,NW 310,Residential,16843,0,0,16843
142015202700000,NW 310,Residential,14089,0,0,14089
142015202800000,NW 310,Residential,14485,0,0,14485
142015202900000,NW 310,Residential,11023,0,0,11023
142015203000000,NW 310,Residential,11150,0,0,11150
142015300100000,NW 310,Residential,17869,53154,0,71023
142015300200000,NW 310,Residential,17763,47850,0,65613
142015300300000,NW 310,Residential,22720,53354,0,76074
142015300400000,NW 310,Residential,17763,53018,0,70781
142015300500000,NW 310,Residential,18084,35860,0,53944
142015300600000,NW 310,Residential,18274,55726,0,74000
142015300700000,NW 310,Residential,17890,50176,0,68066
142015300800000,NW 310,Residential,22432,75426,0,97858
142015300900000,NW 310,Residential,21680,73171,0,94851
142015301000000,NW 310,Residential,26447,74774,0,101221
142015301100000,NW 310,Residential,26902,78724,0,105626
142015301200000,NW 310,Residential,20862,86923,0,107785
142015301300000,NW 310,Residential,20862,66697,0,87559
142015301400000,NW 310,Residential,24111,76253,0,100364
142015301500000,NW 310,Residential,17671,61232,0,78903
142015301600000,NW 310,Residential,14364,44493,0,58857
142015301700000,NW 310,Residential,20588,58434,0,79022
142015301800000,NW 310,Residential,19152,53420,0,72572
142015301900000,NW 310,Residential,15048,42464,0,57512
142015302000000,NW 310,Residential,14364,70978,0,85342
142015302100000,NW 310,Residential,20822,68912,0,89734
142015302200000,NW 310,Residential,19703,67926,0,87629
142015302300000,NW 310,Residential,19703,70223,0,89926
142015302400000,NW 310,Residential,20002,57902,0,77904
142015302500000,NW 310,Residential,24725,72864,0,97589
142015302600000,NW 310,Residential,25344,64126,0,89470
142015302700000,NW 310,Residential,20476,66655,0,87131
142015302800000,NW 310,Residential,20812,57939,0,78751
142015302900000,NW 310,Residential,9779,0,0,9779
142015303000000,NW 310,Residential,17977,22255,0,40232
142015400100000,NW 310,Residential,21681,64472,0,86153
142015400200000,NW 310,Residential,20938,48325,0,69263
142015400300000,NW 310,Residential,24502,48917,0,73419
142015400400000,NW 310,Residential,24191,51181,0,75372
142015400500000,NW 310,Residential,30858,69952,0,100810
142015400600000,NW 310,Residential,22016,68204,0,90220
142015400700000,NW 310,Residential,22526,70188,0,92714
142015400800000,NW 310,Residential,23108,72804,0,95912
142015400900000,NW 310,Residential,24612,59787,0,84399
142015401000000,NW 310,Residential,18207,55801,0,74008
142015401100000,NW 310,Residential,27989,78626,0,106615
142015401200000,NW 310,Residential,27527,63876,0,91403
142015401300000,NW 310,Residential,18207,83674,0,101881
142015401400000,NW 310,Residential,15048,30404,0,45452
142015401500000,NW 310,Residential,17100,62340,0,79440
142015401600000,NW 310,Residential,15048,35579,0,50627
142015401700000,NW 310,Residential,14364,42185,0,56549
142015401800000,NW 310,Residential,15048,33982,0,49030
142015401900000,NW 310,Residential,14364,41771,0,56135
142015402000000,NW 310,Residential,22053,92097,0,114150
142015402100000,NW 310,Residential,20862,65971,0,86833
142015402200000,NW 310,Residential,20862,70988,0,91850
142015402300000,NW 310,Residential,21050,72408,0,93458
142015402400000,NW 310,Residential,26697,68902,0,95599
142015402500000,NW 310,Residential,26007,67053,0,93060
142015402600000,NW 310,Residential,22089,73230,0,95319
142015402700000,NW 310,Residential,22465,70820,0,93285
142015500100000,NW 310,Residential,14553,29595,0,44148
142015500200000,NW 310,Residential,14553,42391,0,56944
142015500300000,NW 310,Residential,11583,50077,0,61660
142015500400000,NW 310,Residential,11286,36873,0,48159
142015500500000,NW 310,Residential,11286,26790,0,38076
142015500600000,NW 310,Residential,11286,27624,0,38910
142015500700000,NW 310,Residential,11286,43238,0,54524
142015500800000,NW 310,Residential,11286,41141,0,52427
142015500900000,NW 310,Residential,18533,31743,0,50276
142015501000000,NW 310,Residential,14850,52638,0,67488
142015501100000,E-40 CHURCHES,Exempt,38400,0,109052,147452
142015501200000,NW 310,Residential,9800,0,0,9800
142015501300000,NW 310,Residential,5000,0,0,5000
142015501400000,NW 310,Residential,5000,0,0,5000
142015501500000,NW 310,Residential,5000,0,0,5000
142015501600000,COMM NW,Commercial,8294,0,4910,13204
142015501700000,NW 310,Residential,5840,0,0,5840
142015501800000,COMM NW,Commercial,10368,0,7382,17750
142015501900000,NW 310,Residential,5000,0,0,5000
142015502000000,NW 310,Residential,5570,0,0,5570
142015600100000,NW 310,Residential,9404,0,0,9404
142015600200000,NW 310,Residential,6979,0,0,6979
142015600300000,NW 310,Residential,11487,29461,0,40948
142015600400000,E-40 CHURCHES,Exempt,51011,0,12972,63983
142015600500000,NW 310,Residential,14726,73639,0,88365
142015600600000,NW 310,Residential,9572,0,0,9572
142015600700000,NW 310,Residential,5000,0,0,5000
142015600800000,NW 310,Residential,14726,70583,0,85309
142015600900000,NW 310,Residential,21542,59400,0,80942
142015601000000,NW 310,Residential,5840,0,0,5840
142015601100000,NW 310,Residential,13464,54506,0,67970
142015601200000,NW 310,Residential,5840,0,0,5840
142015601300000,NW 310,Residential,5642,0,0,5642
142015601400000,NW 310,Residential,13296,26775,0,40071
142015601500000,NW 310,Residential,13296,22095,0,35391
142015601600000,NW 310,Residential,13296,73841,0,87137
142015601700000,NW 310,Residential,10637,0,0,10637
142015601800000,NW 310,Residential,14726,123621,0,138347
142015700100000,NW 310,Residential,14432,39905,0,54337
142015700200000,NW 310,Residential,17464,89313,0,106777
142015700300000,NW 310,Residential,10715,54459,0,65174
142015700400000,NW 310,Residential,13187,30148,0,43335
142015700500000,NW 310,Residential,17820,56258,0,74078
142015700600000,NW 310,Residential,17820,57987,0,75807
142015700700000,NW 310,Residential,17820,56833,0,74653
142015700800000,NW 310,Residential,17820,25107,0,42927
142015700900000,NW 310,Residential,17820,66779,0,84599
142015701000000,NW 310,Residential,17820,48933,0,66753
142015701100000,NW 310,Residential,17820,72059,0,89879
142015701200000,NW 310,Residential,14726,37184,0,51910
142015701300000,NW 310,Residential,7325,0,0,7325
142015701400000,NW 310,Residential,14726,23666,0,38392
142015701500000,NW 310,Residential,14726,61789,0,76515
142015701600000,NW 310,Residential,5000,0,0,5000
142015701700000,NW 310,Residential,14726,37941,0,52667
142015701800000,NW 310,Residential,5000,0,0,5000
142015701900000,NW 310,Residential,7093,0,0,7093
142015800100000,NW 310,Residential,17464,63301,0,80765
142015800200000,NW 310,Residential,20242,78119,0,98361
142015800300000,NW 310,Residential,29936,69321,0,99257
142015800400000,NW 310,Residential,20655,72207,0,92862
142015800500000,NW 310,Residential,20655,66676,0,87331
142015800600000,NW 310,Residential,12950,0,0,12950
142015800700000,NW 310,Residential,20655,45675,0,66330
142015800800000,NW 310,Residential,20655,53075,0,73730
142015800900000,NW 310,Residential,20655,55624,0,76279
142015801000000,NW 310,Residential,20655,60565,0,81220
142015801100000,NW 310,Residential,17820,49602,0,67422
142015801200000,NW 310,Residential,17820,35502,0,53322
142015801300000,NW 310,Residential,17820,57964,0,75784
142015801400000,NW 310,Residential,17820,44922,0,62742
142015801500000,NW 310,Residential,17820,47350,0,65170
142015801600000,CONVERSIONS,Commercial,9331,0,32605,41936
142015801700000,NW 310,Residential,17820,54649,0,72469
142015801800000,NW 310,Residential,24734,78029,0,102763
142017600100000,NW 310,Residential,5000,0,0,5000
142017600200000,NW 310,Residential,5067,0,0,5067
142017600300000,NW 310,Residential,5000,0,0,5000
142017600400000,NW 310,Residential,5000,0,0,5000
142017600500000,NW 310,Residential,7325,0,0,7325
142017600600000,NW 310,Residential,5000,0,0,5000
142017600700000,NW 310,Residential,5000,0,0,5000
142017600800000,NW 310,Residential,7325,0,0,7325
142017600900000,NW 310,Residential,5000,0,0,5000
142017601000000,NW 310,Residential,5000,0,0,5000
142017601100000,NW 310,Residential,8915,0,0,8915
142017601200000,NW 310,Residential,8250,0,0,8250
142017601300000,NW 310,Residential,2275,0,0,2275
142017601400000,NW 310,Residential,5000,0,0,5000
142017601500000,NW 310,Residential,5300,0,0,5300
142017601600000,NW 310,Residential,5000,0,0,5000
142017700100000,NW 310,Residential,5000,0,0,5000
142017700200000,NW 310,Residential,5000,0,0,5000
142017700300000,NW 310,Residential,9800,0,0,9800
142017700400000,NW 310,Residential,10740,0,0,10740
142017700500000,NW 310,Residential,5000,0,0,5000
142017700600000,NW 310,Residential,9800,0,0,9800
142017700700000,NW 310,Residential,5000,0,0,5000
142017700800000,NW 310,Residential,5000,0,0,5000
142017700900000,NW 310,Residential,8662,0,0,8662
142017701000000,NW 310,Residential,7325,0,0,7325
142017701100000,NW 310,Residential,5000,0,0,5000
142017701200000,NW 310,Residential,7325,0,0,7325
142017701300000,NW 310,Residential,5000,0,0,5000
142017800100000,NW 310,Residential,8910,0,0,8910
142017800200000,NW 310,Residential,5000,0,0,5000
142017800300000,NW 310,Residential,5000,0,0,5000
142017800400000,NW 310,Residential,9800,0,0,9800
142017800500000,NW 310,Residential,9800,0,0,9800
142017800600000,NW 310,Residential,5000,0,0,5000
142017800700000,NW 310,Residential,9800,0,0,9800
142017800800000,NW 310,Residential,5000,0,0,5000
142017800900000,NW 310,Residential,9900,0,0,9900
142017801000000,NW 310,Residential,5000,0,0,5000
142017801100000,NW 310,Residential,5000,0,0,5000
142017801200000,NW 310,Residential,5000,0,0,5000
142017801300000,NW 310,Residential,5000,0,0,5000
142017801400000,NW 310,Residential,5000,0,0,5000
142017900100000,NW 310,Residential,5000,0,0,5000
142017900200000,NW 310,Residential,10048,0,0,10048
142017900300000,NW 310,Residential,6706,0,0,6706
142017900400000,NW 310,Residential,9730,0,0,9730
142017900500000,NW 310,Residential,10023,0,0,10023
142017900600000,E-64 YMCA,Exempt,20736,0,8408,29144
142017900700000,E-64 YMCA,Exempt,41472,0,79677,121149
142017900800000,NW 310,Residential,5740,0,0,5740
142017900900000,NW 310,Residential,10395,36471,0,46866
142017901000000,E-64 YMCA,Exempt,20736,0,0,20736
142017901100000,NW 310,Residential,9800,0,0,9800
142017901200000,NW 310,Residential,9800,0,0,9800
142017901300000,NW 310,Residential,5000,0,0,5000
142018000100000,NW 310,Residential,6450,0,0,6450
142018000200000,NW 310,Residential,7325,0,0,7325
142018000300000,NW 310,Residential,7325,0,0,7325
142018000400000,NW 310,Residential,5000,0,0,5000
142018000500000,NW 310,Residential,7325,0,0,7325
142018000600000,NW 310,Residential,5000,0,0,5000
142018000700000,NW 310,Residential,7325,0,0,7325
142018000800000,NW 310,Residential,7325,0,0,7325
142018000900000,NW 310,Residential,5000,0,0,5000
142018001000000,NW 310,Residential,5000,0,0,5000
142018001100000,NW 310,Residential,6450,0,0,6450
142018001200000,NW 310,Residential,6450,0,0,6450
142018001300000,NW 310,Residential,5000,0,0,5000
142018001400000,NW 310,Residential,5000,0,0,5000
142018100100000,NW 310,Residential,7325,0,0,7325
142018100200000,NW 310,Residential,9800,0,0,9800
142018100300000,NW 310,Residential,5000,0,0,5000
142018100400000,NW 310,Residential,9800,0,0,9800
142018100500000,NW 310,Residential,9800,0,0,9800
142018100600000,NW 310,Residential,9800,0,0,9800
142018100700000,NW 310,Residential,9800,0,0,9800
142018100800000,NW 310,Residential,5000,0,0,5000
142018100900000,NW 310,Residential,7325,0,0,7325
142018101000000,NW 310,Residential,5000,0,0,5000
142018101100000,NW 310,Residential,7325,0,0,7325
142018101200000,NW 310,Residential,7325,0,0,7325
142018101300000,NW 310,Residential,7325,0,0,7325
142018101400000,NW 310,Residential,7325,0,0,7325
142018200100000,NW 310,Residential,5000,0,0,5000
142018200200000,NW 310,Residential,5000,0,0,5000
142018200300000,NW 310,Residential,8240,0,0,8240
142018200400000,NW 310,Residential,11880,21248,0,33128
142018200500000,NW 310,Residential,9800,0,0,9800
142018200600000,NW 310,Residential,5000,0,0,5000
142018200700000,NW 310,Residential,5000,0,0,5000
142018200800000,NW 310,Residential,9800,0,0,9800
142018200900000,NW 310,Residential,9800,0,0,9800
142018201000000,NW 310,Residential,2800,0,0,2800
142018201100000,NW 310,Residential,7000,0,0,7000
142018201200000,NW 310,Residential,9800,0,0,9800
142018201300000,NW 310,Residential,5000,0,0,5000
142018201400000,NW 310,Residential,9800,0,0,9800
142018201500000,NW 310,Residential,9800,0,0,9800
142018201600000,NW 310,Residential,9800,0,0,9800
142018300100000,NW 310,Residential,9800,0,0,9800
142018300200000,NW 310,Residential,12275,0,0,12275
142018300300000,NW 310,Residential,12275,0,0,12275
142018300400000,NW 310,Residential,12275,0,0,12275
142018300500000,NW 310,Residential,5000,0,0,5000
142018300600000,NW 310,Residential,16706,55749,0,72455
142018300700000,NW 310,Residential,16706,27085,0,43791
142018300800000,NW 310,Residential,9750,0,0,9750
142018300900000,Empty,Other,0,0,0,0
142018301000000,NW 310,Residential,5000,0,0,5000
142018301100000,NW 310,Residential,14850,34311,0,49161
142018301200000,NW 310,Residential,14850,23509,0,38359
142018301300000,NW 310,Residential,5000,0,0,5000
142018301400000,NW 310,Residential,14850,43546,0,58396
142018400100000,NW 310,Residential,5000,0,0,5000
142018400200000,NW 310,Residential,5000,0,0,5000
142018400300000,NW 310,Residential,6037,0,0,6037
142018400400000,NW 310,Residential,7325,0,0,7325
142018400500000,NW 310,Residential,7325,0,0,7325
142018400600000,NW 310,Residential,7325,0,0,7325
142018400700000,NW 310,Residential,7325,0,0,7325
142018400800000,NW 310,Residential,5000,0,0,5000
142018400900000,NW 310,Residential,7325,0,0,7325
142018401000000,NW 310,Residential,7325,0,0,7325
142018401100000,NW 310,Residential,7325,0,0,7325
142018401200000,NW 310,Residential,5000,0,0,5000
142018401300000,NW 310,Residential,9870,0,0,9870
142018401400000,NW 310,Residential,6580,0,0,6580
142018401500000,NW 310,Residential,6450,0,0,6450
142018401600000,NW 310,Residential,6450,0,0,6450
142018401700000,NW 310,Residential,6450,0,0,6450
142018401800000,NW 310,Residential,6450,0,0,6450
142018401900000,NW 310,Residential,6450,0,0,6450
142018500100000,NW 310,Residential,7325,0,0,7325
142018500200000,NW 310,Residential,5000,0,0,5000
142018500300000,NW 310,Residential,8000,0,0,8000
142018500400000,NW 310,Residential,9800,0,0,9800
142018500500000,NW 310,Residential,9800,0,0,9800
142018500600000,NW 310,Residential,9800,0,0,9800
142018500700000,NW 310,Residential,5000,0,0,5000
142018500800000,NW 310,Residential,5000,0,0,5000
142018500900000,NW 310,Residential,5000,0,0,5000
142018501000000,NW 310,Residential,5000,0,0,5000
142018501100000,NW 310,Residential,5000,0,0,5000
142018501200000,NW 310,Residential,9255,0,0,9255
142018501300000,NW 310,Residential,7325,0,0,7325
142018501400000,NW 310,Residential,7325,0,0,7325
142018501500000,NW 310,Residential,5000,0,0,5000
142018501600000,NW 310,Residential,8662,16799,0,25461
142018501700000,NW 310,Residential,7325,0,0,7325
142018501800000,NW 310,Residential,8662,0,0,8662
142018600100000,NW 310,Residential,5000,0,0,5000
142018600200000,NW 310,Residential,9744,23055,0,32799
142018600300000,NW 310,Residential,5000,0,0,5000
142018600400000,NW 310,Residential,5000,0,0,5000
142018600500000,NW 310,Residential,5000,0,0,5000
142018600600000,NW 310,Residential,9800,0,0,9800
142018600700000,NW 310,Residential,14850,55926,0,70776
142018600800000,NW 310,Residential,9800,0,0,9800
142018600900000,NW 310,Residential,14850,26980,0,41830
142018601000000,NW 310,Residential,5000,0,0,5000
142018601100000,NW 310,Residential,5940,0,0,5940
142018601200000,NW 310,Residential,5000,0,0,5000
142018601300000,NW 310,Residential,5000,0,0,5000
142018601400000,NW 310,Residential,14850,36975,0,51825
142018601500000,NW 310,Residential,5000,0,0,5000
142018601600000,NW 310,Residential,9800,0,0,9800
142018601700000,NW 310,Residential,9800,0,0,9800
142018601800000,NW 310,Residential,14850,40092,0,54942
142018601900000,NW 310,Residential,14850,43468,0,58318
142018602000000,NW 310,Residential,5000,0,0,5000
142018602100000,NW 310,Residential,9800,0,0,9800
142018700100000,NW 310,Residential,9800,0,0,9800
142018700200000,NW 310,Residential,5000,0,0,5000
142018700300000,NW 310,Residential,6840,0,0,6840
142018700400000,NW 310,Residential,11880,51459,0,63339
142018700500000,NW 310,Residential,9800,0,0,9800
142018700600000,NW 310,Residential,9800,0,0,9800
142018700700000,NW 310,Residential,5000,0,0,5000
142018700800000,NW 310,Residential,5000,0,0,5000
142018700900000,NW 310,Residential,5000,0,0,5000
142018701000000,NW 310,Residential,7820,0,0,7820
142018701100000,NW 310,Residential,16335,32816,0,49151
142018701200000,NW 310,Residential,5000,0,0,5000
142018701300000,E-40 CHURCHES,Exempt,20736,0,14583,35319
142018701400000,NW 310,Residential,5000,0,0,5000
142018701500000,NW 310,Residential,5000,0,0,5000
142018701600000,NW 310,Residential,11880,36819,0,48699
142018701700000,NW 310,Residential,5000,0,0,5000
142018701800000,NW 310,Residential,5000,0,0,5000
142018701900000,NW 310,Residential,14850,28661,0,43511
142018702000000,NW 310,Residential,5000,0,0,5000
142018702100000,NW 310,Residential,5000,0,0,5000
142020100100000,NW 304,Residential,24603,65791,0,90394
142020100200000,NW 304,Residential,16200,52460,0,68660
142020100300000,NW 304,Residential,14400,77407,0,91807
142020100400000,NW 304,Residential,15600,157683,0,173283
142020100500000,NW 304,Residential,15900,68945,0,84845
142020100600000,NW 304,Residential,16200,98438,0,114638
142020100700000,NW 304,Residential,16200,60476,0,76676
142020100900000,NW 304,Residential,19200,120548,0,139748
142020101000000,NW 304,Residential,19350,79854,0,99204
142020101100000,NW 304,Residential,19350,90300,0,109650
142020101200000,NW 304,Residential,19350,77735,0,97085
142020101300000,NW 304,Residential,19200,81632,0,100832
142020101400000,NW 304,Residential,19050,57866,0,76916
142020101500000,NW 304,Residential,18750,79876,0,98626
142020101600000,NW 304,Residential,18450,71645,0,90095
142020101700000,NW 304,Residential,25410,82892,0,108302
142020101800000,NW 304,Residential,17400,56952,0,74352
142020101900000,NW 304,Residential,19620,43438,0,63058
142020102000000,NW 304,Residential,23836,104504,0,128340
142020102100000,NW 304,Residential,24980,0,0,24980
142020200300000,NW 304,Residential,24150,97085,0,121235
142020200400000,NW 304,Residential,13350,80630,0,93980
142020200500000,NW 304,Residential,22094,111854,0,133948
142020200600000,NW 304,Residential,25336,122430,0,147766
142020200700000,NW 304,Residential,24114,32736,0,56850
142020300100000,NW 304,Residential,68300,57043,0,125343
142020300200000,NW 304,Residential,68300,97098,0,165398
142020300300000,NW 304,Residential,54400,79697,0,134097
142020300400000,NW 304,Residential,27495,130257,0,157752
142020300500000,NW 304,Residential,54300,79827,0,134127
142020300600000,NW 304,Residential,1750,0,0,1750
142020300700000,NW 304,Residential,1750,0,0,1750
142020300800000,NW 304,Residential,23088,91285,0,114373
142020300900000,NW 304,Residential,22464,90727,0,113191
142020301000000,NW 304,Residential,22464,73022,0,95486
142020301100000,NW 304,Residential,26352,84927,0,111279
142020301200000,NW 304,Residential,55650,221968,0,277618
142020301300000,NW 304,Residential,19656,13861,0,33517
142020400100000,NW 304,Residential,23130,85045,0,108175
142020400200000,NW 304,Residential,23715,161923,0,185638
142020400300000,NW 304,Residential,26174,127438,0,153612
142020400400000,NW 304,Residential,15750,94070,0,109820
142020400500000,NW 304,Residential,27590,99284,0,126874
142020400600000,NW 304,Residential,202,0,0,202
142020400700000,NW 304,Residential,18568,54588,0,73156
142020400800000,NW 304,Residential,18360,88600,0,106960
142020400900000,NW 304,Residential,11135,0,0,11135
142020401000000,NW 304,Residential,22425,76632,0,99057
142020401100000,NW 304,Residential,21825,107186,0,129011
142020401200000,NW 304,Residential,15000,82498,0,97498
142020401300000,NW 304,Residential,15150,93193,0,108343
142020401400000,NW 304,Residential,15600,59864,0,75464
142020401500000,NW 304,Residential,16500,50589,0,67089
142020401600000,NW 304,Residential,16500,43974,0,60474
142020401700000,NW 304,Residential,20370,95944,0,116314
142020401800000,NW 304,Residential,18144,101883,0,120027
142020401900000,NW 304,Residential,18042,123911,0,141953
142020402000000,NW 304,Residential,18304,76318,0,94622
142020402100000,NW 304,Residential,16022,100733,0,116755
142020402200000,NW 304,Residential,17000,86377,0,103377
142020402300000,NW 304,Residential,51800,153392,0,205192
142020402400000,NW 304,Residential,5000,3453,0,8453
142020402500000,NW 304,Residential,23479,110338,0,133817
142020402600000,NW 304,Residential,21384,82801,0,104185
142022600100000,NW 304,Residential,166040,0,0,166040
142022600200000,NW 304,Residential,29100,276574,0,305674
142022600300000,NW 304,Residential,32856,224610,0,257466
142022600400000,NW 304,Residential,30360,157997,0,188357
142022600500000,NW 304,Residential,49203,164331,0,213534
142022700100000,NW 304,Residential,38894,107123,0,146017
142022700200000,NW 304,Residential,51650,144888,0,196538
142022700300000,NW 304,Residential,4455,0,0,4455
142022700400000,NW 304,Residential,49000,90742,0,139742
142022700500000,NW 304,Residential,39340,88365,0,127705
142022700600000,NW 304,Residential,178,0,0,178
142022700700000,NW 304,Residential,1095,0,0,1095
142022700800000,NW 304,Residential,18500,76319,0,94819
142022700900000,NW 304,Residential,19950,0,0,19950
142022701000000,NW 304,Residential,18125,118086,0,136211
142022701100000,NW 304,Residential,35490,126243,0,161733
142022701300000,NW 304,Residential,22890,128507,0,151397
142022701400000,NW 304,Residential,40920,83898,0,124818
142022701500000,NW 304,Residential,33060,200658,0,233718
142022701600000,NW 304,Residential,31320,205573,0,236893
142022701700000,NW 304,Residential,31320,162649,0,193969
142022701800000,NW 304,Residential,32035,132106,0,164141
142022701900000,NW 304,Residential,30000,103096,0,133096
142022702000000,NW 304,Residential,29695,149898,0,179593
142022702100000,NW 304,Residential,73200,68271,0,141471
142022702200000,NW 304,Residential,40200,62962,0,103162
142022702300000,NW 304,Residential,25773,110860,0,136633
142022702400000,NW 304,Residential,41160,91062,0,132222
142025100100000,NW 304,Residential,34742,0,0,34742
142025100200000,COMM NW,Commercial,61560,0,0,61560
142025100300000,NW 304,Residential,25587,79326,0,104913
142025100400000,NW 304,Residential,24795,89307,0,114102
142025100500000,NW 304,Residential,24795,95818,0,120613
142025100600000,NW 304,Residential,25056,85972,0,111028
142025100700000,NW 304,Residential,25056,77158,0,102214
142025200100000,NW 304,Residential,32704,95850,0,128554
142025200200000,NW 304,Residential,27574,109851,0,137425
142025200300000,NW 304,Residential,27574,107086,0,134660
142025200400000,NW 304,Residential,27284,106114,0,133398
142025200500000,NW 304,Residential,32543,77963,0,110506
142025200600000,E-70 CHARITY OTHER,Exempt,342427,0,3419344,3761771
142025200701000,CONDO 500,Residential,6000,77892,0,83892
142025200701001,CONDO 500,Residential,10000,115305,0,125305
142025200701002,CONDO 500,Residential,10000,115305,0,125305
142025200701003,CONDO 500,Residential,10000,115305,0,125305
142025200701004,CONDO 500,Residential,8000,105919,0,113919
142025200701005,CONDO 500,Residential,10000,115305,0,125305
142025200701006,CONDO 500,Residential,8000,105919,0,113919
142025200701007,CONDO 500,Residential,6000,77892,0,83892
142025200701008,CONDO 500,Residential,6000,77892,0,83892
142025200701009,CONDO 500,Residential,10000,115305,0,125305
142025200701010,CONDO 500,Residential,10000,115305,0,125305
142025200701011,CONDO 500,Residential,10000,115305,0,125305
142025200701012,CONDO 500,Residential,8000,105919,0,113919
142025200701013,CONDO 500,Residential,10000,115305,0,125305
142025200701014,CONDO 500,Residential,8000,109743,0,117743
142025200701015,CONDO 500,Residential,6000,77892,0,83892
142025200701016,CONDO 500,Residential,6000,77892,0,83892
142025200701017,CONDO 500,Residential,10000,115305,0,125305
142025200701018,CONDO 500,Residential,10000,115305,0,125305
142025200701019,CONDO 500,Residential,10000,115305,0,125305
142025200701020,CONDO 500,Residential,8000,105919,0,113919
142025200701021,CONDO 500,Residential,10000,115305,0,125305
142025200701022,CONDO 500,Residential,8000,105919,0,113919
142025200701023,CONDO 500,Residential,6000,77892,0,83892
142025200701024,CONDO 500,Residential,6000,77892,0,83892
142025200701025,CONDO 500,Residential,6000,77892,0,83892
142025200701026,CONDO 500,Residential,6000,77892,0,83892
142025200701027,CONDO 500,Residential,6000,77892,0,83892
142025200701028,CONDO 500,Residential,6000,77947,0,83947
142025200701029,CONDO 500,Residential,6000,77892,0,83892
142025200701030,CONDO 500,Residential,6000,78184,0,84184
142025200701031,CONDO 500,Residential,6000,77892,0,83892
142025200701032,CONDO 500,Residential,6000,77892,0,83892
142025200701033,CONDO 500,Residential,10000,115305,0,125305
142025200701034,CONDO 500,Residential,10000,115305,0,125305
142025200701035,CONDO 500,Residential,10000,115305,0,125305
142025200701036,CONDO 500,Residential,8000,105919,0,113919
142025200701037,CONDO 500,Residential,10000,115305,0,125305
142025200701038,CONDO 500,Residential,8000,105919,0,113919
142025200701039,CONDO 500,Residential,6000,77892,0,83892
142025200701040,CONDO 500,Residential,6000,79297,0,85297
142025200701041,CONDO 500,Residential,10000,115756,0,125756
142025200701042,CONDO 500,Residential,6000,77892,0,83892
142025200701043,CONDO 500,Residential,10000,115305,0,125305
142025200701044,CONDO 500,Residential,10000,115604,0,125604
142025200701045,CONDO 500,Residential,6000,77892,0,83892
142025200701046,CONDO 500,Residential,10000,115305,0,125305
142025200701047,CONDO 500,Residential,6000,77892,0,83892
142025200701048,CONDO 500,Residential,10000,115305,0,125305
142025200701049,CONDO 500,Residential,6000,77892,0,83892
142025200701050,CONDO 500,Residential,10000,115305,0,125305
142025200701051,CONDO 500,Residential,8000,106476,0,114476
142025200701052,CONDO 500,Residential,10000,115604,0,125604
142025200701053,CONDO 500,Residential,8000,106476,0,114476
142025200701054,CONDO 500,Residential,12000,130907,0,142907
142025200701055,CONDO 500,Residential,10000,115305,0,125305
142025200701056,CONDO 500,Residential,10000,115305,0,125305
142025200701057,CONDO 500,Residential,6000,77892,0,83892
142025200701058,CONDO 500,Residential,10000,115305,0,125305
142025200701059,CONDO 500,Residential,8000,105919,0,113919
142025200701060,CONDO 500,Residential,10000,115305,0,125305
142025200701061,CONDO 500,Residential,8000,105919,0,113919
142025200701062,CONDO 500,Residential,8000,106218,0,114218
142025200701063,CONDO 500,Residential,10000,115604,0,125604
142025200800000,E-70 CHARITY OTHER,Exempt,297216,0,741406,1038622
142025200801000,CONDO 501,Residential,31500,118947,0,150447
142025200801001,CONDO 501,Residential,31500,112206,0,143706
142025200801002,CONDO 501,Residential,31500,112724,0,144224
142025200801003,CONDO 501,Residential,31500,117567,0,149067
142025200801004,CONDO 501,Residential,36500,133340,0,169840
142025200801005,CONDO 501,Residential,31500,114111,0,145611
142025200801006,CONDO 501,Residential,36500,130402,0,166902
142025200801007,CONDO 501,Residential,31500,126500,0,158000
142025200801008,CONDO 501,Residential,31500,135205,0,166705
142025200801009,CONDO 501,Residential,36500,125602,0,162102
142025200801010,CONDO 501,Residential,36500,139646,0,176146
142025200801011,CONDO 501,Residential,36500,129216,0,165716
142025200801012,CONDO 501,Residential,31500,115934,0,147434
142025200801013,CONDO 501,Residential,31500,115662,0,147162
142025200801014,CONDO 501,Residential,31500,139762,0,171262
142025200801015,CONDO 501,Residential,31500,131252,0,162752
142025200801016,CONDO 501,Residential,31500,123839,0,155339
142025200801017,CONDO 501,Residential,36500,137452,0,173952
142025200801018,CONDO 501,Residential,26000,101723,0,127723
142025200801019,CONDO 501,Residential,36500,134334,0,170834
142025200801020,CONDO 501,Residential,36500,137593,0,174093
142025200801021,CONDO 501,Residential,36500,133122,0,169622
142025200801022,CONDO 501,Residential,31500,122880,0,154380
142025200801023,CONDO 501,Residential,36500,131910,0,168410
142025200801024,CONDO 501,Residential,36500,131910,0,168410
142025300100000,COMM NW,Commercial,12636,0,0,12636
142027600100000,NW 304,Residential,37422,86485,0,123907
142027600200000,NW 304,Residential,17460,73714,0,91174
142027600300000,NW 304,Residential,17460,67523,0,84983
142027600400000,NW 304,Residential,17460,81118,0,98578
142027600500000,NW 304,Residential,17460,115471,0,132931
142027600600000,NW 304,Residential,17460,87639,0,105099
142027600700000,NW 304,Residential,17460,126981,0,144441
142027600800000,NW 304,Residential,32410,106003,0,138413
142027600900000,NW 304,Residential,24008,109412,0,133420
142027601000000,NW 304,Residential,29900,97413,0,127313
142027601100000,NW 304,Residential,31769,124801,0,156570
142027601200000,NW 304,Residential,26352,117585,0,143937
142027601300000,NW 304,Residential,24339,105828,0,130167
142027601400000,NW 304,Residential,25620,97862,0,123482
142027601500000,NW 304,Residential,25620,100521,0,126141
142027601600000,NW 304,Residential,29463,98155,0,127618
142027601700000,NW 304,Residential,29682,107916,0,137598
142027601800000,NW 304,Residential,30555,88755,0,119310
142027601900000,NW 304,Residential,28445,82606,0,111051
142027602000000,NW 304,Residential,28445,75288,0,103733
142027602100000,NW 304,Residential,28445,76640,0,105085
142027602200000,NW 304,Residential,28958,84615,0,113573
142027602300000,NW 304,Residential,31185,84746,0,115931
142027602400000,NW 304,Residential,31500,81336,0,112836
142027602500000,NW 304,Residential,29250,75341,0,104591
142027602600000,NW 304,Residential,29543,82291,0,111834
142027602700000,NW 304,Residential,28760,79699,0,108459
142027602800000,NW 304,Residential,30135,75994,0,106129
142027602900000,NW 304,Residential,35251,70029,0,105280
142027603000000,NW 304,Residential,34470,141365,0,175835
142027603100000,NW 304,Residential,30928,74782,0,105710
142027603200000,NW 304,Residential,27540,83036,0,110576
142027603300000,NW 304,Residential,27540,81819,0,109359
142027603400000,NW 304,Residential,27540,89933,0,117473
142027603500000,NW 304,Residential,27540,62357,0,89897
142027603600000,NW 304,Residential,27540,77929,0,105469
142027603700000,NW 304,Residential,27540,79157,0,106697
142027603800000,NW 304,Residential,28443,81594,0,110037
142027700100000,E-15 CITY,Exempt,0,0,0,0
142027700200000,NW 304,Residential,28373,85937,0,114310
142027700300000,NW 304,Residential,28373,91094,0,119467
142027700400000,NW 304,Residential,34440,101540,0,135980
142027700500000,E-15 CITY,Exempt,0,0,0,0
142027700600000,Empty,Exempt,0,0,0,0
142027700700000,NW 304,Residential,32130,127858,0,159988
142027700800000,NW 304,Residential,25018,0,0,25018
142027700900000,NW 304,Residential,32760,126623,0,159383
142027701000000,NW 304,Residential,32197,124005,0,156202
142027701100000,NW 304,Residential,28224,88106,0,116330
142027701200000,NW 304,Residential,27432,76948,0,104380
142027701300000,NW 304,Residential,27864,88383,0,116247
142027701400000,NW 304,Residential,27864,86244,0,114108
142027701500000,NW 304,Residential,27864,83799,0,111663
142027701600000,NW 304,Residential,27574,87814,0,115388
142027800100000,Empty,Exempt,0,0,0,0
142027800200000,Empty,Exempt,0,0,0,0
142027800300000,RES VALUED COMM,Residential,873180,10539582,0,11412762
142030100100000,NW 311,Residential,14400,56774,0,71174
142030100200000,NW 311,Residential,18878,88412,0,107290
142030100300000,NW 311,Residential,17885,49356,0,67241
142030100400000,NW 311,Residential,17885,72614,0,90499
142030100500000,NW 311,Residential,17885,53520,0,71405
142030100600000,NW 311,Residential,17885,53101,0,70986
142030100700000,NW 311,Residential,17885,54308,0,72193
142030100800000,NW 311,Residential,17885,58403,0,76288
142030100900000,NW 311,Residential,17885,42929,0,60814
142030101000000,NW 311,Residential,18746,62798,0,81544
142030101100000,NW 311,Residential,23328,62316,0,85644
142030101200000,NW 311,Residential,18720,82990,0,101710
142030101300000,NW 311,Residential,14400,68771,0,83171
142030101400000,NW 311,Residential,24480,86809,0,111289
142030101500000,NW 311,Residential,14400,73767,0,88167
142030101600000,NW 311,Residential,14400,54263,0,68663
142030101700000,NW 311,Residential,14400,50240,0,64640
142030101800000,NW 311,Residential,14400,58109,0,72509
142030101900000,NW 311,Residential,14400,57884,0,72284
142030200100000,NW 311,Residential,23104,0,0,23104
142030200200000,NW 311,Residential,22593,0,0,22593
142030200300000,NW 312,Residential,21600,77761,0,99361
142030200400000,NW 312,Residential,25569,94722,0,120291
142030200500000,NW 312,Residential,29430,91372,0,120802
142030200600000,NW 312,Residential,30240,108025,0,138265
142030200700000,NW 312,Residential,30395,88552,0,118947
142030200800000,NW 312,Residential,26208,79805,0,106013
142030200900000,NW 312,Residential,26208,97970,0,124178
142030201000000,NW 312,Residential,24804,93811,0,118615
142030201100000,NW 312,Residential,27612,83983,0,111595
142030201200000,NW 312,Residential,26208,95715,0,121923
142030201300000,NW 312,Residential,26208,104236,0,130444
142030201400000,NW 312,Residential,28080,90633,0,118713
142030201500000,NW 312,Residential,28080,96104,0,124184
142030201600000,NW 312,Residential,28080,93457,0,121537
142030201700000,NW 311,Residential,33858,108295,0,142153
142030201800000,NW 311,Residential,33858,116513,0,150371
142030201900000,NW 311,Residential,32405,86567,0,118972
142030202000000,NW 311,Residential,27600,71364,0,98964
142030202100000,NW 311,Residential,33060,129363,0,162423
142030202200000,NW 311,Residential,27600,101267,0,128867
142030202300000,NW 311,Residential,27600,76171,0,103771
142030202400000,NW 311,Residential,24840,0,0,24840
142030202500000,NW 311,Residential,24840,0,0,24840
142030202600000,NW 311,Residential,50199,0,0,50199
142030202800000,E-70 CHARITY OTHER,Exempt,113940,0,1445126,1559066
142030202900000,E-70 CHARITY OTHER,Exempt,7750,0,0,7750
142030203000000,NW 311,Residential,18216,66055,0,84271
142030203100000,NW 311,Residential,18624,0,0,18624
142030203200000,NW 311,Residential,19552,0,0,19552
142030300100000,NW 311,Residential,14847,54923,0,69770
142030300200000,NW 311,Residential,14688,49467,0,64155
142030300300000,NW 311,Residential,14688,45067,0,59755
142030300400000,NW 311,Residential,14688,73649,0,88337
142030300500000,NW 311,Residential,14688,60043,0,74731
142030300600000,NW 311,Residential,14688,42269,0,56957
142030300700000,NW 311,Residential,14688,54307,0,68995
142030300800000,NW 311,Residential,14688,55008,0,69696
142030300900000,NW 311,Residential,14832,32719,0,47551
142030301000000,NW 311,Residential,14832,71523,0,86355
142030301100000,NW 311,Residential,14832,58281,0,73113
142030301200000,NW 311,Residential,14832,50699,0,65531
142030301300000,NW 311,Residential,14832,66976,0,81808
142030301400000,NW 311,Residential,14832,65182,0,80014
142030301500000,NW 311,Residential,14511,45377,0,59888
142030301600000,NW 311,Residential,14688,53244,0,67932
142030301700000,NW 311,Residential,14688,66723,0,81411
142030301800000,NW 311,Residential,14688,50999,0,65687
142030301900000,NW 311,Residential,14688,61080,0,75768
142030302000000,NW 311,Residential,14688,75532,0,90220
142030302100000,NW 311,Residential,14688,60885,0,75573
142030302200000,NW 311,Residential,14688,77953,0,92641
142030302300000,NW 311,Residential,14688,60824,0,75512
142030302400000,NW 311,Residential,14688,48250,0,62938
142030302500000,NW 311,Residential,14688,32064,0,46752
142030302600000,NW 311,Residential,14688,54617,0,69305
142030302700000,NW 311,Residential,14688,51575,0,66263
142030302800000,NW 311,Residential,5000,0,0,5000
142030302900000,NW 311,Residential,15120,57948,0,73068
142030303000000,NW 311,Residential,10944,50926,0,61870
142030303100000,NW 311,Residential,10944,67857,0,78801
142030400100000,NW 312,Residential,25088,90404,0,115492
142030400200000,NW 312,Residential,21816,96997,0,118813
142030400300000,NW 312,Residential,23836,83283,0,107119
142030400400000,NW 312,Residential,23836,90692,0,114528
142030500100000,NW 311,Residential,14832,70376,0,85208
142030500200000,NW 311,Residential,14832,63378,0,78210
142030500300000,NW 311,Residential,14832,60122,0,74954
142030500400000,NW 311,Residential,14832,70622,0,85454
142030500500000,NW 311,Residential,14688,56958,0,71646
142030500600000,NW 311,Residential,14688,74748,0,89436
142030500700000,NW 311,Residential,14688,48293,0,62981
142030500800000,NW 311,Residential,14688,67119,0,81807
142030500900000,NW 311,Residential,17626,71734,0,89360
142030501000000,NW 311,Residential,17626,90927,0,108553
142030501100000,NW 311,Residential,14688,57805,0,72493
142030501200000,NW 311,Residential,14544,83009,0,97553
142030501300000,NW 311,Residential,18907,63290,0,82197
142030501400000,NW 311,Residential,17885,74570,0,92455
142030501500000,NW 311,Residential,17811,70073,0,87884
142030501600000,NW 311,Residential,17631,54928,0,72559
142030501700000,NW 311,Residential,13104,61070,0,74174
142030501800000,NW 311,Residential,13104,40406,0,53510
142030501900000,NW 311,Residential,13104,56086,0,69190
142030502000000,NW 311,Residential,13104,41047,0,54151
142030502100000,NW 311,Residential,13104,41710,0,54814
142030502200000,NW 311,Residential,13104,36690,0,49794
142030502300000,NW 311,Residential,5000,0,0,5000
142030502400000,NW 311,Residential,5000,0,0,5000
142030502500000,NW 311,Residential,13104,56067,0,69171
142030502600000,NW 311,Residential,13104,53523,0,66627
142030502700000,NW 311,Residential,11504,0,0,11504
142030502800000,NW 311,Residential,18870,55171,0,74041
142030600100000,NW 312,Residential,25088,108422,0,133510
142030600200000,NW 312,Residential,21168,86039,0,107207
142030600300000,NW 312,Residential,22176,82425,0,104601
142030600400000,NW 312,Residential,21384,109829,0,131213
142030600500000,NW 312,Residential,20839,96820,0,117659
142032600100000,NW 312,Residential,24404,74632,0,99036
142032600200000,NW 312,Residential,26520,112815,0,139335
142032600300000,NW 312,Residential,29376,120848,0,150224
142032600400000,NW 312,Residential,25349,89181,0,114530
142032600500000,NW 312,Residential,24960,84246,0,109206
142032600600000,NW 312,Residential,27120,57880,0,85000
142032600700000,NW 312,Residential,25680,80662,0,106342
142032600800000,NW 312,Residential,23970,103582,0,127552
142032600900000,NW 312,Residential,32425,118462,0,150887
142032601000000,NW 312,Residential,24133,97890,0,122023
142032601100000,NW 312,Residential,24000,74821,0,98821
142032601200000,NW 312,Residential,24000,89275,0,113275
142032601300000,NW 312,Residential,24000,92779,0,116779
142032601400000,NW 312,Residential,24768,85413,0,110181
142032700100000,NW 312,Residential,63550,116687,0,180237
142032700200000,NW 312,Residential,31718,96826,0,128544
142032700300000,NW 312,Residential,27901,94302,0,122203
142032700400000,NW 312,Residential,25220,104380,0,129600
142032700500000,NW 312,Residential,27677,97602,0,125279
142032700600000,NW 312,Residential,28777,96849,0,125626
142032700700000,NW 312,Residential,29837,91676,0,121513
142032700800000,NW 312,Residential,27179,105588,0,132767
142032701000000,NW 312,Residential,26700,99320,0,126020
142032701100000,NW 312,Residential,26668,102348,0,129016
142032701200000,NW 312,Residential,28120,100616,0,128736
142032701300000,NW 312,Residential,28747,94777,0,123524
142032702100000,NW 312,Residential,23467,98637,0,122104
142032800100000,NW 312,Residential,23823,94408,0,118231
142032800200000,NW 312,Residential,24000,97020,0,121020
142032800300000,NW 312,Residential,24000,92930,0,116930
142032800400000,NW 312,Residential,24000,101977,0,125977
142032800500000,NW 312,Residential,24000,87013,0,111013
142032800600000,NW 312,Residential,24000,78233,0,102233
142032800700000,NW 312,Residential,24000,77413,0,101413
142032800800000,NW 312,Residential,24000,90085,0,114085
142032800900000,NW 312,Residential,24000,89564,0,113564
142032801000000,NW 312,Residential,24000,82140,0,106140
142032801100000,NW 312,Residential,24000,94912,0,118912
142032801200000,NW 312,Residential,24000,90197,0,114197
142032801300000,NW 312,Residential,24000,86110,0,110110
142032801400000,NW 312,Residential,24000,103288,0,127288
142032801500000,NW 312,Residential,25600,93759,0,119359
142032801600000,NW 312,Residential,25600,81509,0,107109
142032801700000,NW 312,Residential,25600,71497,0,97097
142032801800000,NW 312,Residential,25600,100773,0,126373
142032801900000,NW 312,Residential,25600,103582,0,129182
142032802000000,NW 312,Residential,28000,112295,0,140295
142032802100000,NW 312,Residential,28000,124559,0,152559
142032900100000,NW 312,Residential,25700,102153,0,127853
142032900200000,NW 312,Residential,26520,96175,0,122695
142032900300000,NW 312,Residential,26520,111054,0,137574
142032900400000,NW 312,Residential,26539,79238,0,105777
142032900500000,NW 312,Residential,28955,93136,0,122091
142032900600000,NW 312,Residential,28400,84359,0,112759
142032900700000,NW 312,Residential,26787,77386,0,104173
142032900800000,NW 312,Residential,28496,96585,0,125081
142032900900000,NW 312,Residential,29702,73570,0,103272
142032901000000,NW 312,Residential,29430,84572,0,114002
142032901100000,NW 312,Residential,29430,73555,0,102985
142032901200000,NW 312,Residential,31280,86822,0,118102
142033000100000,NW 312,Residential,25480,88313,0,113793
142033000200000,NW 312,Residential,29161,89274,0,118435
142033000300000,NW 312,Residential,27440,95722,0,123162
142033000400000,NW 312,Residential,26160,71952,0,98112
142033000500000,NW 312,Residential,26400,119467,0,145867
142033000600000,NW 312,Residential,29380,80900,0,110280
142033000700000,NW 312,Residential,28340,89875,0,118215
142033000800000,NW 312,Residential,28000,87925,0,115925
142033000900000,NW 312,Residential,28000,89355,0,117355
142033001000000,NW 312,Residential,28000,91178,0,119178
142033001100000,NW 312,Residential,27720,87043,0,114763
142033001200000,NW 312,Residential,27701,99885,0,127586
142033001300000,NW 312,Residential,27160,98699,0,125859
142033001400000,NW 312,Residential,30652,87067,0,117719
142033001500000,NW 312,Residential,29165,99708,0,128873
142033001600000,NW 312,Residential,25600,92606,0,118206
142033001700000,NW 312,Residential,25600,99076,0,124676
142033001800000,NW 312,Residential,25344,86223,0,111567
142033001900000,NW 312,Residential,29200,122442,0,151642
142033002000000,NW 312,Residential,30368,85494,0,115862
142033002100000,NW 312,Residential,29349,86348,0,115697
142033002200000,NW 312,Residential,30766,99871,0,130637
142033002300000,NW 312,Residential,29397,99228,0,128625
142033002400000,NW 312,Residential,26000,93598,0,119598
142033002500000,NW 312,Residential,27744,110247,0,137991
142033002600000,NW 312,Residential,28928,64106,0,93034
142033002700000,NW 312,Residential,29136,101459,0,130595
142033002800000,NW 312,Residential,27120,102874,0,129994
142033002900000,NW 312,Residential,26400,103152,0,129552
142033003000000,NW 312,Residential,28672,85039,0,113711
142033100100000,NW 312,Residential,30396,69469,0,99865
142033100200000,NW 312,Residential,29845,100424,0,130269
142033100300000,NW 312,Residential,22116,76876,0,98992
142033100400000,NW 312,Residential,23280,74532,0,97812
142033100500000,NW 312,Residential,23280,103012,0,126292
142033100600000,NW 312,Residential,23280,83368,0,106648
142033100700000,NW 312,Residential,23280,80120,0,103400
142033100800000,NW 312,Residential,23280,84503,0,107783
142033100900000,NW 312,Residential,23280,79975,0,103255
142033101000000,NW 312,Residential,23280,84259,0,107539
142033101100000,NW 312,Residential,23280,75137,0,98417
142033101200000,NW 312,Residential,23280,95445,0,118725
142033101300000,NW 312,Residential,24832,92149,0,116981
142033101400000,NW 312,Residential,24832,75138,0,99970
142033101500000,NW 312,Residential,24832,82450,0,107282
142033101600000,NW 312,Residential,24832,64313,0,89145
142033101700000,NW 312,Residential,24832,78283,0,103115
142033101800000,NW 312,Residential,27160,96525,0,123685
142033101900000,NW 312,Residential,27160,82702,0,109862
142033102000000,NW 312,Residential,28000,79281,0,107281
142033102100000,NW 312,Residential,28239,83594,0,111833
142033102200000,NW 312,Residential,27160,81989,0,109149
142033102300000,NW 312,Residential,27160,82078,0,109238
142033102400000,NW 312,Residential,27160,75977,0,103137
142033102500000,NW 312,Residential,27160,77112,0,104272
142033102600000,NW 312,Residential,24444,109074,0,133518
142033102700000,NW 312,Residential,24444,94070,0,118514
142033102800000,NW 312,Residential,23280,98534,0,121814
142033102900000,NW 312,Residential,23280,84989,0,108269
142033103000000,NW 312,Residential,23280,91267,0,114547
142033103100000,NW 312,Residential,23280,82249,0,105529
142033103200000,NW 312,Residential,21560,106825,0,128385
142033200100000,NW 312,Residential,29675,86728,0,116403
142033200200000,NW 312,Residential,30977,90791,0,121768
142033200300000,NW 312,Residential,28195,94658,0,122853
142033200400000,NW 312,Residential,29400,94018,0,123418
142033200500000,NW 312,Residential,29640,97127,0,126767
142033200600000,NW 312,Residential,28718,111633,0,140351
142033200700000,NW 312,Residential,25160,80951,0,106111
142033200800000,NW 312,Residential,25440,89499,0,114939
142033200900000,NW 312,Residential,25920,94256,0,120176
142033201000000,NW 312,Residential,29205,117347,0,146552
142035100100000,APTS NW,Commercial,184680,0,1184047,1368727
142035100200000,NW 312,Residential,29184,81654,0,110838
142035100300000,NW 312,Residential,24000,88914,0,112914
142035100400000,NW 312,Residential,24000,81285,0,105285
142035100500000,NW 312,Residential,24000,87350,0,111350
142035100600000,NW 312,Residential,24000,98609,0,122609
142035100700000,NW 312,Residential,24000,85650,0,109650
142035100800000,NW 312,Residential,25317,86549,0,111866
142035100900000,NW 312,Residential,25625,75166,0,100791
142035101800000,APTS NW,Commercial,122580,0,1336332,1458912
142035101900000,NW 312,Residential,26624,118845,0,145469
142035102000000,NW 312,Residential,20188,84365,0,104553
142035102100000,NW 312,Residential,23760,83902,0,107662
142035102200000,NW 312,Residential,17607,148340,0,165947
142035102300000,NW 312,Residential,23760,94202,0,117962
142035102400000,NW 312,Residential,23760,82951,0,106711
142035102500000,NW 312,Residential,23760,114849,0,138609
142035102600000,NW 312,Residential,30969,110605,0,141574
142035102700000,NW 312,Residential,479,0,0,479
142035102800000,NW 312,Residential,28200,112279,0,140479
142035102900000,NW 312,Residential,19176,107564,0,126740
142035103000000,NW 312,Residential,930,0,0,930
142035103100000,NW 312,Residential,51200,236181,0,287381
142035200100000,NW 312,Residential,28613,91783,0,120396
142035200200000,NW 312,Residential,27720,65804,0,93524
142035200300000,NW 312,Residential,28280,61590,0,89870
142035200400000,NW 312,Residential,28560,82036,0,110596
142035200500000,NW 312,Residential,28560,95632,0,124192
142035200600000,NW 312,Residential,28682,74354,0,103036
142035200700000,NW 312,Residential,29387,89195,0,118582
142035200800000,NW 312,Residential,26069,101495,0,127564
142035200900000,NW 312,Residential,25433,83805,0,109238
142035201000000,NW 312,Residential,23280,75638,0,98918
142035201100000,NW 312,Residential,23433,71093,0,94526
142035201200000,NW 312,Residential,24827,71633,0,96460
142035201300000,NW 312,Residential,28292,89806,0,118098
142035201400000,NW 312,Residential,28280,69043,0,97323
142035201500000,NW 312,Residential,28280,83511,0,111791
142035201600000,NW 312,Residential,29484,86722,0,116206
142035300100000,NW 312,Residential,28000,87173,0,115173
142035300200000,NW 312,Residential,28000,76361,0,104361
142035300300000,NW 312,Residential,28000,85290,0,113290
142035300400000,NW 312,Residential,28000,74135,0,102135
142035300500000,NW 312,Residential,28120,89678,0,117798
142035300600000,NW 312,Residential,29682,69071,0,98753
142035400100000,APTS NW,Commercial,13760,0,106695,120455
142035400200000,NW 312,Residential,19012,82283,0,101295
142035400300000,NW 312,Residential,20923,101645,0,122568
142035501000000,NW 312,Residential,29316,103642,0,132958
142035501100000,NW 312,Residential,23040,64832,0,87872
142035501200000,NW 312,Residential,23040,77830,0,100870
142035501300000,NW 312,Residential,23040,84906,0,107946
142035501400000,NW 312,Residential,29100,85624,0,114724
142035501500000,NW 312,Residential,29400,90905,0,120305
142035501600000,NW 312,Residential,25600,91183,0,116783
142035501700000,NW 312,Residential,25976,85149,0,111125
142035600100000,NW 312,Residential,244,0,0,244
142035700100000,APTS NW,Commercial,36666,0,429107,465773
142035700200000,APTS NW,Commercial,40905,0,368653,409558
142035700300000,E-15 CITY,Exempt,0,0,0,0
142035700400000,NW 322,Residential,26705,81560,0,108265
142035700500000,E-15 CITY,Exempt,0,0,0,0
142035700600000,NW 322,Residential,40757,111767,0,152524
142035700700000,NW 322,Residential,30625,76966,0,107591
142035700800000,NW 322,Residential,24745,83717,0,108462
142035700900000,NW 322,Residential,23520,67344,0,90864
142035701000000,NW 322,Residential,23280,76672,0,99952
142035701100000,NW 322,Residential,29582,88448,0,118030
142035701200000,NW 322,Residential,30660,81218,0,111878
142035701300000,NW 322,Residential,28800,73381,0,102181
142035701400000,NW 322,Residential,28453,67165,0,95618
142035701500000,NW 322,Residential,24480,79275,0,103755
142035701600000,NW 322,Residential,24360,54591,0,78951
142035701700000,NW 322,Residential,26536,77040,0,103576
142035701800000,NW 322,Residential,25920,66800,0,92720
142035701900000,NW 322,Residential,26160,47694,0,73854
142035702000000,NW 322,Residential,26400,69146,0,95546
142035800100000,NW 322,Residential,22100,60317,0,82417
142035800200000,NW 322,Residential,22560,69333,0,91893
142035800300000,NW 322,Residential,22560,76417,0,98977
142035800400000,NW 322,Residential,22560,59865,0,82425
142035800500000,NW 322,Residential,22560,58351,0,80911
142035800600000,NW 322,Residential,22560,72258,0,94818
142035800700000,NW 322,Residential,23855,97928,0,121783
142035800800000,NW 322,Residential,19967,73492,0,93459
142035800900000,NW 322,Residential,19740,87630,0,107370
142035801000000,NW 322,Residential,19740,78456,0,98196
142035801100000,NW 322,Residential,19740,82297,0,102037
142035801200000,NW 322,Residential,19740,74337,0,94077
142035801300000,NW 322,Residential,19740,90275,0,110015
142035801400000,NW 322,Residential,21385,72836,0,94221
142037600100000,NW 311,Residential,18376,72236,0,90612
142037600200000,NW 311,Residential,17816,25913,0,43729
142037600300000,NW 311,Residential,11025,34744,0,45769
142037600400000,NW 311,Residential,11025,21164,0,32189
142037600500000,NW 311,Residential,12600,55811,0,68411
142037600600000,NW 311,Residential,12600,36184,0,48784
142037600700000,NW 311,Residential,5000,0,0,5000
142037600800000,NW 311,Residential,17640,51434,0,69074
142037600900000,NW 311,Residential,12600,54126,0,66726
142037601000000,NW 311,Residential,12600,58953,0,71553
142037601100000,NW 311,Residential,12474,51240,0,63714
142037601200000,NW 311,Residential,12474,53719,0,66193
142037601300000,NW 311,Residential,17464,80572,0,98036
142037601400000,NW 311,Residential,15284,51373,0,66657
142037700100000,NW 311,Residential,28433,85836,0,114269
142037700200000,NW 312,Residential,29136,95993,0,125129
142037700300000,NW 312,Residential,29280,77117,0,106397
142037700400000,NW 312,Residential,30973,96527,0,127500
142037700500000,NW 312,Residential,29520,95806,0,125326
142037700600000,NW 312,Residential,26400,103705,0,130105
142037700700000,NW 312,Residential,27060,97890,0,124950
142037700800000,NW 312,Residential,29520,102485,0,132005
142037700900000,NW 312,Residential,29295,91583,0,120878
142037701000000,NW 312,Residential,34648,95968,0,130616
142037701100000,NW 312,Residential,29036,92834,0,121870
142037701200000,NW 312,Residential,28798,93366,0,122164
142037701300000,NW 312,Residential,29621,85925,0,115546
142037701400000,NW 312,Residential,23590,106217,0,129807
142037701500000,NW 312,Residential,23280,87443,0,110723
142037701600000,NW 312,Residential,25973,88991,0,114964
142037701700000,NW 312,Residential,28120,80045,0,108165
142037701800000,NW 311,Residential,34227,130373,0,164600
142037701900000,NW 311,Residential,25235,63330,0,88565
142037702000000,NW 311,Residential,20703,91980,0,112683
142037702100000,NW 311,Residential,23888,112465,0,136353
142037702200000,NW 311,Residential,24000,78346,0,102346
142037702300000,NW 311,Residential,24000,85694,0,109694
142037702400000,NW 311,Residential,24000,67025,0,91025
142037702500000,NW 311,Residential,24000,68184,0,92184
142037702600000,NW 311,Residential,24000,54256,0,78256
142037702700000,NW 311,Residential,24000,80480,0,104480
142037702800000,NW 311,Residential,24240,76405,0,100645
142037702900000,NW 311,Residential,24480,72851,0,97331
142037703000000,NW 311,Residential,24720,59043,0,83763
142037703100000,NW 311,Residential,28600,94097,0,122697
142037703200000,NW 311,Residential,24960,71576,0,96536
142037703300000,NW 311,Residential,27300,91425,0,118725
142037800100000,NW 312,Residential,23538,89762,0,113300
142037800200000,NW 312,Residential,23534,117205,0,140739
142037900100000,NW 312,Residential,22560,96073,0,118633
142037900200000,NW 312,Residential,51,0,0,51
142037900300000,NW 312,Residential,23760,86620,0,110380
142037900400000,NW 312,Residential,23760,131698,0,155458
142037900500000,NW 312,Residential,27720,88735,0,116455
142037900600000,NW 312,Residential,28000,86675,0,114675
142037900700000,NW 312,Residential,27040,102812,0,129852
142037900800000,NW 312,Residential,26784,90147,0,116931
142037900900000,NW 312,Residential,29392,100611,0,130003
142037901000000,NW 312,Residential,29088,88621,0,117709
142038000100000,NW 311,Residential,12996,74024,0,87020
142038000200000,NW 311,Residential,17640,62071,0,79711
142038000300000,NW 311,Residential,17010,32687,0,49697
142038000400000,NW 311,Residential,17010,68937,0,85947
142038000500000,NW 311,Residential,12600,41429,0,54029
142038000600000,NW 311,Residential,17640,52222,0,69862
142038000700000,NW 311,Residential,24570,70271,0,94841
142038000800000,NW 311,Residential,12600,43261,0,55861
142038000900000,NW 311,Residential,17640,49897,0,67537
142038001000000,NW 311,Residential,12600,43052,0,55652
142038001100000,NW 311,Residential,17818,71134,0,88952
142038001200000,NW 311,Residential,13500,50321,0,63821
142038001300000,NW 311,Residential,10710,53335,0,64045
142038001500000,NW 311,Residential,11575,45656,0,57231
142038001600000,NW 311,Residential,17983,75438,0,93421
142038001700000,NW 311,Residential,14400,61114,0,75514
142038001800000,NW 311,Residential,14400,67855,0,82255
142038001900000,NW 311,Residential,14400,60113,0,74513
142038002000000,NW 311,Residential,14400,62072,0,76472
142038002100000,NW 311,Residential,12600,47495,0,60095
142038002200000,NW 311,Residential,14400,62752,0,77152
142038002300000,NW 311,Residential,14400,54773,0,69173
142038002400000,NW 311,Residential,17280,55624,0,72904
142038002500000,NW 311,Residential,16830,64062,0,80892
142038002600000,NW 311,Residential,14400,59834,0,74234
142038002700000,NW 311,Residential,14400,63394,0,77794
142038002800000,NW 311,Residential,14400,64960,0,79360
142038002900000,NW 311,Residential,14004,59783,0,73787
142038100100000,NW 311,Residential,14796,50706,0,65502
142038100200000,NW 311,Residential,14400,50031,0,64431
142038100300000,NW 311,Residential,14400,66557,0,80957
142038100400000,NW 311,Residential,12600,68156,0,80756
142038100500000,NW 311,Residential,14400,55833,0,70233
142038100600000,NW 311,Residential,14400,62125,0,76525
142038100700000,NW 311,Residential,14400,67432,0,81832
142038100800000,NW 311,Residential,14400,54967,0,69367
142038100900000,NW 311,Residential,12600,53933,0,66533
142038101000000,NW 311,Residential,14400,61973,0,76373
142038101100000,NW 311,Residential,14400,60082,0,74482
142038101200000,NW 311,Residential,14400,67511,0,81911
142038101300000,NW 311,Residential,14400,71386,0,85786
142038101400000,NW 311,Residential,14400,54908,0,69308
142038101500000,NW 311,Residential,13186,55337,0,68523
142038101600000,NW 311,Residential,13303,71143,0,84446
142038101700000,NW 311,Residential,15498,61444,0,76942
142038101800000,NW 311,Residential,17010,74277,0,91287
142038101900000,NW 311,Residential,12885,75216,0,88101
142038102000000,NW 311,Residential,12600,57091,0,69691
142038102100000,NW 311,Residential,14400,48572,0,62972
142038102200000,NW 311,Residential,14400,64446,0,78846
142038102300000,NW 311,Residential,14400,59475,0,73875
142038102400000,NW 311,Residential,14400,61200,0,75600
142038102500000,NW 311,Residential,14400,54305,0,68705
142038102600000,NW 311,Residential,14400,78986,0,93386
142038102700000,NW 311,Residential,14400,66756,0,81156
142038102800000,NW 311,Residential,14004,48631,0,62635
142038102900000,NW 311,Residential,15840,63308,0,79148
142038103000000,NW 311,Residential,15840,53543,0,69383
142038103100000,NW 311,Residential,15840,63398,0,79238
142038103200000,NW 311,Residential,15840,75200,0,91040
142038103300000,NW 311,Residential,15840,75495,0,91335
142038200100000,NW 311,Residential,15840,75896,0,91736
142038200200000,NW 311,Residential,15840,67315,0,83155
142038200300000,NW 311,Residential,15840,70563,0,86403
142038200400000,NW 311,Residential,17280,50142,0,67422
142038200500000,NW 311,Residential,14400,74187,0,88587
142038200600000,NW 311,Residential,14796,72576,0,87372
142038200700000,NW 311,Residential,14400,62522,0,76922
142038200800000,NW 311,Residential,14400,48842,0,63242
142038200900000,NW 311,Residential,14400,50532,0,64932
142038201000000,NW 311,Residential,14400,63180,0,77580
142038201100000,NW 311,Residential,14400,65423,0,79823
142038201200000,NW 311,Residential,14400,65000,0,79400
142038201300000,NW 311,Residential,14400,66159,0,80559
142038201400000,NW 311,Residential,16200,53825,0,70025
142038201500000,NW 311,Residential,15988,62733,0,78721
142038201600000,NW 311,Residential,10962,44262,0,55224
142038201700000,NW 311,Residential,11340,62401,0,73741
142038201800000,NW 311,Residential,17302,69276,0,86578
142038201900000,NW 311,Residential,17595,51886,0,69481
142038202000000,NW 311,Residential,14400,0,0,14400
142038202100000,NW 311,Residential,14400,47064,0,61464
142038202200000,NW 311,Residential,14400,53966,0,68366
142038202300000,NW 311,Residential,14400,54917,0,69317
142038202400000,NW 311,Residential,14400,43520,0,57920
142038202500000,NW 311,Residential,15804,82079,0,97883
142038202600000,NW 311,Residential,12600,71763,0,84363
142038202700000,NW 311,Residential,15840,66577,0,82417
142038202800000,NW 311,Residential,15840,5351,0,21191
142038202900000,NW 311,Residential,15840,69508,0,85348
142038203000000,NW 311,Residential,14400,57894,0,72294
142038203100000,NW 311,Residential,17280,60993,0,78273
142038300100000,NW 311,Residential,16669,58331,0,75000
142038300200000,NW 311,Residential,16450,74420,0,90870
142038300300000,NW 311,Residential,14280,37943,0,52223
142038300400000,NW 311,Residential,21210,54813,0,76023
142038300500000,NW 311,Residential,15283,64625,0,79908
142038300600000,NW 311,Residential,15633,61481,0,77114
142038300700000,NW 311,Residential,16632,70288,0,86920
142038300800000,NW 311,Residential,15957,61318,0,77275
142038300900000,NW 311,Residential,18111,45603,0,63714
142038301000000,NW 311,Residential,20503,64563,0,85066
142038301100000,NW 311,Residential,18207,33830,0,52037
142038301200000,NW 311,Residential,21728,67370,0,89098
142038301300000,NW 311,Residential,16000,30021,0,46021
142038301400000,NW 311,Residential,20400,61258,0,81658
142038301500000,NW 311,Residential,20400,56156,0,76556
142038301600000,NW 311,Residential,21326,76484,0,97810
142038301700000,NW 311,Residential,21000,59029,0,80029
142038301800000,NW 311,Residential,12460,54073,0,66533
142038400100000,APTS NW,Commercial,33826,0,291744,325570
142040100100000,NW 317,Residential,6600,0,0,6600
142040100200000,NW 317,Residential,5000,0,0,5000
142040100300000,CONVERSIONS,Commercial,5400,0,0,5400
142040100400000,COMM NW,Commercial,16200,0,770,16970
142040100500000,NW 317,Residential,6600,0,0,6600
142040100600000,NW 317,Residential,5000,0,0,5000
142040100700000,NW 317,Residential,7160,0,0,7160
142040100800000,NW 317,Commercial,7128,0,10467,17595
142040100900000,COMM NW,Commercial,16200,0,11436,27636
142040101000000,NW 317,Residential,5000,0,0,5000
142040200100000,NW 317,Residential,5000,0,0,5000
142040200200000,NW 317,Residential,5000,0,0,5000
142040200300000,NW 317,Residential,5000,0,0,5000
142040200400000,NW 317,Residential,5000,0,0,5000
142040200500000,NW 317,Residential,5000,0,0,5000
142040200600000,NW 317,Residential,5000,0,0,5000
142040200700000,NW 317,Residential,5000,0,0,5000
142040200800000,NW 317,Residential,5000,0,0,5000
142040200900000,NW 317,Residential,6600,0,0,6600
142040201000000,NW 317,Residential,6600,0,0,6600
142040201100000,NW 317,Residential,6600,0,0,6600
142040201200000,NW 317,Residential,5000,0,0,5000
142040201300000,NW 317,Residential,5000,0,0,5000
142040201400000,NW 317,Residential,5000,0,0,5000
142040201500000,NW 317,Residential,5000,0,0,5000
142040201600000,NW 317,Residential,7160,0,0,7160
142040201700000,NW 317,Residential,5000,0,0,5000
142040201800000,NW 317,Residential,5000,0,0,5000
142040201900000,NW 317,Residential,5000,0,0,5000
142040202000000,NW 317,Residential,6600,0,0,6600
142040202200000,NW 317,Residential,5000,0,0,5000
142040202300000,NW 317,Residential,5000,0,0,5000
142040300100000,NW 317,Residential,5000,0,0,5000
142040300200000,NW 317,Residential,7500,0,0,7500
142040300300000,NW 317,Residential,5000,0,0,5000
142040300400000,NW 317,Residential,7500,0,0,7500
142040300500000,NW 317,Residential,5000,0,0,5000
142040300600000,NW 317,Residential,5000,0,0,5000
142040300700000,NW 317,Residential,5000,0,0,5000
142040300800000,NW 317,Residential,5000,0,0,5000
142040300900000,COMM NW,Commercial,3758,0,0,3758
142040301100000,NW 317,Residential,5000,0,0,5000
142040301200000,NW 317,Residential,5265,0,0,5265
142040301400000,NW 317,Residential,5000,0,0,5000
142040301500000,NW 317,Residential,5000,0,0,5000
142040301600000,NW 317,Residential,5000,0,0,5000
142040301700000,NW 317,Residential,7500,23306,0,30806
142040301800000,NW 317,Residential,5000,0,0,5000
142040301900000,NW 317,Residential,5000,0,0,5000
142040400100000,NW 310,Residential,12994,30225,0,43219
142040400200000,NW 310,Residential,5000,0,0,5000
142040400300000,NW 310,Residential,5000,0,0,5000
142040400400000,NW 310,Residential,7276,40060,0,47336
142040400600000,NW 310,Residential,5790,0,0,5790
142040400700000,NW 310,Residential,5000,0,0,5000
142040400800000,NW 310,Residential,7325,0,0,7325
142040400900000,NW 310,Residential,5000,0,0,5000
142040401000000,NW 310,Residential,7325,0,0,7325
142040401100000,NW 310,Residential,9491,0,0,9491
142040401200000,NW 310,Residential,5000,0,0,5000
142040401300000,NW 310,Residential,5000,0,0,5000
142040401400000,NW 310,Residential,5000,0,0,5000
142040401500000,NW 310,Residential,7325,0,0,7325
142040401600000,NW 310,Residential,7325,0,0,7325
142040401700000,NW 310,Residential,7325,0,0,7325
142040500100000,NW 310,Residential,12994,24326,0,37320
142040500200000,NW 310,Residential,5000,0,0,5000
142040500300000,NW 310,Residential,5000,0,0,5000
142040500400000,NW 310,Residential,5000,0,0,5000
142040500500000,NW 310,Residential,5000,0,0,5000
142040500600000,NW 310,Residential,5000,0,0,5000
142040500700000,NW 310,Residential,5000,0,0,5000
142040500800000,COMM NW,Commercial,31104,0,38097,69201
142040500900000,COMM NW,Commercial,20736,0,12204,32940
142040501000000,NW 310,Residential,7325,0,0,7325
142040501100000,NW 310,Residential,7325,0,0,7325
142040501200000,NW 310,Residential,7325,0,0,7325
142040501300000,NW 310,Residential,7325,0,0,7325
142040501400000,NW 310,Residential,7325,0,0,7325
142040501500000,NW 310,Residential,12994,35617,0,48611
142040501600000,NW 310,Residential,12994,26668,0,39662
142040600100000,COMM NW,Commercial,188217,0,437759,625976
142040600200000,E-15 CITY,Exempt,0,0,0,0
142040600300000,APTS NW,Commercial,5400,0,0,5400
142040600400000,NW 310,Residential,2970,0,0,2970
142040600500000,NW 310,Residential,5000,0,0,5000
142040600600000,NW 310,Residential,5000,0,0,5000
142040600700000,NW 310,Residential,7325,0,0,7325
142040600800000,NW 310,Residential,7325,0,0,7325
142040600900000,NW 310,Residential,5000,0,0,5000
142040601000000,NW 310,Residential,5000,0,0,5000
142040601100000,NW 310,Residential,5000,0,0,5000
142040601200000,NW 310,Residential,5000,0,0,5000
142040601300000,NW 310,Residential,5000,0,0,5000
142040601400000,NW 310,Residential,5000,0,0,5000
142040601500000,NW 310,Residential,5000,0,0,5000
142040601600000,NW 310,Residential,2275,0,0,2275
142040602400000,NW 317,Residential,6062,0,0,6062
142040602500000,NW 317,Residential,5000,0,0,5000
142040602600000,NW 317,Residential,5000,0,0,5000
142040602700000,NW 317,Residential,5000,0,0,5000
142040602800000,NW 317,Residential,5000,0,0,5000
142040602900000,NW 317,Residential,8188,0,0,8188
142040700100000,NW 310,Residential,7325,0,0,7325
142040700200000,COMM NW,Commercial,10368,0,22497,32865
142040700300000,NW 310,Residential,5000,0,0,5000
142040700400000,NW 310,Residential,5000,0,0,5000
142040700500000,NW 310,Residential,5000,0,0,5000
142040700600000,NW 310,Residential,5000,0,0,5000
142040700700000,NW 310,Residential,5000,0,0,5000
142040700800000,COMM NW,Commercial,15552,0,0,15552
142040700900000,COMM NW,Commercial,45684,0,6167,51851
142040701000000,NW 310,Residential,3086,0,0,3086
142040701100000,NW 310,Residential,5000,0,0,5000
142040701200000,NW 310,Residential,4830,0,0,4830
142040701300000,NW 310,Residential,5000,0,0,5000
142040701400000,NW 310,Residential,5000,0,0,5000
142040701500000,NW 310,Residential,5000,0,0,5000
142040701600000,NW 310,Residential,7325,0,0,7325
142040701700000,NW 310,Residential,5000,0,0,5000
142040701800000,NW 310,Residential,7325,0,0,7325
142040701900000,NW 310,Residential,7325,0,0,7325
142040800100000,NW 317,Residential,5000,0,0,5000
142040800200000,NW 317,Residential,5000,0,0,5000
142040800300000,NW 317,Residential,5000,0,0,5000
142040800400000,NW 317,Residential,5000,0,0,5000
142040800500000,NW 317,Residential,5000,0,0,5000
142040800600000,NW 317,Residential,5000,0,0,5000
142040800700000,NW 317,Residential,5000,0,0,5000
142040800800000,E-15 CITY,Exempt,0,0,0,0
142040800900000,NW 317,Residential,5000,0,0,5000
142040801000000,NW 317,Residential,5000,0,0,5000
142040801100000,E-10 COUNTY,Exempt,0,0,0,0
142040801200000,NW 317,Residential,5000,0,0,5000
142040801300000,NW 317,Residential,4392,0,0,4392
142040801400000,NW 317,Residential,5000,0,0,5000
142040801500000,NW 317,Residential,5000,0,0,5000
142040801600000,NW 317,Residential,5000,0,0,5000
142040801700000,NW 317,Residential,3060,0,0,3060
142040901700000,NW 310,Residential,5000,0,0,5000
142040901800000,NW 310,Residential,5000,0,0,5000
142040901900000,NW 310,Residential,12994,34734,0,47728
142040902000000,NW 310,Residential,7325,0,0,7325
142040902100000,NW 310,Residential,5000,0,0,5000
142040902200000,NW 310,Residential,5000,0,0,5000
142040902300000,NW 310,Residential,9281,28264,0,37545
142041000100000,NW 310,Residential,5000,0,0,5000
142041000200000,NW 310,Residential,5000,0,0,5000
142041000300000,NW 310,Residential,7325,0,0,7325
142041000400000,NW 310,Residential,5740,0,0,5740
142041000500000,NW 310,Residential,5000,0,0,5000
142041000600000,NW 310,Residential,14850,0,0,14850
142041000700000,NW 310,Residential,5000,0,0,5000
142041000800000,NW 310,Residential,11695,27929,0,39624
142041000900000,NW 310,Residential,5593,0,0,5593
142041001000000,NW 310,Residential,5593,0,0,5593
142041001100000,NW 310,Residential,5000,0,0,5000
142041001200000,NW 310,Residential,5000,0,0,5000
142041001300000,NW 310,Residential,5000,0,0,5000
142041001400000,NW 310,Residential,5000,0,0,5000
142041001500000,NW 310,Residential,5000,0,0,5000
142041100100000,NW 317,Residential,5000,0,0,5000
142041100200000,NW 317,Residential,5000,0,0,5000
142041100300000,NW 317,Residential,5000,0,0,5000
142041100400000,NW 317,Residential,5000,0,0,5000
142041100500000,Empty,Other,0,0,0,0
142042600100000,NW 310,Residential,5000,0,0,5000
142042600200000,NW 310,Residential,5000,0,0,5000
142042600300000,NW 310,Residential,5000,0,0,5000
142042600400000,NW 310,Residential,9800,0,0,9800
142042600500000,NW 310,Residential,5000,0,0,5000
142042600600000,NW 310,Residential,5000,0,0,5000
142042600700000,NW 310,Residential,2970,0,0,2970
142042600800000,COMM NW,Commercial,29565,0,26462,56027
142042600900000,COMM NW,Commercial,10368,0,16512,26880
142042601000000,CONVERSIONS,Commercial,7776,0,56119,63895
142042601100000,COMM NW,Commercial,20736,0,5743,26479
142042601200000,NW 310,Residential,5000,0,0,5000
142042601300000,NW 310,Residential,14850,29809,0,44659
142042601400000,NW 310,Residential,5000,0,0,5000
142042601500000,NW 310,Residential,14850,46061,0,60911
142042700100000,NW 310,Residential,14850,43796,0,58646
142042700200000,NW 310,Residential,9800,0,0,9800
142042700300000,NW 310,Residential,14850,51550,0,66400
142042700400000,NW 310,Residential,9800,0,0,9800
142042700500000,NW 310,Residential,5000,0,0,5000
142042700600000,NW 310,Residential,14850,57990,0,72840
142042700700000,NW 310,Residential,5000,0,0,5000
142042700800000,NW 310,Residential,9800,0,0,9800
142042700900000,NW 310,Residential,14850,26760,0,41610
142042701000000,NW 310,Residential,14850,63252,0,78102
142042701100000,NW 310,Residential,5000,0,0,5000
142042701200000,NW 310,Residential,7425,28076,0,35501
142042701300000,NW 310,Residential,14850,14976,0,29826
142042701400000,NW 310,Residential,5000,0,0,5000
142042701500000,NW 310,Residential,5000,0,0,5000
142042701600000,NW 310,Residential,9800,0,0,9800
142042701700000,NW 310,Residential,9800,0,0,9800
142042800100000,NW 310,Residential,9800,0,0,9800
142042800200000,NW 310,Residential,15592,28073,0,43665
142042800300000,NW 310,Residential,5000,0,0,5000
142042800400000,NW 310,Residential,11880,24679,0,36559
142042800500000,NW 310,Residential,5000,0,0,5000
142042800600000,NW 310,Residential,9800,0,0,9800
142042800700000,NW 310,Residential,14850,33775,0,48625
142042800800000,NW 310,Residential,5000,0,0,5000
142042800900000,NW 310,Residential,5000,0,0,5000
142042801000000,NW 310,Residential,9800,0,0,9800
142042801100000,NW 310,Residential,9800,0,0,9800
142042801200000,NW 310,Residential,14850,24570,0,39420
142042801300000,NW 310,Residential,14850,24349,0,39199
142042801400000,NW 310,Residential,14850,54042,0,68892
142042801500000,NW 310,Residential,5000,0,0,5000
142042801600000,NW 310,Residential,9800,0,0,9800
142042900100000,NW 310,Residential,9800,0,0,9800
142042900200000,NW 310,Residential,18360,37405,0,55765
142042900300000,NW 310,Residential,18360,81600,0,99960
142042900400000,NW 310,Residential,18360,54357,0,72717
142042900500000,NW 310,Residential,18360,34877,0,53237
142042900600000,NW 310,Residential,18360,32295,0,50655
142042900700000,NW 310,Residential,18360,54740,0,73100
142042900800000,NW 310,Residential,18360,35763,0,54123
142042900900000,NW 310,Residential,5400,0,0,5400
142042901000000,NW 310,Residential,5000,0,0,5000
142042901100000,NW 310,Residential,14850,38754,0,53604
142042901200000,NW 310,Residential,14850,35524,0,50374
142042901300000,NW 310,Residential,5000,0,0,5000
142042901400000,NW 310,Residential,9800,0,0,9800
142042901500000,NW 310,Residential,9800,0,0,9800
142042901600000,NW 310,Residential,5000,0,0,5000
142043000100000,COMM NW,Commercial,20736,0,3499,24235
142043000200000,NW 310,Residential,14850,26221,0,41071
142043000300000,NW 310,Residential,14850,20164,0,35014
142043000400000,NW 310,Residential,9800,0,0,9800
142043000500000,NW 310,Residential,9800,0,0,9800
142043000600000,NW 310,Residential,9800,0,0,9800
142043000700000,NW 310,Residential,9800,0,0,9800
142043000800000,NW 310,Residential,7000,0,0,7000
142043000900000,NW 310,Residential,2800,0,0,2800
142043001000000,NW 310,Residential,9800,0,0,9800
142043001100000,NW 310,Residential,9800,0,0,9800
142043001200000,NW 310,Residential,9800,0,0,9800
142043001300000,NW 310,Residential,7425,24041,0,31466
142043001400000,NW 310,Residential,5000,0,0,5000
142043001500000,NW 310,Residential,9800,0,0,9800
142043001600000,NW 310,Residential,5000,0,0,5000
142043001700000,NW 310,Residential,9801,41162,0,50963
142043001800000,NW 310,Residential,5000,0,0,5000
142043001900000,COMM NW,Commercial,10368,0,26793,37161
142043100100000,NW 310,Residential,9800,0,0,9800
142043100200000,NW 310,Residential,5000,0,0,5000
142043100300000,NW 310,Residential,9800,0,0,9800
142043100400000,NW 310,Residential,14850,12991,0,27841
142043100500000,NW 310,Residential,14850,32371,0,47221
142043100600000,NW 310,Residential,14850,35880,0,50730
142043100700000,NW 310,Residential,14850,39512,0,54362
142043100800000,NW 310,Residential,9800,0,0,9800
142043100900000,NW 310,Residential,14850,19097,0,33947
142043101000000,NW 310,Residential,14850,34948,0,49798
142043101100000,NW 310,Residential,9800,0,0,9800
142043101200000,NW 310,Residential,9800,0,0,9800
142043101300000,NW 310,Residential,9800,0,0,9800
142043101400000,NW 310,Residential,14850,23917,0,38767
142043101500000,NW 310,Residential,14850,31748,0,46598
142043101600000,NW 310,Residential,14850,26846,0,41696
142043200100000,NW 310,Residential,5000,0,0,5000
142043200200000,NW 310,Residential,14850,4912,0,19762
142043200300000,NW 310,Residential,9800,0,0,9800
142043200400000,NW 310,Residential,14850,26849,0,41699
142043200500000,NW 310,Residential,5000,0,0,5000
142043200600000,NW 310,Residential,9800,0,0,9800
142043200700000,NW 310,Residential,5000,0,0,5000
142043200800000,NW 310,Residential,5000,0,0,5000
142043200900000,NW 310,Residential,14850,27465,0,42315
142043201000000,NW 310,Residential,5450,31027,0,36477
142043201100000,NW 310,Residential,11092,55411,0,66503
142043201200000,NW 310,Residential,14850,1526,0,16376
142043201300000,NW 310,Residential,14850,28059,0,42909
142043201400000,NW 310,Residential,9800,0,0,9800
142043201500000,NW 310,Residential,5000,0,0,5000
142043201600000,NW 310,Residential,5000,0,0,5000
142043201700000,NW 310,Residential,5000,0,0,5000
142043300100000,NW 310,Residential,9800,0,0,9800
142043300200000,NW 310,Residential,15300,28997,0,44297
142043300300000,NW 310,Residential,15300,38638,0,53938
142043300400000,NW 310,Residential,10400,0,0,10400
142043300500000,NW 310,Residential,15300,29663,0,44963
142043300600000,NW 310,Residential,10400,0,0,10400
142043300700000,NW 310,Residential,10400,0,0,10400
142043300800000,NW 310,Residential,12000,41581,0,53581
142043300900000,NW 310,Residential,6000,0,0,6000
142043301000000,NW 310,Residential,13855,39757,0,53612
142043301100000,NW 310,Residential,5790,0,0,5790
142043301200000,NW 310,Residential,12275,0,0,12275
142043301300000,NW 310,Residential,14850,41069,0,55919
142043301400000,NW 310,Residential,5000,0,0,5000
142043301500000,NW 310,Residential,14850,35879,0,50729
142043301600000,NW 310,Residential,14850,12704,0,27554
142043400100000,NW 310,Residential,9800,0,0,9800
142043400200000,NW 310,Residential,9800,0,0,9800
142043400300000,NW 310,Residential,5000,0,0,5000
142043400400000,NW 310,Residential,9800,0,0,9800
142043400500000,NW 310,Residential,9800,0,0,9800
142043400600000,NW 310,Residential,14850,28319,0,43169
142043400700000,NW 310,Residential,9800,0,0,9800
142043400800000,NW 310,Residential,5840,0,0,5840
142043400900000,COMM NW,Commercial,8294,0,12962,21256
142043401000000,NW 310,Residential,9800,0,0,9800
142043401100000,NW 310,Residential,14850,38342,0,53192
142043401200000,APTS NW,Commercial,6739,0,31269,38008
142043401300000,APTS NW,Commercial,6739,0,32640,39379
142043401400000,NW 310,Residential,5000,0,0,5000
142043500100000,NW 310,Residential,5000,0,0,5000
142043500200000,NW 310,Residential,7325,0,0,7325
142043500300000,NW 310,Residential,5000,0,0,5000
142043500400000,NW 310,Residential,12994,22043,0,35037
142043500500000,NW 310,Residential,5000,0,0,5000
142043500600000,NW 310,Residential,7325,0,0,7325
142043500700000,NW 310,Residential,12994,24704,0,37698
142043500800000,NW 310,Residential,5000,0,0,5000
142043500900000,NW 310,Residential,5840,0,0,5840
142043501000000,NW 310,Residential,9800,0,0,9800
142043501100000,NW 310,Residential,14850,11941,0,26791
142043501200000,NW 310,Residential,5000,0,0,5000
142043501300000,NW 310,Residential,5000,0,0,5000
142043501400000,NW 310,Residential,5000,0,0,5000
142043501500000,NW 310,Residential,5000,0,0,5000
142043600100000,NW 310,Residential,5000,0,0,5000
142043600200000,NW 310,Residential,14850,38984,0,53834
142043600300000,NW 310,Residential,9800,0,0,9800
142043600400000,NW 310,Residential,5000,0,0,5000
142043600500000,NW 310,Residential,14850,60751,0,75601
142043600600000,NW 310,Residential,9800,0,0,9800
142043600700000,NW 310,Residential,14850,2849,0,17699
142043600800000,NW 310,Residential,5840,0,0,5840
142043600900000,NW 310,Residential,10395,62443,0,72838
142043601000000,NW 310,Residential,12994,33791,0,46785
142043601100000,NW 310,Residential,12994,28887,0,41881
142043601200000,NW 310,Residential,5000,0,0,5000
142043601300000,NW 310,Residential,12994,33244,0,46238
142043601400000,NW 310,Residential,12994,36168,0,49162
142043700100000,NW 310,Residential,9800,0,0,9800
142043700200000,NW 310,Residential,15300,29854,0,45154
142043700300000,NW 310,Residential,10400,0,0,10400
142043700400000,NW 310,Residential,15300,34843,0,50143
142043700500000,NW 310,Residential,15300,65785,0,81085
142043700600000,NW 310,Residential,9945,0,0,9945
142043700700000,NW 310,Residential,9945,34879,0,44824
142043700800000,NW 310,Residential,12240,22766,0,35006
142043700900000,NW 310,Residential,5840,0,0,5840
142043701000000,NW 310,Residential,9800,0,0,9800
142043701100000,NW 310,Residential,9800,0,0,9800
142043701200000,NW 310,Residential,9800,0,0,9800
142043701300000,NW 310,Residential,14850,23137,0,37987
142043701400000,NW 310,Residential,14850,24511,0,39361
142045100100000,NW 311,Residential,9975,41201,0,51176
142045100200000,NW 311,Residential,5000,0,0,5000
142045100300000,NW 311,Residential,7980,21448,0,29428
142045100400000,NW 311,Residential,5000,0,0,5000
142045100500000,NW 311,Residential,5000,0,0,5000
142045100600000,NW 311,Residential,5000,0,0,5000
142045100700000,NW 311,Residential,6000,0,0,6000
142045100800000,NW 311,Residential,18000,76364,0,94364
142045100900000,NW 311,Residential,5000,0,0,5000
142045200100000,NW 311,Residential,5000,0,0,5000
142045200200000,NW 311,Residential,10200,27513,0,37713
142045200300000,NW 311,Residential,12000,37645,0,49645
142045200400000,NW 311,Residential,12000,50094,0,62094
142045200500000,NW 311,Residential,7455,18293,0,25748
142045200600000,NW 311,Residential,8520,33911,0,42431
142045200700000,NW 311,Residential,12000,46615,0,58615
142045200800000,NW 311,Residential,6000,0,0,6000
142045200900000,NW 311,Residential,12000,33767,0,45767
142045201000000,NW 311,Residential,12000,56647,0,68647
142045300100000,NW 311,Residential,6000,0,0,6000
142045300200000,NW 311,Residential,13600,57754,0,71354
142045300300000,NW 311,Residential,13600,49658,0,63258
142045300400000,NW 311,Residential,13600,35698,0,49298
142045300500000,NW 311,Residential,13600,48394,0,61994
142045300600000,NW 311,Residential,13600,45281,0,58881
142045300700000,NW 311,Residential,13600,33597,0,47197
142045300800000,NW 311,Residential,13600,52703,0,66303
142045400100000,NW 311,Residential,19754,61893,0,81647
142045400200000,NW 311,Residential,13600,78649,0,92249
142045400300000,NW 311,Residential,5000,0,0,5000
142045400400000,NW 311,Residential,8211,51798,0,60009
142045500100000,NW 311,Residential,11400,28847,0,40247
142045500200000,NW 311,Residential,12000,33900,0,45900
142045500300000,NW 311,Residential,6000,0,0,6000
142045500400000,NW 311,Residential,5000,0,0,5000
142045500500000,NW 311,Residential,6000,0,0,6000
142045500600000,NW 311,Residential,10800,49563,0,60363
142045500700000,NW 311,Residential,10800,41845,0,52645
142045500800000,NW 311,Residential,5000,0,0,5000
142045500900000,NW 311,Residential,7980,21691,0,29671
142045501000000,NW 311,Residential,5000,0,0,5000
142045501100000,NW 311,Residential,8400,25768,0,34168
142045501200000,NW 311,Residential,8400,46206,0,54606
142045501300000,NW 311,Residential,12000,66671,0,78671
142045501400000,NW 311,Residential,12000,65615,0,77615
142045501500000,NW 311,Residential,5000,0,0,5000
142045501600000,NW 311,Residential,6000,0,0,6000
142045501700000,NW 311,Residential,5000,0,0,5000
142045501800000,NW 311,Residential,14544,45896,0,60440
142045501900000,COMM NW,Commercial,2278,0,10619,12897
142045502000000,NW 311,Residential,5000,0,0,5000
142045502100000,NW 311,Residential,10260,26895,0,37155
142045600100000,NW 311,Residential,8400,35308,0,43708
142045600200000,NW 311,Residential,8400,41057,0,49457
142045600300000,NW 311,Residential,12000,59632,0,71632
142045600400000,NW 311,Residential,12000,63773,0,75773
142045600500000,NW 311,Residential,6000,0,0,6000
142045600600000,NW 311,Residential,12000,37754,0,49754
142045600700000,NW 311,Residential,12000,66071,0,78071
142045600800000,NW 311,Residential,12000,42384,0,54384
142045600900000,NW 311,Residential,12000,33018,0,45018
142045601000000,NW 311,Residential,12000,32263,0,44263
142045601100000,NW 311,Residential,6000,0,0,6000
142045601200000,NW 311,Residential,12000,47054,0,59054
142045601300000,NW 311,Residential,5000,0,0,5000
142045601400000,NW 311,Residential,5000,0,0,5000
142045601500000,E-40 CHURCHES,Exempt,36288,0,55213,91501
142045601600000,NW 311,Residential,5000,0,0,5000
142045601700000,NW 311,Residential,5000,0,0,5000
142045700100000,NW 311,Residential,9520,42073,0,51593
142045700200000,NW 311,Residential,9520,55721,0,65241
142045700300000,NW 311,Residential,13600,60944,0,74544
142045700400000,NW 311,Residential,13600,39842,0,53442
142045700500000,NW 311,Residential,6000,0,0,6000
142045700600000,NW 311,Residential,13600,43425,0,57025
142045700700000,NW 311,Residential,9520,41213,0,50733
142045700800000,NW 311,Residential,9520,29336,0,38856
142045700900000,NW 311,Residential,9044,45852,0,54896
142045701000000,NW 311,Residential,9044,46638,0,55682
142045701100000,NW 311,Residential,5000,0,0,5000
142045701200000,NW 311,Residential,13600,53013,0,66613
142045701300000,NW 311,Residential,13600,72291,0,85891
142045701400000,NW 311,Residential,13600,68010,0,81610
142045701500000,NW 311,Residential,6000,0,0,6000
142045701600000,NW 311,Residential,13600,68545,0,82145
142045701700000,NW 311,Residential,19040,48958,0,67998
142045701800000,NW 311,Residential,7913,38498,0,46411
142045701900000,NW 311,Residential,5000,0,0,5000
142045702000000,NW 311,Residential,5000,0,0,5000
142045702100000,NW 311,Residential,7913,53520,0,61433
142045800100000,NW 311,Residential,10234,2693,0,12927
142045800200000,NW 311,Residential,9520,25451,0,34971
142045800300000,NW 311,Residential,6000,0,0,6000
142045800400000,NW 311,Residential,13600,49400,0,63000
142045800500000,NW 311,Residential,13600,53976,0,67576
142045800600000,NW 311,Residential,14620,46862,0,61482
142045800700000,NW 311,Residential,13600,27003,0,40603
142045800800000,NW 311,Residential,6000,0,0,6000
142045800900000,NW 311,Residential,9401,43207,0,52608
142045801000000,NW 311,Residential,9401,44706,0,54107
142045900100000,NW 311,Residential,5000,0,0,5000
142045900200000,NW 311,Residential,8520,0,0,8520
142045900300000,NW 311,Residential,15000,42581,0,57581
142045900400000,NW 311,Residential,6000,0,0,6000
142045900500000,NW 311,Residential,5000,0,0,5000
142045900600000,NW 311,Residential,13500,44587,0,58087
142045900700000,NW 311,Residential,5000,0,0,5000
142045900800000,NW 311,Residential,5000,0,0,5000
142045900900000,NW 311,Residential,12000,54724,0,66724
142045901000000,NW 311,Residential,5000,0,0,5000
142045901100000,CONVERSIONS,Commercial,5400,0,0,5400
142045901200000,NW 311,Residential,5000,0,0,5000
142045901300000,NW 311,Residential,5000,0,0,5000
142045901400000,CONVERSIONS,Commercial,5400,0,0,5400
142045901500000,NW 311,Residential,10000,0,0,10000
142045901600000,NW 311,Residential,5000,0,0,5000
142046000100000,NW 311,Residential,10641,32195,0,42836
142046000200000,NW 311,Residential,5000,0,0,5000
142046000300000,NW 311,Residential,6000,0,0,6000
142046000400000,NW 311,Residential,6000,0,0,6000
142046000500000,NW 311,Residential,12000,60604,0,72604
142046000600000,NW 311,Residential,6000,0,0,6000
142046000700000,NW 311,Residential,6000,0,0,6000
142046000800000,NW 311,Residential,6510,48845,0,55355
142046000900000,NW 311,Residential,5000,0,0,5000
142046001000000,NW 311,Residential,8400,37726,0,46126
142046001100000,NW 311,Residential,5000,0,0,5000
142046001200000,NW 311,Residential,18000,42169,0,60169
142046001300000,NW 311,Residential,6000,0,0,6000
142046001400000,NW 311,Residential,12000,37618,0,49618
142046001500000,NW 311,Residential,6000,0,0,6000
142046001600000,NW 311,Residential,5000,0,0,5000
142046001700000,NW 311,Residential,8100,27793,0,35893
142046001800000,NW 311,Residential,5000,0,0,5000
142046001900000,NW 311,Residential,5000,0,0,5000
142046100100000,NW 311,Residential,9520,65701,0,75221
142046100200000,NW 311,Residential,5000,0,0,5000
142046100300000,NW 311,Residential,13600,42572,0,56172
142046100400000,NW 311,Residential,13600,77603,0,91203
142046100500000,NW 311,Residential,13600,60958,0,74558
142046100600000,NW 311,Residential,13600,58790,0,72390
142046100700000,NW 311,Residential,13600,41219,0,54819
142046100800000,NW 311,Residential,13600,56521,0,70121
142046100900000,NW 311,Residential,13600,62887,0,76487
142046101000000,NW 311,Residential,13600,43060,0,56660
142046101100000,NW 311,Residential,5000,0,0,5000
142046101200000,NW 311,Residential,13600,90751,0,104351
142046101300000,NW 311,Residential,5000,0,0,5000
142046101400000,NW 311,Residential,13600,70071,0,83671
142046101500000,NW 311,Residential,13600,46157,0,59757
142046101600000,NW 311,Residential,13600,31885,0,45485
142046101700000,NW 311,Residential,9044,35765,0,44809
142046101800000,NW 311,Residential,5000,0,0,5000
142046200100000,NW 311,Residential,5000,0,0,5000
142046200200000,NW 311,Residential,13600,69344,0,82944
142046200300000,NW 311,Residential,13600,41141,0,54741
142046200400000,NW 311,Residential,14280,61727,0,76007
142046200500000,NW 311,Residential,13600,55494,0,69094
142046200600000,NW 311,Residential,13600,61470,0,75070
142046200700000,NW 311,Residential,15164,64777,0,79941
142046200800000,NW 311,Residential,10234,73141,0,83375
142046200900000,NW 311,Residential,9401,58144,0,67545
142046300100000,CONVERSIONS,Commercial,8334,0,28839,37173
142046300200000,NW 311,Residential,12000,24116,0,36116
142046300300000,NW 311,Residential,6000,0,0,6000
142046300400000,NW 311,Residential,5000,0,0,5000
142046300500000,NW 311,Residential,12000,56351,0,68351
142046300600000,NW 311,Residential,12000,37109,0,49109
142046300700000,NW 311,Residential,5000,0,0,5000
142046300800000,NW 311,Residential,8775,50504,0,59279
142046300900000,NW 311,Residential,5000,0,0,5000
142046301000000,NW 311,Residential,10500,37953,0,48453
142046301100000,CONVERSIONS,Commercial,6804,0,21625,28429
142046301200000,CONVERSIONS,Commercial,6804,0,28633,35437
142046301300000,NW 311,Residential,6562,33856,0,40418
142046301400000,NW 311,Residential,6562,26131,0,32693
142046301500000,NW 311,Residential,10500,57014,0,67514
142046301600000,NW 311,Residential,5000,0,0,5000
142046301700000,COMM NW,Commercial,5667,0,37341,43008
142046301800000,NW 311,Residential,7350,27478,0,34828
142046301900000,NW 311,Residential,5512,20014,0,25526
142046302000000,NW 311,Residential,5000,0,0,5000
142046400100000,NW 311,Residential,9520,33361,0,42881
142046400200000,NW 311,Residential,13600,85325,0,98925
142046400300000,NW 311,Residential,13600,81246,0,94846
142046400400000,NW 311,Residential,13600,43172,0,56772
142046400500000,NW 311,Residential,13600,38730,0,52330
142046400600000,NW 311,Residential,13600,48983,0,62583
142046400700000,NW 311,Residential,13600,48102,0,61702
142046400800000,NW 311,Residential,13600,57334,0,70934
142046400900000,NW 311,Residential,13600,57599,0,71199
142046401000000,NW 311,Residential,13600,65381,0,78981
142046401100000,NW 311,Exempt,33600,0,114474,148074
142046401200000,NW 311,Residential,13600,60585,0,74185
142046401300000,NW 311,Residential,13600,73766,0,87366
142046401400000,NW 311,Residential,13600,61186,0,74786
142046401500000,NW 311,Residential,10710,65310,0,76020
142046500100000,NW 311,Residential,20400,58655,0,79055
142046500200000,NW 311,Residential,20400,68806,0,89206
142046500300000,NW 311,Residential,13600,72307,0,85907
142046500400000,NW 311,Residential,5000,0,0,5000
142046500500000,CONVERSIONS,Commercial,5400,0,0,5400
142046500600000,COMM NW,Commercial,9072,0,23427,32499
142046500700000,NW 311,Residential,13600,38927,0,52527
142046500800000,NW 311,Residential,13600,64648,0,78248
142046500900000,NW 311,Residential,13600,58735,0,72335
142046501000000,NW 311,Residential,21760,70830,0,92590
142046501100000,NW 311,Residential,13600,73878,0,87478
142046501200000,NW 311,Residential,13600,54375,0,67975
142046501300000,NW 311,Residential,13600,59322,0,72922
142046501400000,NW 311,Residential,13600,58709,0,72309
142046600100000,NW 311,Residential,15480,76147,0,91627
142046600200000,NW 311,Residential,14400,102254,0,116654
142046600300000,NW 311,Residential,14400,79231,0,93631
142046600400000,NW 311,Residential,14400,71248,0,85648
142046600500000,NW 311,Residential,15480,76761,0,92241
142046600600000,NW 311,Residential,14400,71392,0,85792
142046600700000,NW 311,Residential,14400,74582,0,88982
142046600800000,NW 311,Residential,14400,60553,0,74953
142047600100000,NW 317,Residential,5000,0,0,5000
142047600200000,NW 317,Residential,5000,0,0,5000
142047600300000,NW 317,Residential,9296,0,0,9296
142047600400000,NW 317,Residential,5000,0,0,5000
142047600500000,NW 317,Residential,5000,0,0,5000
142047600600000,NW 317,Residential,5000,0,0,5000
142047600700000,NW 317,Residential,5000,0,0,5000
142047600800000,NW 317,Residential,5000,16287,0,21287
142047600900000,NW 317,Residential,5000,0,0,5000
142047601000000,NW 317,Residential,5000,0,0,5000
142047601100000,NW 317,Residential,5000,0,0,5000
142047601200000,NW 317,Residential,2412,0,0,2412
142047601300000,NW 317,Residential,5000,0,0,5000
142047601400000,NW 317,Residential,5000,0,0,5000
142047700100000,NW 317,Residential,5000,0,0,5000
142047700200000,NW 317,Residential,8223,0,0,8223
142047700300000,NW 317,Residential,5000,0,0,5000
142047700400000,NW 317,Residential,5000,0,0,5000
142047800100000,INDUSTRIAL,Industrial,232020,0,1436282,1668302
142047900100000,NW 317,Residential,10500,23841,0,34341
142047900200000,NW 317,Residential,7455,26784,0,34239
142047900300000,NW 317,Residential,5000,0,0,5000
142047900400000,NW 317,Residential,10500,32146,0,42646
142047900500000,NW 317,Residential,5000,0,0,5000
142047900600000,NW 317,Residential,7455,38161,0,45616
142047900700000,NW 317,Residential,5000,0,0,5000
142047900800000,NW 317,Residential,5000,0,0,5000
142047901100000,NW 317,Residential,5000,0,0,5000
142047901200000,NW 317,Residential,5000,0,0,5000
142047901300000,NW 317,Residential,5000,0,0,5000
142047901400000,NW 317,Residential,6415,0,0,6415
142048000100000,COMM NW,Commercial,14196,0,0,14196
142048000200000,NW 317,Residential,5000,0,0,5000
142048000300000,NW 317,Residential,5000,0,0,5000
142048000400000,NW 317,Residential,5000,0,0,5000
142048000500000,NW 317,Residential,5000,0,0,5000
142048000600000,NW 317,Residential,5000,0,0,5000
142048000700000,NW 317,Residential,5000,0,0,5000
142048000800000,NW 317,Residential,5000,0,0,5000
142048000900000,NW 317,Residential,5000,0,0,5000
142048001100000,NW 317,Residential,5000,0,0,5000
142048001200000,NW 317,Residential,5000,0,0,5000
142048001300000,NW 317,Residential,5000,0,0,5000
142048001400000,NW 317,Residential,5000,0,0,5000
142048001500000,CONVERSIONS,Commercial,5400,0,0,5400
142048001600000,NW 317,Residential,5000,0,0,5000
142048001700000,NW 317,Residential,5000,0,0,5000
142048001800000,NW 317,Residential,3600,0,0,3600
142048100100000,COMM NW,Commercial,6237,0,6857,13094
142048100200000,INDUSTRIAL,Industrial,33637,0,52288,85925
142048100300000,NW 317,Residential,5000,0,0,5000
142048100400000,NW 317,Residential,5000,0,0,5000
142048100500000,NW 317,Residential,5000,0,0,5000
142048100600000,NW 317,Residential,5900,0,0,5900
142048100700000,NW 317,Residential,5000,0,0,5000
142048100800000,NW 317,Residential,5000,0,0,5000
142048100900000,NW 317,Residential,5000,0,0,5000
142048101000000,NW 317,Residential,5000,0,0,5000
142048101100000,NW 317,Residential,5000,0,0,5000
142048101200000,NW 317,Residential,5000,0,0,5000
142048101300000,NW 317,Residential,5000,0,0,5000
142048101400000,NW 317,Residential,5000,0,0,5000
142048101500000,E-15 CITY,Exempt,0,0,0,0
142048101600000,NW 317,Residential,6,0,0,6
142048200100000,NW 317,Residential,5000,0,0,5000
142048200200000,NW 317,Residential,5000,0,0,5000
142048200300000,NW 317,Residential,10500,37253,0,47753
142048200400000,NW 317,Residential,5000,0,0,5000
142048200500000,NW 317,Residential,5000,0,0,5000
142048200600000,NW 317,Residential,5000,0,0,5000
142048200700000,NW 317,Residential,11400,46589,0,57989
142048200800000,NW 317,Residential,10260,24987,0,35247
142048200900000,NW 317,Residential,5000,0,0,5000
142048201000000,NW 317,Residential,5000,0,0,5000
142048201100000,NW 317,Residential,5670,14455,0,20125
142048201200000,NW 317,Residential,2976,0,0,2976
142048201300000,NW 317,Residential,5000,0,0,5000
142048201400000,NW 317,Residential,5000,0,0,5000
142048201500000,NW 317,Residential,5000,0,0,5000
142048201600000,NW 317,Residential,5000,0,0,5000
142048201700000,NW 317,Residential,5000,0,0,5000
142048201800000,NW 317,Residential,5000,0,0,5000
142048201900000,NW 317,Residential,9000,21596,0,30596
142048300100000,NW 317,Residential,5000,0,0,5000
142048300200000,NW 317,Residential,5000,0,0,5000
142048300300000,NW 317,Residential,5000,0,0,5000
142048300400000,NW 317,Residential,5000,0,0,5000
142048300500000,CONVERSIONS,Commercial,4536,0,28918,33454
142048300600000,NW 317,Residential,5000,0,0,5000
142048300700000,NW 317,Residential,5000,0,0,5000
142048300800000,NW 317,Residential,5000,0,0,5000
142048300900000,NW 317,Residential,5000,0,0,5000
142048301000000,NW 317,Residential,5000,0,0,5000
142048301100000,INDUSTRIAL,Industrial,81940,0,47414,129354
142048301200000,E-15 CITY,Exempt,0,0,0,0
142048400100000,NW 317,Residential,5000,0,0,5000
142048400200000,NW 317,Residential,5000,0,0,5000
142048400300000,NW 317,Residential,5000,0,0,5000
142048400400000,NW 317,Residential,5000,0,0,5000
142048400500000,NW 317,Residential,5000,0,0,5000
142048400600000,NW 317,Residential,8550,30281,0,38831
142048400700000,NW 317,Residential,5000,0,0,5000
142048400800000,NW 317,Residential,5000,0,0,5000
142048400900000,NW 317,Residential,5000,0,0,5000
142048401000000,NW 317,Residential,5598,0,0,5598
142048401100000,INDUSTRIAL,Industrial,19920,0,9518,29438
142048401200000,NW 317,Residential,5000,0,0,5000
142048401300000,NW 317,Residential,5000,0,0,5000
142048401400000,NW 317,Residential,5000,0,0,5000
142048401500000,NW 317,Residential,5000,0,0,5000
142048401600000,NW 317,Residential,7200,0,0,7200
142048401700000,NW 317,Residential,9000,56437,0,65437
142048401800000,COMM NW,Commercial,48384,0,10160,58544
142048401900000,NW 317,Residential,5000,0,0,5000
142048402000000,COMM NW,Commercial,24192,0,125916,150108
142048402100000,NW 317,Residential,5000,0,0,5000
142048500300000,Empty,Exempt,0,0,0,0
142048500400000,COMM NW,Commercial,48989,0,114779,163768
142048500500000,COMM NW,Commercial,48384,0,48014,96398
142048500600000,NW 317,Residential,5000,0,0,5000
142048500700000,CONVERSIONS,Commercial,5400,0,0,5400
142048500800000,Empty,Exempt,0,0,0,0
142048600100000,COMM NW,Commercial,7603,0,45426,53029
142048600200000,NW 317,Residential,5000,0,0,5000
142048600300000,NW 317,Residential,5000,0,0,5000
142048600400000,NW 317,Residential,5000,0,0,5000
142048600500000,NW 317,Residential,5000,0,0,5000
142048600600000,NW 317,Residential,6000,0,0,6000
142048600700000,NW 317,Residential,6000,0,0,6000
142048600800000,NW 317,Residential,5000,0,0,5000
142048600900000,NW 317,Residential,5000,0,0,5000
142048601000000,NW 317,Residential,5000,0,0,5000
142048601100000,NW 317,Residential,5000,0,0,5000
142048601200000,CONVERSIONS,Commercial,5400,0,0,5400
142048601300000,NW 317,Residential,5000,0,0,5000
142048601400000,NW 317,Residential,5000,18202,0,23202
142048601500000,NW 317,Residential,5000,0,0,5000
142048601600000,NW 317,Residential,5000,0,0,5000
142048601700000,NW 317,Residential,5000,0,0,5000
142048601800000,NW 317,Residential,5000,0,0,5000
142048601900000,NW 317,Residential,5000,0,0,5000
142048602000000,COMM NW,Commercial,5000,0,0,5000
142048602100000,COMM NW,Commercial,5000,0,2450,7450
142048602200000,COMM NW,Commercial,5000,0,1960,6960
142048700100000,CONVERSIONS,Commercial,5400,0,0,5400
142048700200000,NW 317,Residential,9000,36784,0,45784
142048700300000,NW 317,Residential,9000,44118,0,53118
142048700400000,NW 317,Residential,5000,0,0,5000
142048700500000,NW 317,Residential,9000,37986,0,46986
142048700600000,NW 317,Residential,5000,0,0,5000
142048700700000,NW 317,Residential,9000,52826,0,61826
142048700800000,NW 317,Residential,6300,27823,0,34123
142048700900000,NW 317,Residential,4725,24945,0,29670
142048701000000,NW 317,Residential,4725,36685,0,41410
142048701100000,NW 317,Residential,6480,31292,0,37772
142048701200000,NW 317,Residential,3360,0,0,3360
142048701300000,COMM NW,Commercial,36029,0,116092,152121
142048701400000,NW 317,Residential,5563,21143,0,26706
142048701500000,NW 317,Residential,5000,0,0,5000
142048701600000,NW 317,Residential,5000,19679,0,24679
142048701700000,NW 317,Residential,5000,0,0,5000
142048701800000,NW 317,Residential,4934,0,0,4934
142048701900000,NW 317,Residential,5000,0,0,5000
142048702000000,NW 317,Residential,5427,20077,0,25504
142048800100000,COMM NW,Commercial,10395,0,16121,26516
142048800200000,INDUSTRIAL,Industrial,33625,0,10210,43835
142048800300000,NW 317,Residential,5000,0,0,5000
142048800400000,NW 317,Residential,5000,0,0,5000
142048800500000,COMM NW,Commercial,30964,0,43019,73983
142048900100000,COMM NW,Commercial,14731,0,0,14731
142048900200000,COMM NW,Commercial,29635,0,51452,81087
142048900300000,COMM NW,Commercial,18144,0,0,18144
142048900400000,COMM NW,Commercial,36288,0,0,36288
142048900500000,COMM NW,Commercial,36288,0,1836,38124
142048900600000,COMM NW,Commercial,36288,0,87312,123600
142048900700000,INDUSTRIAL,Industrial,57250,0,158745,215995
142110100100000,COMM NE,Commercial,10995,0,0,10995
142110100200000,NE 156,Residential,10582,45345,0,55927
142110100300000,COMM NE,Commercial,17496,0,79699,97195
142110100400000,COMM NE,Commercial,120463,0,233980,354443
142110100402000,COMM NE,Commercial,0,0,15472,15472
142110100500000,COMM NE,Commercial,48540,0,92322,140862
142110200100000,COMM NE,Commercial,39691,0,108612,148303
142110200200000,COMM NE,Commercial,43252,0,110425,153677
142110200300000,COMM NE,Commercial,37441,0,86756,124197
142110200400000,COMM NE,Commercial,30192,0,44335,74527
142110200500000,COMM NE,Commercial,23377,0,56844,80221
142110300100000,COMM NE,Commercial,27216,0,99829,127045
142110300200000,COMM NE,Commercial,20412,0,66217,86629
142110300300000,COMM NE,Commercial,13608,0,3698,17306
142110300400000,COMM NE,Commercial,13608,0,2368,15976
142110300500000,COMM NE,Commercial,20412,0,72573,92985
142110300600000,E-70 CHARITY OTHER,Exempt,161482,0,215190,376672
142110300602000,COMM NE,Commercial,0,0,41574,41574
142110400100000,COMM NE,Commercial,38831,0,1612,40443
142110400102000,COMM NE,Commercial,0,0,8095,8095
142110400200000,COMM NE,Commercial,27216,0,6843,34059
142110400300000,COMM NE,Commercial,23814,0,27463,51277
142110500100000,E-83 EDU OTHER,Exempt,18144,0,778,18922
142110500200000,NE 156,Exempt,10000,54051,0,64051
142110500300000,NE 156,Residential,10000,3000,0,13000
142110500400000,NE 156,Residential,10000,43650,0,53650
142110500500000,NE 156,Residential,6500,4355,0,10855
142110500600000,NE 156,Residential,5400,0,0,5400
142110500700000,NE 156,Residential,5400,0,0,5400
142110500800000,NE 156,Exempt,10000,53511,0,63511
142110500900000,NE 156,Residential,10000,49329,0,59329
142110501000000,E-77 EDU DORMS,Exempt,18144,0,217166,235310
142110501100000,COMM NE,Commercial,29691,0,46327,76018
142110501200000,COMM NE,Commercial,5327,0,32094,37421
142110501300000,E-77 EDU DORMS,Exempt,266112,0,217402,483514
142110600100000,COMM NE,Commercial,4700,0,0,4700
142110600200000,COMM NE,Commercial,27498,0,0,27498
142110600300000,COMM NE,Commercial,33048,0,85574,118622
142110600400000,COMM NE,Commercial,13219,0,53283,66502
142110600500000,COMM NE,Commercial,13219,0,44325,57544
142110600600000,COMM NE,Commercial,42962,0,59089,102051
142110600700000,Empty,Other,0,0,0,0
142110700100000,COMM NE,Commercial,213840,0,179910,393750
142110700200000,Empty,Other,0,0,0,0
142110700300000,Empty,Other,0,0,0,0
142110700400000,Empty,Other,0,0,0,0
142110700500000,Empty,Other,0,0,0,0
142110700600000,E-78 EDU ATHLETIC,Exempt,34353,0,0,34353
142110700602000,COMM NE,Commercial,0,0,8095,8095
142110800100000,E-78 EDU ATHLETIC,Exempt,444960,0,3967477,4412437
142112600100000,COMM NE,Commercial,9720,0,8897,18617
142112600200000,Empty,Other,0,0,0,0
142112600300000,Empty,Other,0,0,0,0
142112600400000,Empty,Other,0,0,0,0
142112700100000,Empty,Other,0,0,0,0
142112700200000,Empty,Other,0,0,0,0
142112700300000,Empty,Other,0,0,0,0
142112800100000,Empty,Other,0,0,0,0
142115100100000,Empty,Other,0,0,0,0
142115200100000,Empty,Other,0,0,0,0
142115200200000,Empty,Other,0,0,0,0
142115200300000,INDUSTRIAL,Industrial,9666,0,343230,352896
142115200500000,Empty,Other,0,0,0,0
142115200600000,Empty,Other,0,0,0,0
142115300100000,Empty,Other,0,0,0,0
142117600100000,E-76 EDU CLASS BLDG,Exempt,2378160,0,19942154,22320314
142117700100000,E-60 HOSPITAL,Exempt,969840,0,16514550,17484390
142117700102000,COMM NE,Commercial,0,0,48383,48383
142117700200000,E-15 CITY,Exempt,0,0,0,0
142117800100000,COMM NE,Commercial,1083240,0,82027108,83110348
142120100100000,Empty,Other,0,0,0,0
142120100200000,COMM NE,Commercial,79704,0,0,79704
142122600100000,Empty,Other,0,0,0,0
142125100100000,NW 310,Residential,7125,13058,0,20183
142125100200000,NW 310,Residential,5000,0,0,5000
142125100300000,NW 310,Residential,5300,0,0,5300
142125100400000,NW 310,Residential,5000,0,0,5000
142125100500000,NW 310,Residential,5000,0,0,5000
142125100600000,NW 310,Residential,5000,0,0,5000
142125100700000,NW 310,Residential,5000,0,0,5000
142125100800000,NW 310,Residential,5000,0,0,5000
142125100900000,NW 310,Residential,5000,0,0,5000
142125101000000,NW 310,Residential,5000,0,0,5000
142125101100000,NW 310,Residential,5000,0,0,5000
142125200100000,NW 310,Residential,5000,0,0,5000
142125200200000,NW 310,Residential,5000,0,0,5000
142125200300000,NW 310,Residential,6450,0,0,6450
142125200400000,NW 310,Residential,6800,0,0,6800
142125200500000,NW 310,Residential,7150,0,0,7150
142125200600000,NW 310,Residential,7325,0,0,7325
142125200700000,NW 310,Residential,7675,0,0,7675
142125200800000,NW 310,Residential,11210,0,0,11210
142125200900000,CONVERSIONS,Commercial,5400,0,0,5400
142125201000000,NW 310,Residential,5000,0,0,5000
142125201100000,NW 310,Residential,5000,0,0,5000
142125201200000,NW 310,Residential,5300,0,0,5300
142125201300000,NW 310,Residential,5000,0,0,5000
142125201400000,NW 310,Residential,5000,0,0,5000
142125201500000,NW 310,Residential,5000,0,0,5000
142125201600000,NW 310,Residential,7275,0,0,7275
142125201700000,NW 310,Residential,5000,0,0,5000
142125201800000,NW 310,Residential,5000,0,0,5000
142127600100000,COMM NE,Commercial,225990,0,5658,231648
142127600200000,COMM NE,Commercial,41796,0,0,41796
142127600300000,COMM NE,Commercial,171963,0,464001,635964
142127600400000,COMM NE,Commercial,17739,0,0,17739
142130100100000,Empty,Other,0,0,0,0
142130100200000,INDUSTRIAL,Industrial,4711,0,0,4711
142130100300000,Empty,Other,0,0,0,0
142130100400000,Empty,Other,0,0,0,0
142130100500000,Empty,Other,0,0,0,0
142130100600000,Empty,Other,0,0,0,0
142130200100000,INDUSTRIAL,Industrial,24150,0,47613,71763
142130200200000,Empty,Other,0,0,0,0
142130400100000,Empty,Other,0,0,0,0
142130400200000,Empty,Other,0,0,0,0
142130400300000,Empty,Other,0,0,0,0
142130400400000,INDUSTRIAL,Industrial,8464,0,275455,283919
142130500100000,COMM NE,Commercial,135540,0,225050,360590
142130500200000,Empty,Other,0,0,0,0
142130600100000,INDUSTRIAL,Industrial,599085,0,6990250,7589335
142132600100000,COMM NW,Commercial,65340,0,163191,228531
142132600200000,COMM NW,Commercial,12960,0,6898,19858
142132600300000,COMM NW,Commercial,20250,0,16404,36654
142132600400000,NW 317,Residential,5000,0,0,5000
142132600500000,COMM NW,Commercial,7897,0,11432,19329
142132600600000,NW 317,Residential,5000,0,0,5000
142132600700000,NW 317,Residential,5000,0,0,5000
142132600800000,COMM NW,Commercial,19845,0,0,19845
142132600900000,COMM NW,Commercial,22842,0,50865,73707
142132601000000,NW 317,Residential,5000,0,0,5000
142132601100000,NW 317,Residential,5000,0,0,5000
142132601200000,NW 317,Residential,5000,0,0,5000
142132601300000,COMM NW,Commercial,19926,0,89054,108980
142132700100000,COMM NW,Commercial,160272,0,849181,1009453
142135100100000,E-15 CITY,Exempt,0,0,0,0
142135200100000,E-15 CITY,Exempt,0,0,0,0
142135200200000,COMM CTRL CORE,Commercial,192629,0,562304,754933
142135200300000,E-70 CHARITY OTHER,Exempt,162000,0,0,162000
142135200400000,E-70 CHARITY OTHER,Exempt,127980,0,711963,839943
142135300100000,COMM NW,Commercial,105975,0,892328,998303
142135400100000,INDUSTRIAL,Industrial,105000,0,305811,410811
142135500100000,INDUSTRIAL,Industrial,8040,0,0,8040
142135500200000,COMM CTRL CORE,Commercial,4763,0,0,4763
142135600100000,INDUSTRIAL,Industrial,101396,0,0,101396
142135600200000,INDUSTRIAL,Industrial,9600,0,0,9600
142137600100000,INDUSTRIAL,Industrial,20790,0,1042378,1063168
142137600200000,INDUSTRIAL,Industrial,3795,0,5838,9633
142137600300000,INDUSTRIAL,Industrial,4050,0,22743,26793
142137700100000,E-15 CITY,Exempt,0,0,0,0
142137700102000,COMM CTRL CORE,Commercial,0,0,5060000,5060000
142137800100000,E-15 CITY,Exempt,0,0,0,0
142137800102000,E-15 CITY,Exempt,0,0,0,0
142137800200000,COMM CTRL CORE,Commercial,81648,0,409352,491000
142137800300000,COMM CTRL CORE,Commercial,177811,0,556686,734497
142137800302000,COMM CTRL CORE,Commercial,0,0,22,22
142137800400000,COMM CTRL CORE,Commercial,459648,0,2031799,2491447
142137800500000,COMM CTRL CORE,Commercial,272160,0,407219,679379
142137800502000,COMM CTRL CORE,Commercial,0,0,22,22
142137900100000,COMM CTRL CORE,Commercial,689472,0,2603559,3293031
142137900200000,COMM CTRL CORE,Commercial,54810,0,3701,58511
142137900300000,COMM CTRL CORE,Commercial,37395,0,5500,42895
142137900501000,COMM CTRL CORE,Commercial,7560,0,72157,79717
142137900501001,COMM CTRL CORE,Commercial,7560,0,176840,184400
142137900501002,COMM CTRL CORE,Commercial,7560,0,18049,25609
142137900501003,COMM CTRL CORE,Commercial,7560,0,110796,118356
142137900501004,COMM CTRL CORE,Commercial,6480,0,272527,279007
142137900501005,COMM CTRL CORE,Commercial,7560,0,220979,228539
142137900501006,CONDO 502,Residential,5000,35977,0,40977
142137900501007,CONDO 502,Residential,5000,35977,0,40977
142137900501008,CONDO 502,Residential,5000,35977,0,40977
142137900501009,CONDO 502,Residential,5000,35977,0,40977
142137900501010,CONDO 502,Residential,5000,40096,0,45096
142137900501011,CONDO 502,Residential,5000,35977,0,40977
142137900501012,CONDO 502,Residential,5000,35977,0,40977
142137900501013,CONDO 502,Residential,5000,32811,0,37811
142137900501014,CONDO 502,Residential,5000,46844,0,51844
142137900501015,CONDO 502,Residential,5000,35977,0,40977
142137900501016,CONDO 502,Residential,5000,35977,0,40977
142137900501017,CONDO 502,Residential,5000,40096,0,45096
142137900501018,CONDO 502,Residential,5000,40096,0,45096
142137900501019,CONDO 502,Residential,5000,35977,0,40977
142137900501020,CONDO 502,Residential,5000,35977,0,40977
142137900501021,CONDO 502,Residential,5000,32811,0,37811
142137900501022,CONDO 502,Residential,5000,46844,0,51844
142137900501023,CONDO 502,Residential,5000,35977,0,40977
142137900501024,CONDO 502,Residential,5000,35977,0,40977
142137900501025,CONDO 502,Residential,5000,40096,0,45096
142137900501026,CONDO 502,Residential,5000,40096,0,45096
142137900501027,CONDO 502,Residential,5000,35977,0,40977
142137900501028,CONDO 502,Residential,5000,35977,0,40977
142137900501029,CONDO 502,Residential,5000,32811,0,37811
142137900501030,CONDO 502,Residential,5000,46844,0,51844
142137900501031,CONDO 502,Residential,5000,35977,0,40977
142137900501032,CONDO 502,Residential,5000,35977,0,40977
142137900501033,CONDO 502,Residential,5000,40096,0,45096
142137900501034,CONDO 502,Residential,5000,40096,0,45096
142137900501035,CONDO 502,Residential,5000,35977,0,40977
142137900501036,CONDO 502,Residential,5000,35977,0,40977
142137900501037,CONDO 502,Residential,5000,32811,0,37811
142137900501038,CONDO 502,Residential,5000,46844,0,51844
142137900501039,CONDO 502,Residential,5000,35977,0,40977
142137900501040,CONDO 502,Residential,5000,35977,0,40977
142137900501041,CONDO 502,Residential,5000,40096,0,45096
142137900501042,CONDO 502,Residential,5000,40096,0,45096
142137900501043,CONDO 502,Residential,5000,35977,0,40977
142137900501044,CONDO 502,Residential,5000,35977,0,40977
142137900501045,CONDO 502,Residential,5000,32811,0,37811
142137900501046,CONDO 502,Residential,5000,46844,0,51844
142137900501047,CONDO 502,Residential,5000,35977,0,40977
142137900501048,CONDO 502,Residential,5000,35977,0,40977
142137900501049,CONDO 502,Residential,5000,40096,0,45096
142137900501050,CONDO 502,Residential,5000,40096,0,45096
142137900501051,CONDO 502,Residential,5000,35977,0,40977
142137900501052,CONDO 502,Residential,5000,35977,0,40977
142137900501053,CONDO 502,Residential,5000,32811,0,37811
142137900501054,CONDO 502,Residential,5000,46844,0,51844
142137900501055,CONDO 502,Residential,5000,35977,0,40977
142137900501056,CONDO 502,Residential,5000,35977,0,40977
142137900501057,CONDO 502,Residential,5000,40096,0,45096
142137900501058,CONDO 502,Residential,5000,40096,0,45096
142137900501059,CONDO 502,Residential,5000,35977,0,40977
142137900501060,CONDO 502,Residential,5000,35977,0,40977
142137900501061,CONDO 502,Residential,5000,32811,0,37811
142137900501062,CONDO 502,Residential,5000,46844,0,51844
142137900501063,CONDO 502,Residential,5000,35977,0,40977
142137900501064,CONDO 502,Residential,5000,35977,0,40977
142137900501065,CONDO 502,Residential,5000,40096,0,45096
142137900501066,CONDO 502,Residential,5000,40096,0,45096
142137900501067,CONDO 502,Residential,5000,35977,0,40977
142137900501068,CONDO 502,Residential,5000,35977,0,40977
142137900501069,CONDO 502,Residential,5000,32811,0,37811
142137900501070,CONDO 502,Residential,5000,46844,0,51844
142137900501071,CONDO 502,Residential,5000,51890,0,56890
142137900501072,CONDO 502,Residential,5000,40096,0,45096
142137900501073,CONDO 502,Residential,5000,40096,0,45096
142137900501074,CONDO 502,Residential,5000,35977,0,40977
142137900501075,CONDO 502,Residential,5000,35977,0,40977
142137900501076,CONDO 502,Residential,5000,32811,0,37811
142137900501077,CONDO 502,Residential,5000,46844,0,51844
142137900501078,CONDO 502,Residential,5000,35977,0,40977
142137900501079,CONDO 502,Residential,5000,35977,0,40977
142137900501080,CONDO 502,Residential,5000,40096,0,45096
142137900501081,CONDO 502,Residential,5000,32811,0,37811
142137900501082,CONDO 502,Residential,5000,35977,0,40977
142137900501083,CONDO 502,Residential,5000,35977,0,40977
142137900501084,CONDO 502,Residential,5000,32811,0,37811
142137900501085,CONDO 502,Residential,5000,46844,0,51844
142137900501086,CONDO 502,Residential,5000,35977,0,40977
142137900501087,CONDO 502,Residential,5000,35977,0,40977
142137900501088,CONDO 502,Residential,5000,45094,0,50094
142137900501089,CONDO 502,Residential,5000,40096,0,45096
142137900501090,CONDO 502,Residential,5000,35977,0,40977
142137900501091,CONDO 502,Residential,5000,35977,0,40977
142137900501092,CONDO 502,Residential,5000,32811,0,37811
142137900501093,CONDO 502,Residential,5000,46844,0,51844
142137900501094,CONDO 502,Residential,5000,35977,0,40977
142137900501095,CONDO 502,Residential,5000,35977,0,40977
142137900501096,CONDO 502,Residential,5000,40096,0,45096
142137900501097,CONDO 502,Residential,5000,40096,0,45096
142137900501098,CONDO 502,Residential,5000,35977,0,40977
142137900501099,CONDO 502,Residential,5000,35977,0,40977
142137900501100,CONDO 502,Residential,5000,32811,0,37811
142137900501101,CONDO 502,Residential,5000,46844,0,51844
142137900501102,CONDO 502,Residential,5000,35977,0,40977
142137900501103,CONDO 502,Residential,5000,35977,0,40977
142137900501104,CONDO 502,Residential,5000,40096,0,45096
142137900501105,CONDO 502,Residential,5000,32811,0,37811
142137900501106,CONDO 502,Residential,5000,35977,0,40977
142137900501107,CONDO 502,Residential,5000,35977,0,40977
142137900501108,CONDO 502,Residential,5000,32811,0,37811
142137900501109,CONDO 502,Residential,5000,46844,0,51844
142137900501110,CONDO 502,Residential,5000,35977,0,40977
142137900501111,CONDO 502,Residential,5000,35977,0,40977
142137900501112,CONDO 502,Residential,5000,45094,0,50094
142137900501113,CONDO 502,Residential,5000,40096,0,45096
142137900501114,CONDO 502,Residential,5000,35977,0,40977
142137900501115,CONDO 502,Residential,5000,35977,0,40977
142137900501116,CONDO 502,Residential,5000,32811,0,37811
142137900501117,CONDO 502,Residential,5000,46844,0,51844
142137900501118,CONDO 502,Residential,5000,35977,0,40977
142137900501119,CONDO 502,Residential,5000,35977,0,40977
142137900501120,CONDO 502,Residential,5000,40096,0,45096
142137900501121,CONDO 502,Residential,5000,40096,0,45096
142137900501122,CONDO 502,Residential,5000,35977,0,40977
142137900501123,CONDO 502,Residential,5000,35977,0,40977
142137900501124,CONDO 502,Residential,5000,32811,0,37811
142137900501125,CONDO 502,Residential,5000,46844,0,51844
142137900501126,CONDO 502,Residential,5000,35977,0,40977
142137900501127,CONDO 502,Residential,5000,35977,0,40977
142137900501128,CONDO 502,Residential,5000,40096,0,45096
142137900501129,CONDO 502,Residential,5000,40096,0,45096
142137900501130,CONDO 502,Residential,5000,35977,0,40977
142137900501131,CONDO 502,Residential,5000,35977,0,40977
142137900501132,CONDO 502,Residential,5000,32811,0,37811
142137900501133,CONDO 502,Residential,5000,46844,0,51844
142137900501134,CONDO 502,Residential,5000,35977,0,40977
142137900501135,CONDO 502,Residential,5000,35977,0,40977
142137900501136,CONDO 502,Residential,5000,40096,0,45096
142137900501137,CONDO 502,Residential,5000,40096,0,45096
142137900501138,CONDO 502,Residential,5000,51890,0,56890
142137900501139,CONDO 502,Residential,5000,32811,0,37811
142137900501140,CONDO 502,Residential,5000,46844,0,51844
142137900501141,CONDO 502,Residential,5000,35977,0,40977
142137900501142,CONDO 502,Residential,5000,35977,0,40977
142137900501143,CONDO 502,Residential,5000,40096,0,45096
142137900501144,CONDO 502,Residential,5000,40096,0,45096
142137900501145,CONDO 502,Residential,5000,35977,0,40977
142137900501146,CONDO 502,Residential,5000,35977,0,40977
142137900501147,CONDO 502,Residential,5000,32811,0,37811
142137900501148,CONDO 502,Residential,5000,46844,0,51844
142137900501149,CONDO 502,Residential,5000,35977,0,40977
142137900501150,CONDO 502,Residential,5000,35977,0,40977
142137900501151,CONDO 502,Residential,5000,40096,0,45096
142137900501152,CONDO 502,Residential,5000,147115,0,152115
142137900501153,CONDO 502,Residential,5000,35977,0,40977
142137900501154,CONDO 502,Residential,5000,35977,0,40977
142137900501155,CONDO 502,Residential,5000,72461,0,77461
142138000100000,E-15 CITY,Exempt,0,0,0,0
142138100100000,COMM CTRL CORE,Commercial,328104,0,13519,341623
142138100200000,COMM CTRL CORE,Commercial,110225,0,23975,134200
142138100300000,COMM CTRL CORE,Commercial,36742,0,48258,85000
142138100400000,COMM CTRL CORE,Commercial,95256,0,166789,262045
142138100500000,COMM CTRL CORE,Commercial,42768,0,80599,123367
142138100600000,COMM CTRL CORE,Commercial,116640,0,324427,441067
142138100700000,COMM CTRL CORE,Commercial,30132,0,47447,77579
142138100800000,COMM CTRL CORE,Commercial,30132,0,48841,78973
142138100900000,COMM CTRL CORE,Commercial,77760,0,247051,324811
142138101000000,COMM CTRL CORE,Commercial,123120,0,532126,655246
142138101100000,COMM CTRL CORE,Commercial,98496,0,375460,473956
142138101200000,COMM CTRL CORE,Commercial,136080,0,427954,564034
142138101300000,COMM CTRL CORE,Commercial,158004,0,538311,696315
142138101400000,COMM CTRL CORE,Commercial,0,0,22,22
142138200100000,COMM CTRL CORE,Commercial,474317,0,2934085,3408402
142138200200000,COMM CTRL CORE,Commercial,340200,0,646105,986305
142138200300000,COMM CTRL CORE,Commercial,68040,0,229776,297816
142138200400000,COMM CTRL CORE,Commercial,258552,0,490802,749354
142138200402000,COMM CTRL CORE,Commercial,0,0,4049,4049
142138200500000,COMM CTRL CORE,Commercial,274882,0,864072,1138954
142140100100000,COMM SE,Commercial,81648,0,143535,225183
142140100200000,COMM SE,Commercial,81648,0,378130,459778
142140100300000,COMM SE,Commercial,81648,0,14594,96242
142140100400000,COMM SE,Commercial,45360,0,16898,62258
142140100500000,COMM SE,Commercial,45360,0,0,45360
142140300100000,COMM NE,Commercial,272160,0,2750358,3022518
142140400100000,E-60 HOSPITAL,Exempt,90720,0,618,91338
142140400200000,COMM SE,Commercial,414720,0,5062414,5477134
142140400300000,E-60 HOSPITAL,Exempt,127008,0,260714,387722
142140400400000,E-60 HOSPITAL,Exempt,45360,0,7095,52455
142140500100000,COMM NE,Commercial,30240,0,211135,241375
142140500200000,COMM NE,Commercial,26536,0,1983,28519
142140500300000,COMM NE,Commercial,26536,0,1149,27685
142140500500000,COMM NE,Commercial,37044,0,0,37044
142140500600000,COMM NE,Commercial,94349,0,182622,276971
142140500602000,COMM NE,Commercial,0,0,24488,24488
142140500700000,E-60 HOSPITAL,Exempt,297756,0,34056,331812
142140500800000,COMM NE,Commercial,24343,0,2365,26708
142140500900000,COMM NE,Commercial,151200,0,336695,487895
142140501000000,E-60 HOSPITAL,Exempt,78926,0,510283,589209
142140501100000,E-70 CHARITY OTHER,Exempt,78926,0,5964,84890
142140501200000,E-70 CHARITY OTHER,Exempt,78926,0,5964,84890
142140501300000,E-60 HOSPITAL,Exempt,78926,0,947512,1026438
142140501400000,COMM NE,Commercial,78926,0,92381,171307
142140501500000,COMM NE,Commercial,78926,0,128452,207378
142140501600000,COMM NE,Commercial,78926,0,8402,87328
142140501700000,COMM NE,Commercial,78926,0,5141,84067
142140501800000,COMM NE,Commercial,45490,0,191661,237151
142140501900000,COMM NE,Commercial,25855,0,2833,28688
142140502000000,E-15 CITY,Exempt,0,0,0,0
142140600100000,E-60 HOSPITAL,Exempt,336960,0,47896,384856
142140600200000,E-40 CHURCHES,Exempt,362880,0,2876788,3239668
142140600400000,COMM NE,Commercial,245676,0,9454324,9700000
142140700200000,E-60 HOSPITAL,Exempt,208602,0,158907,367509
142140700300000,APTS SE,Commercial,32724,0,439222,471946
142140700400000,E-68 FRATERNAL ORG,Exempt,473785,0,2347654,2821439
142140700700000,E-60 HOSPITAL,Exempt,143640,0,47623,191263
142140700800000,COMM SE,Commercial,254016,0,558619,812635
142140700900000,COMM SE,Commercial,140211,0,425490,565701
142140701000000,COMM SE,Commercial,31054,0,250933,281987
142140701100000,COMM SE,Commercial,81490,0,6397,87887
142140800100000,COMM SE,Commercial,190512,0,274180,464692
142140800200000,COMM SE,Commercial,166320,0,102636,268956
142140800400000,COMM SE,Commercial,133056,0,11207,144263
142140800500000,COMM SE,Commercial,199584,0,25548,225132
142140800600000,COMM SE,Commercial,127008,0,141726,268734
142140900100000,COMM SE,Commercial,136080,0,52599,188679
142140900200000,COMM SE,Commercial,136080,0,211617,347697
142140900300000,COMM SE,Commercial,60750,0,154651,215401
142140900400000,COMM SE,Commercial,60750,0,18057,78807
142140900500000,COMM SE,Commercial,121500,0,218500,340000
142140900600000,INDUSTRIAL,Industrial,61320,0,202078,263398
142140900900000,COMM SE,Commercial,40739,0,51258,91997
142140901000000,COMM SE,Commercial,19710,0,4088,23798
142140901100000,COMM SE,Commercial,12717,0,82120,94837
142140901200000,COMM SE,Commercial,70492,0,185471,255963
142140901300000,CONVERSIONS,Commercial,13316,0,134560,147876
142140901400000,INDUSTRIAL,Industrial,28980,0,42689,71669
142140901500000,CONVERSIONS,Commercial,14580,0,56068,70648
142140901600000,COMM SE,Commercial,14580,0,117865,132445
142140901700000,E-40 CHURCHES,Exempt,145800,0,536070,681870
142140901800000,COMM SE,Commercial,48951,0,113703,162654
142140901802000,COMM SE,Commercial,0,0,16714,16714
142141000100000,E-40 CHURCHES,Exempt,169344,0,1059048,1228392
142141000200000,CONVERSIONS,Commercial,17010,0,132031,149041
142142600100000,Empty,Other,0,0,0,0
142142700100000,COMM NE,Commercial,69304,0,375362,444666
142142700200000,COMM NE,Commercial,61560,0,290091,351651
142142700300000,INDUSTRIAL,Industrial,37650,0,201609,239259
142142800200000,INDUSTRIAL,Industrial,315220,0,2441807,2757027
142142900100000,COMM NE,Commercial,272160,0,1288537,1560697
142142900200000,COMM NE,Commercial,498960,0,2883884,3382844
142143000100000,COMM NE,Commercial,156492,0,170031,326523
142143000200000,COMM NE,Commercial,118571,0,12485,131056
142143100100000,COMM NE,Commercial,299376,0,356863,656239
142143100200000,E-60 HOSPITAL,Exempt,108864,0,427037,535901
142143100300000,COMM NE,Commercial,54432,0,7794,62226
142143100400000,COMM NE,Commercial,54432,0,6198,60630
142143100500000,COMM NE,Commercial,54432,0,7679,62111
142143100600000,COMM SE,Commercial,124740,0,13530,138270
142143100700000,COMM NE,Commercial,74844,0,4764,79608
142143200100000,E-68 FRATERNAL ORG,Exempt,270151,0,1806202,2076353
142143300100000,E-40 CHURCHES,Exempt,121176,0,468837,590013
142143300200000,E-47 RELIG OTHER,Exempt,33048,0,0,33048
142143400100000,COMM NE,Commercial,200731,0,20786,221517
142143500100000,COMM SE,Commercial,134006,0,206536,340542
142145100100000,COMM SE,Commercial,78105,0,138891,216996
142145100300000,E-70 CHARITY OTHER,Exempt,369624,0,485895,855519
142145100400000,E-70 CHARITY OTHER,Exempt,63504,0,98617,162121
142145100500000,COMM SE,Commercial,43394,0,113597,156991
142145100600000,COMM SE,Commercial,43394,0,77746,121140
142145100700000,COMM SE,Commercial,37573,0,91258,128831
142145100800000,COMM SE,Commercial,51549,0,8763,60312
142145200201000,COMM CTRL CORE,Commercial,121414,0,870834,992248
142145200201001,COMM CTRL CORE,Commercial,134719,0,1851558,1986277
142145200201002,COMM CTRL CORE,Commercial,121414,0,1320491,1441905
142145200201003,COMM CTRL CORE,Commercial,121420,0,1064735,1186155
142145200300000,E-40 CHURCHES,Exempt,117936,0,85204,203140
142145300100000,COMM SE,Commercial,63504,0,299480,362984
142145300200000,E-70 CHARITY OTHER,Exempt,95256,0,467626,562882
142145400100000,COMM CTRL CORE,Commercial,96768,0,555736,652504
142145400200000,COMM CTRL CORE,Commercial,498960,0,963231,1462191
142145400300000,COMM CTRL CORE,Other,0,0,0,0
142145500100000,COMM CTRL CORE,Commercial,140778,0,405319,546097
142145500200000,E-15 CITY,Exempt,0,0,0,0
142145500300000,E-15 CITY,Exempt,0,0,0,0
142145600100000,COMM SE,Commercial,235872,0,2464128,2700000
142145600200000,COMM CTRL CORE,Commercial,96768,0,82693,179461
142145600300000,COMM CTRL CORE,Commercial,120960,0,1587354,1708314
142145600400000,COMM SE,Commercial,127008,0,444686,571694
142145600500000,COMM CTRL CORE,Commercial,145152,0,114161,259313
142145700100000,COMM CTRL CORE,Commercial,81648,0,1171760,1253408
142145700200000,COMM CTRL CORE,Commercial,153014,0,140233,293247
142145700300000,COMM CTRL CORE,Commercial,79834,0,170166,250000
142145700400000,COMM CTRL CORE,Commercial,166320,0,851251,1017571
142145700500000,COMM CTRL CORE,Commercial,99792,0,7800,107592
142145700600000,COMM CTRL CORE,Commercial,81648,0,7800,89448
142145700700000,COMM CTRL CORE,Commercial,142884,0,257116,400000
142145700800000,COMM CTRL CORE,Commercial,40824,0,141333,182157
142145800100000,E-46 RELIG PARKING,Exempt,42336,0,3378,45714
142145800200000,E-40 CHURCHES,Exempt,148176,0,2260409,2408585
142145900100000,E-15 CITY,Exempt,0,0,0,0
142145900200000,COMM CTRL CORE,Commercial,76483,0,265736,342219
142145900300000,COMM CTRL CORE,Commercial,40824,0,3084,43908
142145900400000,COMM CTRL CORE,Commercial,36742,0,104183,140925
142145900500000,E-15 CITY,Exempt,0,0,0,0
142145900600000,COMM CTRL CORE,Commercial,81648,0,6949,88597
142145900700000,E-55 LIBRARY/ART,Exempt,72576,0,0,72576
142146000100000,E-15 CITY,Exempt,0,0,0,0
142146000200000,E-15 CITY,Exempt,0,0,0,0
142146000300000,COMM CTRL CORE,Commercial,108475,0,8942,117417
142146000400000,E-55 LIBRARY/ART,Exempt,237248,0,398055,635303
142146000500000,COMM CTRL CORE,Commercial,118612,0,193059,311671
142146000600000,COMM CTRL CORE,Commercial,201096,0,1888830,2089926
142146000700000,COMM CTRL CORE,Commercial,84672,0,0,84672
142146000800000,COMM CTRL CORE,Commercial,35721,0,0,35721
142146000900000,COMM CTRL CORE,Commercial,35721,0,0,35721
142146001000000,COMM CTRL CORE,Commercial,39690,0,0,39690
142146001100000,COMM CTRL CORE,Commercial,29938,0,114737,144675
142146100100000,E-15 CITY,Exempt,0,0,0,0
142146200100000,COMM CTRL CORE,Commercial,98221,0,55067,153288
142146200200000,COMM CTRL CORE,Commercial,21170,0,3269,24439
142146200300000,COMM CTRL CORE,Commercial,53824,0,128987,182811
142146200400000,COMM CTRL CORE,Commercial,79168,0,11012,90180
142146200500000,COMM CTRL CORE,Commercial,62869,0,156806,219675
142146200600000,E-10 COUNTY,Exempt,0,0,0,0
142146200700000,COMM CTRL CORE,Commercial,344736,0,769985,1114721
142146200800000,COMM CTRL CORE,Commercial,69854,0,19726,89580
142146200900000,COMM CTRL CORE,Commercial,69854,0,15513,85367
142146300100000,COMM CTRL CORE,Commercial,313171,0,3685022,3998193
142146300200000,COMM CTRL CORE,Commercial,218297,0,1674256,1892553
142146400100000,COMM CTRL CORE,Commercial,110808,0,717852,828660
142146400200000,COMM CTRL CORE,Commercial,69984,0,59686,129670
142146400300000,COMM CTRL CORE,Commercial,42687,0,73534,116221
142146400400000,COMM CTRL CORE,Commercial,141481,0,380964,522445
142146400500000,COMM CTRL CORE,Commercial,122487,0,474534,597021
142146400600000,COMM CTRL CORE,Commercial,3629,0,315,3944
142146400800000,COMM CTRL CORE,Commercial,54432,0,111484,165916
142146400900000,COMM CTRL CORE,Commercial,430920,0,355680,786600
142146401001000,COMM CTRL CORE,Commercial,28179,0,146572,174751
142146401001001,COMM CTRL CORE,Commercial,36231,0,149655,185886
142146401001002,COMM CTRL CORE,Commercial,36231,0,156160,192391
142146401001003,COMM CTRL CORE,Commercial,36231,0,2330,38561
142147600100000,E-45 CONVENT-DORMS,Exempt,184464,0,276403,460867
142147600200000,COMM SE,Commercial,142560,0,632440,775000
142147600400000,COMM SE,Commercial,45360,0,158765,204125
142147600600000,COMM SE,Commercial,145152,0,278892,424044
142147600700000,COMM SE,Commercial,224640,0,1289741,1514381
142147700100000,COMM SE,Commercial,27579,0,40504,68083
142147700200000,COMM SE,Commercial,11340,0,1922,13262
142147800100000,COMM SE,Commercial,54432,0,490239,544671
142147800200000,COMM SE,Commercial,24840,0,84835,109675
142147800300000,COMM SE,Commercial,62257,0,42766,105023
142147800302000,COMM SE,Commercial,0,0,10053,10053
142147800400000,COMM SE,Commercial,46834,0,8239,55073
142147800500000,COMM SE,Commercial,46834,0,34350,81184
142147800600000,COMM SE,Commercial,63504,0,352795,416299
142147800700000,COMM SE,Commercial,63504,0,6169,69673
142147800800000,COMM SE,Commercial,54432,0,5156,59588
142147800900000,COMM SE,Commercial,54432,0,6169,60601
142147801000000,COMM SE,Commercial,54432,0,191559,245991
142147801100000,COMM SE,Commercial,54432,0,157053,211485
142147900100000,COMM SE,Commercial,14580,0,105852,120432
142147900200000,E-60 HOSPITAL,Exempt,248832,0,67585,316417
142147900300000,SE 238,Residential,15300,61722,0,77022
142147900400000,E-60 HOSPITAL,Exempt,38880,0,0,38880
142148000100000,CONVERSIONS,Commercial,6440,0,48344,54784
142148000200000,CONVERSIONS,Commercial,10530,0,59929,70459
142148000300000,CONVERSIONS,Commercial,5832,0,90348,96180
142148000400000,COMM SE,Commercial,31104,0,5479,36583
142148000500000,E-67 SALVATION ARMY,Exempt,90720,0,196835,287555
142148000600000,COMM SE,Commercial,9113,0,34537,43650
142148000700000,COMM SE,Commercial,9049,0,33039,42088
142148000800000,COMM SE,Commercial,9054,0,37678,46732
142148000900000,COMM SE,Commercial,9097,0,33039,42136
142148001000000,COMM SE,Commercial,9101,0,33022,42123
142148001100000,COMM SE,Commercial,9097,0,39524,48621
142148001200000,COMM SE,Commercial,18325,0,37236,55561
142148001300000,COMM SE,Commercial,54550,0,3670,58220
142148001400000,COMM SE,Commercial,88906,0,18892,107798
142148001500000,CONVERSIONS,Commercial,12020,0,177589,189609
142148001600000,SE 238,Residential,8578,33669,0,42247
142148100100000,COMM SE,Commercial,181440,0,16565,198005
142148100300000,COMM SE,Commercial,22680,0,103914,126594
142148100400000,COMM SE,Commercial,31752,0,1166,32918
142148100500000,COMM SE,Commercial,81648,0,5870,87518
142148100600000,E-40 CHURCHES,Exempt,105840,0,221880,327720
142148200100000,COMM SE,Commercial,125453,0,769463,894916
142148200300000,E-60 HOSPITAL,Exempt,23501,0,2462,25963
142148300100000,COMM SE,Commercial,145152,0,393378,538530
142148300200000,E-60 HOSPITAL,Exempt,90720,0,15901,106621
142148300300000,E-60 HOSPITAL,Exempt,54432,0,3878,58310
142148300600000,COMM SE,Commercial,36288,0,0,36288
142148300700000,E-60 HOSPITAL,Exempt,4941,0,0,4941
142148300800000,E-60 HOSPITAL,Exempt,4941,0,0,4941
142148300900000,E-60 HOSPITAL,Exempt,18922,0,0,18922
142148400100000,COMM SE,Commercial,36288,0,119259,155547
142148400200000,Empty,Other,0,0,0,0
142148400300000,Empty,Other,0,0,0,0
142148400400000,Empty,Other,0,0,0,0
142148400500000,Empty,Other,0,0,0,0
142148400600000,SE 238,Residential,4425,38100,0,42525
142148400700000,SE 238,Residential,4425,37717,0,42142
142148400800000,COMM SE,Commercial,19008,0,4039,23047
142148400900000,Empty,Other,0,0,0,0
142148401000000,APTS SE,Commercial,13608,0,13781,27389
142148401100000,COMM SE,Commercial,36288,0,2100,38388
142148500100000,COMM SE,Commercial,628290,0,11130410,11758700
142148500200000,APTS SE,Commercial,20380,0,380452,400832
142148600200000,CONVERSIONS,Commercial,4374,0,37747,42121
142148600700000,COMM SE,Commercial,27216,0,57121,84337
142148600800000,COMM SE,Commercial,70070,0,13356,83426
142148600900000,E-40 CHURCHES,Exempt,10368,0,23121,33489
142148601100000,COMM SE,Commercial,66407,0,27248,93655
142148601300000,COMM SE,Commercial,121500,0,2003823,2125323
142148700100000,COMM SE,Commercial,23328,0,64330,87658
142148700200000,E-60 HOSPITAL,Exempt,49248,0,9144,58392
142148700300000,E-60 HOSPITAL,Exempt,181440,0,530842,712282
142148700400000,E-70 CHARITY OTHER,Exempt,36288,0,0,36288
142148700500000,E-70 CHARITY OTHER,Exempt,18144,0,74368,92512
142148700600000,COMM SE,Commercial,54432,0,136763,191195
142148800100000,E-65 YWCA,Exempt,68040,0,616970,685010
142148800200000,E-46 RELIG PARKING,Exempt,63504,0,5288,68792
142148800300000,E-46 RELIG PARKING,Exempt,63504,0,5288,68792
142148800400000,E-65 YWCA,Exempt,136080,0,1076499,1212579
142148800500000,E-65 YWCA,Exempt,22680,0,3977,26657
142148900100000,COMM SE,Commercial,49594,0,15839,65433
142148900300000,COMM SE,Commercial,45360,0,87626,132986
142148900400000,COMM SE,Commercial,60480,0,13719,74199
142148900500000,COMM SE,Commercial,19656,0,41411,61067
142148900600000,COMM SE,Commercial,22680,0,6040,28720
142148900700000,COMM SE,Commercial,22680,0,48853,71533
142148900800000,COMM SE,Commercial,29484,0,141462,170946
142148900900000,COMM SE,Commercial,12960,0,0,12960
142148901000000,COMM SE,Commercial,72576,0,48135,120711
142148901300000,COMM SE,Commercial,22982,0,2916,25898
142210100100000,SE 248,Residential,74900,209803,0,284703
142210100200000,SE 248,Residential,95762,100036,0,195798
142210100300000,SE 248,Residential,75600,229622,0,305222
142210100400000,SE 248,Residential,147550,201197,0,348747
142210100500000,SE 248,Residential,84750,274138,0,358888
142210100600000,SE 248,Residential,82500,198865,0,281365
142210100700000,SE 248,Residential,73600,168952,0,242552
142210100800000,SE 248,Residential,63000,193256,0,256256
142210100900000,SE 248,Residential,92085,151750,0,243835
142210200100000,SE 248,Residential,83456,219664,0,303120
142210200200000,SE 248,Residential,91000,312783,0,403783
142210200300000,SE 248,Residential,130839,569161,0,700000
142210200400000,SE 248,Residential,124320,279057,0,403377
142210200500000,SE 248,Residential,74592,237222,0,311814
142210200600000,SE 248,Residential,66600,212744,0,279344
142210200700000,SE 248,Residential,69143,211017,0,280160
142210200800000,SE 248,Residential,92171,346083,0,438254
142210200900000,SE 248,Residential,85053,152914,0,237967
142210201000000,SE 248,Residential,87733,158755,0,246488
142210201100000,SE 248,Residential,81408,287877,0,369285
142210201200000,SE 248,Residential,58240,258775,0,317015
142210201300000,SE 248,Residential,67840,112705,0,180545
142210201400000,SE 248,Residential,74523,176432,0,250955
142210201500000,SE 248,Residential,49451,130542,0,179993
142210201600000,SE 248,Residential,103600,400361,0,503961
142210201700000,SE 248,Residential,87387,107358,0,194745
142210201800000,SE 248,Residential,70512,186080,0,256592
142210201900000,SE 248,Residential,110288,306673,0,416961
142210202000000,SE 248,Residential,90400,351600,0,442000
142210300100000,SE 248,Residential,95040,199960,0,295000
142210300200000,SE 248,Residential,54000,193368,0,247368
142210300300000,SE 248,Residential,54000,194755,0,248755
142210300400000,SE 248,Residential,103000,315238,0,418238
142210300500000,SE 248,Residential,132450,238988,0,371438
142210400100000,SE 248,Exempt,141450,0,481358,622808
142210400200000,SE 248,Residential,52400,281506,0,333906
142210400300000,SE 248,Residential,52380,139253,0,191633
142210400400000,SE 248,Residential,21560,123405,0,144965
142210400500000,SE 248,Residential,39263,199348,0,238611
142210400600000,SE 248,Residential,24000,139523,0,163523
142210400700000,SE 248,Residential,24000,151461,0,175461
142210400800000,SE 248,Residential,28280,183079,0,211359
142210400900000,SE 248,Residential,24480,145447,0,169927
142210401000000,SE 248,Residential,61095,135665,0,196760
142210401100000,SE 248,Residential,58880,158524,0,217404
142210401200000,SE 248,Residential,50880,142481,0,193361
142210401300000,SE 248,Residential,55035,160368,0,215403
142210401400000,SE 248,Residential,51360,104904,0,156264
142210401500000,SE 248,Residential,122944,219902,0,342846
142210401600000,SE 248,Residential,138450,687550,0,826000
142210401700000,SE 248,Residential,140850,422461,0,563311
142210500100000,SE 216,Residential,49756,87433,0,137189
142210600100000,SE 216,Residential,45934,91936,0,137870
142210600200000,SE 216,Residential,20958,112994,0,133952
142210600300000,SE 216,Residential,48000,139473,0,187473
142210600400000,SE 216,Residential,48000,129709,0,177709
142210600500000,SE 216,Residential,48000,116515,0,164515
142210600600000,SE 216,Residential,51200,118448,0,169648
142210600700000,SE 216,Residential,48000,104933,0,152933
142210600800000,SE 216,Residential,40000,108133,0,148133
142210600900000,SE 216,Residential,56000,122633,0,178633
142210601000000,SE 216,Residential,48000,116288,0,164288
142210601100000,SE 216,Residential,48000,103381,0,151381
142210601200000,SE 216,Residential,48000,119607,0,167607
142210601300000,SE 216,Residential,48000,140063,0,188063
142210601400000,SE 216,Residential,48000,148425,0,196425
142210601500000,SE 216,Residential,32000,107034,0,139034
142210601600000,SE 216,Residential,32000,99059,0,131059
142210601700000,SE 216,Residential,44000,102313,0,146313
142210601800000,SE 216,Residential,39240,109819,0,149059
142210601900000,SE 216,Residential,36520,103744,0,140264
142210602000000,SE 216,Residential,12450,96803,0,109253
142210900100000,SE 231,Residential,12500,65176,0,77676
142210900800000,CONVERSIONS,Commercial,13608,0,56145,69753
142212600100000,SE 218,Residential,19500,149719,0,169219
142212600200000,SE 218,Residential,19500,178826,0,198326
142212600300000,SE 218,Residential,18000,0,0,18000
142212600400000,SE 218,Residential,18000,185482,0,203482
142212600500000,SE 218,Residential,18000,174038,0,192038
142212600600000,SE 218,Residential,18000,194216,0,212216
142212600700000,SE 218,Residential,18000,198913,0,216913
142212600800000,SE 218,Residential,18000,0,0,18000
142212600900000,SE 218,Residential,18000,246895,0,264895
142212601000000,SE 218,Residential,18000,144279,0,162279
142212601100000,SE 218,Residential,18000,186000,0,204000
142212601200000,SE 218,Residential,18000,139789,0,157789
142212601300000,SE 218,Residential,18000,161469,0,179469
142212601400000,SE 218,Residential,18000,129697,0,147697
142212601500000,SE 218,Residential,18000,135912,0,153912
142212601600000,SE 218,Residential,18000,189181,0,207181
142212601700000,SE 218,Residential,18000,122164,0,140164
142212601800000,SE 218,Residential,18000,138000,0,156000
142212601900000,SE 218,Residential,18000,144201,0,162201
142212602000000,SE 218,Residential,18000,140898,0,158898
142212700100000,SE 218,Residential,30000,277023,0,307023
142212700200000,SE 218,Residential,24900,270376,0,295276
142212700300000,SE 218,Residential,24600,219757,0,244357
142212700400000,CONVERSIONS,Commercial,13608,0,65518,79126
142212700500000,SE 218,Residential,18000,71971,0,89971
142212700600000,SE 218,Residential,18000,107623,0,125623
142212700700000,COMM SE,Commercial,54432,0,69087,123519
142212700800000,SE 218,Residential,18000,168584,0,186584
142212700900000,SE 218,Residential,18000,122556,0,140556
142212701000000,SE 218,Residential,18000,226239,0,244239
142212701100000,SE 218,Residential,18000,164609,0,182609
142212800100000,COMM NE,Commercial,63180,0,116952,180132
142212900100000,SE 217,Residential,13680,94785,0,108465
142212900200000,SE 217,Residential,21623,104870,0,126493
142212900300000,SE 217,Residential,11856,95131,0,106987
142212900400000,SE 217,Residential,7826,118815,0,126641
142212900500000,SE 217,Residential,12600,88411,0,101011
142212900600000,SE 217,Residential,30736,121662,0,152398
142212900700000,SE 217,Residential,23200,96035,0,119235
142212900800000,SE 217,Residential,16800,106674,0,123474
142212900900000,SE 217,Residential,24000,115749,0,139749
142212901000000,SE 217,Residential,9920,92580,0,102500
142213000100000,SE 218,Residential,15300,108126,0,123426
142213000200000,SE 218,Residential,15300,95572,0,110872
142213000300000,SE 218,Residential,15300,88405,0,103705
142213000400000,SE 218,Residential,15300,74571,0,89871
142213000500000,SE 218,Residential,15300,69612,0,84912
142213000600000,SE 218,Residential,18000,101212,0,119212
142213000700000,SE 218,Residential,15300,101428,0,116728
142213000800000,CONVERSIONS,Commercial,13608,0,3000,16608
142213000900000,CONVERSIONS,Commercial,13608,0,67677,81285
142213001000000,SE 218,Residential,15300,126733,0,142033
142213001100000,SE 218,Residential,15300,151449,0,166749
142213001200000,SE 218,Residential,15300,143394,0,158694
142213001300000,SE 218,Residential,15300,82849,0,98149
142213001400000,SE 218,Residential,15300,105267,0,120567
142213001500000,SE 218,Residential,15300,102373,0,117673
142213001600000,SE 218,Residential,15300,91046,0,106346
142213100100000,SE 222,Exempt,17136,0,218009,235145
142213100200000,COMM SE,Commercial,208170,0,933566,1141736
142213100300000,COMM SE,Commercial,163296,0,960457,1123753
142213100400000,COMM SE,Commercial,54432,0,7308,61740
142213100500000,SE 218,Residential,16800,119370,0,136170
142213100600000,SE 218,Residential,15000,84553,0,99553
142213100700000,SE 218,Residential,15300,87216,0,102516
142213100800000,SE 218,Residential,15300,105987,0,121287
142213100900000,SE 218,Residential,15300,169152,0,184452
142213101000000,SE 218,Residential,15675,106962,0,122637
142213101100000,SE 218,Residential,15675,138098,0,153773
142213200100000,SE 231,Residential,12500,83892,0,96392
142213200400000,SE 217,Residential,7634,62359,0,69993
142213200500000,SE 217,Residential,8468,80342,0,88810
142213200600000,SE 217,Residential,6228,76907,0,83135
142213300100000,SE 217,Residential,19920,110312,0,130232
142213300200000,SE 217,Residential,24000,107197,0,131197
142213300300000,SE 217,Residential,16000,122257,0,138257
142213300400000,SE 217,Residential,16000,96277,0,112277
142213300500000,SE 217,Residential,16000,93570,0,109570
142213300600000,SE 217,Residential,24000,41781,0,65781
142213300700000,SE 217,Residential,24000,86770,0,110770
142213300800000,SE 217,Residential,21120,155896,0,177016
142213300900000,SE 217,Residential,6200,85071,0,91271
142213301000000,SE 217,Residential,7440,99729,0,107169
142213301100000,SE 217,Residential,12600,114598,0,127198
142213301200000,SE 217,Residential,7500,73324,0,80824
142213301300000,SE 217,Residential,7500,71718,0,79218
142213301400000,SE 217,Residential,9700,89298,0,98998
142213301500000,SE 217,Residential,300,2728,0,3028
142213301600000,SE 217,Residential,10000,79773,0,89773
142213301700000,SE 217,Residential,10000,109714,0,119714
142213301800000,SE 217,Residential,10000,99651,0,109651
142213301900000,SE 217,Residential,11250,111907,0,123157
142213302000000,SE 217,Residential,8750,88096,0,96846
142213302100000,SE 217,Residential,12450,107332,0,119782
142213302200000,SE 217,Residential,12400,91391,0,103791
142213302300000,SE 217,Residential,12400,108093,0,120493
142213400100000,SE 217,Residential,8671,69643,0,78314
142213400200000,SE 217,Residential,8568,71420,0,79988
142213400300000,SE 217,Residential,8311,52686,0,60997
142213400700000,SE 217,Residential,6600,56157,0,62757
142213400800000,SE 217,Residential,10000,91723,0,101723
142213400900000,SE 217,Residential,10000,80509,0,90509
142213401000000,SE 217,Residential,11050,131145,0,142195
142213401100000,SE 217,Residential,8752,85607,0,94359
142213401200000,SE 217,Residential,4375,67870,0,72245
142213500100000,SE 231,Residential,8400,90792,0,99192
142213500200000,SE 231,Residential,6650,31436,0,38086
142213500300000,SE 231,Residential,6650,33835,0,40485
142213500400000,CONVERSIONS,Commercial,9072,0,53495,62567
142213500500000,CONVERSIONS,Commercial,27216,0,183784,211000
142213500600000,E-70 CHARITY OTHER,Exempt,9072,0,92541,101613
142213500700000,SE 231,Residential,12500,46902,0,59402
142213500800000,SE 231,Residential,10000,94492,0,104492
142213500900000,CONVERSIONS,Commercial,9072,0,68089,77161
142213501000000,SE 231,Residential,12000,59251,0,71251
142213501100000,SE 231,Residential,12000,81564,0,93564
142213501200000,SE 231,Residential,12000,72596,0,84596
142213501300000,SE 231,Residential,12000,71878,0,83878
142213501400000,SE 231,Residential,12000,90747,0,102747
142213501500000,CONVERSIONS,Commercial,9072,0,59412,68484
142213501600000,SE 231,Residential,8400,74577,0,82977
142213600100000,SE 217,Residential,10582,79193,0,89775
142213600200000,SE 217,Residential,9300,93920,0,103220
142213600300000,SE 217,Residential,12500,92310,0,104810
142213600400000,SE 217,Residential,10000,94963,0,104963
142213600500000,SE 217,Residential,10000,100782,0,110782
142213600600000,SE 217,Residential,10000,96165,0,106165
142213600700000,SE 217,Residential,10000,102158,0,112158
142213600800000,SE 217,Residential,10000,100804,0,110804
142213600900000,SE 217,Residential,12075,118693,0,130768
142213601000000,SE 217,Residential,9690,67361,0,77051
142213601100000,SE 217,Residential,8755,81406,0,90161
142213700100000,SE 217,Residential,9669,94316,0,103985
142213700200000,SE 217,Residential,9380,79726,0,89106
142213700300000,SE 217,Residential,12750,78918,0,91668
142213700400000,SE 217,Residential,10000,64641,0,74641
142213700500000,SE 217,Residential,12500,56586,0,69086
142213700600000,SE 217,Residential,11250,69103,0,80353
142213700700000,SE 217,Residential,10398,75308,0,85706
142213700800000,SE 217,Residential,8925,85900,0,94825
142213700900000,SE 217,Residential,10374,54426,0,64800
142213800100000,SE 217,Residential,8617,37011,0,45628
142213800200000,SE 217,Residential,9106,39814,0,48920
142215100100000,SE 217,Residential,9300,83399,0,92699
142215100200000,SE 217,Residential,10582,92078,0,102660
142215100300000,SE 217,Residential,10000,111090,0,121090
142215100400000,SE 217,Residential,10000,100097,0,110097
142215100500000,SE 217,Residential,10000,104772,0,114772
142215100600000,SE 217,Residential,10000,91036,0,101036
142215100700000,SE 217,Residential,10000,97645,0,107645
142215100800000,SE 217,Residential,10000,86638,0,96638
142215100900000,SE 217,Residential,12240,125942,0,138182
142215101000000,SE 217,Residential,8925,73881,0,82806
142215101100000,SE 217,Residential,9690,96450,0,106140
142215200100000,SE 217,Residential,8000,81585,0,89585
142215200200000,SE 217,Residential,590,0,0,590
142215200300000,SE 217,Residential,9927,89257,0,99184
142215200400000,SE 217,Residential,9703,71265,0,80968
142215200500000,SE 217,Residential,10000,91567,0,101567
142215200600000,SE 217,Residential,10000,65195,0,75195
142215200700000,SE 217,Residential,10000,72572,0,82572
142215200800000,SE 217,Residential,10000,73283,0,83283
142215200900000,SE 217,Residential,12500,85657,0,98157
142215201000000,SE 217,Residential,7905,67337,0,75242
142215201100000,SE 217,Residential,9690,74044,0,83734
142215300100000,SE 217,Residential,10640,71892,0,82532
142215300200000,SE 217,Residential,7000,76381,0,83381
142215300300000,SE 217,Residential,7000,81550,0,88550
142215300400000,SE 217,Residential,10000,40106,0,50106
142215300500000,SE 217,Residential,8889,73836,0,82725
142215300600000,SE 217,Residential,8925,92659,0,101584
142215300700000,SE 217,Residential,10943,32817,0,43760
142215300800000,SE 217,Residential,8707,63856,0,72563
142215400100000,CONVERSIONS,Commercial,13608,0,156989,170597
142215400200000,SE 217,Residential,12000,97042,0,109042
142215400300000,SE 217,Residential,10500,116128,0,126628
142215400400000,SE 217,Residential,10000,115965,0,125965
142215400500000,SE 217,Residential,10000,103158,0,113158
142215400600000,SE 217,Residential,12750,103974,0,116724
142215400700000,SE 217,Residential,10000,108331,0,118331
142215400800000,SE 217,Residential,6125,62144,0,68269
142215400900000,SE 217,Residential,7875,64429,0,72304
142215401000000,SE 217,Residential,7600,65237,0,72837
142215401100000,SE 217,Residential,5700,71811,0,77511
142215401200000,SE 217,Residential,6650,61189,0,67839
142215401300000,SE 217,Residential,6650,68721,0,75371
142215401400000,SE 217,Residential,7875,87931,0,95806
142215401500000,SE 217,Residential,6125,63934,0,70059
142215401600000,SE 217,Residential,10000,83375,0,93375
142215401700000,SE 217,Residential,10000,93625,0,103625
142215401800000,SE 217,Residential,10000,83079,0,93079
142215401900000,SE 217,Residential,7500,66693,0,74193
142215402000000,SE 217,Residential,12500,113545,0,126045
142215402100000,SE 217,Residential,10000,64057,0,74057
142215402200000,SE 217,Residential,10000,112692,0,122692
142215402300000,SE 217,Residential,5250,75524,0,80774
142215402400000,SE 217,Residential,5250,63753,0,69003
142215402500000,SE 217,Residential,5580,70349,0,75929
142215402600000,SE 217,Residential,7440,63125,0,70565
142215402700000,SE 217,Residential,7440,86953,0,94393
142215500100000,SE 217,Residential,8100,116119,0,124219
142215500200000,SE 217,Residential,7530,89161,0,96691
142215500300000,SE 217,Residential,10000,69283,0,79283
142215500400000,SE 217,Residential,10000,89038,0,99038
142215500500000,SE 217,Residential,10000,62070,0,72070
142215500600000,SE 217,Residential,10000,93688,0,103688
142215500700000,SE 217,Residential,10000,83678,0,93678
142215500800000,SE 217,Residential,7300,49981,0,57281
142215500900000,SE 217,Residential,7300,86018,0,93318
142215501000000,SE 217,Residential,6175,50778,0,56953
142215501100000,SE 217,Residential,6175,50439,0,56614
142215501200000,SE 217,Residential,6125,63662,0,69787
142215501300000,SE 217,Residential,6125,55577,0,61702
142215501400000,SE 217,Residential,7000,59470,0,66470
142215501500000,SE 217,Residential,5250,55320,0,60570
142215501600000,SE 217,Residential,7500,75002,0,82502
142215501700000,SE 217,Residential,10000,64565,0,74565
142215501800000,SE 217,Residential,10000,88696,0,98696
142215501900000,SE 217,Residential,10000,73428,0,83428
142215502000000,SE 217,Residential,10000,81081,0,91081
142215502100000,SE 217,Residential,10000,64981,0,74981
142215502200000,SE 217,Residential,5688,59725,0,65413
142215502300000,SE 217,Residential,5688,56078,0,61766
142215502400000,SE 217,Residential,5863,55180,0,61043
142215502500000,SE 217,Residential,5863,52384,0,58247
142215502600000,SE 217,Residential,6500,61011,0,67511
142215502700000,SE 217,Residential,6665,52279,0,58944
142215600100000,APTS SE,Commercial,19278,0,167552,186830
142215600200000,SE 231,Residential,10000,93146,0,103146
142215600300000,SE 231,Residential,10000,90684,0,100684
142215600400000,SE 231,Residential,10000,73468,0,83468
142215600500000,SE 231,Residential,10000,91051,0,101051
142215600600000,SE 231,Residential,10000,80230,0,90230
142215600700000,APTS SE,Commercial,13608,0,150513,164121
142215600800000,SE 231,Residential,7000,87648,0,94648
142215600900000,SE 231,Residential,9125,69966,0,79091
142215601000000,SE 231,Residential,11850,19129,0,30979
142215601100000,SE 231,Residential,9409,68842,0,78251
142215601200000,SE 231,Residential,10000,97176,0,107176
142215601300000,SE 231,Residential,10000,96804,0,106804
142215601400000,SE 231,Residential,10000,104732,0,114732
142215601500000,SE 231,Residential,10000,66052,0,76052
142215601600000,SE 231,Residential,10000,77787,0,87787
142215601700000,SE 231,Residential,9669,74598,0,84267
142215601800000,SE 231,Residential,5863,61322,0,67185
142215601900000,SE 231,Residential,5863,62697,0,68560
142215700100000,COMM SE,Exempt,11340,0,240531,251871
142215700200000,SE 217,Residential,10000,83757,0,93757
142215700300000,SE 217,Residential,10000,101220,0,111220
142215700400000,SE 217,Residential,10000,89749,0,99749
142215700500000,SE 217,Residential,12500,83141,0,95641
142215700600000,SE 217,Exempt,10000,127182,0,137182
142215700700000,SE 217,Residential,10000,84393,0,94393
142215700800000,SE 217,Residential,7000,68648,0,75648
142215700900000,SE 217,Residential,5250,75826,0,81076
142215701000000,Empty,Exempt,0,0,0,0
142215701100000,Empty,Exempt,0,0,0,0
142215701200000,SE 217,Residential,5038,54709,0,59747
142215701300000,SE 217,Residential,9307,85004,0,94311
142215701400000,SE 217,Residential,7500,50484,0,57984
142215701500000,SE 217,Residential,7500,76410,0,83910
142215701600000,SE 217,Residential,10000,94242,0,104242
142215701700000,SE 217,Residential,10000,80524,0,90524
142215701800000,SE 217,Residential,10000,88049,0,98049
142215701900000,SE 217,Residential,10000,88547,0,98547
142215702000000,SE 217,Residential,10000,78083,0,88083
142215702100000,SE 217,Residential,10000,92076,0,102076
142215702200000,SE 217,Residential,5250,84921,0,90171
142215702300000,SE 217,Residential,5250,79757,0,85007
142215702400000,SE 217,Residential,6510,56527,0,63037
142215702500000,SE 217,Residential,6510,64634,0,71144
142215800100000,Empty,Exempt,0,0,0,0
142215900100000,SE 231,Residential,5931,53340,0,59271
142215900200000,SE 231,Residential,5931,55153,0,61084
142215900300000,SE 231,Residential,10000,78240,0,88240
142215900400000,SE 231,Residential,15000,68586,0,83586
142215900500000,SE 231,Residential,12750,77959,0,90709
142215900600000,SE 231,Residential,10000,103146,0,113146
142215900700000,SE 231,Residential,10000,125632,0,135632
142215900800000,SE 231,Residential,7905,71829,0,79734
142215900900000,SE 231,Residential,6200,66898,0,73098
142215901000000,SE 231,Residential,6200,69885,0,76085
142215901100000,SE 216,Residential,17000,38661,0,55661
142215901200000,CONVERSIONS,Commercial,11794,0,14700,26494
142215901300000,E-46 RELIG PARKING,Exempt,13608,0,311,13919
142215901400000,E-40 CHURCHES,Exempt,13608,0,173,13781
142215901500000,E-40 CHURCHES,Exempt,28350,0,692755,721105
142215901600000,SE 231,Residential,5444,64988,0,70432
142215901700000,SE 231,Residential,5444,64818,0,70262
142216000100000,SE 217,Residential,5360,77829,0,83189
142216000200000,SE 217,Residential,6050,84420,0,90470
142216000300000,SE 217,Residential,8315,103438,0,111753
142216000400000,SE 217,Residential,9500,84366,0,93866
142216000500000,SE 217,Residential,8500,91713,0,100213
142216000600000,SE 217,Residential,8500,61888,0,70388
142216000700000,SE 217,Residential,8000,92757,0,100757
142216000800000,SE 217,Residential,10000,99262,0,109262
142216000900000,SE 217,Residential,10000,81210,0,91210
142216001000000,SE 217,Residential,10000,64989,0,74989
142216001100000,SE 217,Residential,5250,57482,0,62732
142216001200000,SE 217,Residential,5250,60926,0,66176
142216001300000,SE 217,Residential,5425,65352,0,70777
142216001400000,SE 217,Residential,5425,69608,0,75033
142216001500000,SE 217,Residential,5425,58254,0,63679
142216001600000,SE 217,Residential,5425,67842,0,73267
142216001700000,SE 217,Residential,8925,108573,0,117498
142216001800000,SE 217,Residential,10000,121555,0,131555
142216001900000,SE 217,Residential,9000,94092,0,103092
142216002000000,SE 217,Residential,11000,88516,0,99516
142216002100000,SE 217,Residential,10000,90472,0,100472
142216002200000,SE 217,Residential,10000,78213,0,88213
142216002300000,SE 217,Residential,10000,100505,0,110505
142216002400000,SE 217,Residential,10000,119220,0,129220
142216002500000,SE 217,Residential,9900,91425,0,101325
142216002600000,SE 217,Residential,7300,101974,0,109274
142216002700000,SE 217,Residential,10260,85481,0,95741
142216002800000,SE 217,Residential,7560,75730,0,83290
142216002900000,SE 217,Residential,8091,92515,0,100606
142216100100000,CONVERSIONS,Commercial,7371,0,42092,49463
142216100200000,SE 217,Residential,10000,69375,0,79375
142216100300000,SE 217,Residential,10000,59962,0,69962
142216100400000,SE 217,Residential,10000,106178,0,116178
142216100500000,SE 217,Residential,10000,68581,0,78581
142216100600000,SE 217,Residential,10000,60142,0,70142
142216100700000,SE 217,Residential,10000,38772,0,48772
142216100800000,SE 217,Residential,7905,51804,0,59709
142216100900000,SE 217,Residential,6200,49215,0,55415
142216101000000,SE 217,Residential,6200,69529,0,75729
142216101100000,SE 217,Residential,5475,42472,0,47947
142216101200000,SE 217,Residential,12867,79824,0,92691
142216101300000,SE 217,Residential,10000,71638,0,81638
142216101400000,SE 217,Residential,10000,84920,0,94920
142216101500000,SE 217,Residential,10000,58769,0,68769
142216101600000,SE 217,Residential,10000,112930,0,122930
142216101700000,SE 217,Residential,8750,94536,0,103286
142216101800000,SE 217,Residential,12644,106119,0,118763
142216101900000,SE 217,Residential,8099,93560,0,101659
142216102000000,SE 217,Residential,6820,66798,0,73618
142216102100000,SE 217,Residential,5940,79566,0,85506
142216102200000,SE 217,Residential,5863,83381,0,89244
142216102300000,SE 217,Residential,5863,67683,0,73546
142216200100000,SE 231,Residential,8564,110214,0,118778
142216200200000,SE 231,Residential,10000,45580,0,55580
142216200300000,SE 231,Residential,10000,64899,0,74899
142216200400000,SE 231,Residential,10000,59149,0,69149
142216200500000,SE 231,Residential,10000,57937,0,67937
142216200600000,SE 231,Residential,10000,40821,0,50821
142216200700000,SE 231,Residential,10000,70782,0,80782
142216200800000,SE 231,Residential,8925,66696,0,75621
142216200900000,SE 231,Residential,5425,55287,0,60712
142216201000000,SE 231,Residential,5425,65094,0,70519
142216201100000,SE 231,Residential,7750,51536,0,59286
142216201200000,SE 231,Residential,10582,102721,0,113303
142216201300000,SE 231,Residential,12750,57250,0,70000
142216201400000,CONVERSIONS,Commercial,13608,0,65392,79000
142216201500000,SE 231,Exempt,10000,0,93889,103889
142216201600000,SE 231,Residential,10000,88708,0,98708
142216201700000,SE 231,Residential,10000,75139,0,85139
142216201800000,SE 231,Residential,9112,104689,0,113801
142216201900000,SE 231,Residential,6198,63991,0,70189
142216202000000,SE 231,Residential,5863,52686,0,58549
142216202100000,SE 231,Residential,6700,40913,0,47613
142216202200000,SE 231,Residential,6700,41108,0,47808
142217600100000,SE 216,Residential,33440,121272,0,154712
142217600200000,SE 216,Residential,38400,97073,0,135473
142217700100000,SE 216,Residential,31217,85696,0,116913
142217700200000,SE 216,Residential,30000,147253,0,177253
142217700300000,SE 216,Residential,30000,140961,0,170961
142217700400000,SE 216,Residential,30000,131960,0,161960
142217700500000,SE 216,Residential,30000,137309,0,167309
142217700600000,SE 216,Residential,30000,101907,0,131907
142217700700000,SE 216,Residential,30000,130431,0,160431
142217700800000,SE 216,Residential,37500,186873,0,224373
142217700900000,SE 216,Residential,32500,159094,0,191594
142217701000000,SE 216,Residential,30000,136088,0,166088
142217701100000,SE 216,Residential,30000,109160,0,139160
142217701200000,SE 216,Residential,30000,119354,0,149354
142217701300000,SE 216,Residential,30000,107573,0,137573
142217701400000,SE 216,Residential,30000,114102,0,144102
142217701500000,SE 216,Residential,30000,105751,0,135751
142217701600000,SE 216,Residential,30000,102708,0,132708
142217701700000,SE 216,Residential,30000,112635,0,142635
142217701800000,SE 216,Residential,30000,120620,0,150620
142217800100000,SE 216,Residential,17549,95682,0,113231
142217800200000,SE 216,Residential,19381,86242,0,105623
142217800300000,SE 216,Residential,18500,85305,0,103805
142217800400000,SE 216,Residential,20500,110205,0,130705
142217800500000,SE 216,Residential,20000,97558,0,117558
142217800600000,SE 216,Residential,20000,80727,0,100727
142217800700000,SE 216,Residential,19000,86777,0,105777
142217800800000,SE 216,Residential,19000,92101,0,111101
142217800900000,SE 216,Residential,19000,102653,0,121653
142217801000000,SE 216,Residential,17000,67082,0,84082
142217801100000,SE 216,Residential,18287,114601,0,132888
142217801200000,SE 216,Residential,16800,87448,0,104248
142217801300000,SE 216,Residential,13300,71488,0,84788
142217801400000,SE 216,Residential,13300,85990,0,99290
142217801500000,SE 216,Residential,13300,84274,0,97574
142217801600000,SE 216,Residential,14000,87474,0,101474
142217801700000,SE 216,Residential,14000,63621,0,77621
142217801800000,SE 216,Residential,20000,80840,0,100840
142217801900000,SE 216,Residential,20000,86886,0,106886
142217802000000,SE 216,Residential,20000,75904,0,95904
142217802100000,SE 216,Residential,15000,62468,0,77468
142217802200000,SE 216,Residential,20000,78616,0,98616
142217802300000,SE 216,Residential,20000,85253,0,105253
142217802400000,SE 216,Residential,20000,86811,0,106811
142217802500000,SE 216,Residential,20475,103666,0,124141
142217802600000,SE 216,Residential,20000,77857,0,97857
142217802700000,SE 216,Residential,14000,52953,0,66953
142217802800000,SE 216,Residential,14117,82790,0,96907
142217802900000,SE 216,Residential,17395,91936,0,109331
142217803000000,SE 216,Residential,16575,59060,0,75635
142217900100000,SE 216,Residential,17000,92833,0,109833
142217900200000,SE 216,Residential,17000,72133,0,89133
142217900300000,SE 216,Residential,20000,94956,0,114956
142217900400000,SE 216,Residential,20000,114112,0,134112
142217900500000,SE 216,Residential,17500,90025,0,107525
142217900600000,SE 216,Residential,17500,83193,0,100693
142217900700000,SE 216,Residential,20000,93855,0,113855
142217900800000,SE 216,Residential,22500,105771,0,128271
142217900900000,SE 216,Residential,22500,92333,0,114833
142217901000000,SE 216,Residential,20000,89321,0,109321
142217901100000,SE 216,Residential,22100,77631,0,99731
142217901200000,SE 216,Residential,19000,82612,0,101612
142217901300000,SE 216,Residential,24000,95788,0,119788
142217901400000,SE 216,Residential,7980,80015,0,87995
142217901500000,SE 216,Residential,7980,79703,0,87683
142217901600000,SE 216,Residential,14000,67928,0,81928
142217901700000,SE 216,Residential,14000,87952,0,101952
142217901800000,SE 216,Residential,20000,85247,0,105247
142217901900000,SE 216,Residential,20000,79048,0,99048
142217902000000,SE 216,Residential,20000,93955,0,113955
142217902100000,SE 216,Residential,20000,84906,0,104906
142217902200000,SE 216,Residential,20000,78926,0,98926
142217902300000,SE 216,Residential,20000,87529,0,107529
142217902400000,SE 216,Residential,20000,55173,0,75173
142217902500000,SE 216,Residential,20000,102861,0,122861
142217902600000,SE 216,Residential,20000,44861,0,64861
142217902700000,SE 216,Residential,20000,85761,0,105761
142217902800000,SE 216,Residential,19250,63154,0,82404
142217902900000,SE 216,Residential,14000,69128,0,83128
142217903000000,SE 216,Residential,14000,75852,0,89852
142217903100000,SE 216,Residential,13300,75797,0,89097
142217903200000,SE 216,Residential,15050,85117,0,100167
142217903300000,SE 216,Residential,15958,85800,0,101758
142218000100000,SE 216,Residential,13067,88006,0,101073
142218000200000,SE 216,Residential,14000,71133,0,85133
142218000300000,SE 216,Residential,20000,76095,0,96095
142218000400000,SE 216,Residential,20000,73632,0,93632
142218000500000,SE 216,Residential,20000,72754,0,92754
142218000600000,SE 216,Residential,20000,86361,0,106361
142218000700000,SE 216,Residential,20000,96240,0,116240
142218000800000,SE 216,Residential,20000,57585,0,77585
142218000900000,SE 216,Residential,20000,77432,0,97432
142218001000000,SE 216,Residential,20000,27066,0,47066
142218001100000,SE 216,Residential,21250,100773,0,122023
142218001200000,SE 216,Residential,14000,79755,0,93755
142218001300000,SE 216,Residential,14000,0,0,14000
142218001400000,SE 216,Residential,8000,0,0,8000
142218001500000,SE 216,Residential,13300,79575,0,92875
142218001600000,SE 216,Residential,13300,74842,0,88142
142218001700000,SE 216,Residential,13300,68922,0,82222
142218001800000,SE 216,Residential,14000,80527,0,94527
142218001900000,SE 216,Residential,14000,81470,0,95470
142218002000000,SE 216,Residential,20000,75169,0,95169
142218002100000,SE 216,Residential,20000,62233,0,82233
142218002200000,SE 216,Residential,17500,71370,0,88870
142218002300000,SE 216,Residential,17500,70162,0,87662
142218002400000,SE 216,Residential,20000,63915,0,83915
142218002500000,SE 216,Residential,20000,71223,0,91223
142218002600000,SE 216,Residential,20000,56798,0,76798
142218002700000,SE 216,Residential,20000,68939,0,88939
142218002800000,SE 216,Residential,20000,89406,0,109406
142218002900000,SE 216,Residential,16780,85549,0,102329
142218003000000,SE 216,Residential,16210,87902,0,104112
142218003100000,SE 216,Residential,16567,82016,0,98583
142218003200000,SE 216,Residential,12425,70463,0,82888
142218003300000,SE 216,Residential,12600,69564,0,82164
142218003400000,SE 216,Residential,14000,82488,0,96488
142218003500000,SE 216,Residential,13650,67021,0,80671
142218100100000,SE 216,Residential,18000,91459,0,109459
142218100200000,SE 216,Residential,18000,95716,0,113716
142218100300000,SE 216,Residential,20000,90001,0,110001
142218100400000,SE 216,Residential,20000,81079,0,101079
142218100500000,SE 216,Residential,20000,84513,0,104513
142218100600000,SE 216,Residential,20000,74031,0,94031
142218100700000,SE 216,Residential,20000,80350,0,100350
142218100800000,SE 216,Residential,20000,75405,0,95405
142218100900000,SE 216,Residential,20000,82665,0,102665
142218101000000,SE 216,Residential,20000,64137,0,84137
142218101100000,SE 216,Residential,20000,85336,0,105336
142218101200000,SE 216,Residential,20000,91996,0,111996
142218101300000,SE 216,Residential,19865,83278,0,103143
142218101400000,SE 216,Residential,14135,60653,0,74788
142218101500000,SE 216,Residential,14000,69300,0,83300
142218101600000,SE 216,Residential,7980,80521,0,88501
142218101700000,SE 216,Residential,7980,73335,0,81315
142218101800000,SE 216,Residential,7980,84803,0,92783
142218101900000,SE 216,Residential,18000,79440,0,97440
142218102000000,SE 216,Residential,18000,71458,0,89458
142218102100000,SE 216,Residential,20000,79556,0,99556
142218102200000,SE 216,Residential,20000,94678,0,114678
142218102300000,SE 216,Residential,20000,85432,0,105432
142218102400000,SE 216,Residential,20000,85885,0,105885
142218102500000,SE 216,Residential,20000,103733,0,123733
142218102600000,SE 216,Residential,20000,75302,0,95302
142218102700000,SE 216,Residential,20000,92514,0,112514
142218102800000,SE 216,Residential,20000,95165,0,115165
142218102900000,SE 216,Residential,20000,87818,0,107818
142218103000000,SE 216,Residential,20000,96496,0,116496
142218103100000,SE 216,Residential,20000,71643,0,91643
142218103200000,SE 216,Residential,14000,83009,0,97009
142218103300000,SE 216,Residential,14000,55000,0,69000
142218103400000,SE 216,Residential,13300,75770,0,89070
142218103500000,SE 216,Residential,13300,91534,0,104834
142218103600000,SE 216,Residential,13300,91146,0,104446
142218200100000,SE 216,Residential,16338,63785,0,80123
142218200200000,SE 216,Residential,18000,72137,0,90137
142218200300000,SE 216,Residential,20000,84011,0,104011
142218200400000,SE 216,Residential,20000,69673,0,89673
142218200500000,SE 216,Residential,20000,64547,0,84547
142218200600000,SE 216,Residential,20000,77607,0,97607
142218200700000,SE 216,Residential,20000,96653,0,116653
142218200800000,SE 216,Residential,20000,76208,0,96208
142218200900000,SE 216,Residential,20000,93351,0,113351
142218201000000,SE 216,Residential,20000,80209,0,100209
142218201100000,SE 216,Residential,20900,76734,0,97634
142218201200000,SE 216,Residential,20900,89036,0,109936
142218201300000,SE 216,Residential,14200,65123,0,79323
142218201400000,SE 216,Residential,14164,97789,0,111953
142218201500000,SE 216,Residential,13650,82169,0,95819
142218201600000,SE 216,Residential,13650,78404,0,92054
142218201700000,SE 216,Residential,17220,89299,0,106519
142218201800000,SE 216,Residential,16359,79525,0,95884
142218201900000,SE 216,Residential,16974,93918,0,110892
142218202000000,SE 216,Residential,20000,91997,0,111997
142218202100000,SE 216,Residential,20000,80907,0,100907
142218202200000,SE 216,Residential,19950,88578,0,108528
142218202300000,SE 216,Residential,20000,111835,0,131835
142218202400000,SE 216,Residential,20000,94081,0,114081
142218202500000,SE 216,Residential,20900,93096,0,113996
142218202600000,SE 216,Residential,20000,89409,0,109409
142218202700000,SE 216,Residential,20000,98737,0,118737
142218202800000,SE 216,Residential,20000,91016,0,111016
142218202900000,SE 216,Residential,20000,92104,0,112104
142218203000000,SE 216,Residential,18560,86080,0,104640
142218203100000,SE 216,Residential,18061,128451,0,146512
142218203200000,SE 216,Residential,14245,54900,0,69145
142218203300000,SE 216,Residential,13825,93589,0,107414
142218300100000,SE 216,Residential,14880,78944,0,93824
142218300200000,E-40 CHURCHES,Exempt,18144,0,102706,120850
142218300300000,E-45 CONVENT-DORMS,Exempt,11340,0,60470,71810
142218300400000,SE 216,Residential,25000,73249,0,98249
142218300500000,SE 216,Residential,21250,75879,0,97129
142218300600000,SE 216,Residential,21250,66342,0,87592
142218300700000,SE 216,Residential,20000,89111,0,109111
142218300800000,SE 216,Residential,20000,86709,0,106709
142218300900000,SE 216,Residential,20000,88968,0,108968
142218301000000,SE 216,Residential,20000,73719,0,93719
142218301100000,SE 216,Residential,14000,81564,0,95564
142218301200000,SE 216,Residential,14000,87777,0,101777
142218301300000,SE 216,Residential,7980,89758,0,97738
142218301400000,SE 216,Residential,7980,92043,0,100023
142218301500000,SE 216,Residential,7980,74226,0,82206
142218301600000,SE 216,Residential,7980,79429,0,87409
142218301700000,SE 216,Residential,14000,99636,0,113636
142218301800000,SE 216,Residential,14000,70300,0,84300
142218301900000,SE 216,Residential,20000,57535,0,77535
142218302000000,SE 216,Residential,20000,105120,0,125120
142218302100000,SE 216,Residential,20000,85744,0,105744
142218302200000,SE 216,Residential,20250,89276,0,109526
142218302300000,SE 216,Residential,20000,80086,0,100086
142218302400000,SE 216,Residential,17500,61923,0,79423
142218302500000,SE 216,Residential,20000,80640,0,100640
142218302600000,SE 216,Residential,21250,95146,0,116396
142218302700000,SE 216,Residential,21250,76683,0,97933
142218302800000,SE 216,Residential,22500,88070,0,110570
142218302900000,SE 216,Residential,14000,67795,0,81795
142218303000000,SE 216,Residential,14000,92191,0,106191
142218303100000,SE 216,Residential,13300,92791,0,106091
142218303200000,SE 216,Residential,13300,83293,0,96593
142218303300000,SE 216,Residential,13300,95229,0,108529
142218303400000,SE 216,Residential,15390,81655,0,97045
142220100100000,APTS NE,Commercial,24300,0,141593,165893
142220100200000,NE 155,Residential,12750,77199,0,89949
142220100300000,NE 155,Residential,12750,46005,0,58755
142220100400000,NE 155,Residential,10200,62384,0,72584
142220100500000,NE 155,Residential,10200,66019,0,76219
142220100600000,NE 155,Residential,10200,81570,0,91770
142220100700000,NE 155,Residential,10200,66947,0,77147
142220100800000,NE 155,Residential,10200,78043,0,88243
142220100900000,NE 155,Residential,13005,73066,0,86071
142220101000000,NE 155,Residential,10200,63633,0,73833
142220101100000,NE 155,Residential,5400,78756,0,84156
142220101200000,NE 155,Residential,6885,32430,0,39315
142220101300000,CONVERSIONS,Commercial,8100,0,51943,60043
142220101400000,CONVERSIONS,Commercial,8100,0,60653,68753
142220101500000,COMM NE,Commercial,186030,0,671003,857033
142220101600000,COMM NE,Commercial,278100,0,1453327,1731427
142220200100000,NE 155,Residential,12500,82635,0,95135
142220200200000,NE 155,Residential,12500,81046,0,93546
142220200300000,NE 155,Residential,12500,63079,0,75579
142220200400000,NE 155,Residential,10000,79064,0,89064
142220200500000,NE 155,Residential,5250,49454,0,54704
142220200600000,NE 155,Residential,5250,60286,0,65536
142220200700000,NE 155,Residential,5425,54575,0,60000
142220200800000,NE 155,Residential,5425,64434,0,69859
142220200900000,NE 155,Residential,12500,93123,0,105623
142220300100000,NE 156,Residential,6569,60493,0,67062
142220300200000,NE 156,Residential,7483,45771,0,53254
142220300300000,NE 156,Residential,7483,43125,0,50608
142220300400000,NE 156,Residential,6844,47368,0,54212
142220300500000,NE 156,Residential,6844,49510,0,56354
142220300600000,NE 156,Residential,2903,29093,0,31996
142220300700000,NE 156,Residential,5160,45055,0,50215
142220300800000,NE 156,Residential,6767,65506,0,72273
142220300900000,CONVERSIONS,Commercial,9819,0,66725,76544
142220301000000,NE 156,Residential,8606,76145,0,84751
142220301100000,CONVERSIONS,Commercial,12150,0,59891,72041
142220301200000,NE 156,Residential,12750,40093,0,52843
142220301300000,NE 156,Residential,12750,46321,0,59071
142220301400000,CONVERSIONS,Commercial,12150,0,61422,73572
142220301500000,NE 156,Residential,12750,71757,0,84507
142220301600000,NE 156,Residential,12750,62775,0,75525
142220301700000,NE 156,Residential,12750,53366,0,66116
142220302000000,NE 156,Residential,10200,86454,0,96654
142220302100000,NE 156,Residential,12750,81301,0,94051
142220302200000,NE 156,Residential,12750,57814,0,70564
142220302300000,NE 156,Residential,12750,62639,0,75389
142220302400000,NE 156,Residential,12750,70546,0,83296
142220302500000,NE 156,Residential,12750,73740,0,86490
142220302600000,CONVERSIONS,Commercial,12150,0,74557,86707
142220302700000,NE 156,Residential,9461,23286,0,32747
142220302800000,NE 156,Residential,9461,39105,0,48566
142220302900000,NE 156,Residential,6210,29778,0,35988
142220303100000,NE 156,Residential,13200,87828,0,101028
142220303200000,COMM NE,Commercial,32021,0,194967,226988
142220400100000,CONVERSIONS,Commercial,11794,0,54646,66440
142220400200000,NE 156,Residential,12350,55602,0,67952
142220400300000,CONVERSIONS,Commercial,11794,0,62295,74089
142220400400000,CONVERSIONS,Commercial,11794,0,50751,62545
142220400500000,NE 156,Residential,12587,48406,0,60993
142220400600000,NE 156,Residential,12587,49521,0,62108
142220400700000,NE 156,Residential,12587,56937,0,69524
142220400800000,NE 156,Residential,11329,44133,0,55462
142220400900000,NE 156,Residential,5094,42659,0,47753
142220401000000,NE 156,Residential,4275,39518,0,43793
142220401100000,NE 156,Residential,5700,63730,0,69430
142220401200000,NE 156,Residential,8811,62795,0,71606
142220401300000,NE 156,Residential,12587,49561,0,62148
142220401400000,NE 156,Residential,12587,66035,0,78622
142220401500000,NE 156,Residential,12587,87498,0,100085
142220500100000,E-15 CITY,Exempt,0,0,0,0
142220500200000,NE 156,Residential,4113,58742,0,62855
142220500300000,NE 156,Residential,4113,54849,0,58962
142220500400000,NE 156,Residential,12350,72550,0,84900
142220600100000,SE 231,Residential,6013,53815,0,59828
142220600200000,SE 231,Residential,3263,46935,0,50198
142220600300000,SE 231,Residential,8400,36250,0,44650
142220600400000,SE 231,Residential,11460,62432,0,73892
142220600500000,APTS SE,Commercial,9072,0,71882,80954
142220600600000,COMM SE,Commercial,27216,0,61879,89095
142220600700000,SE 231,Residential,9000,36438,0,45438
142220600800000,COMM SE,Commercial,127008,0,559953,686961
142220600900000,COMM SE,Commercial,127008,0,199845,326853
142220601000000,CONVERSIONS,Commercial,4536,0,63841,68377
142220601100000,SE 231,Residential,7000,82132,0,89132
142220601200000,SE 231,Residential,10000,93891,0,103891
142220601300000,SE 231,Residential,10000,78193,0,88193
142220601400000,SE 231,Residential,7500,57627,0,65127
142220601500000,SE 231,Residential,7500,88950,0,96450
142220601600000,SE 231,Residential,10000,40831,0,50831
142220601700000,SE 231,Residential,10000,69511,0,79511
142220601800000,SE 231,Residential,10000,71547,0,81547
142220601900000,SE 231,Residential,10000,83557,0,93557
142220602000000,SE 231,Residential,10000,97370,0,107370
142220602100000,SE 231,Residential,12500,54861,0,67361
142220700100000,COMM NE,Commercial,545940,0,2459243,3005183
142220700200000,APTS NE,Commercial,12150,0,74145,86295
142220700300000,NE 156,Residential,12750,11910,0,24660
142220700400000,NE 156,Residential,4650,51578,0,56228
142220700500000,NE 156,Residential,4650,46650,0,51300
142220700600000,NE 156,Residential,6200,62086,0,68286
142220700700000,NE 156,Residential,8140,66781,0,74921
142220700800000,CONVERSIONS,Commercial,6480,0,44187,50667
142220700900000,CONVERSIONS,Commercial,6966,0,0,6966
142220701000000,CONVERSIONS,Commercial,6480,0,46776,53256
142220701100000,COMM NE,Commercial,69120,0,51027,120147
142220701200000,COMM NE,Commercial,97200,0,98550,195750
142220701300000,COMM NE,Commercial,51840,0,11390,63230
142220701400000,COMM NE,Commercial,48600,0,135044,183644
142220800100000,NE 156,Residential,6200,39645,0,45845
142220800200000,NE 156,Residential,7600,38637,0,46237
142220800300000,NE 156,Residential,11000,62342,0,73342
142220800400000,CONVERSIONS,Commercial,14580,0,44635,59215
142220800500000,NE 156,Residential,13770,61474,0,75244
142220800600000,NE 156,Residential,12750,47076,0,59826
142220800700000,NE 156,Residential,12750,73484,0,86234
142220800800000,NE 156,Residential,12500,65239,0,77739
142220800900000,NE 156,Residential,12750,77696,0,90446
142220801000000,NE 156,Residential,10000,79539,0,89539
142220801100000,NE 156,Residential,10000,60424,0,70424
142220801200000,CONVERSIONS,Commercial,9072,0,17755,26827
142220801300000,NE 156,Residential,10000,66566,0,76566
142220801400000,NE 156,Residential,10000,42996,0,52996
142220801500000,NE 156,Residential,10000,68178,0,78178
142220801600000,NE 156,Residential,8925,44356,0,53281
142220801700000,CONVERSIONS,Commercial,10935,0,43264,54199
142220801800000,NE 156,Residential,6600,49825,0,56425
142220801900000,NE 156,Exempt,6600,0,62795,69395
142220802000000,NE 156,Residential,6200,71088,0,77288
142220900200000,SE 231,Residential,10000,52653,0,62653
142220900300000,SE 231,Residential,10000,61014,0,71014
142220900400000,SE 231,Residential,11220,56179,0,67399
142220900500000,SE 231,Residential,6200,58012,0,64212
142220900600000,SE 231,Residential,8680,68080,0,76760
142220900700000,APTS SE,Commercial,6804,0,93639,100443
142221000100000,CONVERSIONS,Commercial,15552,0,88333,103885
142221000200000,SE 231,Residential,6600,56217,0,62817
142221000300000,SE 231,Residential,7500,54450,0,61950
142221100100000,CONVERSIONS,Commercial,13608,0,65807,79415
142221100200000,COMM SE,Commercial,90720,0,218353,309073
142221100300000,COMM SE,Commercial,36288,0,11854,48142
142221100400000,COMM SE,Commercial,36288,0,95185,131473
142221100500000,COMM SE,Commercial,127008,0,191080,318088
142221100600000,CONVERSIONS,Commercial,3402,0,63253,66655
142221100700000,COMM SE,Commercial,36288,0,0,36288
142221100800000,SE 231,Residential,12750,107155,0,119905
142221100900000,CONVERSIONS,Commercial,13608,0,62663,76271
142221101000000,CONVERSIONS,Commercial,13608,0,75251,88859
142221200100000,SE 231,Residential,1500,0,0,1500
142221200200000,SE 231,Residential,2778,0,0,2778
142221200300000,COMM SE,Commercial,23311,0,44469,67780
142221200400000,SE 231,Residential,11349,50385,0,61734
142221200500000,COMM SE,Commercial,40990,0,123036,164026
142221200600000,COMM SE,Commercial,31752,0,80918,112670
142221200700000,COMM SE,Commercial,31752,0,96994,128746
142221200800000,COMM SE,Commercial,21168,0,65303,86471
142221300100000,COMM NE,Commercial,613656,0,1312986,1926642
142221300500000,COMM NE,Commercial,55728,0,8486,64214
142221300600000,COMM NE,Commercial,388800,0,529512,918312
142221300700000,COMM NE,Commercial,32400,0,14526,46926
142221300800000,COMM NE,Commercial,32400,0,10853,43253
142221300900000,CONVERSIONS,Commercial,7290,0,68689,75979
142221301000000,COMM NE,Commercial,8100,0,80452,88552
142221301100000,E-15 CITY,Exempt,0,0,0,0
142221301200000,COMM NE,Commercial,97200,0,226980,324180
142221301300000,COMM NE,Commercial,22680,0,56530,79210
142221301400000,COMM NE,Commercial,22680,0,59642,82322
142221301500000,COMM NE,Commercial,45360,0,106335,151695
142222600100000,NE 156,Residential,5425,62352,0,67777
142222600200000,NE 156,Residential,5425,57591,0,63016
142222600300000,NE 156,Residential,4650,51207,0,55857
142222600400000,NE 156,Residential,12500,67179,0,79679
142222600500000,NE 156,Residential,10000,68436,0,78436
142222600600000,NE 156,Residential,10000,68769,0,78769
142222600700000,NE 156,Residential,7500,68139,0,75639
142222600800000,NE 156,Residential,7500,66336,0,73836
142222600900000,NE 156,Residential,7500,68239,0,75739
142222601000000,NE 156,Residential,7500,55589,0,63089
142222601100000,NE 156,Residential,7500,56324,0,63824
142222601200000,NE 156,Residential,7500,43780,0,51280
142222601300000,NE 156,Residential,10000,57562,0,67562
142222601400000,NE 156,Residential,7000,46243,0,53243
142222601500000,NE 156,Residential,7000,63695,0,70695
142222601600000,NE 156,Residential,6650,50254,0,56904
142222601700000,NE 156,Residential,6650,48350,0,55000
142222601800000,NE 156,Residential,7000,61348,0,68348
142222601900000,CONVERSIONS,Commercial,12960,0,45314,58274
142222602000000,NE 156,Residential,12500,24806,0,37306
142222602100000,NE 156,Residential,8500,64961,0,73461
142222602200000,NE 156,Residential,6500,61722,0,68222
142222602300000,NE 156,Residential,7500,56706,0,64206
142222602400000,NE 156,Residential,8750,78944,0,87694
142222602500000,NE 156,Residential,8750,53279,0,62029
142222602600000,NE 156,Residential,10000,49574,0,59574
142222602700000,NE 156,Residential,10000,66639,0,76639
142222602800000,NE 156,Residential,7500,73202,0,80702
142222602900000,NE 156,Residential,7500,53782,0,61282
142222603000000,NE 156,Residential,7500,55083,0,62583
142222603100000,NE 156,Residential,7500,45137,0,52637
142222603200000,NE 156,Residential,7500,54553,0,62053
142222603300000,NE 156,Residential,7500,60475,0,67975
142222700100000,NE 156,Residential,7500,56631,0,64131
142222700200000,NE 156,Residential,7500,51608,0,59108
142222700300000,NE 156,Residential,7500,45735,0,53235
142222700400000,NE 156,Residential,5283,49575,0,54858
142222700500000,NE 156,Residential,8517,49575,0,58092
142222700600000,NE 156,Residential,4805,48309,0,53114
142222800100000,E-78 EDU ATHLETIC,Exempt,443988,0,432948,876936
142222900100000,NE 156,Residential,12000,54672,0,66672
142223000100000,NE 156,Residential,7350,40816,0,48166
142223000200000,NE 156,Residential,9500,74765,0,84265
142223000300000,NE 156,Residential,10000,72985,0,82985
142223000400000,NE 156,Residential,8625,56649,0,65274
142223000500000,NE 156,Residential,8563,58737,0,67300
142223000600000,E-15 CITY,Exempt,0,0,0,0
142223000700000,Empty,Exempt,0,0,0,0
142223000800000,E-15 CITY,Exempt,0,0,0,0
142223000900000,Empty,Exempt,0,0,0,0
142223001000000,NE 156,Residential,7500,50767,0,58267
142223001100000,NE 156,Residential,10000,76727,0,86727
142223001200000,NE 156,Residential,12750,104951,0,117701
142223100100000,NE 156,Residential,13077,62338,0,75415
142223100200000,NE 156,Residential,12750,67043,0,79793
142223100300000,NE 156,Residential,12750,59755,0,72505
142223100400000,NE 156,Residential,12750,53387,0,66137
142223100500000,NE 156,Residential,9307,49293,0,58600
142223100600000,NE 156,Residential,5115,67772,0,72887
142223100700000,NE 156,Residential,5038,72757,0,77795
142223100800000,NE 156,Residential,6125,63952,0,70077
142223100900000,NE 156,Residential,6125,65547,0,71672
142223101000000,NE 156,Residential,9800,53975,0,63775
142223101100000,NE 156,Residential,10000,81972,0,91972
142223101200000,NE 156,Residential,10000,63107,0,73107
142223200100000,APTS NE,Commercial,9720,0,71821,81541
142223200200000,E-82 EDU ADMIN HOME,Exempt,10368,0,70407,80775
142223200300000,E-83 EDU OTHER,Exempt,13608,0,0,13608
142223200400000,NE 156,Exempt,36288,0,96346,132634
142223200500000,NE 156,Residential,7500,57747,0,65247
142223200600000,NE 156,Residential,7500,44502,0,52002
142223200700000,NE 156,Residential,7500,52138,0,59638
142223200800000,NE 156,Residential,7500,50089,0,57589
142223200900000,NE 156,Exempt,18144,0,0,18144
142223201000000,NE 156,Residential,7500,52952,0,60452
142223201100000,NE 156,Exempt,18144,0,0,18144
142223201200000,NE 156,Exempt,18144,0,0,18144
142223201300000,NE 156,Exempt,17626,0,0,17626
142223201400000,E-83 EDU OTHER,Exempt,11146,0,0,11146
142223201500000,E-77 EDU DORMS,Exempt,4536,0,0,4536
142223201600000,NE 156,Exempt,8294,0,0,8294
142223201700000,NE 156,Residential,9025,50578,0,59603
142223201800000,CONVERSIONS,Commercial,13608,0,62258,75866
142223201900000,NE 156,Residential,14700,76603,0,91303
142223202000000,NE 156,Residential,10000,79572,0,89572
142223202100000,E-83 EDU OTHER,Exempt,18144,0,0,18144
142223202200000,E-15 CITY,Exempt,0,0,0,0
142223202300000,E-15 CITY,Exempt,0,0,0,0
142223202400000,E-83 EDU OTHER,Exempt,6804,0,0,6804
142223202500000,NE 156,Residential,7500,68604,0,76104
142223202600000,NE 156,Exempt,7500,0,0,7500
142223202700000,NE 156,Exempt,7500,0,0,7500
142223300100000,NE 156,Exempt,9126,0,0,9126
142223300200000,E-83 EDU OTHER,Exempt,6845,0,0,6845
142223300300000,E-83 EDU OTHER,Exempt,19440,0,0,19440
142223300400000,E-83 EDU OTHER,Exempt,26163,0,0,26163
142223400100000,NE 156,Exempt,6804,0,0,6804
142223400200000,NE 156,Exempt,6804,0,0,6804
142223400300000,NE 156,Residential,5425,0,0,5425
142223400400000,NE 156,Exempt,12096,0,0,12096
142223400500000,NE 156,Residential,6650,56400,0,63050
142223400600000,COMM NE,Commercial,9072,0,31663,40735
142223400700000,NE 156,Exempt,7000,0,0,7000
142223400800000,NE 156,Residential,10000,56675,0,66675
142223400900000,NE 156,Exempt,18144,0,0,18144
142223401000000,NE 156,Exempt,24192,0,0,24192
142223401100000,NE 156,Residential,10000,81413,0,91413
142223401200000,NE 156,Exempt,10000,0,0,10000
142223401300000,E-83 EDU OTHER,Exempt,86022,0,0,86022
142223401600000,NE 156,Residential,7363,69226,0,76589
142223402000000,E-82 EDU ADMIN HOME,Exempt,72576,0,0,72576
142223402100000,NE 156,Residential,12750,73383,0,86133
142223402200000,NE 156,Residential,12750,71184,0,83934
142223402300000,CONVERSIONS,Commercial,13608,0,48153,61761
142223402400000,NE 156,Residential,10000,49512,0,59512
142223402500000,E-83 EDU OTHER,Exempt,9526,0,0,9526
142223402600000,NE 156,Exempt,22982,0,0,22982
142223402700000,NE 156,Residential,5250,47626,0,52876
142223500100000,NE 156,Residential,10000,46803,0,56803
142225100100000,COMM NE,Commercial,314496,0,356784,671280
142225100200000,E-83 EDU OTHER,Exempt,72576,0,3024,75600
142225100400000,E-83 EDU OTHER,Exempt,36288,0,0,36288
142225101000000,COMM NE,Commercial,16848,0,109589,126437
142225101100000,COMM NE,Commercial,38880,0,39053,77933
142225101200000,CONVERSIONS,Commercial,13608,0,100464,114072
142225101400000,COMM NE,Commercial,183859,0,512338,696197
142225101600000,COMM NE,Commercial,36288,0,11383,47671
142225101700000,E-83 EDU OTHER,Exempt,72576,0,10497,83073
142225300100000,E-83 EDU OTHER,Exempt,1191510,0,3458098,4649608
142225300200000,E-75 EDU ADMIN BLDG,Exempt,290304,0,1078923,1369227
142225300300000,E-83 EDU OTHER,Exempt,266112,0,1023197,1289309
142225300400000,E-83 EDU OTHER,Exempt,181440,0,15496,196936
142225300500000,COMM NE,Commercial,48384,0,5384,53768
142225300600000,COMM NE,Commercial,169344,0,309399,478743
142225300700000,COMM NE,Commercial,108864,0,157339,266203
142225301000000,COMM NE,Commercial,72576,0,154264,226840
142225301100000,COMM NE,Commercial,36288,0,2430,38718
142225400100000,COMM SE,Commercial,145152,0,405002,550154
142225400200000,COMM SE,Commercial,81907,0,94848,176755
142225400300000,COMM SE,Commercial,31622,0,172823,204445
142225400400000,APTS SE,Commercial,31752,0,1168248,1200000
142225500100000,CONVERSIONS,Commercial,8165,0,68368,76533
142225500200000,COMM SE,Commercial,14515,0,129795,144310
142225500300000,COMM SE,Commercial,217728,0,479244,696972
142225500400000,COMM SE,Commercial,108864,0,206304,315168
142225500500000,COMM SE,Commercial,108864,0,96855,205719
142225500502000,COMM SE,Commercial,0,0,32291,32291
142225500600000,COMM SE,Commercial,181440,0,75045,256485
142225500700000,COMM SE,Commercial,90720,0,321710,412430
142225500800000,COMM SE,Commercial,90720,0,312645,403365
142225500900000,E-70 CHARITY OTHER,Exempt,90720,0,275763,366483
142225600100000,APTS SE,Commercial,14288,0,291476,305764
142225600200000,APTS SE,Commercial,12928,0,184637,197565
142225601200000,CONVERSIONS,Commercial,9072,0,48694,57766
142225601300000,CONVERSIONS,Commercial,12474,0,64108,76582
142225601400000,CONVERSIONS,Commercial,11340,0,54483,65823
142225601500000,E-47 RELIG OTHER,Exempt,12500,0,49287,61787
142225601600000,E-46 RELIG PARKING,Exempt,24192,0,4979,29171
142225601700000,E-40 CHURCHES,Exempt,415072,0,3102499,3517571
142225700100000,COMM SE,Commercial,136080,0,883359,1019439
142225700200000,COMM SE,Commercial,90720,0,97945,188665
142225700202000,COMM SE,Commercial,0,0,32358,32358
142225700300000,APTS SE,Commercial,27216,0,528017,555233
142225700400000,COMM NE,Commercial,60480,0,5141,65621
142225700500000,COMM SE,Commercial,120960,0,89040,210000
142225700600000,COMM SE,Commercial,72576,0,233540,306116
142225700700000,COMM SE,Commercial,52690,0,213230,265920
142225700800000,COMM SE,Commercial,44078,0,141140,185218
142225700900000,COMM SE,Commercial,36288,0,88122,124410
142225701000000,COMM SE,Commercial,60480,0,86360,146840
142225701100000,SE 231,Residential,18600,167882,0,186482
142225701200000,COMM SE,Commercial,36288,0,11346,47634
142225800100000,COMM SE,Commercial,108864,0,9239,118103
142227600100000,CONVERSIONS,Commercial,13608,0,191874,205482
142227600200000,SE 231,Residential,10000,53746,0,63746
142227600300000,SE 231,Residential,10000,76796,0,86796
142227600400000,SE 231,Residential,10000,57584,0,67584
142227600500000,SE 231,Residential,7905,56221,0,64126
142227600600000,SE 231,Residential,6975,63610,0,70585
142227600700000,SE 231,Residential,5425,55335,0,60760
142227600800000,CONVERSIONS,Commercial,18144,0,72555,90699
142227600900000,SE 231,Residential,18000,106302,0,124302
142227700100000,COMM SE,Commercial,36288,0,143387,179675
142227700200000,E-70 CHARITY OTHER,Exempt,36288,0,118106,154394
142227700300000,CONVERSIONS,Commercial,13608,0,75542,89150
142227700400000,COMM SE,Commercial,21168,0,65303,86471
142227700500000,COMM SE,Commercial,84672,0,124748,209420
142227700600000,COMM SE,Commercial,22000,0,0,22000
142227700700000,COMM SE,Commercial,36832,0,67673,104505
142227700800000,COMM SE,Commercial,31752,0,90728,122480
142227700900000,COMM SE,Commercial,31752,0,72181,103933
142227701000000,COMM SE,Commercial,90720,0,269280,360000
142227701100000,COMM SE,Commercial,166579,0,483421,650000
142227800100000,E-15 CITY,Exempt,0,0,0,0
142227900100000,SE 231,Residential,10200,66249,0,76449
142227900200000,SE 231,Residential,8099,53926,0,62025
142227900300000,SE 231,Exempt,5425,0,76647,82072
142227900400000,SE 231,Residential,5425,50936,0,56361
142227900500000,SE 231,Residential,5503,72484,0,77987
142227900600000,SE 231,Residential,5425,77900,0,83325
142227900700000,SE 231,Residential,7500,0,0,7500
142227900800000,SE 231,Residential,7500,43644,0,51144
142227900900000,SE 231,Residential,12750,78190,0,90940
142227901000000,SE 231,Residential,12750,28285,0,41035
142227901100000,SE 231,Residential,12750,84576,0,97326
142227901200000,CONVERSIONS,Commercial,6804,0,41867,48671
142227901300000,SE 231,Residential,7500,45568,0,53068
142227901400000,CONVERSIONS,Commercial,13608,0,74245,87853
142227901500000,CONVERSIONS,Commercial,13608,0,68255,81863
142227901600000,SE 231,Residential,7657,76524,0,84181
142227901700000,SE 231,Residential,12300,49976,0,62276
142227901800000,CONVERSIONS,Commercial,13608,0,57934,71542
142227901900000,SE 231,Residential,7500,65091,0,72591
142227902000000,SE 231,Residential,7500,60405,0,67905
142227902100000,SE 231,Residential,12750,67902,0,80652
142227902200000,SE 231,Residential,12750,96850,0,109600
142227902300000,CONVERSIONS,Commercial,13608,0,71028,84636
142227902400000,SE 231,Residential,12750,49530,0,62280
142228000100000,COMM SE,Commercial,72576,0,261315,333891
142228000200000,COMM SE,Commercial,3686,0,29204,32890
142228000300000,CONVERSIONS,Commercial,3686,0,31752,35438
142228000400000,COMM SE,Commercial,30240,0,88002,118242
142228000500000,COMM SE,Commercial,18900,0,53058,71958
142228000600000,CONVERSIONS,Commercial,7938,0,51193,59131
142228000700000,COMM SE,Commercial,96768,0,86541,183309
142228000800000,COMM SE,Commercial,72576,0,23663,96239
142228000900000,COMM SE,Commercial,22680,0,8459,31139
142228001000000,COMM SE,Commercial,13608,0,5340,18948
142228001100000,E-70 CHARITY OTHER,Exempt,36288,0,78290,114578
142228100100000,SE 231,Residential,5250,87849,0,93099
142228100200000,SE 231,Residential,5250,74834,0,80084
142228100300000,SE 231,Residential,10000,83604,0,93604
142228100400000,SE 231,Residential,10000,36758,0,46758
142228100500000,SE 231,Residential,10000,42251,0,52251
142228100600000,SE 231,Residential,12750,73152,0,85902
142228100700000,SE 231,Residential,11250,85900,0,97150
142228100800000,SE 231,Residential,11250,67201,0,78451
142228100900000,SE 231,Residential,12500,87753,0,100253
142228101000000,SE 231,Residential,10000,65203,0,75203
142228101100000,SE 231,Residential,10151,68391,0,78542
142228101200000,SE 231,Residential,9440,88444,0,97884
142228101300000,CONVERSIONS,Commercial,4253,0,49348,53601
142228101400000,CONVERSIONS,Commercial,6736,0,59338,66074
142228101500000,SE 231,Residential,11400,74718,0,86118
142228101600000,SE 231,Residential,14250,60750,0,75000
142228101700000,CONVERSIONS,Commercial,3888,0,62490,66378
142228101800000,SE 231,Residential,7700,37452,0,45152
142228101900000,SE 231,Residential,12350,80856,0,93206
142228102000000,APTS SE,Commercial,13608,0,92255,105863
142228102100000,SE 231,Residential,10000,77376,0,87376
142228102200000,SE 231,Residential,10000,67440,0,77440
142228102300000,SE 231,Residential,10000,67839,0,77839
142228102400000,SE 231,Residential,7500,63283,0,70783
142228102500000,SE 231,Residential,7500,62698,0,70198
142228102600000,SE 231,Residential,7500,45097,0,52597
142228102700000,SE 231,Residential,7500,41271,0,48771
142228102800000,CONVERSIONS,Commercial,13608,0,94365,107973
142228102900000,SE 231,Residential,4928,73041,0,77969
142228103000000,SE 231,Residential,6023,69948,0,75971
142228103100000,SE 231,Residential,5115,60674,0,65789
142228103200000,SE 231,Residential,5115,64125,0,69240
142228103300000,SE 231,Residential,5270,66958,0,72228
142228103400000,SE 231,Residential,5580,51644,0,57224
142228200100000,E-15 CITY,Exempt,0,0,0,0
142228300100000,SE 231,Residential,5250,45452,0,50702
142228300200000,SE 231,Residential,5425,46962,0,52387
142228300300000,SE 231,Residential,5425,27783,0,33208
142228300400000,APTS SE,Commercial,6350,0,91139,97489
142228300500000,CONVERSIONS,Commercial,9526,0,65118,74644
142228300600000,CONVERSIONS,Commercial,11340,0,55398,66738
142228300700000,SE 231,Residential,7500,42915,0,50415
142228300800000,SE 231,Residential,7500,68372,0,75872
142228300900000,CONVERSIONS,Commercial,13608,0,46392,60000
142228301000000,CONVERSIONS,Commercial,9072,0,40928,50000
142228301100000,E-46 RELIG PARKING,Exempt,48384,0,15744,64128
142228301200000,CONVERSIONS,Commercial,13608,0,43367,56975
142228301300000,SE 231,Residential,12750,111685,0,124435
142228301400000,E-46 RELIG PARKING,Exempt,72576,0,16634,89210
142228301500000,E-46 RELIG PARKING,Exempt,36288,0,10332,46620
142228301600000,CONVERSIONS,Commercial,9072,0,59006,68078
142228301700000,CONVERSIONS,Commercial,9072,0,6575,15647
142228301800000,SE 231,Residential,10000,42369,0,52369
142228301900000,SE 231,Residential,7500,47546,0,55046
142228302000000,SE 231,Residential,7890,61064,0,68954
142228302100000,SE 231,Residential,14880,74017,0,88897
142228302200000,SE 231,Residential,5250,59615,0,64865
142228400100000,SE 231,Residential,9675,39658,0,49333
142228400200000,SE 231,Residential,8225,35730,0,43955
142228400300000,SE 231,Residential,7500,47233,0,54733
142228400400000,SE 231,Residential,7000,50761,0,57761
142228400500000,SE 231,Residential,10500,46616,0,57116
142228400600000,SE 231,Residential,12750,85132,0,97882
142228400700000,SE 231,Residential,10000,73453,0,83453
142228400800000,SE 231,Residential,10000,70044,0,80044
142228400900000,SE 231,Residential,10000,42000,0,52000
142228401000000,SE 231,Residential,10000,63699,0,73699
142228401100000,SE 231,Residential,10000,50281,0,60281
142228401200000,CONVERSIONS,Commercial,9072,0,62680,71752
142228401300000,SE 231,Residential,12750,43594,0,56344
142228401400000,SE 231,Residential,5250,81609,0,86859
142228401500000,SE 231,Residential,5250,54074,0,59324
142228401600000,SE 231,Exempt,5425,0,43852,49277
142228401700000,SE 231,Residential,5425,43150,0,48575
142228401800000,SE 231,Residential,5425,44792,0,50217
142228401900000,SE 231,Residential,5425,43679,0,49104
142228402000000,SE 231,Residential,5250,54642,0,59892
142228402100000,SE 231,Residential,5250,54961,0,60211
142228402200000,SE 231,Residential,12750,61868,0,74618
142228402300000,SE 231,Residential,7500,65221,0,72721
142228402400000,SE 231,Residential,7500,77615,0,85115
142228402500000,SE 231,Residential,7500,52732,0,60232
142228402600000,SE 231,Residential,8750,77528,0,86278
142228402700000,SE 231,Residential,8750,59191,0,67941
142228402800000,SE 231,Residential,10000,89283,0,99283
142228402900000,SE 231,Residential,10000,65286,0,75286
142228403000000,SE 231,Residential,10000,63924,0,73924
142228403100000,CONVERSIONS,Commercial,9072,0,46638,55710
142228403200000,SE 231,Residential,10000,47357,0,57357
142228403300000,SE 231,Residential,10000,60752,0,70752
142228403400000,SE 231,Residential,6750,48980,0,55730
142228403500000,SE 231,Residential,8750,71250,0,80000
142228403600000,SE 231,Residential,5425,51723,0,57148
142228403700000,SE 231,Residential,5425,51831,0,57256
142228403800000,SE 231,Residential,6975,37693,0,44668
142228500100000,CONVERSIONS,Commercial,7517,0,75501,83018
142228500200000,SE 231,Residential,8175,61088,0,69263
142228500300000,SE 231,Residential,12625,17520,0,30145
142228500400000,SE 231,Residential,12350,49587,0,61937
142228500500000,SE 231,Residential,7500,57051,0,64551
142228500600000,SE 231,Residential,4937,44444,0,49381
142228500700000,SE 231,Residential,7756,18680,0,26436
142228500800000,SE 231,Residential,7350,33210,0,40560
142228500900000,SE 231,Residential,6471,41559,0,48030
142228501000000,SE 231,Residential,6608,31312,0,37920
142228501100000,SE 231,Residential,7260,47341,0,54601
142228501200000,APTS SE,Commercial,8751,0,205968,214719
142228501300000,SE 231,Residential,6490,30356,0,36846
142228501400000,SE 231,Residential,10000,0,0,10000
142228501500000,SE 231,Residential,10000,45216,0,55216
142228501600000,SE 231,Residential,10000,41821,0,51821
142228501700000,SE 231,Residential,7500,37317,0,44817
142228501800000,SE 231,Residential,7500,47842,0,55342
142228501900000,SE 231,Residential,10000,18756,0,28756
142228502000000,SE 231,Residential,10000,31758,0,41758
142228502100000,SE 231,Residential,12500,53524,0,66024
142228502200000,SE 231,Residential,12190,30625,0,42815
142228502300000,CONVERSIONS,Commercial,6026,0,76837,82863
142228502400000,SE 231,Residential,6200,47361,0,53561
142228502500000,SE 231,Residential,6200,40814,0,47014
142228502600000,SE 231,Residential,5580,36889,0,42469
142230100100000,COMM SE,Commercial,5511,0,57168,62679
142230100200000,CONVERSIONS,Commercial,5511,0,57681,63192
142230100300000,SE 231,Residential,10000,55707,0,65707
142230100400000,SE 231,Residential,10000,93597,0,103597
142230100500000,COMM SE,Commercial,13608,0,46392,60000
142230100600000,SE 231,Residential,10000,57667,0,67667
142230100700000,SE 231,Residential,10000,63754,0,73754
142230100800000,SE 231,Residential,10000,79520,0,89520
142230100900000,SE 231,Residential,10000,63272,0,73272
142230101000000,SE 231,Residential,10000,20554,0,30554
142230101100000,SE 231,Residential,10000,82158,0,92158
142230101200000,SE 231,Residential,10000,86780,0,96780
142230101300000,SE 231,Residential,10000,38661,0,48661
142230101400000,SE 231,Residential,10000,40102,0,50102
142230101500000,SE 231,Residential,10000,81340,0,91340
142230101600000,SE 231,Residential,9307,75638,0,84945
142230101700000,SE 231,Residential,5038,26848,0,31886
142230101800000,SE 231,Residential,5038,27475,0,32513
142230101900000,SE 231,Residential,5270,0,0,5270
142230102000000,SE 231,Exempt,5270,0,59400,64670
142230102100000,SE 231,Residential,5325,36864,0,42189
142230102200000,SE 231,Residential,5325,55620,0,60945
142230102300000,SE 231,Residential,10000,37172,0,47172
142230102400000,SE 231,Residential,10000,92374,0,102374
142230102500000,SE 231,Exempt,10000,0,53355,63355
142230102600000,SE 231,Residential,12750,66758,0,79508
142230102700000,SE 231,Residential,10000,83592,0,93592
142230102800000,SE 231,Residential,12500,81952,0,94452
142230102900000,CONVERSIONS,Commercial,11340,0,64014,75354
142230103000000,SE 231,Residential,10000,68717,0,78717
142230103100000,SE 231,Residential,10000,65582,0,75582
142230103200000,SE 231,Residential,10000,50759,0,60759
142230103300000,SE 231,Residential,10000,54658,0,64658
142230103400000,SE 231,Residential,13246,64867,0,78113
142230103500000,SE 231,Exempt,5475,0,46376,51851
142230103600000,SE 231,Residential,5846,70371,0,76217
142230103700000,SE 231,Residential,5038,51378,0,56416
142230103800000,SE 231,Residential,4956,62988,0,67944
142230103900000,SE 231,Residential,5363,64710,0,70073
142230200100000,SE 231,Residential,7905,70554,0,78459
142230200200000,SE 231,Residential,10000,63172,0,73172
142230200300000,SE 231,Residential,10000,34449,0,44449
142230200400000,SE 231,Residential,10000,40160,0,50160
142230200500000,SE 231,Residential,7500,57999,0,65499
142230200600000,SE 231,Exempt,7500,0,45692,53192
142230200700000,SE 231,Residential,7500,52789,0,60289
142230200800000,SE 231,Residential,7500,57146,0,64646
142230200900000,SE 231,Residential,11250,27843,0,39093
142230201000000,APTS SE,Commercial,17010,0,145399,162409
142230201100000,CONVERSIONS,Commercial,7258,0,47742,55000
142230201200000,SE 231,Residential,7000,57967,0,64967
142230201300000,SE 231,Residential,5475,0,0,5475
142230201400000,SE 231,Residential,5700,47550,0,53250
142230201500000,SE 231,Residential,5063,36459,0,41522
142230201600000,SE 231,Residential,4650,36612,0,41262
142230201700000,SE 231,Residential,5425,52336,0,57761
142230201800000,SE 231,Residential,5425,45573,0,50998
142230201900000,E-46 RELIG PARKING,Exempt,6804,0,0,6804
142230202000000,SE 231,Residential,12750,54058,0,66808
142230202100000,SE 231,Exempt,7500,0,45205,52705
142230202200000,SE 231,Residential,7500,64454,0,71954
142230202300000,SE 231,Residential,7500,25506,0,33006
142230202400000,SE 231,Residential,7500,24799,0,32299
142230202500000,SE 231,Residential,10000,24000,0,34000
142230202600000,SE 231,Residential,10000,36374,0,46374
142230202700000,SE 231,Residential,10000,33913,0,43913
142230202800000,SE 231,Residential,10000,66250,0,76250
142230202900000,SE 231,Residential,14000,61279,0,75279
142230203100000,SE 231,Residential,5250,52096,0,57346
142230203200000,SE 231,Residential,3675,0,0,3675
142230203300000,SE 231,Residential,5425,34160,0,39585
142230203400000,SE 231,Residential,5425,43530,0,48955
142230203500000,CONVERSIONS,Commercial,3888,0,33773,37661
142230203600000,SE 231,Residential,6200,27296,0,33496
142230300100000,SE 231,Residential,7848,79222,0,87070
142230300200000,SE 231,Residential,7300,58600,0,65900
142230300300000,SE 231,Residential,10000,50517,0,60517
142230300400000,SE 231,Residential,10000,59216,0,69216
142230300500000,SE 231,Residential,10000,67299,0,77299
142230300600000,SE 231,Residential,10000,53240,0,63240
142230300700000,SE 231,Residential,10000,73286,0,83286
142230300800000,SE 231,Residential,10000,72585,0,82585
142230300900000,SE 231,Residential,10000,65157,0,75157
142230301000000,SE 231,Residential,10000,59689,0,69689
142230301100000,SE 231,Residential,10000,50976,0,60976
142230301200000,SE 231,Residential,10000,40496,0,50496
142230301300000,SE 231,Residential,10000,56077,0,66077
142230301400000,SE 231,Residential,10000,53347,0,63347
142230301500000,SE 231,Residential,10000,59173,0,69173
142230301600000,SE 231,Residential,5293,37707,0,43000
142230301700000,SE 231,Residential,5658,29342,0,35000
142230301800000,SE 231,Residential,4631,44245,0,48876
142230301900000,SE 231,Residential,4631,41542,0,46173
142230302000000,SE 231,Residential,813,0,0,813
142230302100000,SE 231,Residential,5038,26428,0,31466
142230302200000,SE 231,Residential,5038,36919,0,41957
142230302300000,SE 231,Residential,9307,55243,0,64550
142230302400000,SE 231,Residential,10000,80469,0,90469
142230302500000,SE 231,Residential,10000,35000,0,45000
142230302600000,SE 231,Residential,12500,64500,0,77000
142230302700000,SE 231,Residential,10000,67306,0,77306
142230302801000,CONDO 500,Residential,2520,28883,0,31403
142230302801001,CONDO 500,Residential,2520,19825,0,22345
142230302801002,CONDO 500,Residential,2520,25575,0,28095
142230302801003,CONDO 500,Residential,2520,23190,0,25710
142230302801004,CONDO 500,Residential,2520,19246,0,21766
142230302900000,SE 231,Residential,8750,33637,0,42387
142230303000000,CONVERSIONS,Commercial,11340,0,53624,64964
142230303100000,SE 231,Residential,10000,81422,0,91422
142230303200000,SE 231,Residential,10000,79234,0,89234
142230303300000,SE 231,Residential,10000,76714,0,86714
142230303400000,SE 231,Residential,10000,81998,0,91998
142230303500000,SE 231,Residential,10000,70000,0,80000
142230303600000,SE 231,Residential,10000,69691,0,79691
142230303700000,CONVERSIONS,Commercial,7727,0,67751,75478
142230303800000,SE 231,Residential,5363,47940,0,53303
142230303900000,SE 231,Residential,5363,54926,0,60289
142230304000000,SE 231,Residential,6419,65043,0,71462
142230304100000,SE 231,Residential,6419,37592,0,44011
142230400100000,SE 231,Residential,4650,0,0,4650
142230400200000,SE 231,Residential,4650,0,0,4650
142230400300000,SE 231,Residential,10000,41808,0,51808
142230400400000,SE 231,Residential,10000,79879,0,89879
142230400500000,SE 231,Residential,10000,66937,0,76937
142230400600000,SE 231,Residential,10000,71983,0,81983
142230400700000,SE 231,Residential,10000,37773,0,47773
142230400800000,SE 231,Residential,10000,27666,0,37666
142230400900000,SE 231,Residential,10000,45028,0,55028
142230401000000,SE 231,Residential,10000,45666,0,55666
142230401100000,SE 231,Residential,10000,52585,0,62585
142230401200000,SE 231,Residential,168,0,0,168
142230401300000,SE 231,Residential,7345,35558,0,42903
142230401400000,SE 231,Residential,7500,52578,0,60078
142230401500000,SE 231,Residential,6200,48834,0,55034
142230401600000,SE 231,Residential,4650,50742,0,55392
142230401700000,APTS SE,Commercial,6804,0,59067,65871
142230401800000,SE 231,Residential,7750,36564,0,44314
142230401900000,SE 231,Residential,10582,73029,0,83611
142230402000000,SE 231,Residential,7500,1286,0,8786
142230402100000,SE 231,Residential,7500,37500,0,45000
142230402200000,SE 231,Residential,10000,56287,0,66287
142230402300000,SE 231,Residential,10000,55730,0,65730
142230402400000,SE 231,Residential,10000,44297,0,54297
142230402500000,SE 231,Residential,10000,66000,0,76000
142230402600000,SE 231,Residential,10000,57414,0,67414
142230402700000,SE 231,Residential,10000,24055,0,34055
142230402800000,SE 231,Residential,10000,54000,0,64000
142230402900000,SE 231,Residential,10000,63230,0,73230
142230403000000,SE 231,Residential,10000,50120,0,60120
142230403100000,SE 231,Residential,5475,45046,0,50521
142230403200000,SE 231,Residential,5475,66525,0,72000
142230403300000,SE 231,Residential,5038,34249,0,39287
142230403400000,SE 231,Residential,5038,44439,0,49477
142230403600000,SE 231,Residential,6200,41117,0,47317
142230403700000,SE 231,Residential,6200,40588,0,46788
142230500100000,SE 231,Residential,7975,51116,0,59091
142230500200000,SE 231,Residential,7300,92377,0,99677
142230500300000,SE 231,Residential,10000,87471,0,97471
142230500400000,SE 231,Residential,10000,46030,0,56030
142230500500000,SE 231,Residential,10000,72960,0,82960
142230500600000,APTS SE,Commercial,9072,0,74929,84001
142230500700000,SE 231,Residential,10000,96010,0,106010
142230500800000,SE 231,Residential,10000,66976,0,76976
142230500900000,SE 231,Residential,10000,61333,0,71333
142230501000000,SE 231,Residential,10000,63730,0,73730
142230501100000,SE 231,Residential,10000,58894,0,68894
142230501200000,SE 231,Residential,10000,71905,0,81905
142230501300000,SE 231,Residential,10000,36000,0,46000
142230501400000,SE 231,Residential,10000,47230,0,57230
142230501500000,SE 231,Residential,10000,67344,0,77344
142230501600000,SE 231,Residential,5250,47289,0,52539
142230501700000,SE 231,Exempt,5250,0,58606,63856
142230501800000,SE 231,Residential,5425,67708,0,73133
142230501900000,SE 231,Residential,5425,60054,0,65479
142230502000000,SE 231,Residential,5444,69898,0,75342
142230502100000,SE 231,Residential,5363,49833,0,55196
142230502200000,SE 231,Residential,5250,52630,0,57880
142230502300000,SE 231,Residential,5928,25458,0,31386
142230502400000,SE 231,Residential,10000,20349,0,30349
142230502500000,SE 231,Residential,10000,33799,0,43799
142230502600000,SE 231,Residential,10000,26334,0,36334
142230502700000,SE 231,Residential,10000,51649,0,61649
142230502800000,SE 231,Residential,10000,84595,0,94595
142230502900000,SE 231,Residential,10000,94618,0,104618
142230503000000,SE 231,Residential,10000,77264,0,87264
142230503100000,SE 231,Residential,10000,84386,0,94386
142230503200000,SE 231,Residential,10000,48744,0,58744
142230503300000,SE 231,Residential,10000,64608,0,74608
142230503400000,SE 231,Residential,10000,76052,0,86052
142230503500000,SE 231,Residential,10000,58196,0,68196
142230503600000,SE 231,Residential,9978,47717,0,57695
142230503700000,SE 231,Residential,7300,35121,0,42421
142230503800000,SE 231,Residential,7802,27237,0,35039
142230503900000,SE 231,Residential,6175,43898,0,50073
142230504000000,SE 231,Residential,6175,56520,0,62695
142230504100000,SE 231,Residential,6419,49809,0,56228
142230504200000,SE 231,Residential,6419,53374,0,59793
142230600100000,SE 231,Residential,5475,49822,0,55297
142230600200000,SE 231,Residential,5475,54829,0,60304
142230600300000,SE 231,Exempt,10000,0,61294,71294
142230600400000,SE 231,Residential,10000,318,0,10318
142230600500000,CONVERSIONS,Commercial,9072,0,3240,12312
142230600600000,SE 231,Residential,10000,55509,0,65509
142230600700000,SE 231,Residential,10000,66678,0,76678
142230600800000,SE 231,Residential,9250,48138,0,57388
142230600900000,SE 231,Residential,5475,33150,0,38625
142230601000000,SE 231,Residential,5475,49525,0,55000
142230601100000,SE 231,Residential,4650,62275,0,66925
142230601200000,SE 231,Residential,7263,43981,0,51244
142230601300000,SE 231,Residential,8375,67171,0,75546
142230601400000,SE 231,Residential,10582,37591,0,48173
142230601500000,SE 231,Residential,10000,82274,0,92274
142230601600000,SE 231,Residential,10000,59661,0,69661
142230601700000,SE 231,Residential,12750,50107,0,62857
142230601800000,SE 231,Residential,10000,54158,0,64158
142230601900000,SE 231,Residential,10000,56094,0,66094
142230602000000,SE 231,Residential,7347,55600,0,62947
142230602100000,SE 231,Exempt,7600,0,65157,72757
142230602200000,SE 231,Residential,9307,59121,0,68428
142230602300000,SE 231,Residential,5038,45922,0,50960
142230602400000,SE 231,Residential,5038,39213,0,44251
142230700100000,CONVERSIONS,Commercial,4528,0,5400,9928
142230700200000,SE 232,Residential,10070,55611,0,65681
142230700300000,SE 232,Residential,9085,45820,0,54905
142230700500000,SE 232,Residential,5850,35815,0,41665
142230700600000,SE 232,Residential,4200,34353,0,38553
142230700700000,SE 232,Residential,9158,9757,0,18915
142230700800000,SE 232,Residential,9900,32094,0,41994
142230700900000,SE 232,Exempt,9900,0,40346,50246
142230701000000,SE 232,Exempt,7673,0,43273,50946
142230701100000,SE 232,Residential,7673,48858,0,56531
142230701200000,SE 232,Residential,7673,45483,0,53156
142230701300000,SE 232,Exempt,9900,0,33723,43623
142230701400000,SE 232,Residential,6200,48412,0,54612
142230701500000,SE 232,Exempt,6975,0,55613,62588
142230701600000,SE 232,Residential,7595,49116,0,56711
142230800100000,SE 231,Residential,7163,47034,0,54197
142230800200000,SE 231,Residential,6388,37250,0,43638
142230800300000,SE 231,Residential,6094,43766,0,49860
142230800400000,SE 231,Residential,6175,59100,0,65275
142230800500000,SE 231,Residential,10000,51997,0,61997
142230800600000,SE 231,Residential,10000,58528,0,68528
142230800700000,SE 231,Residential,10000,54790,0,64790
142230800800000,SE 231,Residential,10000,51276,0,61276
142230800900000,SE 231,Residential,10000,50301,0,60301
142230801000000,SE 231,Residential,10000,80298,0,90298
142230801100000,SE 231,Residential,12750,60392,0,73142
142230801200000,SE 231,Residential,12750,68397,0,81147
142230801300000,SE 231,Residential,10000,51531,0,61531
142230801400000,SE 231,Residential,10000,37351,0,47351
142230801500000,SE 231,Residential,10000,39441,0,49441
142230801600000,SE 231,Residential,10000,68283,0,78283
142230801700000,SE 231,Residential,13766,47458,0,61224
142230900100000,SE 231,Exempt,9406,0,77455,86861
142230900200000,SE 231,Exempt,8771,0,51300,60071
142230900300000,SE 231,Residential,9910,42642,0,52552
142230900400000,SE 231,Residential,10000,83988,0,93988
142230900500000,SE 231,Residential,10000,51140,0,61140
142230900600000,SE 231,Residential,10000,50188,0,60188
142230900700000,SE 231,Residential,10000,39979,0,49979
142230900800000,SE 231,Residential,10000,61262,0,71262
142230900900000,SE 231,Residential,5550,62856,0,68406
142230901000000,SE 231,Residential,6646,50214,0,56860
142230901100000,SE 231,Residential,5280,50779,0,56059
142230901200000,SE 231,Residential,5200,30032,0,35232
142232600100000,E-40 CHURCHES,Exempt,210816,0,2654068,2864884
142232600300000,SE 232,Residential,10000,34543,0,44543
142232600400000,SE 232,Exempt,10000,0,54712,64712
142232600500000,CONVERSIONS,Commercial,9072,0,62600,71672
142232600600000,SE 232,Residential,10000,31805,0,41805
142232600700000,CONVERSIONS,Commercial,9072,0,55731,64803
142232600800000,APTS SE,Commercial,9072,0,102826,111898
142232600900000,APTS SE,Commercial,9072,0,102997,112069
142232601000000,SE 232,Residential,10000,0,0,10000
142232601100000,COMM SE,Commercial,24192,0,78052,102244
142232601201000,COMM SE,Commercial,83160,0,309623,392783
142232601201001,COMM SE,Commercial,83160,0,326949,410109
142232601300000,COMM SE,Commercial,120960,0,20304,141264
142232601400000,SE 232,Residential,12500,0,0,12500
142232601700000,SE 232,Residential,12500,71535,0,84035
142232601800000,SE 232,Residential,12500,53107,0,65607
142232601900000,SE 232,Residential,10000,34442,0,44442
142232602000000,E-47 RELIG OTHER,Exempt,48384,0,23110,71494
142232602200000,SE 232,Residential,10000,52402,0,62402
142232602300000,SE 232,Residential,10000,35853,0,45853
142232602400000,SE 232,Exempt,24192,0,9912,34104
142232602500000,E-46 RELIG PARKING,Exempt,89662,0,35618,125280
142232602600000,APTS SE,Commercial,40176,0,247194,287370
142232700100000,COMM SE,Commercial,135821,0,775868,911689
142232700400000,E-83 EDU OTHER,Exempt,12474,0,127695,140169
142232700500000,COMM SE,Commercial,12316,0,0,12316
142232700600000,COMM SE,Commercial,15966,0,0,15966
142232700700000,CONVERSIONS,Commercial,11340,0,82005,93345
142232700800000,SE 232,Residential,7500,0,0,7500
142232700900000,SE 232,Residential,7906,41225,0,49131
142232701000000,CONVERSIONS,Commercial,6156,0,47677,53833
142232701100000,CONVERSIONS,Commercial,2592,0,37395,39987
142232701200000,COMM SE,Commercial,6739,0,3227,9966
142232701300000,CONVERSIONS,Commercial,12814,0,90043,102857
142232701500000,COMM SE,Commercial,70459,0,140457,210916
142232701600000,CONVERSIONS,Commercial,11340,0,72114,83454
142232701700000,CONVERSIONS,Commercial,15876,0,66446,82322
142232701800000,SE 232,Residential,16750,87250,0,104000
142232701900000,CONVERSIONS,Commercial,6804,0,43075,49879
142232702000000,SE 232,Residential,7500,43173,0,50673
142232702100000,SE 232,Residential,7500,40459,0,47959
142232702200000,CONVERSIONS,Commercial,6804,0,47997,54801
142232702300000,COMM SE,Commercial,122170,0,899772,1021942
142232702400000,CONVERSIONS,Commercial,8278,0,63811,72089
142232800100000,COMM SE,Commercial,34776,0,3970,38746
142232800200000,COMM SE,Commercial,24348,0,0,24348
142232800300000,COMM SE,Commercial,25704,0,7774,33478
142232800400000,COMM SE,Commercial,25704,0,3485,29189
142232800500000,COMM SE,Commercial,18144,0,29071,47215
142232800600000,COMM SE,Commercial,18144,0,27353,45497
142232800700000,COMM SE,Commercial,69930,0,165095,235025
142232800800000,E-70 CHARITY OTHER,Commercial,163296,0,270845,434141
142232800900000,COMM SE,Commercial,81648,0,11970,93618
142232900100000,COMM SE,Commercial,90720,0,118714,209434
142232900102000,COMM SE,Commercial,0,0,28412,28412
142232900200000,COMM SE,Commercial,90720,0,183518,274238
142233000100000,E-70 CHARITY OTHER,Exempt,47628,0,131941,179569
142233000200000,APTS SE,Commercial,10773,0,144227,155000
142233000300000,COMM SE,Commercial,60480,0,94520,155000
142233000400000,COMM SE,Commercial,102060,0,167799,269859
142233000500000,COMM SE,Commercial,34020,0,122109,156129
142233000600000,APTS SE,Residential,10206,218077,0,228283
142233000900000,E-43 RELIG RECREAT'N,Exempt,143640,0,10993,154633
142233100100000,E-61 NURSING HOME,Exempt,263520,0,2452134,2715654
142233100200000,COMM SE,Commercial,42517,0,140319,182836
142233100300000,COMM SE,Commercial,33445,0,5053,38498
142233100400000,E-47 RELIG OTHER,Exempt,37981,0,3850,41831
142233100500000,COMM SE,Commercial,29484,0,118045,147529
142233100600000,E-47 RELIG OTHER,Exempt,45360,0,177955,223315
142233100700000,CONVERSIONS,Commercial,9072,0,53000,62072
142233100800000,E-70 CHARITY OTHER,Exempt,90720,0,522030,612750
142233100900000,COMM SE,Commercial,52920,0,13718,66638
142233101000000,COMM SE,Commercial,63504,0,14723,78227
142233101100000,COMM SE,Commercial,63504,0,11758,75262
142233101200000,COMM SE,Commercial,218160,0,2180012,2398172
142233200101000,CONDO 506,Residential,6000,41076,0,47076
142233200101001,CONDO 506,Residential,6000,41076,0,47076
142233200200000,E-70 CHARITY OTHER,Exempt,23085,0,0,23085
142233200500000,E-70 CHARITY OTHER,Exempt,27234,0,167079,194313
142233200600000,E-70 CHARITY OTHER,Exempt,0,0,0,0
142233200700000,COMM SE,Commercial,18144,0,1254,19398
142233200800000,COMM SE,Commercial,24192,0,58396,82588
142233201000000,E-47 RELIG OTHER,Exempt,22032,0,105959,127991
142233201100000,E-70 CHARITY OTHER,Exempt,0,0,0,0
142233201200000,E-61 NURSING HOME,Exempt,300672,0,2247253,2547925
142233201300000,SE 232,Residential,9700,53818,0,63518
142233201400000,SE 232,Residential,10875,48226,0,59101
142233300100000,COMM SE,Commercial,7560,0,99912,107472
142233300200000,COMM SE,Commercial,7452,0,1904,9356
142233300300000,SE 232,Residential,4185,39005,0,43190
142233300400000,SE 232,Residential,6750,37160,0,43910
142233300500000,SE 232,Residential,5400,35229,0,40629
142233300600000,COMM SE,Commercial,504360,0,3224177,3728537
142233400100000,CONVERSIONS,Commercial,7128,0,44599,51727
142233400200000,SE 232,Residential,10000,65054,0,75054
142233400300000,SE 232,Residential,12750,25748,0,38498
142233400400000,SE 232,Residential,7500,38595,0,46095
142233400500000,SE 232,Residential,7500,31950,0,39450
142233400600000,SE 232,Residential,12750,61432,0,74182
142233400700000,CONVERSIONS,Commercial,6804,0,49098,55902
142233400800000,SE 232,Residential,7500,45315,0,52815
142233400900000,CONVERSIONS,Commercial,9234,0,70224,79458
142233401000000,SE 232,Residential,6975,33572,0,40547
142233401100000,SE 232,Residential,6650,40160,0,46810
142233401200000,SE 232,Residential,6650,62293,0,68943
142233401300000,SE 232,Residential,4500,103,0,4603
142233401400000,SE 232,Residential,12750,0,0,12750
142233401500000,SE 232,Residential,8000,49095,0,57095
142233401600000,SE 232,Residential,6817,26996,0,33813
142233401700000,SE 232,Exempt,7320,0,41150,48470
142233500100000,SE 232,Exempt,12750,0,87008,99758
142233500200000,SE 232,Exempt,7725,0,43695,51420
142235100100000,SE 232,Residential,7000,9590,0,16590
142235100200000,SE 232,Residential,3375,37022,0,40397
142235100300000,SE 232,Residential,4500,32310,0,36810
142235200100000,Empty,Exempt,0,0,0,0
142235200200000,SE 232,Residential,5700,34804,0,40504
142235200300000,CONVERSIONS,Commercial,3888,0,40017,43905
142235200400000,SE 232,Residential,6200,42736,0,48936
142235200500000,SE 232,Residential,5700,15950,0,21650
142235200600000,SE 232,Residential,5700,25190,0,30890
142235200700000,SE 232,Residential,5700,35961,0,41661
142235200800000,SE 232,Residential,5700,0,0,5700
142235200900000,SE 232,Residential,12936,0,0,12936
142235201000000,SE 232,Residential,4940,0,0,4940
142235201100000,SE 232,Residential,7600,35224,0,42824
142235201200000,SE 232,Residential,7600,25227,0,32827
142235201300000,SE 232,Residential,8800,35133,0,43933
142235201400000,SE 232,Residential,9386,47775,0,57161
142235201500000,Empty,Exempt,0,0,0,0
142235201600000,SE 232,Residential,11520,41356,0,52876
142235201700000,Empty,Exempt,0,0,0,0
142235202000000,SE 232,Residential,6000,0,0,6000
142235202100000,E-15 CITY,Exempt,0,0,0,0
142235202200000,CONVERSIONS,Commercial,5832,0,74292,80124
142235202300000,SE 232,Residential,7350,32191,0,39541
142235202400000,SE 232,Residential,7350,31468,0,38818
142235202500000,SE 232,Residential,12495,41129,0,53624
142235202600000,SE 232,Residential,7040,39546,0,46586
142235202700000,E-70 CHARITY OTHER,Exempt,6156,0,85320,91476
142235202800000,CONVERSIONS,Commercial,8100,0,72415,80515
142235202900000,SE 232,Residential,11500,50294,0,61794
142235203000000,SE 232,Residential,10540,0,0,10540
142235203100000,Empty,Exempt,0,0,0,0
142235203200000,Empty,Exempt,0,0,0,0
142235203300000,Empty,Exempt,0,0,0,0
142235203500000,E-60 HOSPITAL,Exempt,160989,0,15387,176376
142235203600000,SE 232,Residential,8050,43177,0,51227
142235203700000,COMM SE,Commercial,21384,0,6103,27487
142235203800000,COMM SE,Commercial,183902,0,454098,638000
142235203900000,E-70 CHARITY OTHER,Exempt,40824,0,4839,45663
142235204000000,COMM SE,Commercial,108670,0,273585,382255
142235204100000,E-70 CHARITY OTHER,Exempt,55404,0,1201,56605
142235204400000,COMM SE,Commercial,27410,0,103380,130790
142235300100000,COMM SE,Commercial,334800,0,863444,1198244
142235400100000,COMM SE,Commercial,97200,0,370491,467691
142235400102000,COMM SE,Commercial,0,0,16128,16128
142235400200000,COMM SE,Commercial,576450,0,2090924,2667374
142235500100000,COMM SE,Commercial,810454,0,87231101,88041555
142235500200000,E-60 HOSPITAL,Exempt,313200,0,7885652,8198852
142235500300000,E-60 HOSPITAL,Exempt,103162,0,7620,110782
142235500400000,COMM SE,Commercial,376650,0,1894228,2270878
142235500500000,E-60 HOSPITAL,Exempt,38880,0,8399,47279
142235500600000,E-60 HOSPITAL,Exempt,386208,0,467895,854103
142235500700000,COMM SE,Commercial,89424,0,482133,571557
142235500800000,COMM SE,Commercial,38880,0,8736,47616
142235600100000,E-60 HOSPITAL,Exempt,153187,0,255371,408558
142235600400000,E-15 CITY,Exempt,0,0,0,0
142235600500000,E-15 CITY,Exempt,0,0,0,0
142235600600000,E-60 HOSPITAL,Exempt,1296,0,0,1296
142235600900000,E-60 HOSPITAL,Exempt,10368,0,6023,16391
142237600100000,SE 231,Residential,6256,48900,0,55156
142237600200000,SE 231,Residential,6338,39272,0,45610
142237600300000,SE 231,Residential,8349,81997,0,90346
142237600400000,SE 231,Residential,7300,40580,0,47880
142237600500000,SE 231,Residential,10000,42296,0,52296
142237600600000,SE 231,Residential,10000,63770,0,73770
142237600700000,SE 231,Residential,10000,79500,0,89500
142237600800000,SE 231,Residential,10000,52644,0,62644
142237600900000,SE 231,Residential,10000,67199,0,77199
142237601000000,SE 231,Residential,10000,58933,0,68933
142237601100000,SE 231,Residential,10000,77660,0,87660
142237601200000,SE 231,Residential,10000,56498,0,66498
142237601300000,SE 231,Residential,10000,74224,0,84224
142237601400000,SE 231,Residential,10000,49096,0,59096
142237601500000,SE 231,Residential,10000,46185,0,56185
142237601600000,SE 231,Residential,10000,65322,0,75322
142237601700000,SE 231,Residential,10000,11686,0,21686
142237601800000,SE 231,Residential,5775,38680,0,44455
142237601900000,SE 231,Exempt,5600,0,45711,51311
142237602000000,SE 231,Residential,9235,56269,0,65504
142237700100000,SE 231,Residential,7394,50470,0,57864
142237700200000,SE 231,Residential,7475,50715,0,58190
142237700300000,SE 231,Residential,8349,44077,0,52426
142237700400000,SE 231,Residential,6023,21643,0,27666
142237700500000,SE 231,Residential,6205,61081,0,67286
142237700600000,SE 231,Residential,8250,49485,0,57735
142237700700000,SE 231,Residential,10000,53907,0,63907
142237700800000,SE 231,Residential,10000,69896,0,79896
142237700900000,SE 231,Residential,10000,41746,0,51746
142237701000000,SE 231,Residential,10000,13916,0,23916
142237701100000,SE 231,Residential,9005,56124,0,65129
142237701200000,SE 231,Residential,5719,39789,0,45508
142237701300000,SE 231,Residential,5038,46647,0,51685
142237800100000,COMM SE,Commercial,49896,0,156346,206242
142237800200000,SE 231,Residential,10000,55239,0,65239
142237800300000,COMM SE,Commercial,24192,0,9729,33921
142237900100000,SE 231,Residential,7163,73514,0,80677
142237900200000,SE 231,Residential,6388,46574,0,52962
142237900300000,SE 231,Residential,10000,90270,0,100270
142237900400000,SE 231,Residential,10000,63826,0,73826
142237900500000,SE 231,Residential,10000,79164,0,89164
142237900600000,SE 231,Residential,10000,97386,0,107386
142237900700000,SE 231,Residential,10000,75476,0,85476
142237900800000,SE 231,Residential,10000,50626,0,60626
142237900900000,SE 231,Residential,10000,46395,0,56395
142237901000000,SE 231,Residential,10000,78662,0,88662
142237901100000,SE 231,Residential,10000,63036,0,73036
142237901200000,SE 231,Residential,10000,52650,0,62650
142237901300000,SE 231,Residential,10000,108390,0,118390
142237901400000,SE 231,Residential,10000,58486,0,68486
142237901500000,SE 231,Residential,10000,64789,0,74789
142237901600000,SE 231,Residential,6458,46656,0,53114
142237901700000,SE 231,Residential,6388,63255,0,69643
142237901800000,SE 231,Residential,5606,55003,0,60609
142237901900000,SE 231,Residential,5444,54235,0,59679
142237902000000,SE 231,Residential,9240,56188,0,65428
142237902100000,SE 231,Residential,5250,60314,0,65564
142237902200000,SE 231,Residential,5098,64915,0,70013
142237902300000,SE 231,Residential,10000,56175,0,66175
142237902400000,SE 231,Residential,10000,57014,0,67014
142237902500000,SE 231,Residential,10000,45301,0,55301
142237902600000,SE 231,Residential,10000,70008,0,80008
142237902700000,SE 231,Residential,10000,79136,0,89136
142237902800000,SE 231,Residential,10000,87326,0,97326
142237902900000,SE 231,Residential,10000,47426,0,57426
142237903000000,SE 231,Residential,10000,70450,0,80450
142237903100000,SE 231,Residential,10000,65398,0,75398
142237903200000,SE 231,Residential,10000,57157,0,67157
142237903300000,SE 231,Residential,10000,48352,0,58352
142237903400000,SE 231,Residential,8333,54278,0,62611
142237903500000,SE 231,Residential,8333,52174,0,60507
142237903600000,SE 231,Residential,8333,79424,0,87757
142237903700000,SE 231,Residential,9599,81357,0,90956
142237903800000,SE 231,Residential,5200,53494,0,58694
142237903900000,SE 231,Residential,5200,69930,0,75130
142237904000000,SE 231,Residential,6175,36168,0,42343
142237904100000,SE 231,Residential,6094,38007,0,44101
142238000100000,SE 231,Residential,9005,53992,0,62997
142238000200000,SE 231,Residential,10000,58176,0,68176
142238000300000,SE 231,Residential,10000,77244,0,87244
142238000400000,SE 231,Residential,10000,59796,0,69796
142238000500000,SE 231,Exempt,10000,52375,0,62375
142238000600000,SE 231,Residential,10000,58382,0,68382
142238000700000,SE 231,Residential,10000,57955,0,67955
142238000800000,SE 231,Residential,6536,54550,0,61086
142238000900000,SE 231,Residential,7055,62055,0,69110
142238001000000,SE 231,Residential,8000,94828,0,102828
142238001100000,SE 231,Residential,5038,58538,0,63576
142238001200000,SE 231,Residential,5338,50924,0,56262
142238001300000,SE 231,Residential,8782,63651,0,72433
142238001400000,SE 231,Residential,10000,54259,0,64259
142238001500000,SE 231,Residential,10000,83373,0,93373
142238001600000,SE 231,Residential,10000,57850,0,67850
142238001700000,SE 231,Residential,12500,78708,0,91208
142238001800000,SE 231,Residential,12500,87184,0,99684
142238001900000,SE 231,Residential,10954,86470,0,97424
142238002000000,SE 231,Exempt,6256,0,51268,57524
142238002100000,SE 231,Residential,6338,12174,0,18512
142238002200000,SE 231,Residential,5425,44701,0,50126
142238002300000,SE 231,Residential,5338,72376,0,77714
142238100100000,SE 231,Residential,5561,66806,0,72367
142238100200000,SE 231,Residential,6191,46089,0,52280
142238100300000,SE 231,Residential,5444,39763,0,45207
142238100400000,SE 231,Residential,5444,48969,0,54413
142238100500000,SE 231,Residential,5038,27817,0,32855
142238100600000,SE 231,Residential,5038,37063,0,42101
142238100700000,SE 231,Residential,5475,48016,0,53491
142238100800000,SE 231,Residential,5475,48164,0,53639
142238100900000,SE 231,Residential,11125,57193,0,68318
142238101000000,SE 231,Residential,10000,76438,0,86438
142238101100000,SE 231,Residential,10000,75786,0,85786
142238101200000,SE 231,Residential,10000,37034,0,47034
142238101300000,SE 231,Residential,10000,57558,0,67558
142238101400000,SE 231,Residential,10000,37882,0,47882
142238101500000,SE 231,Residential,10000,66447,0,76447
142238101600000,SE 231,Residential,12500,30808,0,43308
142238101700000,SE 231,Residential,10000,30037,0,40037
142238101800000,SE 231,Residential,10000,54792,0,64792
142238101900000,SE 231,Residential,10000,52482,0,62482
142238102000000,SE 231,Residential,12500,120038,0,132538
142238102100000,SE 231,Residential,10000,29630,0,39630
142238102200000,SE 231,Residential,10000,51097,0,61097
142238102300000,SE 231,Residential,12750,46465,0,59215
142238102400000,SE 231,Residential,13425,60231,0,73656
142238102500000,SE 230,Residential,17100,71310,0,88410
142238102600000,SE 231,Residential,4117,38227,0,42344
142238102700000,SE 230,Residential,16686,97306,0,113992
142238102800000,SE 230,Residential,13812,88163,0,101975
142238102900000,SE 231,Residential,12375,86116,0,98491
142238103000000,SE 231,Residential,9900,83338,0,93238
142238103100000,SE 231,Residential,9900,80864,0,90764
142238103200000,SE 231,Residential,9900,64970,0,74870
142238103300000,SE 231,Residential,3200,29047,0,32247
142238103400000,SE 231,Residential,6700,70782,0,77482
142238200100000,SE 231,Residential,8645,59254,0,67899
142238200200000,SE 231,Residential,7875,53199,0,61074
142238200300000,SE 231,Residential,7875,65875,0,73750
142238200400000,SE 231,Residential,6375,80428,0,86803
142238200500000,SE 231,Residential,8455,55668,0,64123
142238200600000,SE 231,Residential,10000,39212,0,49212
142238200700000,SE 231,Residential,7500,53722,0,61222
142238200800000,SE 231,Residential,7500,48712,0,56212
142238200900000,SE 231,Residential,10000,58924,0,68924
142238201000000,SE 231,Residential,10000,61555,0,71555
142238201100000,SE 231,Residential,10000,67922,0,77922
142238201200000,SE 231,Residential,10000,53083,0,63083
142238201300000,SE 231,Residential,10000,51489,0,61489
142238201400000,SE 231,Residential,10000,59807,0,69807
142238201500000,SE 231,Residential,10000,60996,0,70996
142238201600000,SE 231,Residential,10000,57130,0,67130
142238201700000,SE 231,Residential,10000,65744,0,75744
142238201800000,SE 231,Residential,10000,49892,0,59892
142238201900000,SE 231,Residential,10000,50444,0,60444
142238202000000,SE 231,Residential,12750,59990,0,72740
142238202100000,COMM SE,Commercial,14040,0,13105,27145
142238202200000,COMM SE,Commercial,19966,0,54482,74448
142238202300000,COMM SE,Commercial,12960,0,49537,62497
142238202400000,SE 231,Residential,10582,64584,0,75166
142238202500000,SE 231,Residential,10000,32204,0,42204
142238202600000,SE 231,Residential,10000,29575,0,39575
142238202700000,SE 231,Residential,10000,82012,0,92012
142238202800000,SE 231,Residential,10000,49834,0,59834
142238202900000,SE 231,Residential,9000,76587,0,85587
142238203000000,SE 231,Residential,11000,72903,0,83903
142238203100000,SE 231,Residential,10000,54154,0,64154
142238203200000,SE 231,Residential,10000,53449,0,63449
142238203300000,CONVERSIONS,Commercial,13608,0,53989,67597
142238203400000,SE 231,Residential,10000,38246,0,48246
142238203500000,SE 231,Residential,10000,83494,0,93494
142238203600000,SE 231,Residential,10000,51811,0,61811
142238203700000,SE 231,Residential,10000,40748,0,50748
142238203800000,SE 231,Residential,8745,50374,0,59119
142238300100000,SE 231,Residential,5025,46232,0,51257
142238300200000,SE 231,Residential,5425,70729,0,76154
142238300300000,SE 231,Residential,5425,68331,0,73756
142238300400000,SE 231,Residential,5425,52126,0,57551
142238300500000,SE 231,Residential,8680,81559,0,90239
142238300600000,SE 231,Residential,10582,67869,0,78451
142238300700000,SE 231,Residential,10600,58885,0,69485
142238300800000,SE 231,Residential,10600,66218,0,76818
142238300900000,SE 231,Residential,10600,68864,0,79464
142238301000000,SE 231,Residential,10600,80949,0,91549
142238301100000,SE 231,Residential,10600,100237,0,110837
142238301200000,SE 231,Residential,10600,57271,0,67871
142238301300000,SE 231,Residential,2358,1652,0,4010
142238301400000,SE 231,Residential,10865,71731,0,82596
142238301500000,COMM SE,Commercial,33048,0,80380,113428
142238301600000,COMM SE,Commercial,254016,0,455192,709208
142238301700000,COMM SE,Commercial,14256,0,12105,26361
142238301800000,SE 231,Residential,7750,18177,0,25927
142238301900000,SE 231,Residential,5658,39535,0,45193
142238302000000,SE 231,Residential,6200,33352,0,39552
142238302100000,COMM SE,Commercial,19566,0,130775,150341
142238302200000,SE 231,Residential,13515,62392,0,75907
142238302300000,SE 231,Residential,10865,57458,0,68323
142238302400000,SE 231,Residential,10865,45315,0,56180
142238302500000,SE 231,Residential,10600,43789,0,54389
142238302600000,SE 231,Residential,10600,46364,0,56964
142238302700000,SE 231,Residential,7950,80720,0,88670
142238302800000,SE 231,Residential,9275,74494,0,83769
142238302900000,SE 231,Residential,9275,46316,0,55591
142238303000000,SE 231,Residential,13515,69044,0,82559
142238303100000,SE 231,Residential,5025,38560,0,43585
142238303200000,SE 231,Residential,8508,39010,0,47518
142240100100000,SE 228,Residential,24479,116738,0,141217
142240100200000,SE 228,Residential,25000,102753,0,127753
142240100300000,SE 228,Residential,30000,149733,0,179733
142240100400000,SE 228,Residential,30000,137649,0,167649
142240100500000,SE 228,Residential,30000,138212,0,168212
142240100600000,SE 228,Residential,30000,129042,0,159042
142240100700000,SE 228,Residential,30000,130124,0,160124
142240100800000,SE 228,Residential,30000,139255,0,169255
142240100900000,SE 228,Residential,30000,128796,0,158796
142240101000000,SE 228,Residential,30716,227479,0,258195
142240101100000,SE 228,Residential,27667,162526,0,190193
142240101200000,SE 228,Residential,30000,181675,0,211675
142240101300000,SE 228,Residential,30000,133965,0,163965
142240101400000,SE 228,Residential,30000,103948,0,133948
142240101500000,SE 228,Residential,30000,140648,0,170648
142240101600000,SE 228,Residential,30000,147369,0,177369
142240101700000,SE 228,Residential,33750,156687,0,190437
142240101800000,SE 228,Residential,33750,149680,0,183430
142240101900000,SE 228,Residential,23999,93906,0,117905
142240102000000,SE 228,Residential,20800,100268,0,121068
142240102100000,SE 228,Residential,18975,103173,0,122148
142240200100000,SE 228,Residential,31034,154215,0,185249
142240200200000,SE 228,Residential,25000,105702,0,130702
142240200300000,SE 228,Residential,30000,138613,0,168613
142240200400000,SE 228,Residential,30000,154729,0,184729
142240200500000,SE 228,Residential,30000,117308,0,147308
142240200600000,SE 228,Residential,30000,139209,0,169209
142240200700000,SE 228,Residential,32000,116274,0,148274
142240200800000,SE 228,Residential,25000,125959,0,150959
142240200900000,SE 228,Residential,25000,105522,0,130522
142240201000000,SE 228,Residential,30716,177205,0,207921
142240201100000,SE 228,Residential,10980,97954,0,108934
142240201200000,SE 228,Residential,20647,96600,0,117247
142240201300000,SE 228,Residential,30000,122545,0,152545
142240201400000,SE 228,Residential,30000,121856,0,151856
142240201500000,SE 228,Residential,30000,144327,0,174327
142240201600000,SE 228,Residential,30000,111423,0,141423
142240201700000,SE 228,Residential,30000,170024,0,200024
142240201800000,SE 228,Residential,30000,113320,0,143320
142240201900000,SE 228,Residential,30000,106026,0,136026
142240202000000,SE 228,Residential,30000,191328,0,221328
142240202100000,SE 228,Residential,25824,127099,0,152923
142240202200000,SE 228,Residential,16000,88738,0,104738
142240300100000,SE 228,Residential,26462,105184,0,131646
142240300200000,SE 228,Residential,25810,98368,0,124178
142240300300000,SE 228,Residential,29610,122344,0,151954
142240300400000,SE 228,Residential,30566,146767,0,177333
142240300500000,SE 228,Residential,30000,226944,0,256944
142240300600000,SE 228,Residential,30000,117187,0,147187
142240300700000,SE 228,Residential,30000,128150,0,158150
142240300800000,SE 228,Residential,30000,114904,0,144904
142240300900000,SE 228,Residential,25824,116943,0,142767
142240301000000,SE 228,Residential,16000,90950,0,106950
142240301100000,SE 228,Residential,15500,99917,0,115417
142240301200000,SE 228,Residential,27141,77859,0,105000
142240301300000,SE 228,Residential,36000,120100,0,156100
142240301400000,SE 228,Residential,36000,228618,0,264618
142240301500000,SE 228,Residential,36000,158714,0,194714
142240301600000,SE 228,Residential,36000,125065,0,161065
142240301700000,SE 228,Residential,35340,190711,0,226051
142240301800000,SE 228,Residential,35340,195741,0,231081
142240301900000,SE 228,Residential,37400,191488,0,228888
142240302000000,SE 228,Residential,35800,133291,0,169091
142240302100000,SE 228,Residential,34987,131467,0,166454
142240400100000,SE 228,Residential,26284,127543,0,153827
142240400200000,SE 228,Residential,30000,78771,0,108771
142240400300000,SE 228,Residential,30000,145149,0,175149
142240400400000,SE 228,Residential,30000,110460,0,140460
142240400500000,SE 228,Residential,30000,95708,0,125708
142240400600000,SE 228,Residential,30000,95917,0,125917
142240400700000,SE 228,Residential,30000,105886,0,135886
142240400800000,SE 228,Residential,30000,135616,0,165616
142240400900000,SE 228,Residential,30000,113276,0,143276
142240401000000,SE 228,Residential,27020,125705,0,152725
142240401100000,SE 228,Residential,8256,110438,0,118694
142240401200000,SE 228,Residential,27667,92650,0,120317
142240401300000,SE 228,Residential,30000,170763,0,200763
142240401400000,SE 228,Residential,30000,108244,0,138244
142240401500000,SE 228,Residential,30000,191076,0,221076
142240401600000,SE 228,Residential,30000,122143,0,152143
142240401700000,SE 228,Residential,30000,158277,0,188277
142240401800000,SE 228,Residential,30000,141337,0,171337
142240401900000,SE 228,Residential,30000,148503,0,178503
142240402000000,SE 228,Residential,30000,152349,0,182349
142240402100000,SE 228,Residential,25824,142074,0,167898
142240402200000,SE 228,Residential,16000,100102,0,116102
142240500100000,E-15 CITY,Exempt,0,0,0,0
142240600100000,SE 247,Residential,97988,191960,0,289948
142240600200000,SE 247,Residential,98333,140416,0,238749
142240600300000,SE 247,Residential,102286,153428,0,255714
142240600400000,SE 247,Residential,91498,207209,0,298707
142240600500000,SE 247,Residential,94874,168363,0,263237
142240600600000,SE 247,Residential,73480,177945,0,251425
142240600700000,SE 247,Residential,64750,138026,0,202776
142240600800000,SE 247,Residential,60720,173837,0,234557
142240600900000,SE 247,Residential,77760,197723,0,275483
142240601000000,E-15 CITY,Exempt,0,0,0,0
142240601100000,SE 247,Residential,176950,270064,0,447014
142240601200000,SE 247,Residential,72896,148171,0,221067
142240601300000,SE 247,Residential,94410,204967,0,299377
142240601400000,SE 247,Residential,88208,179544,0,267752
142240601500000,SE 247,Residential,94041,292600,0,386641
142240601600000,SE 247,Residential,900,0,0,900
142240700100000,SE 247,Residential,175150,129814,0,304964
142240800100000,SE 247,Residential,142975,235092,0,378067
142240800200000,SE 247,Residential,83250,218787,0,302037
142240800300000,SE 230,Residential,52020,137494,0,189514
142240800400000,SE 230,Residential,45900,143712,0,189612
142240800500000,SE 247,Residential,90000,226432,0,316432
142242600100000,SE 230,Residential,13845,134020,0,147865
142242600200000,SE 230,Residential,10000,96073,0,106073
142242600300000,SE 230,Residential,11250,80740,0,91990
142242600400000,SE 230,Residential,12500,122180,0,134680
142242600500000,SE 230,Residential,10000,75000,0,85000
142242600600000,SE 230,Residential,10000,103285,0,113285
142242600700000,SE 230,Residential,10000,77820,0,87820
142242600800000,SE 230,Residential,6023,95831,0,101854
142242600900000,SE 230,Residential,6524,82141,0,88665
142242601000000,SE 230,Residential,5444,67543,0,72987
142242601100000,SE 230,Residential,5363,64631,0,69994
142242601200000,SE 230,Residential,5606,71770,0,77376
142242601300000,SE 230,Residential,5606,62721,0,68327
142242601400000,SE 230,Residential,9967,71504,0,81471
142242601500000,SE 230,Residential,10000,54927,0,64927
142242601600000,SE 230,Residential,10000,93506,0,103506
142242601700000,SE 230,Residential,12500,76396,0,88896
142242601800000,SE 230,Residential,12500,119227,0,131727
142242601900000,SE 230,Residential,10000,96023,0,106023
142242602000000,SE 230,Residential,10000,73020,0,83020
142242602100000,SE 230,Residential,8959,79471,0,88430
142242602200000,SE 230,Residential,10318,119023,0,129341
142242602300000,SE 230,Residential,11400,83649,0,95049
142242602400000,SE 230,Residential,12174,83786,0,95960
142242700100000,SE 230,Residential,8007,57301,0,65308
142242700200000,SE 230,Residential,9139,48311,0,57450
142242700300000,SE 230,Residential,11278,40509,0,51787
142242700400000,CONVERSIONS,Commercial,14262,0,70614,84876
142242700500000,SE 230,Residential,9775,43891,0,53666
142242700600000,SE 230,Residential,8343,53746,0,62089
142242700700000,SE 230,Residential,12750,71099,0,83849
142242700800000,SE 230,Residential,10000,55499,0,65499
142242700900000,SE 230,Residential,10000,62642,0,72642
142242701000000,SE 230,Residential,10000,81370,0,91370
142242701100000,APTS SE,Commercial,13608,0,114498,128106
142242701200000,COMM SE,Commercial,13608,0,50247,63855
142242701300000,SE 230,Residential,4650,37169,0,41819
142242701400000,SE 230,Residential,6200,52515,0,58715
142242701500000,SE 230,Residential,9900,61942,0,71842
142242701600000,SE 230,Residential,9900,78908,0,88808
142242701700000,SE 230,Residential,10050,90945,0,100995
142242701800000,SE 230,Residential,9735,85753,0,95488
142242701900000,SE 230,Residential,9405,86819,0,96224
142242702000000,SE 230,Residential,5520,49314,0,54834
142242702100000,SE 230,Residential,5911,75377,0,81288
142242702200000,SE 230,Residential,5363,63703,0,69066
142242702300000,SE 230,Residential,5200,66675,0,71875
142242702400000,SE 230,Residential,7700,72805,0,80505
142242702500000,SE 230,Residential,7700,69805,0,77505
142242800100000,SE 230,Residential,14700,80263,0,94963
142242800200000,SE 230,Residential,8050,39618,0,47668
142242800300000,SE 230,Residential,9200,28910,0,38110
142242800400000,SE 230,Residential,8740,77946,0,86686
142242800500000,SE 230,Residential,8510,39208,0,47718
142242800600000,SE 230,Residential,8740,49948,0,58688
142242800700000,SE 230,Residential,8510,34656,0,43166
142242800800000,COMM SE,Exempt,26730,0,104877,131607
142242800900000,SE 230,Residential,5038,14962,0,20000
142242801000000,SE 230,Residential,5038,50684,0,55722
142242801100000,SE 230,Residential,5813,28532,0,34345
142242801200000,SE 230,Exempt,5813,0,34564,40377
142242801300000,SE 230,Residential,12750,59676,0,72426
142242801400000,SE 230,Residential,7500,58891,0,66391
142242801500000,SE 230,Residential,7500,60549,0,68049
142242801600000,SE 230,Residential,12750,42685,0,55435
142242900100000,SE 230,Residential,10744,121307,0,132051
142242900200000,SE 230,Residential,10000,56000,0,66000
142242900300000,SE 230,Residential,10000,79610,0,89610
142242900400000,SE 230,Residential,10000,87572,0,97572
142242900500000,SE 230,Residential,10000,92732,0,102732
142242900600000,SE 230,Residential,10000,78526,0,88526
142242900700000,SE 230,Residential,7500,61220,0,68720
142242900800000,SE 230,Residential,7500,59365,0,66865
142242900900000,SE 230,Residential,7500,66927,0,74427
142242901000000,SE 230,Residential,8340,57518,0,65858
142242901100000,SE 230,Residential,6707,71612,0,78319
142242901200000,SE 230,Residential,5444,52877,0,58321
142242901300000,SE 230,Residential,5363,53906,0,59269
142242901400000,SE 230,Residential,5261,51918,0,57179
142242901500000,SE 230,Residential,5951,51244,0,57195
142242901600000,SE 230,Residential,6068,49319,0,55387
142242901700000,SE 230,Residential,5658,49135,0,54793
142242901800000,SE 230,Residential,10000,54436,0,64436
142242901900000,SE 230,Residential,10000,83718,0,93718
142242902000000,SE 230,Residential,12500,69359,0,81859
142242902100000,SE 230,Residential,12500,75445,0,87945
142242902200000,SE 230,Residential,10000,76550,0,86550
142242902300000,SE 230,Residential,10000,103482,0,113482
142242902400000,SE 230,Residential,10000,116416,0,126416
142242902500000,SE 230,Residential,10676,90902,0,101578
142242902600000,SE 230,Residential,7695,79336,0,87031
142242902700000,SE 230,Residential,9300,92072,0,101372
142243000100000,SE 230,Residential,6074,66725,0,72799
142243000200000,SE 230,Residential,5840,68613,0,74453
142243000300000,SE 230,Residential,9500,50960,0,60460
142243000400000,SE 230,Residential,9167,45699,0,54866
142243000500000,SE 230,Residential,7500,60151,0,67651
142243000600000,SE 230,Residential,7500,0,0,7500
142243000700000,SE 230,Residential,7500,74868,0,82368
142243000800000,SE 230,Residential,10000,58014,0,68014
142243000900000,E-70 CHARITY OTHER,Exempt,27216,0,360522,387738
142243001000000,COMM SE,Commercial,27216,0,29859,57075
142243001100000,APTS SE,Commercial,13608,0,109783,123391
142243001200000,SE 230,Residential,12750,61261,0,74011
142243001300000,APTS SE,Commercial,5832,0,84647,90479
142243001400000,SE 230,Residential,6975,20304,0,27279
142243001500000,SE 230,Residential,5425,42881,0,48306
142243001600000,SE 230,Residential,10000,48513,0,58513
142243001700000,SE 230,Residential,12500,36363,0,48863
142243001800000,SE 230,Residential,10000,49529,0,59529
142243001900000,SE 230,Residential,9833,65442,0,75275
142243002000000,SE 230,Residential,9500,81972,0,91472
142243002100000,SE 230,Residential,9128,65533,0,74661
142243002200000,SE 230,Residential,6000,71412,0,77412
142243002300000,SE 230,Residential,5038,49343,0,54381
142243002400000,SE 230,Residential,5688,78272,0,83960
142243002500000,SE 230,Residential,5606,44064,0,49670
142243100100000,SE 230,Residential,7000,64589,0,71589
142243100200000,SE 230,Residential,6650,55005,0,61655
142243100300000,SE 230,Residential,6650,62182,0,68832
142243100400000,SE 230,Residential,9500,33044,0,42544
142243100500000,SE 230,Residential,7000,68088,0,75088
142243100600000,SE 230,Residential,7000,65448,0,72448
142243100700000,SE 230,Residential,7000,67229,0,74229
142243100800000,SE 230,Residential,9200,65111,0,74311
142243100900000,SE 230,Residential,9200,70771,0,79971
142243101000000,SE 230,Residential,9200,61033,0,70233
142243101100000,SE 230,Residential,11730,79576,0,91306
142243101200000,APTS SE,Commercial,7290,0,94038,101328
142243101300000,SE 230,Residential,4573,13939,0,18512
142243101400000,SE 230,Exempt,5503,0,71807,77310
142243101500000,SE 230,Residential,7500,65399,0,72899
142243101600000,SE 230,Residential,7500,61333,0,68833
142243101700000,SE 230,Residential,12750,72115,0,84865
142243101800000,SE 230,Residential,10000,63366,0,73366
142243101900000,SE 230,Residential,7000,70021,0,77021
142243200100000,SE 230,Residential,10776,60450,0,71226
142243200200000,SE 230,Residential,9798,40719,0,50517
142243200300000,SE 230,Residential,10000,100076,0,110076
142243200400000,SE 230,Residential,10000,62341,0,72341
142243200500000,SE 230,Residential,10000,95788,0,105788
142243200600000,SE 230,Residential,10000,104148,0,114148
142243200700000,SE 230,Residential,10000,87977,0,97977
142243200800000,SE 230,Residential,7500,71891,0,79391
142243200900000,SE 230,Residential,5475,59688,0,65163
142243201000000,SE 230,Residential,10026,90478,0,100504
142243201100000,SE 230,Residential,11741,77934,0,89675
142243201200000,SE 230,Residential,5606,56826,0,62432
142243201300000,SE 230,Residential,5606,45855,0,51461
142243201400000,SE 230,Residential,6068,95155,0,101223
142243201500000,SE 230,Residential,5658,62974,0,68632
142243201600000,SE 230,Residential,10000,58561,0,68561
142243201700000,SE 230,Residential,10000,88813,0,98813
142243201800000,SE 230,Residential,7500,54348,0,61848
142243201900000,SE 230,Residential,10000,81019,0,91019
142243202000000,SE 230,Residential,7500,56766,0,64266
142243202100000,SE 230,Residential,10000,82675,0,92675
142243202200000,SE 230,Residential,10000,69708,0,79708
142243202300000,SE 230,Residential,10000,81066,0,91066
142243202400000,SE 230,Residential,12382,78453,0,90835
142243202500000,SE 230,Residential,8550,90996,0,99546
142243202600000,SE 230,Residential,9873,73411,0,83284
142243300100000,SE 230,Residential,6141,46822,0,52963
142243300200000,SE 230,Residential,5840,40203,0,46043
142243300300000,SE 230,Residential,9500,53000,0,62500
142243300400000,SE 230,Residential,9167,78952,0,88119
142243300500000,SE 230,Residential,11250,63157,0,74407
142243300600000,SE 230,Residential,8750,56486,0,65236
142243300700000,SE 230,Residential,10000,74303,0,84303
142243300800000,SE 230,Residential,10000,46474,0,56474
142243300900000,SE 230,Residential,10000,91890,0,101890
142243301000000,CONVERSIONS,Commercial,9299,0,68892,78191
142243301100000,APTS SE,Commercial,11113,0,104693,115806
142243301200000,SE 230,Residential,6125,41525,0,47650
142243301300000,SE 230,Residential,6125,62773,0,68898
142243301400000,SE 230,Residential,6125,43184,0,49309
142243301500000,SE 230,Residential,6125,62390,0,68515
142243301600000,SE 230,Residential,10000,62638,0,72638
142243301700000,SE 230,Residential,10000,84562,0,94562
142243301800000,SE 230,Residential,10000,74546,0,84546
142243301900000,SE 230,Residential,11250,73358,0,84608
142243302000000,Empty,Other,0,0,0,0
142243302100000,SE 230,Residential,11626,30877,0,42503
142243302200000,SE 230,Residential,9833,44913,0,54746
142243302300000,SE 230,Residential,8645,40816,0,49461
142243302400000,SE 230,Residential,5840,56402,0,62242
142243302500000,SE 230,Residential,6050,42944,0,48994
142243302600000,SE 230,Residential,5200,50538,0,55738
142243302700000,SE 230,Residential,7069,68221,0,75290
142243302800000,SE 230,Residential,6125,66181,0,72306
142243302900000,SE 230,Residential,5175,46902,0,52077
142243400100000,SE 230,Residential,9945,73528,0,83473
142243400200000,SE 230,Residential,14000,60398,0,74398
142243400300000,SE 230,Residential,10000,74533,0,84533
142243400400000,SE 230,Residential,9750,64354,0,74104
142243400500000,SE 230,Residential,10000,8142,0,18142
142243400600000,SE 230,Residential,8434,58768,0,67202
142243400700000,SE 230,Residential,5344,73401,0,78745
142243400800000,SE 230,Residential,5344,39176,0,44520
142243400900000,SE 230,Residential,7705,63598,0,71303
142243401000000,SE 230,Residential,5025,50742,0,55767
142243401100000,SE 230,Residential,5445,45582,0,51027
142243401200000,SE 230,Residential,5445,39247,0,44692
142243401300000,SE 230,Residential,10083,37888,0,47971
142243401400000,SE 230,Residential,9917,47434,0,57351
142243401500000,SE 230,Residential,9750,49760,0,59510
142243401600000,SE 230,Residential,6125,58206,0,64331
142243401700000,SE 230,Residential,7875,59109,0,66984
142243401800000,SE 230,Residential,6650,41879,0,48529
142243401900000,SE 230,Residential,6650,42323,0,48973
142243402000000,SE 230,Residential,4988,27659,0,32647
142243402100000,SE 230,Residential,2993,21179,0,24172
142243500100000,SE 230,Residential,12892,127010,0,139902
142243500200000,SE 230,Residential,9300,60381,0,69681
142243500300000,SE 230,Residential,10000,70558,0,80558
142243500400000,SE 230,Residential,10000,81140,0,91140
142243500500000,SE 230,Residential,10000,85202,0,95202
142243500600000,SE 230,Residential,10000,103068,0,113068
142243500700000,SE 230,Residential,10000,108573,0,118573
142243500800000,SE 230,Residential,10000,102851,0,112851
142243500900000,SE 230,Residential,10000,93088,0,103088
142243501000000,SE 230,Residential,7300,55263,0,62563
142243501100000,SE 230,Residential,8897,89103,0,98000
142243501200000,SE 230,Residential,6500,64766,0,71266
142243501300000,SE 230,Residential,6419,55898,0,62317
142243600100000,SE 230,Residential,6141,67295,0,73436
142243600200000,SE 230,Residential,5840,45697,0,51537
142243600300000,SE 230,Residential,9500,58842,0,68342
142243600400000,SE 230,Residential,9167,65363,0,74530
142243600500000,SE 230,Residential,12558,62529,0,75087
142243600600000,SE 230,Residential,10000,71848,0,81848
142243600700000,SE 230,Residential,10000,60416,0,70416
142243600800000,SE 230,Residential,10000,53799,0,63799
142243600900000,SE 230,Residential,10000,71457,0,81457
142243601000000,SE 230,Residential,10250,83569,0,93819
142243601100000,SE 230,Residential,6358,75538,0,81896
142243601200000,SE 230,Residential,10111,79210,0,89321
142243601300000,SE 230,Residential,5513,68550,0,74063
142243601400000,SE 230,Residential,5779,64088,0,69867
142243700100000,SE 230,Residential,7000,44023,0,51023
142243700200000,SE 230,Residential,7000,71559,0,78559
142243700300000,SE 230,Residential,10000,69532,0,79532
142243700400000,SE 230,Residential,10000,61303,0,71303
142243700500000,SE 230,Residential,10000,51303,0,61303
142243700600000,SE 230,Residential,6125,41595,0,47720
142243700700000,SE 230,Residential,6125,63806,0,69931
142243700800000,SE 230,Residential,6125,54304,0,60429
142243700900000,SE 230,Residential,6125,43061,0,49186
142243701000000,SE 230,Residential,6650,62443,0,69093
142243701100000,SE 230,Residential,6650,73103,0,79753
142245100100000,SE 230,Residential,8550,41469,0,50019
142245100200000,SE 230,Residential,10925,105678,0,116603
142245100300000,SE 230,Residential,7500,87184,0,94684
142245100400000,SE 230,Residential,7500,82003,0,89503
142245100500000,SE 230,Residential,10000,73256,0,83256
142245100600000,SE 230,Residential,10000,78151,0,88151
142245100700000,SE 230,Residential,10000,74390,0,84390
142245100800000,SE 230,Residential,10000,96308,0,106308
142245100900000,SE 230,Residential,14000,97012,0,111012
142245101000000,SE 230,Residential,5606,53032,0,58638
142245101100000,SE 230,Residential,5606,48745,0,54351
142245101200000,SE 230,Residential,6068,61949,0,68017
142245101300000,SE 230,Residential,5658,60931,0,66589
142245200100000,SE 230,Residential,5931,67109,0,73040
142245200200000,SE 230,Residential,8694,61328,0,70022
142245200300000,SE 230,Residential,7510,57179,0,64689
142245200400000,SE 230,Residential,9851,55564,0,65415
142245200500000,SE 230,Residential,14641,89625,0,104266
142245200600000,SE 230,Residential,10000,60447,0,70447
142245200700000,SE 230,Residential,8750,64032,0,72782
142245200800000,SE 230,Residential,11250,87025,0,98275
142245200900000,SE 230,Residential,10000,73700,0,83700
142245201000000,SE 230,Residential,10125,51604,0,61729
142245201100000,SE 230,Residential,8300,65455,0,73755
142245201200000,SE 230,Residential,8638,70656,0,79294
142245300100000,SE 230,Residential,6650,37630,0,44280
142245300200000,SE 230,Residential,6650,44316,0,50966
142245300300000,SE 230,Residential,7000,48825,0,55825
142245300400000,SE 230,Residential,7000,42694,0,49694
142245300500000,SE 230,Residential,10000,66241,0,76241
142245300600000,SE 230,Residential,10000,68127,0,78127
142245300700000,SE 230,Residential,10000,73347,0,83347
142245300800000,SE 230,Residential,6125,45065,0,51190
142245300900000,SE 230,Residential,6125,55154,0,61279
142245301100000,SE 230,Residential,6125,44650,0,50775
142245302000000,SE 230,Residential,6125,43875,0,50000
142245400100000,SE 230,Residential,9825,102033,0,111858
142245400200000,SE 230,Residential,9800,100807,0,110607
142245400300000,SE 230,Residential,9800,93970,0,103770
142245400400000,SE 230,Residential,9800,66430,0,76230
142245400500000,SE 230,Residential,7350,74224,0,81574
142245400600000,SE 230,Residential,7350,73216,0,80566
142245400700000,SE 230,Residential,9800,63715,0,73515
142245400800000,SE 230,Residential,9800,62205,0,72005
142245400900000,SE 230,Residential,9800,105456,0,115256
142245401000000,SE 230,Residential,7840,77767,0,85607
142245401100000,SE 230,Residential,8167,77788,0,85955
142245401200000,SE 230,Residential,8029,71132,0,79161
142245401300000,SE 230,Residential,5033,63199,0,68232
142245401400000,SE 230,Residential,5528,77694,0,83222
142245401500000,SE 230,Residential,5858,83319,0,89177
142245401600000,SE 230,Residential,7500,79296,0,86796
142245401700000,SE 230,Residential,8000,65068,0,73068
142245401800000,SE 230,Residential,8500,86962,0,95462
142245401900000,SE 230,Residential,11115,92397,0,103512
142245402000000,SE 230,Residential,8760,66526,0,75286
142245402100000,SE 230,Residential,10408,90839,0,101247
142245402200000,SE 230,Residential,9150,86525,0,95675
142245500100000,SE 230,Residential,7438,80318,0,87756
142245500200000,SE 230,Residential,7650,35324,0,42974
142245500300000,SE 230,Residential,10633,90818,0,101451
142245500400000,SE 230,Residential,10000,62506,0,72506
142245500500000,SE 230,Residential,10000,66054,0,76054
142245500600000,SE 230,Residential,10000,78988,0,88988
142245500700000,SE 230,Residential,10000,86573,0,96573
142245500800000,SE 230,Residential,10305,87926,0,98231
142245500900000,SE 230,Residential,10498,78449,0,88947
142245501000000,SE 230,Residential,7988,76966,0,84954
142245501100000,SE 230,Residential,11125,63899,0,75024
142245501200000,SE 230,Residential,10738,67804,0,78542
142245501300000,SE 230,Residential,8300,62951,0,71251
142245501400000,SE 230,Residential,14000,113645,0,127645
142245501500000,SE 230,Residential,11500,77077,0,88577
142245501600000,SE 230,Residential,13400,121499,0,134899
142245501700000,SE 230,Residential,9583,79783,0,89366
142245501800000,SE 230,Residential,11500,76369,0,87869
142245501900000,SE 230,Residential,11375,88715,0,100090
142245502000000,SE 230,Residential,10800,78204,0,89004
142245502100000,SE 230,Residential,10575,74786,0,85361
142245502200000,SE 230,Residential,8800,73151,0,81951
142245502300000,SE 230,Residential,8700,61625,0,70325
142245502400000,SE 230,Residential,8600,65880,0,74480
142245502500000,SE 230,Residential,8091,63940,0,72031
142245502600000,SE 230,Residential,7400,50780,0,58180
142245502700000,SE 230,Residential,7500,60133,0,67633
142245502800000,SE 230,Residential,7500,0,0,7500
142245502900000,SE 230,Residential,7306,60581,0,67887
142245503000000,SE 230,Residential,9200,83298,0,92498
142245503100000,SE 230,Residential,9100,68819,0,77919
142245503200000,SE 230,Residential,9100,68322,0,77422
142245503300000,SE 230,Residential,10125,81497,0,91622
142245503400000,SE 230,Residential,11250,70117,0,81367
142245503500000,SE 230,Residential,11125,70440,0,81565
142245503600000,SE 230,Residential,10375,63035,0,73410
142245503700000,SE 230,Residential,10513,63794,0,74307
142245503800000,SE 230,Residential,13500,77014,0,90514
142245503900000,SE 230,Residential,10300,62370,0,72670
142245504000000,SE 230,Residential,10100,61575,0,71675
142245504100000,SE 230,Residential,9900,55284,0,65184
142245504200000,SE 230,Residential,7178,84143,0,91321
142245504300000,SE 230,Residential,7310,49120,0,56430
142245600100000,SE 230,Residential,10000,53847,0,63847
142245600200000,SE 230,Residential,10000,55376,0,65376
142245600300000,SE 230,Residential,10000,76540,0,86540
142245600400000,SE 230,Residential,10000,54603,0,64603
142245600500000,SE 230,Residential,10000,42996,0,52996
142245600600000,SE 230,Residential,6125,37318,0,43443
142245600700000,SE 230,Residential,6125,44964,0,51089
142245600800000,SE 230,Residential,6125,42929,0,49054
142245600900000,SE 230,Residential,6125,37084,0,43209
142245601000000,SE 230,Residential,5688,49034,0,54722
142245601100000,SE 230,Residential,5688,53611,0,59299
142245601200000,SE 230,Residential,6388,56029,0,62417
142245601300000,SE 230,Residential,6388,45586,0,51974
142245601400000,SE 230,Residential,10000,50071,0,60071
142245601500000,SE 230,Residential,10000,86592,0,96592
142245601600000,SE 230,Residential,14000,90639,0,104639
142245601700000,SE 230,Residential,10000,71067,0,81067
142245700100000,SE 230,Residential,13680,82824,0,96504
142245700200000,SE 230,Residential,9300,73437,0,82737
142245700300000,SE 230,Residential,9600,87304,0,96904
142245700400000,SE 230,Residential,9700,76798,0,86498
142245700500000,SE 230,Residential,9900,85153,0,95053
142245700600000,SE 230,Residential,8900,67642,0,76542
142245700700000,SE 230,Residential,13362,68580,0,81942
142245700800000,SE 230,Residential,7700,57631,0,65331
142245700900000,SE 230,Residential,10300,60746,0,71046
142245701000000,SE 230,Residential,10300,66217,0,76517
142245701100000,SE 230,Residential,10300,64477,0,74777
142245701200000,SE 230,Residential,10400,70050,0,80450
142245701300000,SE 230,Residential,10400,60867,0,71267
142245701400000,SE 230,Residential,8194,64889,0,73083
142245701500000,SE 230,Residential,7700,60961,0,68661
142245701600000,SE 230,Residential,7700,72264,0,79964
142245701700000,SE 230,Residential,7347,35091,0,42438
142245701800000,SE 230,Residential,10240,54175,0,64415
142245701900000,SE 230,Residential,7700,63666,0,71366
142245702000000,SE 230,Residential,7700,60439,0,68139
142245702100000,SE 230,Residential,7610,72819,0,80429
142245702200000,SE 230,Residential,11280,82806,0,94086
142245702300000,SE 230,Residential,12480,84571,0,97051
142245702400000,SE 230,Residential,12480,92471,0,104951
142245702500000,SE 230,Residential,12480,77685,0,90165
142245702600000,SE 230,Residential,12480,80041,0,92521
142245702700000,SE 230,Residential,9960,80064,0,90024
142245800100000,SE 230,Residential,11403,72980,0,84383
142245800200000,SE 230,Residential,11000,89182,0,100182
142245800300000,SE 230,Residential,11000,60193,0,71193
142245800400000,SE 230,Residential,11000,70006,0,81006
142245800500000,SE 230,Residential,12161,82992,0,95153
142245800600000,SE 230,Residential,15970,70591,0,86561
142245800700000,SE 230,Residential,16078,99718,0,115796
142245800800000,SE 230,Residential,16078,118500,0,134578
142245800900000,SE 230,Residential,16187,109506,0,125693
142245801000000,SE 230,Residential,18000,111156,0,129156
142245801100000,COMM SE,Commercial,369360,0,1598724,1968084
142245801200000,SE 230,Residential,9450,53915,0,63365
142245801300000,SE 230,Residential,9425,88992,0,98417
142245801400000,SE 230,Residential,9425,67770,0,77195
142245801500000,SE 230,Residential,6388,48910,0,55298
142245801600000,SE 230,Residential,6929,59260,0,66189
142245801700000,SE 230,Residential,5769,70319,0,76088
142245801800000,SE 230,Residential,5688,58325,0,64013
142245801900000,SE 230,Residential,10220,101782,0,112002
142245802000000,SE 230,Residential,6846,74084,0,80930
142245802100000,SE 230,Residential,6650,47802,0,54452
142245802200000,SE 230,Residential,9563,50912,0,60475
142245802300000,SE 230,Residential,9563,80847,0,90410
142245802400000,SE 230,Residential,9563,58100,0,67663
142245802500000,SE 230,Residential,8738,56347,0,65085
142245802600000,SE 230,Residential,14300,92611,0,106911
142245802700000,SE 230,Residential,16215,85167,0,101382
142245802800000,SE 230,Residential,13675,77809,0,91484
142245802900000,SE 230,Residential,13675,67325,0,81000
142245803000000,SE 230,Residential,12627,58429,0,71056
142245900100000,APTS SE,Commercial,10824,0,88259,99083
142245900200000,SE 230,Residential,11025,74854,0,85879
142245900300000,SE 230,Residential,7300,42400,0,49700
142245900400000,SE 230,Residential,5475,47401,0,52876
142245900500000,SE 230,Residential,6388,41765,0,48153
142245900600000,SE 230,Residential,6750,63949,0,70699
142245900700000,SE 230,Residential,9785,51787,0,61572
142245900800000,SE 230,Residential,9500,74075,0,83575
142245900900000,SE 230,Residential,9500,82436,0,91936
142245901000000,SE 230,Residential,18011,98529,0,116540
142245901100000,SE 230,Residential,15434,79257,0,94691
142245901200000,SE 230,Residential,9315,81411,0,90726
142245901300000,SE 230,Residential,9419,80568,0,89987
142245901400000,SE 230,Residential,13623,85076,0,98699
142245901500000,SE 230,Residential,38556,218621,0,257177
142245901600000,APTS SE,Commercial,17982,0,103014,120996
142245901700000,CONVERSIONS,Commercial,8879,0,71856,80735
142246000100000,SE 230,Residential,6728,60471,0,67199
142246000200000,SE 230,Residential,6388,70748,0,77136
142246000300000,SE 230,Residential,10100,72568,0,82668
142246000400000,SE 230,Residential,10100,67155,0,77255
142246000500000,SE 230,Residential,10100,53581,0,63681
142246000600000,SE 230,Residential,10100,84244,0,94344
142246000700000,SE 230,Residential,10100,108332,0,118432
142246000800000,SE 230,Residential,6563,61399,0,67962
142246000900000,SE 230,Residential,6369,73422,0,79791
142246001000000,SE 230,Residential,6030,75042,0,81072
142246001100000,SE 230,Residential,5695,70928,0,76623
142246001200000,SE 230,Residential,5931,54588,0,60519
142246001300000,SE 230,Residential,5850,68801,0,74651
142246001400000,SE 230,Residential,6503,63201,0,69704
142246001500000,SE 230,Residential,6388,16151,0,22539
142246001600000,SE 230,Residential,10000,81716,0,91716
142246001700000,SE 230,Residential,9900,61800,0,71700
142246001800000,SE 230,Residential,9900,62301,0,72201
142246001900000,SE 230,Residential,9900,89321,0,99221
142246002000000,SE 230,Residential,9900,58998,0,68898
142246002100000,SE 230,Residential,9758,63683,0,73441
142246002200000,SE 230,Residential,7118,52264,0,59382
142246002300000,SE 230,Residential,7020,61869,0,68889
142246002400000,SE 230,Residential,7980,60711,0,68691
142246002500000,SE 230,Residential,7875,52342,0,60217
142246100100000,SE 230,Residential,15606,80105,0,95711
142246100200000,SE 230,Residential,19140,120976,0,140116
142246100300000,SE 230,Residential,16141,129660,0,145801
142246100400000,SE 230,Residential,12750,64795,0,77545
142246100500000,SE 230,Residential,13393,96573,0,109966
142246100600000,SE 230,Residential,16575,68899,0,85474
142246100700000,SE 230,Residential,2419,0,0,2419
142247600100000,SE 247,Residential,96603,288690,0,385293
142247600200000,SE 247,Residential,93133,283332,0,376465
142247600300000,SE 247,Residential,95016,198162,0,293178
142247600400000,SE 247,Residential,95958,216487,0,312445
142247700100000,SE 247,Residential,130711,282894,0,413605
142247700200000,SE 247,Residential,93886,184772,0,278658
142247700300000,SE 247,Residential,93789,141918,0,235707
142247700400000,SE 247,Residential,91545,184694,0,276239
142247700500000,SE 247,Residential,90581,152843,0,243424
142247700600000,SE 247,Residential,130832,169929,0,300761
142247800100000,SE 247,Residential,181600,390247,0,571847
142247800200000,SE 247,Residential,91282,233171,0,324453
142247800300000,SE 247,Residential,91282,256129,0,347411
142247800400000,SE 247,Residential,148400,0,0,148400
142247800500000,SE 247,Residential,95962,158705,0,254667
142247900100000,SE 247,Residential,90000,245902,0,335902
142247900200000,SE 230,Residential,45900,159940,0,205840
142247900300000,SE 230,Residential,47277,125657,0,172934
142247900400000,SE 247,Residential,93880,184087,0,277967
142247900500000,SE 247,Residential,90000,166207,0,256207
142248000100000,SE 247,Residential,48609,87347,0,135956
142248000200000,SE 247,Residential,62667,109333,0,172000
142248000300000,SE 247,Residential,63997,110471,0,174468
142248000400000,SE 247,Residential,64800,97492,0,162292
142248000500000,SE 230,Residential,21398,144230,0,165628
142248000600000,SE 230,Residential,15000,96671,0,111671
142248000700000,SE 230,Residential,15800,93027,0,108827
142248100100000,SE 247,Residential,64555,154795,0,219350
142248100200000,SE 247,Residential,79459,141463,0,220922
142248100300000,SE 247,Residential,53994,96530,0,150524
142248100400000,SE 247,Residential,51837,79117,0,130954
142248100500000,SE 230,Residential,24750,101086,0,125836
142248100600000,SE 230,Residential,24750,49105,0,73855
142248100700000,SE 230,Residential,24750,117499,0,142249
142248100800000,SE 247,Residential,45424,81490,0,126914
142248100900000,SE 247,Residential,45424,99794,0,145218
142248101000000,SE 247,Residential,48573,106227,0,154800
142248101100000,SE 247,Residential,51857,117534,0,169391
142248200100000,SE 247,Residential,87075,197762,0,284837
142248200200000,SE 247,Residential,52920,81038,0,133958
142248200300000,SE 247,Residential,52920,120934,0,173854
142248200400000,SE 230,Residential,24750,83947,0,108697
142248200500000,SE 230,Residential,24750,100266,0,125016
142248200600000,SE 230,Residential,24750,84343,0,109093
142248200700000,SE 230,Residential,24750,67679,0,92429
142248200800000,SE 230,Residential,25245,104506,0,129751
142248200900000,SE 230,Residential,19800,80248,0,100048
142248201000000,E-15 CITY,Exempt,0,0,0,0
142248201100000,SE 230,Residential,24750,94540,0,119290
142248201200000,SE 230,Residential,24750,69441,0,94191
142248201300000,SE 230,Residential,24750,101870,0,126620
142248201400000,SE 230,Residential,24750,83828,0,108578
142248201500000,SE 230,Residential,24750,128701,0,153451
142248300100000,SE 230,Residential,17600,100498,0,118098
142248300200000,SE 230,Residential,30400,121225,0,151625
142248300300000,SE 230,Residential,30400,93611,0,124011
142248300400000,SE 230,Residential,30000,75252,0,105252
142248300500000,SE 230,Residential,18620,90488,0,109108
142248300600000,SE 230,Residential,16660,67486,0,84146
142248300700000,SE 230,Residential,19600,70196,0,89796
142248300800000,SE 230,Residential,19600,94270,0,113870
142248300900000,SE 230,Residential,21560,86940,0,108500
142248301000000,SE 230,Residential,11160,112826,0,123986
142248301100000,SE 230,Residential,11160,79108,0,90268
142248301200000,SE 230,Residential,11160,77883,0,89043
142248301300000,SE 230,Residential,11160,88844,0,100004
142248301400000,SE 230,Residential,11160,91646,0,102806
142248301500000,SE 230,Residential,8640,84451,0,93091
142248301600000,SE 230,Residential,8640,70900,0,79540
142248301700000,SE 230,Residential,15200,72390,0,87590
142248301800000,SE 230,Residential,22270,79139,0,101409
142248301900000,SE 230,Residential,19380,43533,0,62913
142248302000000,SE 230,Residential,22950,60716,0,83666
142248302100000,SE 230,Residential,24480,101444,0,125924
142248302200000,SE 230,Residential,20200,77048,0,97248
142248302300000,SE 230,Residential,20000,90593,0,110593
142248302400000,SE 230,Residential,16000,77269,0,93269
142248302500000,SE 230,Residential,16000,86209,0,102209
142248302600000,SE 230,Residential,27200,133844,0,161044
142248302700000,SE 230,Residential,17600,99848,0,117448
142248302800000,SE 230,Residential,17600,57835,0,75435
142248302900000,SE 230,Residential,17600,67659,0,85259
142248303000000,SE 230,Residential,17600,74894,0,92494
142248303100000,SE 230,Residential,17600,72506,0,90106
142248303200000,SE 230,Residential,17600,81737,0,99337
142248400100000,SE 247,Residential,60107,96048,0,156155
142248400200000,SE 247,Residential,48830,124451,0,173281
142248400300000,SE 247,Residential,50234,99266,0,149500
142248400400000,SE 247,Residential,52906,139342,0,192248
142248400500000,SE 235,Residential,21574,89895,0,111469
142248400600000,SE 235,Residential,23415,66286,0,89701
142248400700000,SE 235,Residential,22488,75913,0,98401
142248400800000,SE 235,Residential,17500,76566,0,94066
142248400900000,SE 235,Residential,17500,65861,0,83361
142248500100000,SE 230,Residential,17600,92797,0,110397
142248500200000,SE 230,Residential,21330,71677,0,93007
142248500300000,SE 230,Residential,21330,87710,0,109040
142248500400000,SE 230,Residential,21330,70735,0,92065
142248500500000,SE 230,Residential,15200,68966,0,84166
142248500600000,SE 230,Residential,15200,76976,0,92176
142248500700000,SE 230,Residential,25840,90841,0,116681
142248500800000,SE 230,Residential,16000,70220,0,86220
142248500900000,SE 230,Residential,16000,62940,0,78940
142248501000000,SE 230,Residential,15200,65864,0,81064
142248501100000,SE 230,Residential,15200,71229,0,86429
142248501200000,SE 230,Residential,22572,62753,0,85325
142248501300000,SE 230,Residential,10950,73318,0,84268
142248501400000,SE 230,Residential,10950,71451,0,82401
142248501500000,SE 230,Residential,14050,86028,0,100078
142248501600000,COMM SE,Commercial,58061,0,172902,230963
142248501700000,COMM SE,Commercial,51011,0,87187,138198
142248501800000,COMM SE,Commercial,63452,0,4116,67568
142248501900000,SE 230,Residential,18240,56806,0,75046
142248502000000,SE 230,Residential,18970,76334,0,95304
142248502100000,SE 230,Residential,18970,85523,0,104493
142248502200000,SE 230,Residential,18240,47871,0,66111
142248502300000,SE 230,Residential,18240,83431,0,101671
142248502400000,SE 230,Residential,14250,54272,0,68522
142248502500000,SE 230,Residential,14250,60875,0,75125
142248502600000,SE 230,Residential,17600,81734,0,99334
142248502700000,SE 230,Residential,17600,60333,0,77933
142248502800000,SE 230,Residential,17600,61405,0,79005
142310100100000,SE 212,Residential,5450,0,0,5450
142310100200000,SE 212,Residential,126200,264970,0,391170
142310100300000,SE 212,Residential,118692,556933,0,675625
142310100400000,SE 212,Residential,130950,369950,0,500900
142310100500000,SE 212,Residential,94735,234132,0,328867
142310100600000,SE 212,Residential,89706,325040,0,414746
142310100700000,SE 212,Residential,94002,307680,0,401682
142310100800000,SE 212,Residential,85406,286212,0,371618
142310100900000,SE 212,Residential,91060,296405,0,387465
142310101000000,SE 212,Residential,128300,502847,0,631147
142310101100000,SE 212,Residential,89779,341437,0,431216
142310101200000,SE 211,Residential,35904,207802,0,243706
142310101300000,SE 211,Residential,34680,174840,0,209520
142310101400000,SE 211,Residential,34680,155180,0,189860
142310101500000,SE 211,Residential,35092,178824,0,213916
142310101600000,SE 211,Residential,33858,188896,0,222754
142310101700000,SE 211,Residential,37120,217263,0,254383
142310101800000,SE 211,Residential,38972,268657,0,307629
142310101900000,SE 212,Residential,88400,310474,0,398874
142310102000000,SE 212,Residential,84032,0,0,84032
142310102100000,SE 212,Residential,101419,358427,0,459846
142310102200000,SE 212,Residential,103369,253285,0,356654
142310102300000,SE 211,Residential,38500,208328,0,246828
142310102400000,SE 211,Residential,38149,237795,0,275944
142310102500000,SE 211,Residential,35934,199006,0,234940
142310102600000,SE 211,Residential,34688,195981,0,230669
142310102700000,SE 211,Residential,37845,185582,0,223427
142310102800000,SE 211,Residential,38089,229098,0,267187
142310102900000,SE 211,Residential,34248,148826,0,183074
142310103000000,SE 211,Residential,34680,135344,0,170024
142310103100000,SE 211,Residential,34680,149604,0,184284
142310103200000,SE 211,Residential,34680,159832,0,194512
142310103300000,SE 211,Residential,91750,226807,0,318557
142310103400000,SE 212,Residential,139200,281225,0,420425
142310103500000,SE 212,Residential,133300,360451,0,493751
142310103600000,SE 211,Residential,40520,237409,0,277929
142310103700000,SE 211,Residential,60320,164598,0,224918
142310103800000,SE 211,Residential,69032,220116,0,289148
142310104000000,SE 211,Residential,69768,136025,0,205793
142310104100000,SE 211,Residential,40229,0,0,40229
142310104200000,SE 212,Residential,2195,0,0,2195
142310104300000,SE 212,Residential,0,0,0,0
142310104400000,SE 212,Residential,20,0,0,20
142312600100000,E-15 CITY,Exempt,0,0,0,0
142312600200000,E-15 CITY,Exempt,0,0,0,0
142312600300000,SE 211,Residential,37968,177876,0,215844
142312600400000,SE 211,Residential,38330,234435,0,272765
142312600500000,SE 211,Residential,38964,252305,0,291269
142312600600000,SE 211,Residential,37108,186235,0,223343
142312800100000,SE 211,Residential,35308,169527,0,204835
142315100100000,SE 213,Residential,30916,132845,0,163761
142315200100000,SE 213,Residential,34982,130750,0,165732
142315200200000,SE 213,Residential,35000,188868,0,223868
142315200300000,SE 213,Residential,34340,136374,0,170714
142315200400000,SE 213,Residential,34000,156971,0,190971
142315200500000,SE 213,Residential,31680,194851,0,226531
142315200600000,SE 213,Residential,31680,105820,0,137500
142315200700000,SE 213,Residential,31680,99918,0,131598
142315200800000,SE 213,Residential,31060,87715,0,118775
142315200900000,SE 213,Residential,18400,109533,0,127933
142315201000000,SE 213,Residential,16000,58109,0,74109
142315201100000,SE 213,Residential,16000,76173,0,92173
142315201200000,SE 213,Residential,16000,51101,0,67101
142315201300000,SE 213,Residential,23512,46778,0,70290
142315201400000,SE 213,Residential,16488,48755,0,65243
142315201500000,SE 213,Residential,16000,49296,0,65296
142315201600000,SE 213,Residential,16000,38736,0,54736
142315201700000,SE 213,Residential,16000,44479,0,60479
142315201800000,SE 213,Residential,16000,39520,0,55520
142315201900000,SE 213,Residential,16000,35597,0,51597
142315202000000,SE 213,Residential,27000,24451,0,51451
142315202100000,SE 213,Residential,20000,49906,0,69906
142315300100000,SE 213,Residential,30958,130111,0,161069
142315300200000,SE 213,Residential,30780,148090,0,178870
142315300300000,SE 213,Residential,30780,134864,0,165644
142315400100000,SE 213,Residential,31680,121364,0,153044
142315400200000,SE 213,Residential,31112,115881,0,146993
142315400300000,SE 213,Residential,18400,37838,0,56238
142315400400000,SE 213,Residential,22400,51284,0,73684
142315400500000,SE 213,Residential,28600,112323,0,140923
142315400600000,SE 213,Residential,16000,21176,0,37176
142315400700000,SE 213,Residential,16000,38618,0,54618
142315400800000,SE 213,Residential,16000,45520,0,61520
142315400900000,SE 213,Residential,22400,57911,0,80311
142315401000000,SE 213,Residential,19360,64917,0,84277
142315401100000,SE 213,Residential,25200,62677,0,87877
142315401200000,SE 213,Residential,18592,103761,0,122353
142315401300000,SE 213,Residential,28000,74212,0,102212
142317600100000,SE 213,Residential,78050,297975,0,376025
142317600200000,SE 213,Residential,36317,148699,0,185016
142317600300000,SE 213,Residential,37339,115997,0,153336
142317600400000,SE 213,Residential,37087,170856,0,207943
142317600500000,SE 213,Residential,34509,166502,0,201011
142317600600000,SE 213,Residential,31515,125226,0,156741
142317600700000,SE 213,Residential,32895,140504,0,173399
142317600800000,SE 213,Residential,31556,131035,0,162591
142317600900000,SE 213,Residential,33101,142973,0,176074
142317601000000,SE 213,Residential,31661,162739,0,194400
142317601100000,SE 213,Residential,31389,126405,0,157794
142317601200000,SE 213,Residential,31674,158647,0,190321
142317601300000,SE 213,Residential,31713,155315,0,187028
142317700100000,SE 213,Residential,34042,127764,0,161806
142317700200000,SE 213,Residential,34340,165611,0,199951
142317700300000,SE 213,Residential,34340,133306,0,167646
142317700400000,SE 213,Residential,34680,146489,0,181169
142317700500000,SE 213,Residential,34680,141735,0,176415
142317700600000,SE 213,Residential,33048,137536,0,170584
142317700700000,SE 213,Residential,32320,159851,0,192171
142317700800000,SE 213,Residential,33128,147297,0,180425
142317700900000,SE 213,Residential,32859,133235,0,166094
142317701000000,SE 213,Residential,30545,147908,0,178453
142317701100000,SE 213,Residential,31680,116384,0,148064
142317701200000,SE 213,Residential,32472,142265,0,174737
142317701300000,SE 213,Residential,32076,83194,0,115270
142317701400000,SE 213,Residential,34000,163353,0,197353
142317701500000,SE 213,Residential,34000,163983,0,197983
142317701600000,SE 213,Residential,34000,115653,0,149653
142317701700000,SE 213,Residential,34340,156640,0,190980
142317701800000,SE 213,Residential,33650,172671,0,206321
142317800100000,SE 213,Residential,93050,285855,0,378905
142317800200000,SE 213,Residential,27100,108847,0,135947
142317800300000,SE 213,Residential,36502,145118,0,181620
142317800400000,SE 213,Residential,35578,130726,0,166304
142317800500000,SE 213,Residential,34142,168678,0,202820
142317800600000,SE 213,Residential,34222,149502,0,183724
142317800700000,SE 213,Residential,33320,159338,0,192658
142317800800000,SE 213,Residential,33320,176257,0,209577
142317800900000,SE 213,Residential,33660,143413,0,177073
142317801000000,SE 213,Residential,33402,133931,0,167333
142317801100000,SE 213,Residential,31680,135231,0,166911
142317801200000,SE 213,Residential,31680,124074,0,155754
142317801300000,SE 213,Residential,34689,103967,0,138656
142317801400000,SE 213,Residential,33838,97375,0,131213
142317801500000,SE 213,Residential,31369,88489,0,119858
142317801600000,SE 213,Residential,27880,50589,0,78469
142317801700000,SE 213,Residential,28560,26743,0,55303
142317801800000,SE 213,Residential,21280,42226,0,63506
142317801900000,SE 213,Residential,28000,72771,0,100771
142317802000000,SE 213,Residential,24000,62600,0,86600
142317802100000,SE 213,Residential,33351,0,0,33351
142317802200000,SE 213,Residential,30918,0,0,30918
142317802300000,SE 213,Residential,32300,132782,0,165082
142317802400000,SE 213,Residential,24700,99626,0,124326
142317802500000,SE 213,Residential,24700,61899,0,86599
142317802600000,SE 213,Residential,31752,90153,0,121905
142317802700000,SE 213,Residential,31360,77483,0,108843
142317802800000,SE 213,Residential,31360,115228,0,146588
142317802900000,SE 213,Residential,32300,142145,0,174445
142317803000000,SE 213,Residential,32640,119486,0,152126
142317803100000,SE 213,Residential,30756,152894,0,183650
142317803200000,SE 213,Residential,34720,181275,0,215995
142317803300000,SE 213,Residential,44006,195065,0,239071
142317803400000,SE 213,Residential,43245,162508,0,205753
142317803500000,SE 213,Residential,32813,142808,0,175621
142317803600000,SE 213,Residential,40831,162661,0,203492
142317803700000,SE 213,Residential,41450,135217,0,176667
142317803800000,SE 213,Residential,28724,178225,0,206949
142317803900000,E-40 CHURCHES,Exempt,102600,0,847860,950460
142317804000000,SE 213,Residential,28616,92576,0,121192
142317804100000,SE 213,Residential,27832,136364,0,164196
142317804200000,SE 213,Residential,27832,102982,0,130814
142317804300000,SE 213,Residential,29400,78988,0,108388
142317804400000,SE 213,Residential,33320,146771,0,180091
142317804500000,SE 213,Residential,33320,159195,0,192515
142317804600000,SE 213,Residential,69154,221911,0,291065
142317804700000,SE 213,Residential,94750,384872,0,479622
142317804800000,SE 213,Residential,58368,230723,0,289091
142320100100000,SE 248,Residential,176650,263895,0,440545
142320100200000,SE 248,Residential,183550,536618,0,720168
142320100300000,SE 248,Residential,150675,188036,0,338711
142320100400000,SE 248,Residential,156800,418765,0,575565
142320100500000,SE 248,Residential,192400,342646,0,535046
142320100600000,SE 248,Residential,152250,299784,0,452034
142320100700000,SE 248,Residential,166425,288899,0,455324
142320100800000,SE 248,Residential,218500,432810,0,651310
142320100900000,SE 248,Residential,192270,546162,0,738432
142320101000000,SE 248,Residential,61347,138935,0,200282
142320101100000,SE 248,Residential,71232,188530,0,259762
142320101200000,SE 248,Residential,66667,191748,0,258415
142320101300000,SE 248,Residential,78507,199444,0,277951
142320101400000,SE 248,Residential,78320,193697,0,272017
142320101500000,SE 248,Residential,71040,146209,0,217249
142320101600000,SE 248,Residential,80000,201511,0,281511
142320101700000,SE 248,Residential,80000,120820,0,200820
142320101800000,SE 248,Residential,179220,198104,0,377324
142320101900000,SE 248,Residential,82822,198566,0,281388
142320102000000,SE 248,Residential,179670,423926,0,603596
142320102100000,SE 248,Residential,79483,0,0,79483
142320102200000,SE 248,Residential,79429,0,0,79429
142320102300000,SE 248,Residential,179350,198421,0,377771
142320102400000,SE 248,Residential,95200,166460,0,261660
142320102500000,SE 248,Residential,54320,161867,0,216187
142320102600000,SE 248,Residential,56107,160483,0,216590
142320102700000,SE 248,Residential,62560,236553,0,299113
142320102800000,SE 248,Residential,89540,183167,0,272707
142320200100000,SE 248,Residential,52746,231281,0,284027
142320200200000,SE 248,Residential,53973,147323,0,201296
142320200300000,SE 248,Residential,57840,118900,0,176740
142320200400000,SE 248,Residential,61333,137917,0,199250
142320300100000,SE 248,Residential,52358,144138,0,196496
142320300200000,SE 248,Residential,52877,169849,0,222726
142322600100000,SE 248,Residential,182050,331305,0,513355
142322600200000,SE 248,Residential,172200,249130,0,421330
142322700100000,SE 248,Residential,171500,323921,0,495421
142322700200000,SE 248,Residential,187750,303544,0,491294
142322700300000,SE 248,Residential,103007,326770,0,429777
142322800100000,SE 248,Residential,114735,224543,0,339278
142322800200000,SE 248,Residential,56021,222663,0,278684
142322800300000,SE 248,Residential,77357,119012,0,196369
142322800400000,SE 248,Residential,61440,158253,0,219693
142322800500000,SE 248,Residential,50320,164179,0,214499
142322800600000,SE 248,Residential,55968,105286,0,161254
142322800700000,SE 248,Residential,97616,146555,0,244171
142322800800000,SE 248,Residential,78770,155761,0,234531
142322800900000,SE 248,Residential,85200,142030,0,227230
142322801000000,SE 248,Residential,62720,196551,0,259271
142322900100000,SE 248,Residential,178750,453326,0,632076
142322900200000,SE 248,Residential,121840,138426,0,260266
142322900300000,SE 248,Residential,145045,307918,0,452963
142322900400000,SE 248,Residential,113957,437625,0,551582
142322900500000,SE 248,Residential,151025,302019,0,453044
142322900600000,SE 248,Residential,75680,189320,0,265000
142322900700000,SE 248,Residential,43200,131948,0,175148
142322900800000,SE 248,Residential,112662,296817,0,409479
142322900900000,SE 248,Residential,85572,276102,0,361674
142322901000000,SE 248,Residential,43600,165399,0,208999
142322901100000,SE 248,Residential,43600,148006,0,191606
142322901200000,SE 248,Residential,43600,134412,0,178012
142322901300000,SE 248,Residential,43600,147186,0,190786
142322901400000,SE 248,Residential,47960,145933,0,193893
142322901500000,SE 248,Residential,48400,111170,0,159570
142322901600000,SE 248,Residential,61600,153584,0,215184
142322901700000,SE 248,Residential,180100,353222,0,533322
142323000100000,SE 248,Residential,99264,175047,0,274311
142323100100000,SE 248,Residential,55267,214659,0,269926
142323200100000,SE 248,Residential,69888,173065,0,242953
142323200200000,SE 248,Residential,54880,175851,0,230731
142323200300000,SE 248,Residential,73830,164876,0,238706
142323200400000,SE 248,Residential,178600,231400,0,410000
142323200500000,SE 248,Residential,176110,307115,0,483225
142323200600000,SE 248,Residential,133700,179936,0,313636
142323200700000,SE 248,Residential,94400,335455,0,429855
142323200800000,SE 248,Residential,111360,240153,0,351513
142323200900000,SE 248,Residential,67800,216636,0,284436
142323201000000,SE 248,Residential,49280,145107,0,194387
142323201100000,SE 248,Residential,59349,147243,0,206592
142323201200000,SE 248,Residential,55840,157156,0,212996
142323201300000,SE 248,Residential,64640,178192,0,242832
142323201400000,SE 248,Residential,46912,122222,0,169134
142323201500000,SE 216,Residential,41867,99660,0,141527
142325100100000,SE 248,Residential,58133,179181,0,237314
142325100200000,SE 248,Residential,58133,161854,0,219987
142325100300000,SE 248,Residential,92163,181877,0,274040
142325100400000,SE 248,Residential,88000,170543,0,258543
142325200100000,SE 248,Residential,57333,155804,0,213137
142325200200000,SE 248,Residential,56187,125663,0,181850
142325200300000,SE 248,Residential,69692,199566,0,269258
142325200400000,SE 248,Residential,63000,201598,0,264598
142325200500000,SE 248,Residential,63000,153000,0,216000
142325200600000,SE 248,Residential,63000,244320,0,307320
142325200700000,SE 248,Residential,63000,146840,0,209840
142325200800000,SE 248,Residential,63000,190606,0,253606
142325200900000,SE 248,Residential,63000,154448,0,217448
142325201000000,SE 248,Residential,63000,128655,0,191655
142325201100000,SE 248,Residential,63000,306759,0,369759
142325201200000,SE 248,Residential,63000,243148,0,306148
142325201300000,SE 248,Residential,47250,185651,0,232901
142325201400000,SE 248,Residential,25200,134998,0,160198
142325201500000,SE 248,Residential,22050,95933,0,117983
142325201600000,SE 248,Residential,36816,129799,0,166615
142325201700000,SE 248,Residential,36312,122751,0,159063
142325201800000,SE 248,Residential,32160,130212,0,162372
142325300100000,SE 248,Residential,142975,210121,0,353096
142325300200000,SE 248,Residential,110304,172592,0,282896
142325300300000,SE 248,Residential,114480,238475,0,352955
142325300400000,SE 248,Residential,95040,180622,0,275662
142325300500000,SE 248,Residential,102773,257227,0,360000
142325300600000,SE 248,Residential,96784,320079,0,416863
142325400100000,SE 248,Residential,84207,250665,0,334872
142325400200000,SE 248,Residential,84800,367010,0,451810
142325400300000,SE 248,Residential,81691,276184,0,357875
142325400400000,SE 248,Residential,73680,132478,0,206158
142325400500000,SE 248,Residential,78261,157244,0,235505
142325400600000,SE 248,Residential,84293,185943,0,270236
142325400700000,SE 248,Residential,80640,170224,0,250864
142325400800000,SE 248,Residential,118763,314851,0,433614
142325400900000,SE 248,Residential,65208,192746,0,257954
142325401000000,SE 248,Residential,63744,202072,0,265816
142325500100000,SE 248,Residential,62981,251167,0,314148
142325500200000,SE 248,Residential,74360,185047,0,259407
142325500300000,SE 248,Residential,86188,195533,0,281721
142325500400000,SE 248,Residential,74624,224505,0,299129
142325500500000,SE 248,Residential,59136,183718,0,242854
142325500600000,SE 248,Residential,51520,117201,0,168721
142325500700000,SE 248,Residential,63626,134102,0,197728
142325500800000,SE 248,Residential,61152,184478,0,245630
142325500900000,SE 248,Residential,67891,164332,0,232223
142325501000000,SE 248,Residential,77486,156697,0,234183
142325501100000,SE 248,Residential,69115,136287,0,205402
142325501200000,SE 248,Residential,68238,148650,0,216888
142325501300000,SE 248,Residential,63240,156307,0,219547
142325501400000,SE 248,Residential,68800,151016,0,219816
142325600100000,SE 248,Residential,187000,710147,0,897147
142325600200000,SE 227,Residential,30149,93805,0,123954
142325600300000,SE 227,Residential,27900,121241,0,149141
142325600400000,SE 227,Residential,27621,55681,0,83302
142325600500000,SE 227,Residential,26966,106042,0,133008
142325600600000,SE 227,Residential,28500,136711,0,165211
142325600700000,SE 227,Residential,27233,94838,0,122071
142325600800000,SE 248,Residential,62149,109504,0,171653
142325600900000,SE 248,Residential,86079,232313,0,318392
142325601000000,SE 248,Residential,54941,120236,0,175177
142325601100000,SE 248,Residential,35640,126714,0,162354
142325601200000,SE 248,Residential,45200,144294,0,189494
142325601300000,SE 248,Residential,76262,127344,0,203606
142325700100000,SE 248,Residential,75571,198034,0,273605
142325700200000,SE 248,Residential,80000,179178,0,259178
142325700300000,SE 248,Residential,72720,184321,0,257041
142325700400000,SE 248,Residential,73440,147976,0,221416
142325700500000,SE 248,Residential,76584,181761,0,258345
142325700600000,SE 248,Residential,78779,187711,0,266490
142325700700000,SE 248,Residential,86240,196218,0,282458
142325700800000,SE 248,Residential,74400,123593,0,197993
142325700900000,SE 248,Residential,86832,211948,0,298780
142325701000000,SE 227,Residential,55962,149569,0,205531
142325701100000,SE 227,Residential,47616,115681,0,163297
142325701200000,SE 227,Residential,48000,106461,0,154461
142325701300000,SE 227,Residential,48000,96389,0,144389
142325701400000,SE 227,Residential,48000,114484,0,162484
142325701500000,SE 227,Residential,48000,141319,0,189319
142325701600000,SE 227,Residential,48000,115799,0,163799
142325701700000,SE 227,Residential,48000,190582,0,238582
142325701800000,SE 227,Residential,48000,141246,0,189246
142325701900000,SE 227,Residential,48000,124123,0,172123
142325702000000,SE 227,Residential,48000,123597,0,171597
142325702100000,SE 227,Residential,48000,99889,0,147889
142325702200000,SE 227,Residential,54000,143186,0,197186
142325702300000,SE 227,Residential,61056,78944,0,140000
142325800100000,SE 227,Residential,33997,101231,0,135228
142325800200000,SE 227,Residential,31298,67232,0,98530
142325800300000,SE 227,Residential,30262,108077,0,138339
142325800400000,SE 227,Residential,36920,138101,0,175021
142325800500000,SE 227,Residential,26145,92108,0,118253
142325800600000,SE 227,Residential,26145,78412,0,104557
142325800700000,SE 227,Residential,29700,105132,0,134832
142327600100000,SE 248,Residential,59021,154484,0,213505
142327600200000,SE 248,Residential,46200,149875,0,196075
142327600300000,SE 248,Residential,41712,108527,0,150239
142327600400000,SE 248,Residential,48918,110473,0,159391
142327600500000,SE 248,Residential,41712,130591,0,172303
142327600600000,SE 248,Residential,46015,132494,0,178509
142327600700000,SE 248,Residential,44400,130477,0,174877
142327600800000,SE 248,Residential,68800,153376,0,222176
142327700100000,SE 248,Residential,59904,149250,0,209154
142327700200000,SE 248,Residential,49507,143748,0,193255
142327700300000,SE 248,Residential,46720,123551,0,170271
142327700400000,SE 248,Residential,47888,125679,0,173567
142327700500000,SE 248,Residential,52891,114417,0,167308
142327700600000,SE 248,Residential,44773,124111,0,168884
142327800100000,SE 248,Residential,43800,144104,0,187904
142327800200000,SE 248,Residential,43195,127397,0,170592
142327800300000,SE 248,Residential,46754,144377,0,191131
142327800400000,SE 248,Residential,46886,108338,0,155224
142327800500000,SE 248,Residential,48240,168139,0,216379
142327800600000,SE 248,Residential,48642,197712,0,246354
142327800700000,SE 248,Residential,105538,239569,0,345107
142327800800000,SE 248,Residential,74818,183892,0,258710
142327800900000,SE 248,Residential,68704,185296,0,254000
142327801000000,SE 248,Residential,66383,157032,0,223415
142327801100000,SE 248,Residential,68251,224332,0,292583
142327801200000,SE 248,Residential,55227,140420,0,195647
142327801300000,SE 248,Residential,146475,334692,0,481167
142327801400000,SE 248,Residential,79560,161474,0,241034
142327801500000,SE 248,Residential,61360,208313,0,269673
142327801600000,SE 248,Residential,91915,243968,0,335883
142327801700000,SE 248,Residential,68016,195054,0,263070
142327801800000,SE 248,Residential,68080,170161,0,238241
142327801900000,SE 248,Residential,57552,172518,0,230070
142327802000000,SE 248,Residential,53059,153154,0,206213
142327802100000,SE 248,Residential,52602,112002,0,164604
142327900100000,SE 248,Residential,145160,416806,0,561966
142327900200000,SE 248,Residential,87200,201706,0,288906
142327900300000,SE 248,Residential,106864,173204,0,280068
142327900400000,SE 248,Residential,125850,370205,0,496055
142327900500000,SE 248,Residential,117040,279666,0,396706
142327900600000,SE 248,Residential,109440,271753,0,381193
142327900700000,SE 248,Residential,103187,201302,0,304489
142327900800000,SE 248,Residential,108867,195542,0,304409
142327900900000,SE 248,Residential,65056,146631,0,211687
142327901000000,SE 248,Residential,61333,89237,0,150570
142327901100000,SE 248,Residential,48000,112651,0,160651
142327901200000,SE 248,Residential,48000,141781,0,189781
142327901300000,SE 248,Residential,48000,125270,0,173270
142327901400000,SE 248,Residential,49333,161734,0,211067
142328000100000,SE 248,Residential,67891,172915,0,240806
142328000200000,SE 248,Residential,63360,214264,0,277624
142328000300000,SE 248,Residential,65280,170994,0,236274
142328000400000,SE 248,Residential,64800,191187,0,255987
142328000500000,SE 248,Residential,73372,199837,0,273209
142328000600000,SE 248,Residential,56800,208342,0,265142
142328000700000,SE 248,Residential,50425,135863,0,186288
142328000800000,SE 248,Residential,68523,182145,0,250668
142328000900000,SE 248,Residential,44888,176476,0,221364
142328001000000,SE 248,Residential,44518,115884,0,160402
142328001100000,SE 248,Residential,48484,85657,0,134141
142328001200000,SE 248,Residential,49776,157015,0,206791
142328001300000,SE 248,Residential,53040,133859,0,186899
142328001400000,SE 248,Residential,59718,233585,0,293303
142328001500000,SE 248,Residential,63054,234879,0,297933
142328001600000,SE 248,Residential,82335,188732,0,271067
142328001700000,SE 227,Residential,52205,96712,0,148917
142328001800000,SE 227,Residential,35436,96994,0,132430
142328001900000,SE 227,Residential,36000,133994,0,169994
142328002000000,SE 227,Residential,36000,112035,0,148035
142328002100000,SE 227,Residential,36000,119437,0,155437
142328002200000,SE 227,Residential,35000,91352,0,126352
142328002300000,SE 248,Residential,71400,123563,0,194963
142328100100000,SE 227,Residential,81555,153296,0,234851
142328100200000,SE 248,Residential,83755,215541,0,299296
142328100300000,SE 248,Residential,82256,346980,0,429236
142328100400000,SE 248,Residential,180730,714930,0,895660
142328100500000,SE 248,Residential,177535,638739,0,816274
142328100600000,SE 248,Residential,109800,380453,0,490253
142328100700000,SE 248,Residential,118557,274118,0,392675
142328100800000,SE 248,Residential,82384,329753,0,412137
142328100900000,SE 248,Residential,109744,231653,0,341397
142328101000000,SE 248,Residential,102698,0,0,102698
142328101100000,SE 227,Residential,70144,156178,0,226322
142328101200000,SE 227,Residential,52520,132747,0,185267
142328101300000,SE 227,Residential,49920,107105,0,157025
142328101400000,SE 227,Residential,59920,161431,0,221351
142328101500000,SE 227,Residential,54080,99691,0,153771
142328101600000,SE 227,Residential,54080,178749,0,232829
142328101700000,SE 227,Residential,49920,104151,0,154071
142328101800000,SE 227,Residential,48000,159798,0,207798
142328101900000,SE 227,Residential,54000,114773,0,168773
142330100100000,SE 227,Residential,30960,92558,0,123518
142330100200000,SE 227,Residential,28800,83982,0,112782
142330100300000,SE 227,Residential,28800,90351,0,119151
142330100400000,SE 227,Residential,28000,97395,0,125395
142330100500000,SE 227,Residential,32340,104926,0,137266
142330100600000,SE 227,Residential,32340,99845,0,132185
142330100700000,SE 227,Residential,32340,138185,0,170525
142330100800000,SE 227,Residential,30590,110510,0,141100
142330100900000,SE 227,Residential,30451,92000,0,122451
142330101000000,SE 227,Residential,30294,87794,0,118088
142330101100000,SE 227,Residential,24074,85405,0,109479
142330101200000,SE 227,Residential,29400,21481,0,50881
142330101300000,SE 227,Residential,29400,91138,0,120538
142330101400000,SE 227,Residential,29400,93955,0,123355
142330101500000,SE 227,Residential,31860,98156,0,130016
142330101600000,SE 227,Residential,31860,77593,0,109453
142330101700000,SE 227,Residential,29400,90550,0,119950
142330101800000,SE 227,Residential,32400,88248,0,120648
142330101900000,SE 227,Residential,29400,104569,0,133969
142330102000000,SE 227,Residential,29400,78382,0,107782
142330102100000,SE 227,Residential,28714,90837,0,119551
142330102200000,SE 227,Residential,29400,70253,0,99653
142330102300000,SE 227,Residential,33237,88998,0,122235
142330102400000,SE 227,Residential,32767,98944,0,131711
142330102500000,SE 227,Residential,31500,55960,0,87460
142330102600000,SE 227,Residential,31500,45856,0,77356
142330102700000,SE 227,Residential,31500,84140,0,115640
142330102800000,SE 227,Residential,31500,98795,0,130295
142330102900000,SE 227,Residential,28350,116940,0,145290
142330103000000,SE 227,Residential,28017,84217,0,112234
142330103100000,SE 227,Residential,28092,110552,0,138644
142330103200000,SE 227,Residential,33300,109947,0,143247
142330103300000,SE 227,Residential,32492,106224,0,138716
142330103400000,SE 227,Residential,32828,128318,0,161146
142330103500000,SE 227,Residential,27750,87067,0,114817
142330103600000,SE 227,Residential,24975,97900,0,122875
142330103700000,SE 227,Residential,24975,85859,0,110834
142330103800000,SE 227,Residential,26048,84040,0,110088
142330200100000,SE 227,Residential,55226,176476,0,231702
142330200200000,SE 227,Residential,48369,130631,0,179000
142330200300000,SE 227,Residential,40800,74036,0,114836
142330200400000,SE 227,Residential,35088,72384,0,107472
142330200500000,SE 227,Residential,41861,95708,0,137569
142330200600000,SE 227,Residential,41779,119845,0,161624
142330200700000,SE 227,Residential,41616,126638,0,168254
142330200800000,SE 227,Residential,39815,100541,0,140356
142330200900000,SE 227,Residential,40800,95610,0,136410
142330201000000,SE 227,Residential,40800,146158,0,186958
142330201100000,SE 227,Residential,40800,124390,0,165190
142330201200000,SE 227,Residential,41600,83086,0,124686
142330201300000,SE 227,Residential,43656,122187,0,165843
142330201400000,SE 227,Residential,44000,112872,0,156872
142330201500000,SE 227,Residential,43620,132365,0,175985
142330201600000,SE 227,Residential,35130,88107,0,123237
142330201700000,SE 227,Residential,37445,98133,0,135578
142330201800000,SE 227,Residential,35796,94407,0,130203
142330201900000,SE 227,Residential,42541,90644,0,133185
142330202000000,SE 227,Residential,36288,141471,0,177759
142330202100000,SE 227,Residential,39155,96952,0,136107
142330202200000,SE 227,Residential,40524,92190,0,132714
142330202300000,SE 227,Residential,38528,86459,0,124987
142330202400000,SE 227,Residential,32411,107081,0,139492
142330202500000,SE 227,Residential,31584,88486,0,120070
142330202600000,SE 227,Residential,31133,86780,0,117913
142330202700000,SE 227,Residential,23008,75020,0,98028
142330202800000,SE 227,Residential,29100,85226,0,114326
142330202900000,SE 227,Residential,29100,81169,0,110269
142330203000000,SE 227,Residential,29100,90732,0,119832
142330203100000,SE 227,Residential,29100,79765,0,108865
142330203200000,SE 227,Residential,29100,85755,0,114855
142330203300000,SE 227,Residential,29100,92390,0,121490
142330203400000,SE 227,Residential,29818,67399,0,97217
142330203500000,SE 227,Residential,29100,90848,0,119948
142330203600000,SE 227,Residential,29100,118081,0,147181
142330203700000,SE 227,Residential,26202,101193,0,127395
142330203800000,SE 227,Residential,30398,98062,0,128460
142330203900000,SE 227,Residential,29100,127863,0,156963
142330204000000,SE 227,Residential,29100,69247,0,98347
142330204100000,SE 227,Residential,29100,103012,0,132112
142330204200000,SE 227,Residential,29100,92465,0,121565
142330204300000,SE 227,Residential,29100,61483,0,90583
142330300100000,SE 227,Residential,41880,112008,0,153888
142330300200000,SE 227,Residential,40000,149635,0,189635
142330300300000,SE 227,Residential,40000,121225,0,161225
142330300400000,SE 227,Residential,40000,107457,0,147457
142330300500000,SE 227,Residential,40000,84143,0,124143
142330300600000,SE 227,Residential,40000,99813,0,139813
142330300700000,SE 227,Residential,40080,111223,0,151303
142330300800000,SE 227,Residential,42000,80263,0,122263
142330300900000,SE 227,Residential,40000,97982,0,137982
142330301000000,SE 227,Residential,40000,94567,0,134567
142330301100000,SE 227,Residential,40000,91377,0,131377
142330301200000,SE 227,Residential,40000,97057,0,137057
142330301300000,SE 227,Residential,40000,117013,0,157013
142330301400000,SE 227,Residential,39408,73309,0,112717
142330400100000,SE 227,Residential,40944,123458,0,164402
142330400200000,SE 227,Residential,40000,85254,0,125254
142330400300000,SE 227,Residential,40000,112212,0,152212
142330400400000,SE 227,Residential,40000,98309,0,138309
142330400500000,SE 227,Residential,40000,118603,0,158603
142330400600000,SE 227,Residential,40000,118914,0,158914
142330400700000,SE 227,Residential,40080,119593,0,159673
142330400800000,SE 227,Residential,46592,111050,0,157642
142330400900000,SE 227,Residential,45696,103602,0,149298
142330401000000,SE 227,Residential,41933,88503,0,130436
142330401100000,SE 227,Residential,42310,119685,0,161995
142330401200000,SE 227,Residential,43697,102661,0,146358
142330401300000,SE 227,Residential,40063,99756,0,139819
142330500100000,SE 227,Residential,42747,97165,0,139912
142330500200000,SE 227,Residential,43979,102349,0,146328
142330500300000,SE 227,Residential,42651,84159,0,126810
142330500400000,SE 227,Residential,42651,40710,0,83361
142330600100000,SE 227,Residential,24353,74485,0,98838
142330600200000,SE 227,Residential,36266,122667,0,158933
142330600300000,SE 227,Residential,31500,88101,0,119601
142330600400000,SE 227,Residential,31500,82053,0,113553
142330600500000,SE 227,Residential,18900,78530,0,97430
142330600600000,SE 227,Residential,18295,0,0,18295
142330600700000,SE 227,Residential,30184,92352,0,122536
142330600800000,SE 227,Residential,29400,88143,0,117543
142330600900000,SE 227,Residential,30086,67411,0,97497
142330601000000,SE 227,Residential,39348,106078,0,145426
142330601100000,SE 227,Residential,38625,78468,0,117093
142330601200000,SE 227,Residential,38625,87768,0,126393
142330601300000,SE 227,Residential,38625,137362,0,175987
142330601400000,SE 227,Residential,38625,90016,0,128641
142330601500000,SE 227,Residential,38625,100031,0,138656
142330601600000,SE 227,Residential,40303,104455,0,144758
142330601700000,SE 227,Residential,49827,126411,0,176238
142330601800000,SE 227,Residential,23250,85929,0,109179
142330601900000,SE 227,Residential,22000,69204,0,91204
142330700100000,SE 227,Residential,38888,109946,0,148834
142330700200000,SE 227,Residential,39480,93216,0,132696
142330700300000,SE 227,Residential,39480,100428,0,139908
142330700400000,SE 227,Residential,39480,105490,0,144970
142330700500000,SE 227,Residential,39480,77169,0,116649
142330800100000,SE 227,Residential,34216,94472,0,128688
142330800200000,SE 227,Residential,34216,83418,0,117634
142330800300000,SE 227,Residential,34216,82266,0,116482
142330800400000,SE 227,Residential,34216,79173,0,113389
142330800500000,SE 227,Residential,34216,54537,0,88753
142330800600000,SE 227,Residential,34717,67942,0,102659
142330900100000,SE 227,Residential,23490,98772,0,122262
142330900200000,SE 227,Residential,39744,96447,0,136191
142330900300000,SE 227,Residential,38448,110308,0,148756
142330900400000,SE 227,Residential,38880,121236,0,160116
142330900500000,SE 227,Residential,42614,108853,0,151467
142330900600000,SE 227,Residential,41069,116672,0,157741
142330900700000,SE 227,Residential,28594,79212,0,107806
142330900800000,SE 227,Residential,51492,111528,0,163020
142330900900000,SE 227,Residential,42000,82478,0,124478
142330901000000,SE 227,Residential,42000,81267,0,123267
142330901100000,SE 227,Residential,42000,89982,0,131982
142330901200000,SE 227,Residential,42000,97339,0,139339
142330901300000,SE 227,Residential,42000,110134,0,152134
142330901400000,SE 227,Residential,26910,144187,0,171097
142330901500000,SE 227,Residential,34320,101774,0,136094
142330901600000,SE 227,Residential,24412,128615,0,153027
142330901700000,SE 227,Residential,23400,112211,0,135611
142330901800000,SE 227,Residential,21900,97090,0,118990
142330901900000,SE 227,Residential,48123,139595,0,187718
142332600100000,SE 227,Residential,45547,203538,0,249085
142332600200000,SE 227,Residential,44800,116326,0,161126
142332600300000,SE 227,Residential,40000,113398,0,153398
142332600400000,SE 227,Residential,40000,120195,0,160195
142332600500000,SE 227,Residential,38933,88169,0,127102
142332600600000,SE 227,Residential,41067,137756,0,178823
142332600700000,SE 227,Residential,40000,88773,0,128773
142332600800000,SE 227,Residential,40000,94765,0,134765
142332600900000,SE 227,Residential,40000,105670,0,145670
142332601000000,SE 227,Residential,40000,94241,0,134241
142332601100000,SE 227,Residential,38933,100811,0,139744
142332700100000,SE 227,Residential,41067,92700,0,133767
142332700200000,SE 227,Residential,40000,94497,0,134497
142332700300000,SE 227,Residential,40000,88122,0,128122
142332700400000,SE 227,Residential,40000,111469,0,151469
142332700500000,SE 227,Residential,40000,113676,0,153676
142332700600000,SE 227,Residential,41706,90902,0,132608
142332700700000,SE 227,Residential,43696,124471,0,168167
142332700800000,SE 227,Residential,40386,120253,0,160639
142332700900000,SE 227,Residential,40320,101409,0,141729
142332701000000,SE 227,Residential,39960,82608,0,122568
142332800100000,SE 227,Residential,23363,91846,0,115209
142332800200000,SE 227,Residential,23696,108122,0,131818
142332800300000,SE 227,Residential,23850,86329,0,110179
142332800400000,SE 227,Residential,24181,86187,0,110368
142332800500000,SE 227,Residential,29700,103418,0,133118
142332800600000,SE 227,Residential,29700,99108,0,128808
142332800700000,SE 227,Residential,29700,93102,0,122802
142332800800000,SE 227,Residential,29700,110814,0,140514
142332800900000,SE 227,Residential,29700,111985,0,141685
142332801000000,SE 227,Residential,29700,135659,0,165359
142332801100000,SE 227,Residential,29700,123219,0,152919
142332801200000,SE 227,Residential,37961,123915,0,161876
142332801300000,SE 227,Residential,37920,121440,0,159360
142332801400000,SE 227,Residential,41328,117735,0,159063
142332801500000,SE 227,Residential,41412,109758,0,151170
142332801600000,SE 227,Residential,48000,97476,0,145476
142332801700000,SE 227,Residential,48000,181660,0,229660
142332801800000,SE 227,Residential,48000,128096,0,176096
142332801900000,SE 227,Residential,47520,112339,0,159859
142332802000000,SE 227,Residential,57024,103084,0,160108
142332802100000,SE 227,Residential,47520,91704,0,139224
142332900100000,SE 227,Residential,38400,112586,0,150986
142332900200000,SE 227,Residential,35904,104145,0,140049
142332900300000,SE 227,Residential,42789,118223,0,161012
142333000100000,SE 227,Residential,40000,131156,0,171156
142333000200000,SE 227,Residential,40000,138133,0,178133
142333000300000,SE 227,Residential,40000,60961,0,100961
142333000400000,SE 227,Residential,51000,141465,0,192465
142333000500000,SE 227,Residential,51000,86683,0,137683
142333000600000,SE 227,Residential,40000,128263,0,168263
142333000700000,SE 227,Residential,40000,111687,0,151687
142333000800000,SE 227,Residential,40000,129059,0,169059
142333000900000,SE 227,Residential,40000,100378,0,140378
142333001000000,SE 227,Residential,53824,154026,0,207850
142333001100000,SE 227,Residential,52490,144486,0,196976
142333001200000,SE 227,Residential,40000,63532,0,103532
142333001300000,SE 227,Residential,40000,102640,0,142640
142333001400000,SE 227,Residential,40000,123084,0,163084
142333001500000,SE 227,Residential,40000,118740,0,158740
142333001600000,SE 227,Residential,51000,119599,0,170599
142333001700000,SE 227,Residential,51000,102670,0,153670
142333001800000,SE 227,Residential,40000,138969,0,178969
142333100100000,SE 227,Residential,42325,121557,0,163882
142333100200000,SE 227,Residential,43200,114193,0,157393
142333100300000,SE 227,Residential,42800,109938,0,152738
142333100400000,SE 227,Residential,42400,116759,0,159159
142333100500000,SE 227,Residential,42000,137652,0,179652
142333100600000,SE 227,Residential,41600,116255,0,157855
142333100700000,SE 227,Residential,40800,118445,0,159245
142333100800000,SE 227,Residential,40000,95574,0,135574
142333100900000,SE 227,Residential,40000,118183,0,158183
142333101000000,SE 227,Residential,40000,74153,0,114153
142333101100000,SE 227,Residential,40000,152630,0,192630
142333101200000,SE 227,Residential,41800,122966,0,164766
142333101300000,SE 227,Residential,36000,131849,0,167849
142333101400000,SE 227,Residential,40000,121348,0,161348
142333101500000,SE 227,Residential,40000,114057,0,154057
142333101600000,SE 227,Residential,44856,90522,0,135378
142333101700000,SE 227,Residential,43792,105954,0,149746
142333200100000,SE 227,Residential,44257,105551,0,149808
142333200200000,SE 227,Residential,43650,123037,0,166687
142333200300000,SE 227,Residential,35040,72599,0,107639
142333200400000,SE 227,Residential,35040,134682,0,169722
142333200500000,SE 227,Residential,46059,129108,0,175167
142333200600000,SE 227,Residential,41440,123576,0,165016
142333300100000,SE 227,Residential,35040,112102,0,147142
142333300200000,SE 227,Residential,34560,103185,0,137745
142333300300000,SE 227,Residential,43758,101408,0,145166
142333300400000,SE 227,Residential,42432,88503,0,130935
142333300500000,SE 227,Residential,59910,176575,0,236485
142333400100000,SE 227,Residential,41616,120374,0,161990
142333400200000,SE 227,Residential,49852,128852,0,178704
142333400300000,SE 227,Residential,47759,126894,0,174653
142333400400000,SE 227,Residential,48902,115374,0,164276
142333400500000,SE 227,Residential,49248,108488,0,157736
142333400600000,SE 227,Residential,40000,75448,0,115448
142333400700000,SE 227,Residential,40000,113324,0,153324
142333400800000,SE 227,Residential,42180,140221,0,182401
142333400900000,SE 227,Residential,48672,96628,0,145300
142333401000000,SE 227,Residential,48768,108287,0,157055
142333401100000,SE 227,Residential,49852,92621,0,142473
142333401200000,SE 227,Residential,45387,156185,0,201572
142333401300000,SE 227,Residential,40000,111455,0,151455
142333401400000,SE 227,Residential,40000,141334,0,181334
142333401500000,SE 227,Residential,42400,135005,0,177405
142333500100000,SE 227,Residential,68208,151420,0,219628
142333500200000,SE 227,Residential,64288,135149,0,199437
142333500300000,SE 227,Residential,40000,84017,0,124017
142333500400000,SE 227,Residential,40000,84079,0,124079
142333500500000,SE 227,Residential,40000,80614,0,120614
142333500600000,SE 227,Residential,40000,81950,0,121950
142333500700000,SE 227,Residential,40000,111162,0,151162
142333500800000,SE 227,Residential,40000,106451,0,146451
142333500900000,SE 227,Residential,42667,138112,0,180779
142333501000000,SE 227,Residential,43680,30852,0,74532
142333501100000,SE 227,Residential,40000,82429,0,122429
142333501200000,SE 227,Residential,40000,111425,0,151425
142333501300000,SE 227,Residential,40000,101009,0,141009
142333600100000,SE 227,Residential,138562,196682,0,335244
142333600200000,SE 227,Residential,76199,200159,0,276358
142333600300000,SE 227,Residential,94378,306777,0,401155
142333600400000,SE 227,Residential,91728,352498,0,444226
142335100100000,SE 243,Residential,80401,151735,0,232136
142335100200000,SE 243,Residential,85440,132702,0,218142
142335100300000,SE 243,Residential,72320,78869,0,151189
142335100400000,SE 243,Residential,72320,173993,0,246313
142335100500000,SE 243,Residential,114000,214506,0,328506
142335100600000,SE 243,Residential,140000,216306,0,356306
142335100700000,SE 243,Residential,84240,237140,0,321380
142335100800000,SE 243,Residential,76524,197983,0,274507
142335100900000,SE 243,Residential,78874,178822,0,257696
142335101000000,SE 243,Residential,75802,343570,0,419372
142335101100000,SE 243,Residential,84634,218942,0,303576
142335101200000,SE 243,Residential,96736,233033,0,329769
142335101300000,SE 243,Residential,91228,257921,0,349149
142335101400000,SE 247,Residential,175000,290245,0,465245
142335101500000,SE 247,Residential,68160,179768,0,247928
142335101600000,SE 247,Residential,69227,192435,0,261662
142335101700000,SE 247,Residential,75816,349504,0,425320
142335101800000,SE 247,Residential,76973,229053,0,306026
142335101900000,SE 243,Residential,109388,208573,0,317961
142335102000000,SE 243,Residential,93643,134793,0,228436
142335102100000,SE 243,Residential,93643,236357,0,330000
142335102200000,SE 243,Residential,82730,163061,0,245791
142335200100000,SE 247,Residential,72520,145486,0,218006
142335200200000,SE 247,Residential,91123,324031,0,415154
142335200300000,SE 247,Residential,87024,210286,0,297310
142335200400000,SE 247,Residential,92651,140085,0,232736
142335200500000,SE 247,Residential,109670,286955,0,396625
142335200600000,SE 247,Residential,92288,244346,0,336634
142335200700000,SE 247,Residential,92220,270974,0,363194
142335300100000,SE 247,Residential,79283,170929,0,250212
142335300200000,SE 247,Residential,79283,198466,0,277749
142335300300000,SE 247,Residential,65508,167739,0,233247
142335300400000,SE 247,Residential,135275,246372,0,381647
142335300500000,SE 247,Residential,95304,191759,0,287063
142335300600000,SE 247,Residential,93462,253066,0,346528
142335300700000,SE 247,Residential,82800,156511,0,239311
142335300800000,SE 247,Residential,76032,126601,0,202633
142335300900000,SE 247,Residential,66427,103488,0,169915
142335301000000,SE 235,Residential,48000,77968,0,125968
142335301100000,SE 235,Residential,22838,76318,0,99156
142335301200000,SE 235,Residential,40880,60736,0,101616
142335301300000,SE 247,Residential,95010,142256,0,237266
142335301400000,SE 247,Residential,82400,149897,0,232297
142335301500000,SE 247,Residential,83888,138262,0,222150
142335301600000,SE 247,Residential,77611,105808,0,183419
142335301700000,SE 247,Residential,70400,132598,0,202998
142335400100000,SE 235,Residential,22120,62471,0,84591
142335400200000,SE 247,Residential,92209,132533,0,224742
142335400300000,SE 247,Residential,90150,207148,0,297298
142335400400000,SE 247,Residential,89496,205254,0,294750
142335400500000,SE 247,Residential,87433,172278,0,259711
142335400600000,SE 247,Residential,94502,208407,0,302909
142335400700000,SE 247,Residential,94195,330394,0,424589
142335400800000,SE 247,Residential,98374,180343,0,278717
142335400900000,SE 247,Residential,87200,235497,0,322697
142335401000000,SE 247,Residential,97014,148819,0,245833
142335401100000,SE 247,Residential,97888,138391,0,236279
142335401200000,SE 235,Residential,36960,101169,0,138129
142335401300000,SE 235,Residential,44160,84653,0,128813
142335401400000,SE 235,Residential,21000,83857,0,104857
142335401500000,SE 235,Residential,21000,90866,0,111866
142335401600000,SE 235,Residential,21000,72277,0,93277
142335401700000,SE 235,Residential,21000,69004,0,90004
142335401800000,SE 235,Residential,21000,65159,0,86159
142335401900000,SE 235,Residential,22050,99103,0,121153
142335500100000,SE 247,Residential,72420,131331,0,203751
142335500200000,SE 247,Residential,50483,121731,0,172214
142335600100000,SE 235,Residential,54400,95795,0,150195
142335600200000,SE 235,Residential,41547,111513,0,153060
142335600300000,SE 247,Residential,69552,137653,0,207205
142335600400000,SE 247,Residential,71400,143168,0,214568
142335600500000,SE 247,Residential,75264,170115,0,245379
142335600600000,SE 247,Residential,63075,160147,0,223222
142335600700000,SE 247,Residential,62560,158849,0,221409
142335600800000,SE 235,Residential,17500,81000,0,98500
142335600900000,SE 235,Residential,17500,75831,0,93331
142335601000000,SE 235,Residential,17500,89596,0,107096
142335601100000,SE 235,Residential,17500,109088,0,126588
142335601200000,SE 235,Residential,17500,71394,0,88894
142337600100000,SE 224,Residential,38850,63107,0,101957
142337600200000,SE 224,Residential,27721,106491,0,134212
142337600300000,SE 224,Residential,27034,74573,0,101607
142337600400000,SE 224,Residential,28636,105241,0,133877
142337600500000,SE 224,Residential,26422,98201,0,124623
142337600600000,SE 224,Residential,26833,99235,0,126068
142337600700000,SE 224,Residential,28436,82141,0,110577
142337600800000,SE 224,Residential,33300,130388,0,163688
142337600900000,SE 224,Residential,38850,110615,0,149465
142337601000000,SE 224,Residential,33966,81311,0,115277
142337601100000,SE 224,Residential,33966,77924,0,111890
142337700100000,SE 224,Residential,32310,85446,0,117756
142337700200000,SE 224,Residential,28305,77988,0,106293
142337700300000,SE 224,Residential,28305,76288,0,104593
142337700400000,SE 224,Residential,28305,69543,0,97848
142337700500000,SE 224,Residential,28305,100651,0,128956
142337700600000,SE 224,Residential,26700,62244,0,88944
142337700700000,SE 224,Residential,26700,90777,0,117477
142337700800000,SE 224,Residential,27145,74941,0,102086
142337700900000,SE 224,Residential,27540,71443,0,98983
142337701000000,SE 224,Residential,27540,74461,0,102001
142337701100000,SE 224,Residential,28593,95370,0,123963
142337701200000,SE 224,Residential,28435,74821,0,103256
142337701300000,SE 224,Residential,27034,116552,0,143586
142337701400000,SE 224,Residential,28148,92231,0,120379
142337800100000,Empty,Exempt,0,0,0,0
142337800200000,SE 227,Residential,55440,111268,0,166708
142337800300000,SE 227,Residential,26250,108053,0,134303
142337800400000,SE 227,Residential,26250,88172,0,114422
142337800500000,SE 227,Residential,26250,112538,0,138788
142337800600000,SE 227,Residential,26250,114952,0,141202
142337800700000,SE 227,Residential,26250,125088,0,151338
142337800800000,SE 227,Residential,26250,85948,0,112198
142337800900000,SE 227,Residential,26250,131645,0,157895
142337801000000,SE 227,Residential,26250,98805,0,125055
142337801100000,SE 227,Residential,26250,94185,0,120435
142337801200000,SE 227,Residential,23100,100349,0,123449
142337801300000,SE 227,Residential,26250,83830,0,110080
142337801400000,SE 227,Residential,26250,87022,0,113272
142337801500000,SE 227,Residential,26250,105956,0,132206
142337801600000,SE 227,Residential,26250,111674,0,137924
142337801700000,SE 227,Residential,26250,95094,0,121344
142337801800000,SE 227,Residential,26250,71750,0,98000
142337801900000,SE 227,Residential,26250,83876,0,110126
142337802000000,SE 227,Residential,26250,91570,0,117820
142337802100000,SE 227,Residential,26250,98858,0,125108
142337802200000,SE 227,Residential,26250,64438,0,90688
142337802300000,SE 227,Residential,26250,101589,0,127839
142337802400000,SE 227,Residential,26250,78105,0,104355
142337802500000,SE 227,Residential,26250,83515,0,109765
142337802600000,SE 227,Residential,25724,17382,0,43106
142337802700000,E-15 CITY,Exempt,0,0,0,0
142337802800000,SE 224,Residential,17374,63126,0,80500
142337802900000,SE 224,Residential,26513,73161,0,99674
142337803000000,SE 224,Residential,26505,78121,0,104626
142337803100000,SE 224,Residential,27000,95447,0,122447
142337803200000,SE 224,Residential,27360,93388,0,120748
142337803300000,SE 224,Residential,26100,95998,0,122098
142337803400000,SE 224,Residential,25375,78762,0,104137
142337900100000,SE 224,Residential,31080,72203,0,103283
142337900200000,SE 224,Residential,26939,93819,0,120758
142337900300000,SE 224,Residential,26700,88390,0,115090
142337900400000,SE 224,Residential,26700,108273,0,134973
142337900500000,SE 224,Residential,26700,83781,0,110481
142337900600000,SE 224,Residential,27268,103651,0,130919
142337900700000,SE 224,Residential,27268,94827,0,122095
142337900800000,SE 224,Residential,26700,102600,0,129300
142337900900000,SE 224,Residential,29053,123098,0,152151
142337901000000,SE 224,Residential,28533,79692,0,108225
142337901100000,SE 224,Residential,34565,117008,0,151573
142337901200000,SE 224,Residential,33389,109030,0,142419
142337901300000,SE 224,Residential,28533,86039,0,114572
142337901400000,SE 224,Residential,30963,101268,0,132231
142337901500000,SE 224,Residential,26700,76911,0,103611
142337901600000,SE 224,Residential,27268,83657,0,110925
142337901700000,SE 224,Residential,27268,106383,0,133651
142337901800000,SE 224,Residential,26700,82701,0,109401
142337901900000,SE 224,Residential,26700,82497,0,109197
142337902000000,SE 224,Residential,26633,79338,0,105971
142337902100000,SE 224,Residential,27753,98017,0,125770
142337902200000,SE 224,Residential,27553,87745,0,115298
142337902300000,SE 224,Residential,27622,96381,0,124003
142337902400000,SE 224,Residential,26700,108703,0,135403
142337902500000,SE 224,Residential,26255,89264,0,115519
142337902600000,SE 224,Residential,26550,98360,0,124910
142337902700000,SE 224,Residential,26550,60842,0,87392
142337902800000,SE 224,Residential,26550,87659,0,114209
142337902900000,SE 224,Residential,26550,67976,0,94526
142337903000000,SE 224,Residential,26550,107364,0,133914
142337903100000,SE 224,Residential,26550,82831,0,109381
142337903200000,SE 224,Residential,26550,98260,0,124810
142337903300000,SE 224,Residential,26550,75580,0,102130
142337903400000,SE 224,Residential,26550,125395,0,151945
142337903500000,SE 224,Residential,27000,103399,0,130399
142337903600000,SE 224,Residential,17437,80773,0,98210
142337903700000,SE 224,Residential,17424,91743,0,109167
142337903800000,SE 224,Residential,25299,67919,0,93218
142337903900000,SE 224,Residential,25235,89249,0,114484
142337904000000,SE 224,Residential,19600,70198,0,89798
142337904100000,SE 224,Residential,16100,85137,0,101237
142337904200000,SE 224,Residential,31185,96627,0,127812
142337904300000,SE 224,Residential,21475,88545,0,110020
142337904400000,SE 224,Residential,18568,55949,0,74517
142337904500000,SE 224,Residential,27750,55973,0,83723
142337904600000,SE 224,Residential,27750,65042,0,92792
142337904700000,SE 224,Residential,27195,56617,0,83812
142337904800000,SE 224,Residential,27750,117111,0,144861
142337904900000,SE 224,Residential,33300,89316,0,122616
142337905000000,SE 224,Residential,33000,84134,0,117134
142337905100000,SE 224,Residential,23773,63273,0,87046
142337905200000,SE 224,Residential,26363,90855,0,117218
142337905300000,SE 224,Residential,25530,77383,0,102913
142337905400000,SE 224,Residential,21021,0,0,21021
142337905500000,SE 224,Residential,19000,75331,0,94331
142337905600000,SE 224,Residential,31080,97533,0,128613
142337905700000,SE 224,Residential,31080,63810,0,94890
142337905800000,SE 224,Residential,31080,103991,0,135071
142338000100000,SE 224,Residential,24990,58520,0,83510
142338000200000,SE 224,Residential,25092,77988,0,103080
142338000300000,SE 224,Residential,25266,80235,0,105501
142338000400000,SE 224,Residential,24743,85316,0,110059
142338000500000,SE 224,Residential,25583,66253,0,91836
142338000600000,SE 224,Residential,16450,76149,0,92599
142338000700000,SE 224,Residential,22751,96687,0,119438
142338000800000,SE 224,Residential,18725,62367,0,81092
142338000900000,SE 224,Residential,18725,81264,0,99989
142338001000000,SE 224,Residential,24500,73739,0,98239
142338001100000,SE 224,Residential,24990,65295,0,90285
142338001200000,SE 224,Residential,25480,75927,0,101407
142338001300000,SE 224,Residential,24500,68655,0,93155
142340100100000,SE 210,Residential,7560,0,0,7560
142340100200000,SE 210,Residential,54300,461396,0,515696
142340100300000,SE 210,Residential,1290,0,0,1290
142340100400000,SE 210,Residential,1035,0,0,1035
142340100500000,SE 210,Residential,39640,116150,0,155790
142340100600000,SE 210,Residential,27738,154800,0,182538
142340100700000,SE 210,Residential,28444,112024,0,140468
142340100800000,SE 210,Residential,35087,162763,0,197850
142340100900000,SE 210,Residential,35425,121597,0,157022
142340101000000,SE 210,Residential,38362,213959,0,252321
142340101100000,SE 210,Residential,29044,174662,0,203706
142340101200000,SE 210,Residential,26750,131733,0,158483
142340101300000,SE 210,Residential,24304,112272,0,136576
142340101400000,SE 224,Residential,31268,128732,0,160000
142340101500000,SE 210,Residential,42049,137060,0,179109
142340101600000,SE 210,Residential,28609,129895,0,158504
142340101700000,SE 210,Residential,31040,0,0,31040
142340101800000,SE 210,Exempt,33950,0,129359,163309
142340101900000,SE 210,Residential,28420,111109,0,139529
142340102000000,SE 210,Residential,30400,154117,0,184517
142340102100000,SE 210,Residential,31416,128454,0,159870
142340102200000,SE 210,Residential,29376,111851,0,141227
142340102300000,SE 210,Residential,29029,157397,0,186426
142340102400000,SE 210,Residential,25398,117726,0,143124
142340200100000,SE 224,Residential,29460,109658,0,139118
142340200200000,SE 224,Residential,29452,92312,0,121764
142340200300000,SE 224,Residential,34009,93326,0,127335
142340200400000,SE 224,Residential,35363,111776,0,147139
142340200500000,SE 224,Residential,28200,85851,0,114051
142340200600000,SE 224,Residential,28200,93771,0,121971
142340200700000,SE 224,Residential,29022,94229,0,123251
142340200800000,SE 224,Residential,31587,136181,0,167768
142340200900000,SE 224,Residential,32062,93139,0,125201
142340300100000,SE 224,Residential,28458,114586,0,143044
142340300200000,SE 224,Residential,38663,92991,0,131654
142340300300000,SE 224,Residential,24847,113858,0,138705
142340300400000,SE 224,Residential,32831,105311,0,138142
142340300500000,SE 224,Residential,32831,110681,0,143512
142340400100000,SE 210,Residential,28458,129625,0,158083
142340400200000,SE 210,Residential,31512,177950,0,209462
142340400300000,SE 210,Residential,29892,121531,0,151423
142340400400000,SE 210,Residential,22873,110580,0,133453
142340400500000,SE 210,Residential,21150,101095,0,122245
142340400600000,SE 210,Residential,21840,143794,0,165634
142340400700000,SE 210,Residential,21312,116046,0,137358
142340400800000,SE 210,Residential,21150,112699,0,133849
142340400900000,SE 210,Residential,18960,101788,0,120748
142340401000000,SE 210,Residential,26901,125033,0,151934
142340401100000,SE 224,Residential,26560,102074,0,128634
142340401200000,SE 224,Residential,30600,89527,0,120127
142340401300000,SE 224,Residential,31185,129733,0,160918
142340401400000,SE 224,Residential,29808,100685,0,130493
142340401500000,SE 224,Residential,30576,98221,0,128797
142340401600000,SE 224,Residential,26987,130528,0,157515
142340401700000,SE 224,Residential,25200,91647,0,116847
142340401800000,SE 224,Residential,25200,87272,0,112472
142340401900000,SE 224,Residential,31196,122651,0,153847
142340402000000,SE 224,Residential,30080,100657,0,130737
142340402100000,SE 224,Residential,34000,107188,0,141188
142340402200000,SE 224,Residential,34000,109631,0,143631
142340402300000,SE 224,Residential,31512,98179,0,129691
142340500100000,SE 224,Residential,29782,105875,0,135657
142340500200000,SE 224,Residential,29469,80856,0,110325
142340500300000,SE 224,Residential,29469,70395,0,99864
142340500400000,SE 224,Residential,29469,91853,0,121322
142340500500000,SE 224,Residential,29469,97754,0,127223
142340500600000,SE 224,Residential,29469,79253,0,108722
142340500700000,SE 224,Residential,29782,84378,0,114160
142340500800000,SE 224,Residential,29782,88759,0,118541
142340500900000,SE 224,Residential,29782,95876,0,125658
142340501000000,SE 224,Residential,29782,105861,0,135643
142340600100000,SE 224,Residential,32290,104176,0,136466
142340600200000,SE 224,Residential,32290,73131,0,105421
142340600300000,SE 224,Residential,32290,85066,0,117356
142340600400000,SE 224,Residential,32290,116042,0,148332
142340600500000,SE 224,Residential,32290,86961,0,119251
142340700100000,SE 224,Residential,26752,114622,0,141374
142340700200000,SE 224,Residential,23936,80985,0,104921
142340700300000,SE 224,Residential,24218,81662,0,105880
142340700400000,SE 224,Residential,25740,79881,0,105621
142340700500000,SE 224,Residential,29100,98743,0,127843
142340700600000,SE 224,Residential,23520,83028,0,106548
142340800100000,SE 224,Residential,29991,138668,0,168659
142340800200000,SE 224,Residential,25200,84460,0,109660
142340800300000,SE 224,Residential,24600,96545,0,121145
142340800400000,SE 224,Residential,29999,112313,0,142312
142340800500000,SE 224,Residential,28583,81970,0,110553
142340800600000,SE 224,Residential,29400,77459,0,106859
142340800700000,SE 224,Residential,29400,85087,0,114487
142340800800000,SE 224,Residential,29400,82579,0,111979
142340800900000,SE 224,Residential,27900,77751,0,105651
142340801000000,SE 224,Residential,30750,83483,0,114233
142340801100000,SE 224,Residential,28350,91180,0,119530
142340900100000,SE 224,Residential,28500,115848,0,144348
142340900200000,SE 224,Residential,29331,114322,0,143653
142340900300000,SE 224,Residential,30720,115438,0,146158
142340900400000,SE 224,Residential,31040,104077,0,135117
142340900500000,SE 224,Residential,29949,131098,0,161047
142340900600000,SE 224,Residential,29988,106460,0,136448
142340900700000,SE 224,Residential,29700,73977,0,103677
142340900800000,SE 224,Residential,30856,109733,0,140589
142340900900000,SE 224,Residential,29925,81433,0,111358
142340901000000,SE 224,Residential,30887,96077,0,126964
142340901100000,SE 224,Residential,29925,84595,0,114520
142340901200000,SE 224,Residential,30400,88615,0,119015
142340901300000,SE 224,Residential,28500,96151,0,124651
142340901400000,SE 224,Residential,28500,75407,0,103907
142341000100000,SE 224,Residential,29589,104690,0,134279
142341000200000,SE 224,Residential,30600,90608,0,121208
142341000300000,SE 224,Residential,32946,92054,0,125000
142341000400000,SE 224,Residential,32320,84087,0,116407
142341000500000,SE 224,Residential,31500,112092,0,143592
142341000600000,SE 224,Residential,31500,121304,0,152804
142341000700000,SE 224,Residential,30891,97819,0,128710
142341100100000,SE 224,Residential,29073,66459,0,95532
142341100200000,SE 224,Residential,28800,80758,0,109558
142341100300000,SE 224,Residential,28800,69099,0,97899
142341100400000,SE 224,Residential,29440,70535,0,99975
142341100500000,SE 224,Residential,29440,67911,0,97351
142341100600000,SE 224,Residential,30053,81409,0,111462
142341100700000,SE 224,Residential,28520,121634,0,150154
142342600100000,SE 224,Residential,28432,67721,0,96153
142342600200000,SE 224,Residential,19892,48680,0,68572
142342600300000,SE 224,Residential,17600,35195,0,52795
142342600400000,SE 224,Residential,20000,51666,0,71666
142342600500000,SE 224,Residential,20000,34709,0,54709
142342600600000,SE 224,Residential,20000,30850,0,50850
142342600800000,SE 224,Exempt,16000,0,60695,76695
142342600900000,SE 224,Exempt,16534,0,78541,95075
142342700100000,SE 224,Residential,33429,90041,0,123470
142342700200000,SE 224,Residential,31680,82702,0,114382
142342700300000,SE 224,Residential,26928,71199,0,98127
142342700400000,SE 224,Residential,37975,86427,0,124402
142342700500000,SE 224,Residential,33660,63225,0,96885
142342700600000,SE 224,Residential,30000,72440,0,102440
142342700700000,SE 224,Residential,30000,86212,0,116212
142342700800000,SE 224,Residential,43680,98615,0,142295
142342700900000,SE 224,Residential,31200,65184,0,96384
142342701000000,SE 224,Residential,30600,74400,0,105000
142342701100000,SE 224,Residential,30600,68639,0,99239
142342701200000,SE 224,Residential,30600,79275,0,109875
142342701300000,SE 224,Residential,36000,77722,0,113722
142342701400000,SE 224,Residential,30000,97846,0,127846
142342701500000,SE 224,Residential,30000,75000,0,105000
142342701600000,SE 224,Residential,36000,63244,0,99244
142342701700000,SE 224,Residential,36000,71969,0,107969
142342701800000,COMM SE,Commercial,45360,0,315701,361061
142342702000000,SE 224,Residential,15750,0,0,15750
142342702100000,SE 224,Residential,22275,26743,0,49018
142342702200000,SE 224,Residential,24750,71936,0,96686
142342702300000,SE 224,Residential,22275,97696,0,119971
142342702400000,SE 224,Residential,23000,67404,0,90404
142342702500000,SE 224,Residential,30000,65237,0,95237
142342702600000,SE 224,Residential,25000,69911,0,94911
142342702700000,SE 224,Residential,25000,81937,0,106937
142342702800000,SE 224,Residential,30000,87124,0,117124
142342702900000,SE 224,Residential,25500,88035,0,113535
142342703000000,SE 224,Residential,25500,65470,0,90970
142342703100000,SE 224,Residential,25500,99009,0,124509
142342703200000,SE 224,Residential,29000,85451,0,114451
142342703300000,SE 224,Residential,35000,92361,0,127361
142342703400000,SE 224,Residential,26000,49878,0,75878
142342703500000,SE 224,Residential,26000,61560,0,87560
142342703600000,SE 224,Residential,28050,58476,0,86526
142342703700000,SE 224,Residential,29835,96475,0,126310
142342703800000,SE 224,Residential,29835,51166,0,81001
142342703900000,SE 224,Residential,21333,83920,0,105253
142342704000000,SE 224,Residential,20000,103218,0,123218
142342704100000,SE 224,Residential,32000,78184,0,110184
142342704200000,SE 224,Residential,20000,49746,0,69746
142342800100000,SE 224,Residential,33466,44226,0,77692
142342800200000,SE 224,Residential,32000,118914,0,150914
142342800300000,SE 224,Residential,20000,42254,0,62254
142342800400000,SE 224,Residential,20000,69948,0,89948
142342800500000,SE 224,Residential,20000,42133,0,62133
142342800600000,SE 224,Residential,23167,69112,0,92279
142342900100000,SE 224,Residential,21167,75259,0,96426
142342900200000,SE 224,Residential,34069,66883,0,100952
142342900300000,SE 224,Residential,28250,83595,0,111845
142342900400000,SE 224,Residential,31075,89808,0,120883
142342900500000,SE 224,Residential,28000,53145,0,81145
142342900600000,SE 224,Residential,28000,89636,0,117636
142342900700000,SE 224,Residential,40600,132369,0,172969
142342900800000,SE 224,Residential,25000,101262,0,126262
142342900900000,SE 224,Residential,29000,78028,0,107028
142342901000000,SE 224,Residential,29000,102647,0,131647
142342901100000,SE 224,Residential,29000,66016,0,95016
142342901200000,SE 224,Residential,33900,63595,0,97495
142342901300000,SE 224,Residential,25000,100515,0,125515
142342901400000,SE 224,Residential,25000,91809,0,116809
142342901500000,SE 224,Residential,30000,60925,0,90925
142342901600000,SE 224,Residential,30000,62510,0,92510
142342901700000,SE 224,Residential,23750,102227,0,125977
142342901800000,SE 224,Residential,21375,124580,0,145955
142342901900000,SE 224,Residential,21375,79458,0,100833
142342902000000,SE 224,Residential,37088,100253,0,137341
142342902100000,SE 224,Residential,33744,116256,0,150000
142342902200000,SE 224,Residential,34271,121347,0,155618
142342902300000,SE 224,Residential,27750,117235,0,144985
142342902400000,SE 224,Residential,30250,133603,0,163853
142342902500000,SE 224,Residential,40438,84238,0,124676
142342902600000,SE 224,Residential,24720,119066,0,143786
142342902700000,SE 224,Residential,24720,136335,0,161055
142342902800000,SE 224,Residential,24720,126919,0,151639
142342902900000,SE 224,Residential,24651,122223,0,146874
142342903000000,SE 224,Residential,23105,155177,0,178282
142342903100000,SE 224,Residential,27300,157801,0,185101
142342903200000,SE 224,Residential,29748,153001,0,182749
142342903300000,SE 224,Residential,32408,151444,0,183852
142342903400000,SE 224,Residential,23806,148278,0,172084
142342903500000,SE 224,Residential,21120,106715,0,127835
142342903600000,SE 224,Residential,21120,101840,0,122960
142342903700000,SE 224,Residential,22016,123189,0,145205
142342903800000,SE 224,Residential,24738,114461,0,139199
142342903900000,SE 224,Residential,24010,125879,0,149889
142342904000000,SE 224,Residential,20401,108728,0,129129
142342904100000,SE 224,Residential,21056,116429,0,137485
142342904200000,SE 224,Residential,21060,124676,0,145736
142342904300000,SE 224,Residential,21060,98872,0,119932
142342904400000,SE 224,Residential,22477,143016,0,165493
142342904500000,SE 224,Residential,34247,124137,0,158384
142342904600000,SE 224,Residential,26807,82861,0,109668
142342904700000,SE 224,Residential,24960,79814,0,104774
142342904800000,SE 224,Residential,25460,85005,0,110465
142342904900000,SE 223,Residential,25970,83970,0,109940
142342905000000,SE 223,Residential,28090,79102,0,107192
142342905100000,SE 223,Residential,28090,88116,0,116206
142342905200000,SE 223,Residential,28090,87981,0,116071
142342905300000,SE 223,Residential,28090,72774,0,100864
142342905400000,SE 223,Residential,28090,64619,0,92709
142342905500000,SE 223,Residential,27825,67617,0,95442
142342905600000,SE 223,Residential,27825,84067,0,111892
142342905700000,SE 223,Residential,28665,56347,0,85012
142342905800000,SE 223,Residential,29250,73985,0,103235
142342905900000,SE 223,Residential,29250,69078,0,98328
142342906000000,SE 223,Residential,24250,82599,0,106849
142342906100000,SE 223,Residential,29250,65740,0,94990
142342906200000,SE 223,Residential,26550,78861,0,105411
142342906300000,SE 223,Residential,26550,74280,0,100830
142342906400000,SE 223,Residential,25370,72808,0,98178
142342906500000,SE 223,Residential,23010,90368,0,113378
142342906600000,SE 224,Residential,23197,101855,0,125052
142342906700000,SE 224,Residential,36000,80946,0,116946
142342906800000,SE 224,Residential,20000,63073,0,83073
142342906900000,SE 224,Residential,33150,113121,0,146271
142342907000000,SE 224,Residential,21000,83548,0,104548
142342907100000,SE 224,Residential,20000,65555,0,85555
142342907200000,SE 224,Residential,20000,63997,0,83997
142342907300000,SE 224,Residential,20000,78534,0,98534
142342907400000,SE 224,Residential,21167,77523,0,98690
142342907500000,SE 224,Residential,28186,107238,0,135424
142342907600000,SE 224,Residential,28186,102422,0,130608
142342907700000,SE 224,Residential,19780,93471,0,113251
142342907800000,SE 224,Residential,23000,119600,0,142600
142342907900000,SE 224,Residential,24800,96287,0,121087
142342908000000,COMM SE,Commercial,39528,0,298110,337638
142342908100000,SE 224,Residential,21840,66063,0,87903
142342908200000,SE 224,Residential,19200,68808,0,88008
142342908300000,SE 224,Residential,19200,74192,0,93392
142342908400000,SE 224,Residential,20894,112791,0,133685
142342908500000,SE 224,Residential,20857,109320,0,130177
142342908600000,SE 224,Residential,20857,109890,0,130747
142342908700000,SE 224,Residential,23833,62124,0,85957
142342908800000,SE 224,Residential,25000,61487,0,86487
142342908900000,SE 224,Residential,30000,91787,0,121787
142342909000000,SE 224,Residential,25000,95555,0,120555
142342909100000,SE 224,Residential,32000,81164,0,113164
142343000100000,SE 224,Residential,21833,62225,0,84058
142343000200000,SE 224,Residential,32000,88161,0,120161
142343000300000,SE 224,Residential,20000,64624,0,84624
142343000400000,SE 224,Residential,20000,63866,0,83866
142343000500000,SE 224,Residential,20000,73090,0,93090
142343000600000,SE 224,Residential,20000,64391,0,84391
142343000700000,SE 224,Residential,20000,75764,0,95764
142343000800000,SE 224,Residential,20000,65460,0,85460
142343000900000,SE 224,Residential,32000,84128,0,116128
142343001000000,SE 224,Residential,22403,91005,0,113408
142345100100000,SE 223,Residential,23375,0,0,23375
142345100200000,SE 223,Residential,34680,110699,0,145379
142345100300000,SE 223,Residential,24072,74190,0,98262
142345100400000,SE 223,Residential,24745,76138,0,100883
142345100500000,SE 223,Residential,25250,91660,0,116910
142345100600000,SE 223,Residential,26462,79063,0,105525
142345100700000,SE 223,Residential,25385,95052,0,120437
142345100800000,SE 223,Residential,23735,73680,0,97415
142345100900000,SE 223,Residential,30300,89974,0,120274
142345101000000,SE 223,Residential,30300,73585,0,103885
142345101100000,SE 223,Residential,30855,97369,0,128224
142345200100000,SE 223,Residential,22865,110128,0,132993
142345200200000,SE 223,Residential,22185,70734,0,92919
142345200300000,SE 223,Residential,23035,65274,0,88309
142345200400000,SE 223,Residential,23338,75608,0,98946
142345200500000,SE 223,Residential,22145,81947,0,104092
142345200600000,SE 223,Residential,22660,79357,0,102017
142345200700000,SE 223,Residential,22145,62557,0,84702
142345200800000,SE 223,Residential,22660,77541,0,100201
142345200900000,SE 223,Residential,28677,93067,0,121744
142345201000000,SE 223,Residential,23347,68137,0,91484
142345201100000,SE 223,Residential,22145,82759,0,104904
142345201200000,SE 223,Residential,22660,39380,0,62040
142345201300000,SE 223,Residential,29123,83806,0,112929
142345201400000,SE 223,Residential,22145,62936,0,85081
142345201500000,SE 223,Residential,21937,46097,0,68034
142345201600000,SE 223,Residential,23685,91646,0,115331
142345201700000,SE 223,Residential,30636,96144,0,126780
142345300100000,SE 223,Residential,26500,106401,0,132901
142345300200000,SE 223,Residential,31005,94462,0,125467
142345300300000,SE 223,Residential,35535,90900,0,126435
142345300400000,SE 223,Residential,25056,85699,0,110755
142345300500000,SE 223,Residential,24784,77261,0,102045
142345300600000,SE 223,Residential,24250,87756,0,112006
142345300700000,SE 223,Residential,24250,82932,0,107182
142345300800000,SE 223,Residential,24735,64735,0,89470
142345300900000,SE 223,Residential,24250,127297,0,151547
142345301000000,SE 223,Residential,24250,88211,0,112461
142345301100000,SE 223,Residential,24250,88557,0,112807
142345301200000,SE 223,Residential,24250,77105,0,101355
142345301300000,SE 223,Residential,25000,95107,0,120107
142345301400000,SE 223,Residential,24921,102732,0,127653
142345301500000,SE 223,Residential,26070,69839,0,95909
142345301600000,SE 223,Residential,25750,85710,0,111460
142345301700000,SE 223,Residential,27300,102924,0,130224
142345301800000,SE 223,Residential,27300,78593,0,105893
142345301900000,SE 223,Residential,26250,92653,0,118903
142345302000000,SE 223,Residential,26250,94286,0,120536
142345302100000,SE 223,Residential,25257,96468,0,121725
142345302200000,SE 223,Residential,26314,81097,0,107411
142345302300000,SE 223,Residential,33000,135229,0,168229
142345302400000,SE 223,Residential,28840,127212,0,156052
142345302500000,SE 224,Residential,40930,134845,0,175775
142345302600000,SE 224,Residential,35280,75958,0,111238
142345302700000,SE 224,Residential,33129,126409,0,159538
142345302800000,SE 224,Residential,36720,86860,0,123580
142345302900000,SE 224,Residential,31620,81158,0,112778
142345303000000,SE 224,Residential,30600,68735,0,99335
142345303100000,SE 224,Residential,30600,88629,0,119229
142345303200000,SE 224,Residential,31289,78533,0,109822
142345303300000,SE 224,Residential,29610,60489,0,90099
142345303400000,SE 224,Residential,28964,66740,0,95704
142345303500000,SE 223,Residential,25500,84396,0,109896
142345303600000,SE 223,Residential,25500,81772,0,107272
142345303700000,SE 223,Residential,25500,48167,0,73667
142345303800000,SE 223,Residential,25500,87087,0,112587
142345303900000,SE 223,Residential,25500,58322,0,83822
142345304000000,SE 223,Residential,25500,83336,0,108836
142345304100000,SE 223,Residential,25500,86500,0,112000
142345304200000,SE 223,Residential,25500,62756,0,88256
142345304300000,SE 223,Residential,25500,63466,0,88966
142345304400000,SE 223,Residential,25500,94350,0,119850
142345304500000,SE 223,Residential,31319,94638,0,125957
142345304600000,SE 223,Residential,20400,71947,0,92347
142345304700000,SE 223,Residential,20400,80705,0,101105
142345304800000,SE 223,Residential,30600,95906,0,126506
142345304900000,SE 223,Residential,30600,54354,0,84954
142345305000000,SE 223,Residential,20400,80747,0,101147
142345305100000,SE 223,Residential,30600,70297,0,100897
142345305200000,SE 223,Residential,32130,86498,0,118628
142345305300000,SE 223,Residential,25500,63164,0,88664
142345400100000,SE 223,Residential,24964,40031,0,64995
142345400200000,SE 223,Residential,23287,90512,0,113799
142345400300000,SE 223,Residential,22145,72319,0,94464
142345400400000,SE 223,Residential,22660,73984,0,96644
142345400500000,SE 223,Residential,22145,77700,0,99845
142345400600000,SE 223,Residential,22660,52994,0,75654
142345400700000,SE 223,Residential,22145,56449,0,78594
142345400800000,SE 223,Residential,21973,83608,0,105581
142345400900000,SE 223,Residential,23347,84131,0,107478
142345401000000,SE 223,Residential,22145,76740,0,98885
142345401100000,SE 223,Residential,23896,81246,0,105142
142345401200000,SE 223,Residential,23896,91887,0,115783
142345401300000,SE 223,Residential,23896,82018,0,105914
142345401400000,SE 223,Residential,21879,65549,0,87428
142345401500000,SE 223,Residential,23685,63528,0,87213
142345401600000,SE 223,Residential,22725,68902,0,91627
142345401700000,SE 223,Residential,22725,63463,0,86188
142345401800000,SE 223,Residential,22725,75760,0,98485
142345401900000,SE 223,Residential,22725,57696,0,80421
142345500100000,SE 223,Residential,27089,54028,0,81117
142345500200000,SE 223,Residential,28265,90377,0,118642
142345500300000,SE 223,Residential,24745,54642,0,79387
142345500400000,SE 223,Residential,24745,58290,0,83035
142345500500000,SE 223,Residential,24745,53067,0,77812
142345500600000,SE 223,Residential,24745,95269,0,120014
142345500700000,SE 223,Residential,24745,66850,0,91595
142345500800000,SE 223,Residential,24745,65969,0,90714
142345500900000,SE 223,Residential,24745,53559,0,78304
142345501000000,SE 223,Residential,24745,68420,0,93165
142345501100000,COMM SE,Commercial,48978,0,68022,117000
142345501200000,COMM SE,Commercial,40881,0,44316,85197
142345600100000,SE 223,Residential,29286,130629,0,159915
142345600200000,SE 223,Residential,26849,80209,0,107058
142345600300000,E-40 CHURCHES,Exempt,661230,0,3038909,3700139
142345600400000,SE 223,Exempt,25500,0,0,25500
142345600500000,SE 223,Residential,25500,0,0,25500
142345600600000,SE 223,Residential,25500,73533,0,99033
142345600700000,SE 223,Residential,25500,81127,0,106627
142345600800000,SE 223,Residential,27030,93414,0,120444
142345600900000,SE 223,Residential,23970,73863,0,97833
142345601000000,SE 223,Residential,27030,69481,0,96511
142345601100000,SE 224,Residential,29440,76709,0,106149
142345601200000,SE 224,Residential,27600,94060,0,121660
142345601300000,SE 224,Residential,30000,43913,0,73913
142345601400000,SE 224,Residential,30000,61760,0,91760
142345601700000,COMM SE,Commercial,198720,0,259880,458600
142345601800000,E-47 RELIG OTHER,Exempt,12015,0,0,12015
142345601900000,E-46 RELIG PARKING,Exempt,13203,0,0,13203
142345602000000,COMM SE,Commercial,58547,0,15222,73769
142345602002000,COMM SE,Commercial,0,0,154329,154329
142345602100000,COMM SE,Commercial,128993,0,156524,285517
142345602300000,SE 223,Residential,24745,57468,0,82213
142345602400000,SE 223,Residential,24745,92218,0,116963
142345602500000,SE 223,Residential,24745,52899,0,77644
142345602600000,SE 223,Residential,24745,80094,0,104839
142345602700000,SE 223,Residential,24745,76299,0,101044
142345602800000,SE 223,Residential,24745,59601,0,84346
142345602900000,SE 223,Residential,24745,56268,0,81013
142345603000000,COMM SE,Commercial,62351,0,0,62351
142347600100000,SE 225,Residential,32550,56160,0,88710
142347600200000,SE 225,Residential,30000,60546,0,90546
142347600300000,SE 225,Residential,22700,54077,0,76777
142347600400000,SE 225,Residential,33750,68281,0,102031
142347700100000,SE 225,Residential,24583,69659,0,94242
142347700200000,SE 225,Residential,25417,53577,0,78994
142347700300000,SE 225,Residential,25000,75351,0,100351
142347700400000,SE 225,Residential,25000,58568,0,83568
142347700500000,SE 225,Residential,25000,62980,0,87980
142347700600000,SE 225,Residential,25000,60002,0,85002
142347700700000,SE 225,Residential,25000,52569,0,77569
142347700800000,SE 225,Residential,25000,56951,0,81951
142347700900000,SE 225,Residential,24500,63862,0,88362
142347800100000,SE 225,Residential,29538,77006,0,106544
142347800300000,E-40 CHURCHES,Exempt,68292,0,1046618,1114910
142347800400000,SE 223,Residential,27270,88869,0,116139
142347800500000,SE 223,Residential,27270,86435,0,113705
142347800600000,SE 223,Residential,27270,79189,0,106459
142347800700000,SE 223,Residential,27270,116274,0,143544
142347800800000,SE 223,Residential,27270,67024,0,94294
142347800900000,SE 223,Residential,30991,84406,0,115397
142347801000000,SE 223,Residential,29814,71878,0,101692
142347801100000,SE 225,Residential,30559,63846,0,94405
142347801200000,SE 225,Residential,25000,64636,0,89636
142347801300000,SE 225,Residential,25000,67780,0,92780
142347801400000,SE 225,Residential,25000,73032,0,98032
142347801500000,SE 225,Residential,25000,63431,0,88431
142347801600000,SE 225,Residential,25000,63357,0,88357
142347801700000,SE 225,Residential,25000,56729,0,81729
142347801800000,SE 225,Residential,25000,61091,0,86091
142347802000000,SE 225,Exempt,25000,923,50749,76672
142347900100000,SE 223,Residential,30991,100111,0,131102
142347900200000,SE 223,Residential,29500,85522,0,115022
142347900300000,SE 223,Residential,33936,97414,0,131350
142347900400000,SE 223,Residential,30300,72167,0,102467
142347900500000,SE 223,Residential,30300,63833,0,94133
142347900600000,SE 223,Residential,30300,82627,0,112927
142347900700000,SE 223,Residential,30300,104616,0,134916
142347900800000,SE 223,Residential,30300,84668,0,114968
142347900900000,SE 223,Residential,30117,60011,0,90128
142347901000000,SE 223,Residential,29808,90662,0,120470
142348000100000,SE 223,Residential,23760,65094,0,88854
142348000200000,SE 225,Residential,22968,60300,0,83268
142348000300000,SE 225,Residential,22968,38272,0,61240
142348000400000,SE 225,Residential,22968,45755,0,68723
142348000500000,SE 225,Residential,22968,51704,0,74672
142348000600000,SE 225,Residential,22968,45711,0,68679
142348000700000,SE 225,Residential,22968,58804,0,81772
142348000800000,SE 225,Residential,22968,73935,0,96903
142348001000000,SE 225,Residential,41343,65665,0,107008
142348001200000,SE 225,Residential,22968,75902,0,98870
142348001300000,SE 225,Residential,22968,55556,0,78524
142348001400000,SE 223,Residential,23760,77738,0,101498
142348001500000,SE 223,Residential,22968,65689,0,88657
142348001600000,SE 223,Residential,23760,70772,0,94532
142348001700000,SE 223,Residential,23760,79565,0,103325
142348001800000,SE 223,Residential,22968,90865,0,113833
142348001900000,SE 223,Residential,22968,56444,0,79412
142348002000000,SE 223,Residential,22968,74239,0,97207
142348002100000,SE 223,Residential,22968,73509,0,96477
142348100100000,SE 225,Residential,25000,54467,0,79467
142348100200000,SE 225,Residential,25000,46824,0,71824
142348100300000,SE 225,Residential,25000,52721,0,77721
142348100400000,SE 225,Residential,25000,62698,0,87698
142348100500000,SE 225,Residential,25000,61335,0,86335
142348100600000,SE 225,Residential,25000,63740,0,88740
142348100700000,SE 225,Residential,25000,93074,0,118074
142348100800000,SE 225,Residential,25000,55008,0,80008
142348100900000,SE 225,Residential,25000,59225,0,84225
142348101000000,SE 225,Residential,25000,94845,0,119845
142348101100000,SE 225,Residential,25000,73911,0,98911
142348101200000,SE 225,Residential,25000,58244,0,83244
142348101300000,SE 225,Residential,25000,63385,0,88385
142348101400000,SE 225,Residential,25000,68004,0,93004
142348101500000,SE 225,Residential,25000,48954,0,73954
142348101600000,SE 225,Residential,25000,51358,0,76358
142348101700000,SE 225,Residential,25000,62190,0,87190
142348101800000,SE 225,Residential,25000,72899,0,97899
142348200100000,SE 225,Residential,25000,73026,0,98026
142348200200000,SE 225,Residential,25000,75901,0,100901
142348200300000,SE 225,Residential,25000,63823,0,88823
142348200400000,SE 225,Residential,25000,52173,0,77173
142348200500000,SE 225,Residential,25000,57123,0,82123
142348200600000,SE 225,Residential,25000,45948,0,70948
142348200700000,SE 225,Residential,25000,71186,0,96186
142348200800000,SE 225,Residential,25000,44353,0,69353
142348200900000,SE 225,Residential,25000,79398,0,104398
142348201000000,SE 225,Residential,25000,93906,0,118906
142348201100000,SE 225,Residential,25000,75159,0,100159
142348201200000,SE 225,Residential,35000,71199,0,106199
142348201300000,SE 225,Residential,25000,58356,0,83356
142348201400000,SE 225,Residential,25000,52047,0,77047
142348201500000,SE 225,Residential,25000,43218,0,68218
142348201600000,SE 225,Residential,35000,114078,0,149078
142348300100000,SE 223,Residential,24840,95070,0,119910
142348300200000,SE 225,Residential,23400,61876,0,85276
142348300300000,SE 225,Residential,23400,66241,0,89641
142348300400000,SE 225,Residential,23400,69164,0,92564
142348300500000,SE 225,Residential,23400,62417,0,85817
142348300600000,SE 225,Residential,23400,68175,0,91575
142348300700000,SE 225,Residential,23400,78561,0,101961
142348300800000,SE 225,Residential,23400,53371,0,76771
142348300900000,SE 225,Residential,23400,45690,0,69090
142348301000000,SE 225,Residential,23400,47370,0,70770
142348301100000,COMM SE,Commercial,101777,0,94524,196301
142348301200000,COMM SE,Commercial,379080,0,813851,1192931
142348301500000,SE 223,Residential,24840,92892,0,117732
142348400100000,SE 225,Residential,25000,47795,0,72795
142348400200000,SE 225,Residential,28125,51283,0,79408
142348400300000,SE 225,Residential,28125,72027,0,100152
142348400400000,SE 225,Residential,25000,63412,0,88412
142348400500000,SE 225,Residential,25000,65451,0,90451
142348400600000,SE 225,Residential,25000,87100,0,112100
142348400700000,SE 225,Residential,25000,65675,0,90675
142348400800000,SE 225,Residential,25000,64952,0,89952
142348400900000,SE 225,Residential,25000,68472,0,93472
142348401000000,SE 225,Residential,25000,67833,0,92833
142348401100000,SE 225,Residential,25000,79974,0,104974
142348401200000,SE 225,Residential,25000,67963,0,92963
142348401300000,SE 225,Residential,25000,54215,0,79215
142348401400000,SE 225,Residential,25000,45330,0,70330
142348401500000,SE 225,Residential,25000,57422,0,82422
142348401600000,SE 225,Residential,25000,80656,0,105656
142348401700000,SE 225,Residential,25000,53196,0,78196
142348500100000,SE 225,Residential,33345,65277,0,98622
142348500200000,SE 223,Residential,26320,61916,0,88236
142348500300000,SE 223,Residential,26618,55319,0,81937
142348500400000,SE 223,Residential,26010,40626,0,66636
142348500500000,SE 223,Residential,26010,38439,0,64449
142348500600000,SE 223,Residential,26010,82348,0,108358
142348500700000,SE 223,Residential,26285,46395,0,72680
142348500800000,SE 223,Residential,25500,42421,0,67921
142348500900000,SE 223,Residential,25500,56772,0,82272
142348501000000,COMM SE,Commercial,63096,0,120690,183786
142348501200000,SE 225,Residential,25000,64459,0,89459
142348501300000,SE 225,Residential,25000,57387,0,82387
142348501400000,SE 225,Residential,25000,48051,0,73051
142348501500000,SE 225,Residential,25000,43252,0,68252
142348501600000,SE 225,Residential,25000,47534,0,72534
142348501700000,SE 225,Residential,25000,71274,0,96274
142348501800000,COMM SE,Residential,23000,52901,0,75901
142348501900000,COMM SE,Commercial,145800,0,506177,651977
142348600100000,SE 223,Residential,28684,104779,0,133463
142348600200000,SE 223,Residential,28350,53235,0,81585
142348600300000,SE 223,Residential,26520,88991,0,115511
142348600400000,SE 223,Residential,26129,52819,0,78948
142348600500000,SE 223,Residential,30600,61381,0,91981
142348600600000,SE 223,Residential,30600,68978,0,99578
142348600700000,COMM SE,Commercial,241110,0,485906,727016
142348700100000,SE 225,Residential,25000,83596,0,108596
142348700200000,SE 225,Residential,25000,69419,0,94419
142348700300000,SE 225,Residential,25000,68729,0,93729
142348700400000,SE 225,Residential,25000,56307,0,81307
142348700500000,SE 225,Residential,25000,71547,0,96547
142348700600000,SE 225,Residential,25000,59922,0,84922
142348700700000,SE 225,Residential,25000,65900,0,90900
142348700800000,SE 225,Residential,30000,63720,0,93720
142348700900000,SE 225,Residential,16920,58730,0,75650
142348701000000,SE 225,Residential,14430,3266,0,17696
142348701100000,SE 225,Residential,17150,46356,0,63506
142348701200000,SE 225,Residential,17150,42928,0,60078
142348701300000,SE 225,Residential,17150,48233,0,65383
142348701400000,SE 225,Residential,17150,49305,0,66455
142348701500000,COMM SE,Commercial,109836,0,204340,314176
142410200100000,SE 209,Residential,53602,168640,0,222242
142410200200000,SE 209,Residential,51263,180515,0,231778
142410200300000,SE 209,Residential,52392,220132,0,272524
142412600100000,E-15 CITY,Exempt,0,0,0,0
142412600200000,SE 221,Residential,319700,487891,0,807591
142412600500000,SE 221,Residential,110000,197956,0,307956
142412700100000,SE 245,Residential,91624,334666,0,426290
142412700200000,SE 245,Residential,100000,328510,0,428510
142412700300000,SE 245,Residential,93767,259406,0,353173
142415100100000,E-40 CHURCHES,Exempt,301752,0,869746,1171498
142415100200000,SE 245,Residential,67305,452828,0,520133
142415100300000,SE 245,Residential,64200,348080,0,412280
142415100400000,SE 245,Residential,58752,243341,0,302093
142415100500000,SE 245,Residential,61904,308494,0,370398
142415100600000,SE 245,Residential,71734,291502,0,363236
142415100700000,SE 245,Residential,81127,504738,0,585865
142415100800000,SE 245,Residential,71168,369046,0,440214
142415100900000,SE 245,Residential,75816,359828,0,435644
142415101000000,SE 245,Residential,73776,299857,0,373633
142415101100000,SE 245,Residential,77367,312092,0,389459
142415101200000,SE 245,Residential,80922,257264,0,338186
142415101300000,SE 245,Residential,74943,328906,0,403849
142415101400000,SE 245,Residential,79860,319669,0,399529
142415101500000,SE 245,Residential,83405,277611,0,361016
142415101600000,SE 245,Residential,75504,261735,0,337239
142415101700000,SE 245,Residential,73726,269217,0,342943
142415101800000,SE 245,Residential,83941,322565,0,406506
142415101900000,SE 245,Residential,87621,320900,0,408521
142415200100000,SE 220,Residential,37440,133412,0,170852
142415200200000,SE 220,Residential,38848,139911,0,178759
142415200400000,SE 221,Residential,32000,137975,0,169975
142415200500000,SE 221,Residential,31680,121112,0,152792
142415200600000,SE 221,Residential,31680,126153,0,157833
142415200700000,SE 221,Residential,32195,135493,0,167688
142415300100000,SE 221,Residential,32000,134918,0,166918
142415300200000,SE 221,Residential,32000,139906,0,171906
142415300300000,SE 221,Residential,32000,171516,0,203516
142415301900000,SE 221,Residential,35017,126638,0,161655
142415302000000,SE 221,Residential,35378,137284,0,172662
142415302100000,SE 221,Residential,35569,117807,0,153376
142415302200000,SE 221,Residential,37482,193769,0,231251
142415302300000,SE 221,Residential,39047,147831,0,186878
142415302400000,SE 221,Residential,34497,147294,0,181791
142415302500000,SE 221,Residential,31680,160195,0,191875
142415302600000,SE 221,Residential,31680,132850,0,164530
142415400100000,SE 221,Residential,31680,176277,0,207957
142415400200000,SE 221,Residential,31680,113337,0,145017
142415400300000,SE 221,Residential,31680,122391,0,154071
142415400400000,SE 221,Residential,31680,130070,0,161750
142415400500000,SE 221,Residential,31680,129195,0,160875
142415400600000,SE 221,Residential,30790,139017,0,169807
142415400700000,SE 221,Residential,37647,130979,0,168626
142415400800000,SE 221,Residential,33815,141230,0,175045
142415400900000,SE 221,Residential,32640,119393,0,152033
142415401000000,SE 221,Residential,35672,94836,0,130508
142415401100000,SE 221,Residential,37736,139722,0,177458
142415401200000,SE 221,Residential,36267,116530,0,152797
142415401300000,SE 221,Residential,32592,144943,0,177535
142415401400000,SE 221,Residential,32592,133388,0,165980
142415401500000,SE 221,Residential,32592,130406,0,162998
142415401600000,SE 221,Residential,32592,124159,0,156751
142415401700000,SE 221,Residential,38016,186530,0,224546
142415401800000,SE 221,Residential,39110,128581,0,167691
142415402600000,SE 221,Residential,31680,151009,0,182689
142415402700000,SE 221,Residential,31369,161309,0,192678
142415402800000,SE 221,Residential,36018,143656,0,179674
142415402900000,SE 221,Residential,34911,134494,0,169405
142415403000000,SE 221,Residential,31680,141608,0,173288
142415403100000,SE 221,Residential,31680,137217,0,168897
142415403200000,SE 221,Residential,31680,132382,0,164062
142415403300000,SE 221,Residential,31680,116557,0,148237
142415403400000,SE 221,Residential,31680,139293,0,170973
142415500100000,SE 221,Residential,37152,129015,0,166167
142415500200000,SE 221,Residential,35600,137933,0,173533
142415500300000,SE 221,Residential,33320,131104,0,164424
142415500400000,SE 221,Residential,34580,129198,0,163778
142415500500000,SE 221,Residential,36973,131830,0,168803
142415500600000,SE 221,Residential,36705,162938,0,199643
142415500700000,SE 221,Residential,34580,174434,0,209014
142415500800000,SE 221,Residential,33320,118452,0,151772
142415600100000,SE 221,Residential,32592,160913,0,193505
142415600200000,SE 221,Residential,32592,133286,0,165878
142415600300000,SE 221,Residential,32592,152206,0,184798
142415600400000,SE 221,Residential,32592,138144,0,170736
142415600500000,SE 221,Residential,34144,134739,0,168883
142415600600000,SE 221,Residential,32592,152124,0,184716
142415600700000,SE 221,Residential,32592,148198,0,180790
142415600800000,SE 221,Residential,33244,135223,0,168467
142417600100000,SE 219,Residential,105020,757946,0,862966
142417600200000,SE 219,Residential,103620,0,0,103620
142417600400000,SE 219,Residential,57000,40651,0,97651
142417600500000,SE 219,Residential,64816,334588,0,399404
142417600600000,SE 219,Residential,64662,259593,0,324255
142417600700000,SE 219,Residential,79726,323498,0,403224
142417600800000,SE 219,Residential,66569,395225,0,461794
142417600900000,SE 219,Residential,68462,288500,0,356962
142417601000000,SE 219,Residential,59684,0,0,59684
142417601100000,SE 219,Residential,75420,403366,0,478786
142417601200000,SE 219,Residential,53774,309426,0,363200
142417601300000,SE 219,Residential,76500,294480,0,370980
142417601400000,SE 219,Residential,55930,346633,0,402563
142417601500000,SE 219,Residential,109220,442208,0,551428
142417601600000,Empty,Other,0,0,0,0
142417700100000,SE 220,Residential,36117,122649,0,158766
142417700200000,SE 220,Residential,36492,126647,0,163139
142417700300000,SE 220,Residential,42330,204375,0,246705
142417700400000,SE 220,Residential,35948,153134,0,189082
142417700500000,SE 220,Residential,34744,152852,0,187596
142417800100000,SE 220,Residential,39206,170097,0,209303
142417800200000,SE 220,Residential,42714,155854,0,198568
142417800300000,SE 220,Residential,42039,147868,0,189907
142417800400000,SE 220,Residential,41600,199276,0,240876
142417800500000,SE 220,Residential,36960,204850,0,241810
142417800600000,SE 220,Residential,34513,171661,0,206174
142417800700000,SE 220,Residential,34200,171352,0,205552
142417800800000,SE 220,Residential,46147,215523,0,261670
142417900100000,SE 220,Residential,42776,148935,0,191711
142417900200000,SE 220,Residential,51979,178120,0,230099
142417900300000,SE 220,Residential,38548,249899,0,288447
142417900400000,SE 220,Residential,39661,114260,0,153921
142417900500000,SE 220,Residential,38280,128523,0,166803
142417900600000,SE 220,Residential,42016,121929,0,163945
142417900700000,SE 220,Residential,35067,104266,0,139333
142417900800000,SE 220,Residential,33560,131047,0,164607
142417900900000,SE 220,Residential,44336,122913,0,167249
142417901000000,SE 220,Residential,44708,211383,0,256091
142417901100000,SE 220,Residential,43003,148741,0,191744
142417901200000,SE 220,Residential,39240,153550,0,192790
142417901300000,SE 220,Residential,41283,122289,0,163572
142417901400000,SE 220,Residential,38178,178841,0,217019
142417901500000,SE 220,Residential,37353,131156,0,168509
142417901600000,SE 220,Residential,36040,231401,0,267441
142417901700000,SE 220,Residential,36000,173931,0,209931
142417901800000,SE 220,Residential,36000,121439,0,157439
142417901900000,SE 220,Residential,33067,152690,0,185757
142417902000000,SE 220,Residential,35687,163534,0,199221
142417902100000,SE 220,Residential,36393,122230,0,158623
142417902200000,SE 220,Residential,36720,129417,0,166137
142417902300000,SE 220,Residential,39520,153957,0,193477
142418000100000,SE 220,Residential,20,0,0,20
142420100100000,SE 210,Residential,33840,180157,0,213997
142420100200000,SE 210,Residential,33840,215189,0,249029
142420100300000,SE 210,Residential,28200,154328,0,182528
142420100400000,SE 210,Residential,27900,195885,0,223785
142420100500000,SE 210,Residential,45685,212674,0,258359
142420100600000,SE 210,Residential,43537,216274,0,259811
142420100700000,SE 210,Residential,42584,176595,0,219179
142420100800000,SE 210,Residential,36664,243659,0,280323
142420100900000,SE 210,Residential,36720,206261,0,242981
142420101000000,SE 210,Residential,36720,189515,0,226235
142420101100000,SE 210,Residential,36290,217910,0,254200
142420101200000,Empty,Other,0,0,0,0
142420101300000,SE 210,Residential,61244,241094,0,302338
142420101400000,SE 210,Residential,44000,266000,0,310000
142420101500000,SE 210,Residential,36800,250307,0,287107
142420101600000,SE 210,Residential,37200,230802,0,268002
142420101700000,SE 210,Residential,37600,261351,0,298951
142420101800000,SE 210,Residential,43062,179069,0,222131
142420101900000,SE 210,Residential,42749,251676,0,294425
142420102000000,SE 210,Residential,49099,237857,0,286956
142420102100000,SE 210,Residential,45288,283678,0,328966
142420102200000,SE 210,Residential,51760,319933,0,371693
142420200100000,SE 210,Residential,41072,289760,0,330832
142420300100000,SE 210,Residential,36720,230650,0,267370
142420400100000,SE 210,Residential,40320,167381,0,207701
142420400200000,SE 210,Residential,34168,118425,0,152593
142420400300000,SE 210,Residential,34950,130119,0,165069
142420400400000,SE 210,Residential,36480,132917,0,169397
142420400500000,SE 210,Residential,37760,182425,0,220185
142420400600000,SE 210,Residential,39040,130594,0,169634
142420400700000,SE 210,Residential,38400,206287,0,244687
142420400800000,SE 210,Residential,41200,105770,0,146970
142420400900000,SE 210,Residential,41040,155996,0,197036
142420401000000,SE 210,Residential,40320,132430,0,172750
142420500100000,SE 210,Residential,39016,108572,0,147588
142420500200000,SE 210,Residential,38766,126010,0,164776
142420500300000,SE 210,Residential,38102,108058,0,146160
142420500400000,SE 210,Residential,38800,174926,0,213726
142420500500000,SE 210,Residential,38800,119906,0,158706
142420500600000,SE 210,Residential,39461,174309,0,213770
142420500700000,SE 210,Residential,39600,176077,0,215677
142420500800000,SE 210,Residential,39531,133015,0,172546
142420500900000,SE 210,Residential,37440,112685,0,150125
142420501000000,SE 210,Residential,35280,166837,0,202117
142420501100000,SE 210,Residential,36360,153779,0,190139
142420501200000,SE 210,Residential,35640,129196,0,164836
142420501300000,SE 210,Residential,33690,153309,0,186999
142420501400000,SE 210,Residential,36403,141517,0,177920
142420501500000,SE 210,Residential,38528,100332,0,138860
142420501600000,SE 210,Residential,38800,194180,0,232980
142420501700000,SE 210,Residential,34920,140397,0,175317
142420600100000,SE 210,Residential,35944,158724,0,194668
142420600200000,SE 210,Residential,2750,0,0,2750
142420600300000,SE 210,Residential,34772,121218,0,155990
142420600400000,SE 210,Residential,36860,102334,0,139194
142420600500000,SE 210,Residential,36860,127193,0,164053
142420600600000,SE 210,Residential,38800,141111,0,179911
142420600700000,SE 210,Residential,38800,136368,0,175168
142420600800000,SE 210,Residential,38800,147989,0,186789
142420600900000,SE 210,Residential,38800,150687,0,189487
142420601000000,SE 210,Residential,39318,101546,0,140864
142420601100000,SE 210,Residential,33827,137551,0,171378
142420601200000,SE 210,Residential,34515,152302,0,186817
142420601300000,SE 210,Residential,34920,115425,0,150345
142420601400000,SE 210,Residential,34920,172258,0,207178
142420601500000,SE 210,Residential,34920,145173,0,180093
142420601600000,SE 210,Residential,34920,138583,0,173503
142420700100000,SE 210,Residential,36495,162518,0,199013
142420700200000,SE 210,Residential,34705,124334,0,159039
142420700300000,SE 210,Residential,35280,126576,0,161856
142420700400000,SE 210,Residential,35280,186887,0,222167
142420700500000,SE 210,Residential,35280,115988,0,151268
142420700600000,SE 210,Residential,36456,135800,0,172256
142420700700000,SE 210,Residential,36456,101124,0,137580
142420700800000,SE 210,Residential,36456,162167,0,198623
142420700900000,SE 210,Residential,36456,148860,0,185316
142420701000000,SE 210,Residential,36456,152528,0,188984
142420701100000,SE 210,Residential,34783,182508,0,217291
142420800100000,SE 210,Residential,44440,203850,0,248290
142420800200000,SE 210,Residential,36360,103403,0,139763
142420800300000,SE 210,Residential,36360,116078,0,152438
142420800400000,SE 210,Residential,36360,111140,0,147500
142422600100000,SE 211,Residential,100,0,0,100
142422600200000,SE 211,Residential,59042,176368,0,235410
142422600300000,SE 211,Residential,60437,193552,0,253989
142422600400000,SE 211,Residential,60437,201030,0,261467
142422600500000,SE 211,Residential,59649,181132,0,240781
142422600600000,SE 211,Residential,54947,183181,0,238128
142422600700000,SE 211,Residential,64755,130877,0,195632
142422600800000,SE 211,Residential,138550,315086,0,453636
142422600900000,SE 211,Residential,59207,160611,0,219818
142422601000000,SE 211,Residential,62985,192401,0,255386
142422601100000,SE 211,Residential,67925,173036,0,240961
142422601200000,SE 211,Residential,46900,197311,0,244211
142422601300000,SE 211,Residential,49300,122707,0,172007
142422601400000,SE 211,Residential,48346,222658,0,271004
142422601500000,SE 211,Residential,57545,205405,0,262950
142422601600000,SE 211,Residential,51848,154521,0,206369
142422601700000,SE 211,Residential,50325,145721,0,196046
142422601800000,SE 211,Residential,51667,143980,0,195647
142422601900000,SE 211,Residential,52250,132495,0,184745
142422602000000,SE 211,Residential,49284,139911,0,189195
142422602100000,SE 211,Residential,41600,182308,0,223908
142422602200000,SE 211,Residential,62243,175966,0,238209
142422602300000,SE 211,Residential,60442,201668,0,262110
142422602400000,SE 211,Residential,49000,191241,0,240241
142422602500000,SE 211,Residential,49000,183142,0,232142
142422602600000,SE 211,Residential,62100,375751,0,437851
142422602700000,SE 211,Residential,60375,214128,0,274503
142422602800000,SE 211,Residential,62675,339144,0,401819
142422602900000,SE 211,Residential,66125,239616,0,305741
142422603000000,SE 211,Residential,75839,223284,0,299123
142422603100000,SE 211,Residential,71860,249023,0,320883
142422603200000,SE 211,Residential,67996,230860,0,298856
142422603300000,SE 211,Residential,52866,249999,0,302865
142422603400000,SE 211,Residential,67999,219896,0,287895
142422603500000,SE 211,Residential,70150,278935,0,349085
142422603600000,SE 211,Residential,70725,267853,0,338578
142422603700000,SE 211,Residential,4895,0,0,4895
142422603800000,SE 211,Residential,64200,245132,0,309332
142422603900000,SE 211,Residential,65895,223080,0,288975
142422604000000,SE 211,Residential,56320,311960,0,368280
142422604100000,SE 211,Residential,48500,144184,0,192684
142422604200000,SE 211,Residential,50642,148108,0,198750
142422604300000,SE 211,Residential,69212,178622,0,247834
142422604400000,SE 211,Residential,65914,180717,0,246631
142422604500000,SE 211,Residential,53580,179161,0,232741
142422604600000,SE 211,Residential,39949,176575,0,216524
142422604700000,SE 211,Residential,2060,0,0,2060
142422700100000,SE 211,Residential,52800,152484,0,205284
142422700200000,SE 211,Residential,55290,149137,0,204427
142422700300000,SE 211,Residential,43120,203913,0,247033
142422700400000,SE 211,Residential,43120,179059,0,222179
142422700500000,SE 211,Residential,43120,130988,0,174108
142422700600000,SE 211,Residential,52525,126897,0,179422
142422700700000,SE 211,Residential,52800,148216,0,201016
142422700800000,SE 211,Residential,53900,151405,0,205305
142422700900000,SE 211,Residential,53900,143154,0,197054
142422701000000,SE 211,Residential,53900,155950,0,209850
142425100100000,SE 211,Residential,132900,353421,0,486321
142425100200000,SE 211,Residential,98745,387488,0,486233
142425100300000,SE 211,Residential,84989,0,0,84989
142425100400000,SE 211,Residential,96344,408078,0,504422
142425100500000,SE 211,Residential,86966,374211,0,461177
142425100600000,SE 211,Residential,83470,342567,0,426037
142425100700000,SE 211,Residential,88571,378187,0,466758
142425100800000,SE 211,Residential,106880,527120,0,634000
142425100900000,SE 211,Residential,91205,312894,0,404099
142425101200000,SE 211,Residential,128400,588972,0,717372
142425101400000,SE 211,Residential,112500,307924,0,420424
142425101500000,SE 211,Residential,100000,263415,0,363415
142425101600000,SE 211,Residential,94711,314193,0,408904
142425101700000,SE 211,Residential,93065,298396,0,391461
142425101800000,SE 211,Residential,101420,306863,0,408283
142425101900000,SE 211,Residential,100820,315992,0,416812
142425102000000,SE 211,Residential,104420,282065,0,386485
142425102100000,SE 211,Residential,104720,310176,0,414896
142425102200000,SE 211,Residential,73234,273770,0,347004
142425102300000,SE 211,Exempt,118020,0,559202,677222
142425102400000,SE 211,Residential,62080,214941,0,277021
142425102500000,SE 210,Residential,48300,180044,0,228344
142425102600000,SE 210,Residential,53500,255261,0,308761
142425102700000,SE 210,Residential,52428,161819,0,214247
142425102800000,SE 210,Residential,52364,128631,0,180995
142425102900000,SE 210,Residential,47080,143162,0,190242
142425103000000,SE 210,Residential,43248,121859,0,165107
142425103100000,SE 210,Residential,43370,118146,0,161516
142425103200000,SE 210,Residential,43956,149651,0,193607
142425103300000,SE 210,Residential,47460,144784,0,192244
142425103400000,SE 210,Residential,60250,180629,0,240879
142425103500000,SE 210,Residential,47834,117237,0,165071
142425103700000,SE 211,Residential,74375,0,0,74375
142425103900000,SE 211,Residential,51450,0,0,51450
142425104000000,SE 211,Residential,135000,742832,0,877832
142425200100000,SE 210,Residential,41205,185206,0,226411
142425200200000,SE 210,Residential,42835,102218,0,145053
142425200300000,SE 210,Residential,41189,84553,0,125742
142427600100000,SE 210,Residential,36360,131332,0,167692
142427600200000,SE 210,Residential,36360,123336,0,159696
142427600300000,SE 210,Residential,36360,121040,0,157400
142427600400000,SE 210,Residential,36360,107859,0,144219
142427600500000,SE 210,Residential,36360,136427,0,172787
142427600600000,SE 210,Residential,41778,138291,0,180069
142427700100000,SE 210,Residential,42800,153217,0,196017
142427700200000,SE 210,Residential,35640,133951,0,169591
142427700300000,SE 210,Residential,40073,165749,0,205822
142427700400000,SE 210,Residential,37200,169537,0,206737
142427700500000,SE 210,Residential,36800,189092,0,225892
142427700600000,SE 210,Residential,36800,124275,0,161075
142427800100000,SE 210,Residential,41013,160868,0,201881
142427800200000,SE 210,Residential,35020,126830,0,161850
142427800300000,SE 210,Residential,33660,96135,0,129795
142427800400000,SE 210,Residential,36432,111012,0,147444
142427800500000,SE 210,Residential,34796,118272,0,153068
142427900100000,SE 210,Residential,34000,103101,0,137101
142427900200000,SE 210,Residential,34000,110770,0,144770
142427900300000,SE 210,Residential,34000,103304,0,137304
142427900400000,SE 210,Residential,34000,162899,0,196899
142427900500000,SE 210,Residential,34000,121919,0,155919
142427900600000,SE 210,Residential,33867,145315,0,179182
142427900700000,SE 210,Residential,37482,111160,0,148642
142427900800000,SE 210,Residential,36040,120074,0,156114
142427900900000,SE 210,Residential,36040,107782,0,143822
142427901000000,SE 210,Residential,36040,111873,0,147913
142427901100000,SE 210,Residential,36040,108330,0,144370
142427901200000,SE 210,Residential,36040,113225,0,149265
142427901300000,SE 210,Residential,36040,123571,0,159611
142428000100000,SE 210,Residential,37642,137052,0,174694
142428000200000,SE 210,Residential,45635,177973,0,223608
142428000300000,SE 210,Residential,44147,162853,0,207000
142428000400000,SE 210,Residential,39573,112205,0,151778
142428000500000,SE 210,Residential,40000,140226,0,180226
142428000600000,SE 210,Residential,41894,113254,0,155148
142428000700000,SE 210,Residential,43795,107719,0,151514
142428000800000,SE 210,Residential,45108,336511,0,381619
142428000900000,SE 210,Residential,44478,151008,0,195486
142428100100000,SE 210,Residential,33392,116612,0,150004
142428100200000,SE 210,Residential,33762,142304,0,176066
142428100300000,SE 210,Residential,34204,136560,0,170764
142428100400000,SE 210,Residential,34333,124461,0,158794
142428100500000,SE 210,Residential,34804,109892,0,144696
142428100600000,SE 210,Residential,35343,138002,0,173345
142428100700000,SE 210,Residential,35086,126320,0,161406
142428200100000,SE 210,Residential,38170,114416,0,152586
142428200200000,SE 210,Residential,37740,133504,0,171244
142428200300000,SE 210,Residential,37740,167057,0,204797
142428200400000,SE 210,Residential,37475,86117,0,123592
142428200500000,SE 210,Residential,36720,123759,0,160479
142428200600000,SE 210,Residential,36040,115349,0,151389
142428200700000,SE 210,Residential,37536,103186,0,140722
142428200800000,SE 210,Residential,40032,155227,0,195259
142428200900000,SE 210,Residential,42154,122421,0,164575
142428201000000,SE 210,Residential,46250,151191,0,197441
142428201100000,SE 210,Residential,42401,157438,0,199839
142428201200000,SE 210,Residential,41636,129863,0,171499
142428201300000,SE 210,Residential,48561,128362,0,176923
142428201400000,SE 210,Residential,46354,146867,0,193221
142428201500000,SE 210,Residential,47236,141000,0,188236
142428201600000,SE 210,Residential,48576,192737,0,241313
142428201700000,SE 210,Residential,48536,168235,0,216771
142428201800000,SE 210,Residential,46398,126150,0,172548
142428201900000,SE 210,Residential,45562,146190,0,191752
142428202000000,SE 210,Residential,49426,239014,0,288440
142428202100000,SE 210,Residential,41208,211674,0,252882
142428202200000,SE 210,Residential,43639,190503,0,234142
142428202300000,SE 210,Residential,42636,100624,0,143260
142428202400000,SE 210,Residential,43890,103225,0,147115
142428202500000,SE 210,Residential,41616,162616,0,204232
142428202600000,SE 210,Residential,45426,120091,0,165517
142428300100000,SE 210,Residential,44727,116019,0,160746
142428300200000,SE 210,Residential,40293,131480,0,171773
142428300300000,SE 210,Residential,40656,160775,0,201431
142428300400000,SE 210,Residential,40577,120563,0,161140
142428300500000,SE 210,Residential,40669,104650,0,145319
142428300600000,SE 210,Residential,38247,78371,0,116618
142428300700000,SE 210,Residential,38318,88437,0,126755
142430100100000,SE 210,Residential,37318,108608,0,145926
142430100200000,SE 210,Residential,31360,117906,0,149266
142430100300000,SE 210,Residential,29074,112681,0,141755
142430100400000,SE 210,Residential,32275,77768,0,110043
142430100500000,SE 210,Residential,31020,97012,0,128032
142430100600000,SE 210,Residential,34533,116608,0,151141
142430100700000,SE 210,Residential,27744,110443,0,138187
142430100800000,SE 210,Residential,28149,132476,0,160625
142430100900000,SE 210,Residential,28420,80537,0,108957
142430101000000,SE 210,Residential,28420,78483,0,106903
142430101100000,SE 210,Residential,28420,88996,0,117416
142430101200000,SE 210,Residential,28980,78309,0,107289
142430101300000,SE 210,Residential,28704,95359,0,124063
142430101400000,SE 210,Residential,31428,110483,0,141911
142430101500000,SE 210,Residential,28037,76519,0,104556
142430200100000,SE 210,Residential,64350,200262,0,264612
142430200200000,SE 210,Residential,61050,145141,0,206191
142430200300000,SE 210,Residential,34593,131549,0,166142
142430200400000,SE 210,Residential,35178,133294,0,168472
142430200500000,SE 210,Residential,37625,149432,0,187057
142430200600000,SE 210,Residential,34092,149263,0,183355
142430200700000,SE 210,Residential,30975,149195,0,180170
142430200800000,SE 210,Residential,29808,144817,0,174625
142430200900000,SE 210,Residential,39268,161134,0,200402
142430201000000,SE 210,Residential,37223,154792,0,192015
142430201100000,SE 210,Residential,32724,161899,0,194623
142430201200000,SE 210,Residential,34542,142056,0,176598
142430201300000,SE 210,Residential,34200,133399,0,167599
142430201400000,SE 210,Residential,31960,180629,0,212589
142430201500000,SE 210,Residential,34295,147951,0,182246
142430201600000,SE 210,Residential,36442,111044,0,147486
142430201700000,SE 210,Residential,30456,161458,0,191914
142430201800000,SE 210,Residential,30053,154892,0,184945
142430201900000,SE 210,Residential,39000,79086,0,118086
142430202000000,SE 210,Residential,46124,83735,0,129859
142430202100000,SE 210,Residential,27989,88885,0,116874
142430202200000,SE 210,Residential,26802,0,0,26802
142430202300000,SE 210,Residential,30403,105681,0,136084
142430202400000,SE 210,Residential,29478,112420,0,141898
142430202500000,SE 210,Residential,34639,118792,0,153431
142430202600000,SE 210,Residential,34031,114209,0,148240
142430202700000,SE 210,Residential,33920,104070,0,137990
142430202800000,SE 210,Residential,34240,121883,0,156123
142430202900000,SE 210,Residential,33379,101718,0,135097
142430203000000,SE 210,Residential,32760,100982,0,133742
142430203100000,SE 210,Residential,34299,155756,0,190055
142430203200000,SE 210,Residential,34560,123635,0,158195
142430203300000,SE 210,Residential,35136,99949,0,135085
142430300100000,SE 210,Residential,36708,155374,0,192082
142430300200000,SE 210,Residential,31368,179891,0,211259
142430300300000,SE 210,Residential,31583,166790,0,198373
142430300400000,SE 210,Residential,32244,156632,0,188876
142430300500000,SE 210,Residential,32896,100215,0,133111
142430300600000,SE 210,Residential,34592,132466,0,167058
142430300700000,SE 210,Residential,33743,122836,0,156579
142430300800000,SE 210,Residential,31450,123215,0,154665
142430300900000,SE 210,Residential,30053,168744,0,198797
142430301000000,SE 210,Residential,33927,132197,0,166124
142430301100000,SE 210,Residential,38782,117175,0,155957
142430400100000,SE 210,Residential,31772,169255,0,201027
142430400200000,SE 210,Residential,28032,137305,0,165337
142430400300000,SE 210,Residential,29223,123789,0,153012
142430400400000,SE 210,Residential,32605,97532,0,130137
142430400500000,SE 210,Residential,28356,98724,0,127080
142430400600000,SE 210,Residential,28717,110335,0,139052
142430400700000,SE 210,Residential,27200,113428,0,140628
142430500100000,SE 210,Residential,33617,113076,0,146693
142430500200000,SE 210,Residential,32980,107092,0,140072
142430500300000,SE 210,Residential,28149,168777,0,196926
142430500400000,SE 210,Residential,27388,124397,0,151785
142430500500000,SE 210,Residential,25637,153481,0,179118
142430500600000,SE 210,Residential,26727,114757,0,141484
142430500700000,SE 210,Residential,22568,86118,0,108686
142430500800000,SE 210,Residential,24752,121917,0,146669
142430500900000,SE 210,Residential,25760,128845,0,154605
142430501000000,SE 210,Residential,27160,122774,0,149934
142430501100000,SE 210,Residential,30714,105786,0,136500
142430501200000,SE 210,Residential,29488,90926,0,120414
142430501300000,SE 210,Residential,29488,99246,0,128734
142430501400000,SE 210,Residential,29488,101587,0,131075
142430501500000,SE 210,Exempt,29488,0,110510,139998
142430501600000,SE 210,Residential,29488,96794,0,126282
142430501700000,SE 210,Residential,29488,102334,0,131822
142430501800000,SE 210,Residential,29488,109842,0,139330
142430600100000,SE 210,Residential,26640,101851,0,128491
142430600200000,SE 210,Residential,27540,102105,0,129645
142430600300000,SE 210,Residential,25989,87383,0,113372
142430600400000,SE 210,Residential,26218,172125,0,198343
142430600500000,SE 210,Residential,24446,39451,0,63897
142430600600000,SE 210,Residential,30264,34746,0,65010
142430600700000,SE 210,Residential,29841,101624,0,131465
142430600800000,SE 210,Residential,29488,85649,0,115137
142430600900000,SE 210,Residential,29488,102699,0,132187
142430601000000,SE 210,Residential,29488,95350,0,124838
142430601100000,SE 210,Residential,29488,95114,0,124602
142430601200000,SE 210,Residential,29488,86896,0,116384
142430601300000,SE 210,Residential,29488,100091,0,129579
142430601400000,SE 210,Residential,29488,98455,0,127943
142430601500000,SE 210,Residential,30638,103883,0,134521
142432600100000,SE 210,Residential,43061,107801,0,150862
142432600200000,SE 210,Residential,46463,143158,0,189621
142432700100000,SE 210,Residential,41692,192739,0,234431
142432700200000,SE 210,Residential,24092,141588,0,165680
142432700300000,SE 210,Residential,17297,0,0,17297
142432700400000,SE 210,Residential,43546,133444,0,176990
142432700500000,SE 210,Residential,42269,149973,0,192242
142432700600000,SE 210,Residential,46104,133681,0,179785
142432700700000,SE 210,Residential,46104,217477,0,263581
142432700800000,SE 210,Residential,46104,159143,0,205247
142432700900000,SE 210,Residential,46104,265620,0,311724
142432701000000,SE 210,Residential,31237,90826,0,122063
142432701100000,SE 210,Residential,29400,106804,0,136204
142432701200000,SE 210,Residential,27930,102604,0,130534
142432701300000,SE 210,Residential,27930,95122,0,123052
142432701400000,SE 210,Residential,32100,114243,0,146343
142432701500000,SE 210,Residential,32100,120764,0,152864
142432701600000,SE 210,Residential,32100,88985,0,121085
142432701700000,SE 210,Residential,32100,109479,0,141579
142432701800000,SE 210,Residential,32100,132893,0,164993
142432701900000,SE 210,Residential,32742,131147,0,163889
142432702000000,SE 210,Residential,32742,123511,0,156253
142432702100000,SE 210,Residential,32742,115942,0,148684
142432800100000,SE 210,Residential,45937,109541,0,155478
142432800200000,SE 210,Residential,20800,86531,0,107331
142432800300000,SE 210,Residential,43597,135940,0,179537
142432800400000,SE 210,Residential,39200,122017,0,161217
142432800500000,SE 210,Residential,39200,118234,0,157434
142432800600000,SE 210,Residential,38701,110359,0,149060
142432800700000,SE 210,Residential,29100,92436,0,121536
142432800800000,SE 210,Residential,29100,91901,0,121001
142432800900000,SE 210,Residential,29100,104320,0,133420
142432801000000,SE 210,Residential,28567,96979,0,125546
142432801100000,SE 210,Residential,30020,94347,0,124367
142432801200000,SE 210,Residential,33174,123826,0,157000
142432801300000,SE 210,Residential,15770,113217,0,128987
142432801400000,SE 210,Residential,30109,100681,0,130790
142432900100000,SE 222,Residential,28000,148201,0,176201
142432900200000,SE 222,Residential,24700,119171,0,143871
142432900300000,SE 222,Residential,24000,77591,0,101591
142432900400000,SE 222,Residential,24000,89407,0,113407
142432900500000,SE 222,Residential,24000,97470,0,121470
142432900600000,SE 222,Residential,24000,94679,0,118679
142432900700000,SE 222,Residential,24700,93837,0,118537
142432900800000,SE 222,Residential,24000,66790,0,90790
142432900900000,SE 222,Residential,24000,92451,0,116451
142432901000000,SE 222,Residential,24000,84773,0,108773
142432901100000,SE 222,Residential,24000,102986,0,126986
142432901200000,SE 222,Residential,24000,133309,0,157309
142432901300000,SE 222,Residential,24000,86121,0,110121
142432901400000,SE 222,Residential,24000,89941,0,113941
142432901500000,SE 222,Residential,24000,96469,0,120469
142432901600000,SE 222,Residential,24700,110239,0,134939
142432901700000,SE 222,Residential,24700,123739,0,148439
142432901800000,SE 222,Residential,24480,100839,0,125319
142432901900000,SE 222,Residential,24480,104384,0,128864
142433000100000,SE 222,Residential,24000,104716,0,128716
142433000200000,SE 222,Residential,24000,121188,0,145188
142433000300000,SE 222,Residential,24000,116282,0,140282
142433000400000,SE 222,Residential,24000,127870,0,151870
142433000500000,SE 222,Residential,24000,66451,0,90451
142433000600000,SE 222,Residential,24000,72041,0,96041
142433000700000,SE 222,Residential,24000,73712,0,97712
142433000800000,SE 222,Residential,24000,85064,0,109064
142433000900000,SE 222,Residential,24000,70234,0,94234
142433001000000,SE 222,Residential,24000,95162,0,119162
142433001100000,SE 222,Residential,25200,88892,0,114092
142433001200000,E-15 CITY,Exempt,0,0,0,0
142433001300000,SE 222,Residential,24725,68989,0,93714
142433001400000,SE 222,Residential,25200,116859,0,142059
142433001500000,SE 223,Residential,24461,84527,0,108988
142433001600000,SE 223,Residential,20200,77898,0,98098
142433001700000,SE 223,Residential,26438,89739,0,116177
142433001800000,SE 222,Residential,25200,104491,0,129691
142433001900000,SE 222,Residential,24000,97772,0,121772
142433002000000,SE 222,Residential,24000,105655,0,129655
142433002100000,SE 222,Residential,24000,95655,0,119655
142433002200000,SE 222,Residential,24000,84395,0,108395
142433002300000,SE 222,Residential,24000,107254,0,131254
142433002400000,SE 222,Residential,24000,104712,0,128712
142433002500000,SE 222,Residential,24000,102973,0,126973
142433002600000,SE 222,Residential,24000,125519,0,149519
142433100100000,SE 210,Residential,32174,88551,0,120725
142433100200000,SE 210,Residential,32183,109914,0,142097
142433100300000,SE 210,Residential,32183,65725,0,97908
142433100400000,SE 210,Residential,32183,112943,0,145126
142433100500000,SE 210,Residential,30214,98424,0,128638
142433100600000,SE 210,Residential,28028,110532,0,138560
142433100700000,SE 210,Residential,29400,118990,0,148390
142433100800000,SE 210,Residential,29400,129256,0,158656
142433100900000,SE 210,Residential,29100,93980,0,123080
142433101000000,SE 210,Residential,29100,121163,0,150263
142433101100000,SE 210,Residential,29100,104216,0,133316
142433101200000,SE 210,Residential,28509,116567,0,145076
142433101300000,SE 210,Residential,33274,72389,0,105663
142433101400000,SE 210,Residential,30186,97162,0,127348
142433101500000,SE 210,Residential,30186,106252,0,136438
142433101600000,SE 210,Residential,29992,121126,0,151118
142433200100000,SE 223,Residential,22010,104545,0,126555
142433200200000,SE 223,Residential,21709,77316,0,99025
142433200300000,SE 223,Residential,24480,87948,0,112428
142433200400000,SE 223,Residential,23520,81792,0,105312
142433200500000,SE 223,Residential,21840,100062,0,121902
142435100100000,Empty,Exempt,0,0,0,0
142435200100000,SE 223,Residential,21840,89569,0,111409
142435200200000,SE 223,Residential,24027,84158,0,108185
142435200300000,SE 223,Residential,21840,97524,0,119364
142435200400000,SE 223,Residential,21840,85651,0,107491
142435200500000,SE 223,Residential,21840,95463,0,117303
142435200600000,SE 223,Residential,21840,91637,0,113477
142435200700000,SE 223,Residential,21840,105425,0,127265
142435200800000,SE 223,Residential,21840,81805,0,103645
142435200900000,SE 223,Residential,23617,131501,0,155118
142435201000000,SE 223,Residential,23514,134321,0,157835
142435201100000,SE 223,Residential,24752,107899,0,132651
142435201200000,SE 223,Residential,22859,85137,0,107996
142435201300000,SE 223,Residential,23228,88786,0,112014
142435201400000,SE 223,Residential,23296,78788,0,102084
142435201500000,SE 223,Residential,21840,75439,0,97279
142435201600000,SE 223,Residential,21840,77154,0,98994
142435201700000,SE 223,Residential,21840,80848,0,102688
142435201800000,SE 223,Residential,21840,80418,0,102258
142435201900000,SE 223,Residential,21840,77222,0,99062
142435202000000,SE 223,Residential,21840,102083,0,123923
142435202100000,SE 223,Residential,21840,78122,0,99962
142435300100000,SE 223,Residential,26600,124401,0,151001
142435300200000,SE 223,Residential,27669,82484,0,110153
142435300300000,SE 223,Residential,28848,91727,0,120575
142435300400000,SE 223,Residential,23280,81414,0,104694
142435300500000,SE 223,Residential,23280,80147,0,103427
142435300600000,SE 223,Residential,24624,71567,0,96191
142435300700000,SE 223,Residential,32604,61706,0,94310
142435300800000,SE 223,Residential,25080,65260,0,90340
142435300900000,SE 223,Residential,24000,71270,0,95270
142435301000000,SE 223,Residential,24000,99294,0,123294
142435301100000,SE 223,Residential,23040,69726,0,92766
142435301200000,SE 223,Residential,26240,89470,0,115710
142435301300000,SE 223,Residential,23600,72454,0,96054
142435301400000,SE 223,Residential,22890,85560,0,108450
142435301500000,SE 223,Residential,22632,83906,0,106538
142435301600000,SE 223,Residential,22632,113298,0,135930
142435301700000,SE 223,Residential,22632,91689,0,114321
142435301800000,SE 223,Residential,21340,97318,0,118658
142435301900000,SE 223,Residential,21340,85630,0,106970
142435302000000,SE 223,Residential,21185,73642,0,94827
142435302100000,SE 223,Residential,27120,101063,0,128183
142435302200000,SE 223,Residential,24960,85973,0,110933
142435302300000,SE 223,Residential,2160,0,0,2160
142435302400000,SE 223,Residential,25197,97895,0,123092
142435400100000,SE 223,Residential,24177,86222,0,110399
142435400200000,SE 223,Residential,24317,87769,0,112086
142435400300000,SE 223,Residential,24464,101588,0,126052
142435400400000,SE 223,Residential,24177,104294,0,128471
142435400500000,SE 223,Residential,24317,109514,0,133831
142435400600000,SE 223,Residential,24464,95891,0,120355
142435500200000,APTS SE,Commercial,18244,0,121840,140084
142435500300000,APTS SE,Residential,17622,109378,0,127000
142435500401000,CONDO 500,Residential,4000,58744,0,62744
142435500401001,CONDO 500,Residential,4000,59255,0,63255
142435500401002,CONDO 500,Residential,4000,59255,0,63255
142435500401003,CONDO 500,Residential,4000,59255,0,63255
142435500401004,CONDO 500,Residential,4000,62111,0,66111
142435500401005,CONDO 500,Residential,4000,59255,0,63255
142435500401006,CONDO 500,Residential,4000,59332,0,63332
142435500401007,CONDO 500,Residential,4000,59332,0,63332
142435500401008,CONDO 500,Residential,4000,62076,0,66076
142435500401009,CONDO 500,Residential,4000,59332,0,63332
142435500401010,CONDO 500,Residential,4000,59332,0,63332
142435500401011,CONDO 500,Residential,4000,59833,0,63833
142435500401012,CONDO 500,Residential,4000,63119,0,67119
142435500401013,CONDO 500,Residential,4000,59332,0,63332
142435500401014,CONDO 500,Residential,4000,57797,0,61797
142435500401015,CONDO 500,Residential,4000,60153,0,64153
142435500401016,CONDO 500,Residential,4000,61164,0,65164
142435500401017,CONDO 500,Residential,4000,59332,0,63332
142435500401018,CONDO 500,Residential,4000,59332,0,63332
142435500401019,CONDO 500,Residential,4000,59332,0,63332
142435500401020,CONDO 500,Residential,4000,59479,0,63479
142435500401021,CONDO 500,Residential,4000,59332,0,63332
142435500401022,CONDO 500,Residential,4000,58820,0,62820
142435500401023,CONDO 500,Residential,4000,59430,0,63430
142435500401024,CONDO 500,Residential,4000,54212,0,58212
142435500401025,CONDO 500,Residential,4000,55726,0,59726
142435500401026,CONDO 500,Residential,4000,57342,0,61342
142435500401027,CONDO 500,Residential,4000,53091,0,57091
142435500401028,CONDO 500,Residential,4000,58370,0,62370
142435500401029,CONDO 500,Residential,4000,56530,0,60530
142435500401030,CONDO 500,Residential,4000,56065,0,60065
142435500401031,CONDO 500,Residential,4000,55700,0,59700
142435500401032,CONDO 500,Residential,4000,55611,0,59611
142435500401033,CONDO 500,Residential,4000,55765,0,59765
142435500401034,CONDO 500,Residential,4000,57767,0,61767
142435500401035,CONDO 500,Residential,4000,55143,0,59143
142435500401036,CONDO 500,Residential,0,3091,0,3091
142435500401037,CONDO 500,Residential,0,2898,0,2898
142435500401038,CONDO 500,Residential,0,3091,0,3091
142435500401039,CONDO 500,Residential,0,3091,0,3091
142435500401040,CONDO 500,Residential,0,3091,0,3091
142435500401041,CONDO 500,Residential,0,3091,0,3091
142435500401042,CONDO 500,Residential,0,3091,0,3091
142435500401043,CONDO 500,Residential,0,3091,0,3091
142435500401044,CONDO 500,Residential,0,3091,0,3091
142435500401045,CONDO 500,Residential,0,2898,0,2898
142435500401046,CONDO 500,Residential,0,3091,0,3091
142435500401047,CONDO 500,Residential,0,3091,0,3091
142435500401048,CONDO 500,Residential,0,3091,0,3091
142435500401049,CONDO 500,Residential,0,2939,0,2939
142435500401050,CONDO 500,Residential,0,3135,0,3135
142435500401051,CONDO 500,Residential,0,2939,0,2939
142435500401052,CONDO 500,Residential,0,2939,0,2939
142435500401053,CONDO 500,Residential,0,2939,0,2939
142435500401054,CONDO 500,Residential,0,2939,0,2939
142435500401055,CONDO 500,Residential,0,2939,0,2939
142435500401056,CONDO 500,Residential,0,2939,0,2939
142435500401057,CONDO 500,Residential,0,2939,0,2939
142435500401058,CONDO 500,Residential,0,2939,0,2939
142435500401059,CONDO 500,Residential,0,2939,0,2939
142435500401060,CONDO 500,Residential,0,2939,0,2939
142435500401061,CONDO 500,Residential,0,2939,0,2939
142435500500000,CONDO 500,Residential,480,0,0,480
142435500600000,E-40 CHURCHES,Exempt,168750,0,374542,543292
142435500700000,COMM SE,Commercial,362880,0,922019,1284899
142435600100000,SE 223,Residential,22162,76073,0,98235
142435600200000,SE 223,Residential,22575,80434,0,103009
142435600300000,SE 223,Residential,22477,90948,0,113425
142435600400000,SE 223,Residential,22568,77234,0,99802
142435600500000,SE 223,Residential,22896,113623,0,136519
142435600600000,SE 223,Residential,23296,96031,0,119327
142435600700000,COMM SE,Commercial,152023,0,290314,442337
142435600800000,SE 223,Residential,18200,100215,0,118415
142435600900000,SE 223,Residential,18200,98227,0,116427
142435601000000,SE 223,Residential,21840,85938,0,107778
142435601100000,SE 223,Residential,21840,82750,0,104590
142435601200000,SE 223,Residential,21840,79153,0,100993
142435601300000,SE 223,Residential,21840,77720,0,99560
142435601400000,SE 223,Residential,21840,83809,0,105649
142435700100000,SE 223,Residential,23893,106665,0,130558
142435700200000,SE 223,Residential,25085,121299,0,146384
142435700300000,SE 223,Residential,20972,56234,0,77206
142435700400000,SE 223,Residential,21400,69938,0,91338
142435700500000,SE 223,Residential,29680,94094,0,123774
142435700600000,SE 223,Residential,31434,0,0,31434
142435700700000,COMM SE,Commercial,85147,0,160305,245452
142435700800000,COMM SE,Commercial,78790,0,27000,105790
142435700900000,COMM SE,Commercial,221400,0,553975,775375
142435701000000,SE 223,Residential,18952,73085,0,92037
142435701100000,SE 223,Residential,18983,78785,0,97768
142435701200000,SE 223,Residential,23230,103833,0,127063
142435701300000,SE 223,Residential,23147,88135,0,111282
142435701400000,SE 223,Residential,23147,97684,0,120831
142435800100000,SE 223,Residential,24424,89485,0,113909
142435800200000,SE 223,Residential,24571,116696,0,141267
142435800300000,SE 223,Residential,24725,92860,0,117585
142435800400000,SE 223,Residential,21367,122939,0,144306
142435800500000,SE 223,Residential,21499,108537,0,130036
142435800600000,SE 223,Residential,21638,82308,0,103946
142437600100000,SE 223,Residential,22846,90214,0,113060
142437600200000,SE 223,Residential,22800,92084,0,114884
142437600300000,SE 223,Residential,22800,103078,0,125878
142437600400000,SE 223,Residential,27720,110150,0,137870
142437600500000,SE 223,Residential,27720,122062,0,149782
142437600600000,SE 223,Residential,27720,85356,0,113076
142437600700000,SE 223,Residential,27500,95188,0,122688
142437600800000,SE 223,Residential,27500,96679,0,124179
142437600900000,SE 223,Residential,27500,85504,0,113004
142437601000000,SE 223,Residential,27553,87320,0,114873
142437601100000,SE 223,Residential,23320,106370,0,129690
142437601200000,SE 223,Residential,27073,60775,0,87848
142437601300000,SE 223,Residential,26240,109567,0,135807
142437601400000,SE 223,Residential,23548,91771,0,115319
142437601500000,SE 223,Residential,23940,111547,0,135487
142437601600000,SE 223,Residential,24051,123666,0,147717
142437601700000,SE 223,Residential,22851,77221,0,100072
142437601800000,SE 223,Residential,23328,91713,0,115041
142437601900000,SE 223,Residential,23560,106471,0,130031
142437602000000,SE 223,Residential,28679,131521,0,160200
142437602100000,SE 223,Residential,26611,91586,0,118197
142437602200000,SE 223,Residential,23501,122183,0,145684
142437602300000,SE 223,Residential,22560,118275,0,140835
142437602400000,SE 223,Residential,22793,112952,0,135745
142437602500000,SE 223,Residential,24365,109634,0,133999
142437602600000,SE 223,Residential,26825,136101,0,162926
142437602700000,SE 223,Residential,26905,138737,0,165642
142437602800000,SE 223,Residential,26780,74203,0,100983
142437602900000,SE 223,Residential,26780,109684,0,136464
142437603000000,SE 223,Residential,26780,74605,0,101385
142437603100000,SE 223,Residential,26780,110720,0,137500
142437603200000,SE 223,Residential,26780,83365,0,110145
142437603300000,SE 223,Residential,26780,85089,0,111869
142437603400000,SE 223,Residential,25868,78182,0,104050
142437603500000,SE 223,Residential,25086,82809,0,107895
142437603600000,SE 223,Residential,27346,97100,0,124446
142437603700000,SE 223,Residential,27572,102372,0,129944
142437603800000,SE 223,Residential,27572,98733,0,126305
142437603900000,SE 223,Residential,23219,109719,0,132938
142437604000000,SE 223,Residential,24327,124859,0,149186
142437604100000,SE 223,Residential,28016,111391,0,139407
142437604200000,SE 223,Residential,28044,101865,0,129909
142437604300000,SE 223,Residential,23760,82978,0,106738
142437604400000,SE 223,Residential,24683,95238,0,119921
142437604500000,SE 223,Residential,24440,115381,0,139821
142437604600000,SE 223,Residential,25503,119895,0,145398
142437604700000,SE 223,Residential,28938,117007,0,145945
142437604800000,SE 223,Residential,29765,109974,0,139739
142437700100000,SE 223,Residential,26585,73964,0,100549
142437700200000,SE 223,Residential,26585,107217,0,133802
142437700300000,SE 223,Residential,26585,75673,0,102258
142437700400000,SE 223,Residential,26585,78970,0,105555
142437700500000,SE 223,Residential,26585,88953,0,115538
142437700600000,SE 223,Residential,25987,100346,0,126333
142437700700000,SE 223,Residential,25920,92119,0,118039
142437700800000,SE 223,Residential,25900,83103,0,109003
142437700900000,SE 223,Residential,25142,96607,0,121749
142437701000000,SE 223,Residential,26385,76478,0,102863
142437701100000,SE 223,Residential,26088,115314,0,141402
142437701200000,SE 223,Residential,26182,116626,0,142808
142437701300000,SE 223,Residential,25776,87147,0,112923
142437701400000,SE 223,Residential,29469,92004,0,121473
142437701500000,SE 223,Residential,30096,111470,0,141566
142437701600000,SE 223,Residential,29992,93925,0,123917
142437701700000,SE 223,Residential,35708,105638,0,141346
142437701800000,SE 223,Residential,33152,98848,0,132000
142437701900000,SE 223,Residential,33220,114000,0,147220
142437702000000,SE 223,Residential,33220,101703,0,134923
142437702100000,SE 223,Residential,33242,116842,0,150084
142437702200000,SE 223,Residential,33242,107450,0,140692
142437800100000,SE 223,Residential,33792,155120,0,188912
142437800200000,SE 223,Residential,35200,104168,0,139368
142437800300000,SE 223,Residential,35244,124126,0,159370
142437800400000,SE 223,Residential,29788,107893,0,137681
142437800500000,SE 223,Residential,26384,115335,0,141719
142437800600000,SE 223,Residential,32548,109001,0,141549
142437800700000,SE 223,Residential,27333,103046,0,130379
142437800800000,SE 223,Residential,29229,100644,0,129873
142437800900000,SE 223,Residential,30258,82662,0,112920
142437801000000,SE 223,Residential,24952,85743,0,110695
142437801100000,SE 223,Residential,25160,96386,0,121546
142437801200000,SE 223,Residential,25452,92383,0,117835
142437801300000,SE 223,Residential,25376,114354,0,139730
142437801400000,SE 223,Residential,26400,98536,0,124936
142437801500000,SE 223,Residential,29018,86203,0,115221
142437801600000,SE 223,Residential,27986,85438,0,113424
142437801700000,SE 223,Residential,29172,103675,0,132847
142437801800000,SE 223,Residential,29260,93440,0,122700
142437900100000,SE 223,Residential,26198,73845,0,100043
142437900200000,SE 223,Residential,24192,73364,0,97556
142437900300000,SE 223,Residential,23040,113099,0,136139
142437900400000,SE 223,Residential,23040,99402,0,122442
142437900500000,SE 223,Residential,23040,115535,0,138575
142437900600000,SE 223,Residential,23040,85626,0,108666
142437900700000,SE 223,Residential,23040,107006,0,130046
142437900800000,SE 223,Residential,23841,77741,0,101582
142437900900000,SE 223,Residential,24879,141328,0,166207
142437901000000,SE 223,Residential,23040,91008,0,114048
142437901100000,SE 223,Residential,23040,77189,0,100229
142437901200000,SE 223,Residential,23040,89922,0,112962
142437901300000,SE 223,Residential,23040,88173,0,111213
142437901400000,SE 223,Residential,23040,90024,0,113064
142437901500000,SE 223,Residential,24192,84065,0,108257
142437901600000,SE 223,Residential,26188,111150,0,137338
142437901700000,SE 223,Residential,24948,95390,0,120338
142438000100000,SE 223,Residential,25615,79026,0,104641
142438000200000,SE 223,Residential,25724,89557,0,115281
142438000300000,SE 223,Residential,25724,87023,0,112747
142438000400000,SE 223,Residential,25791,73087,0,98878
142438000500000,SE 223,Residential,24471,71291,0,95762
142438000600000,SE 223,Residential,24735,91840,0,116575
142438000700000,SE 223,Residential,24339,97499,0,121838
142438000800000,SE 223,Residential,25395,80753,0,106148
142438000900000,SE 223,Residential,24576,100276,0,124852
142438001000000,SE 223,Residential,24576,86301,0,110877
142438001100000,SE 223,Residential,21297,79143,0,100440
142438001200000,SE 223,Residential,21644,85575,0,107219
142438001300000,SE 223,Residential,21597,81161,0,102758
142438001400000,SE 223,Residential,20385,71076,0,91461
142438001500000,SE 223,Residential,21185,91619,0,112804
142438001600000,SE 223,Residential,21185,78448,0,99633
142438001700000,SE 223,Residential,21275,95355,0,116630
142438100100000,SE 223,Residential,26560,118716,0,145276
142438100200000,SE 223,Residential,23280,74181,0,97461
142438100300000,SE 223,Residential,23280,89936,0,113216
142438100400000,SE 223,Residential,23280,73973,0,97253
142438100500000,SE 223,Residential,23280,91294,0,114574
142438100600000,SE 223,Residential,23280,89039,0,112319
142438100700000,SE 223,Residential,24056,95487,0,119543
142438100800000,SE 223,Residential,24806,130512,0,155318
142438100900000,SE 223,Residential,21452,93725,0,115177
142438101000000,SE 223,Residential,21049,91099,0,112148
142438101100000,SE 223,Residential,20370,76116,0,96486
142438101200000,SE 223,Residential,20370,66630,0,87000
142438101300000,SE 223,Residential,20370,79594,0,99964
142438101400000,SE 223,Residential,20370,66369,0,86739
142438101500000,SE 223,Residential,20370,93946,0,114316
142438101600000,SE 223,Residential,26880,88595,0,115475
142438101700000,SE 223,Residential,25200,107341,0,132541
142440100100000,SE 220,Residential,38890,287501,0,326391
142440200100000,SE 220,Residential,44080,173340,0,217420
142440200200000,SE 220,Residential,6700,0,0,6700
142440200400000,SE 220,Residential,103820,284779,0,388599
142440200500000,SE 220,Residential,152620,494837,0,647457
142440200600000,SE 220,Residential,42667,158881,0,201548
142440200700000,SE 220,Residential,43264,231792,0,275056
142440200800000,SE 220,Residential,48336,192668,0,241004
142440200900000,SE 220,Residential,63000,241016,0,304016
142440201000000,SE 220,Residential,43942,161090,0,205032
142440201100000,SE 220,Residential,44475,222786,0,267261
142440201200000,SE 220,Residential,44080,124145,0,168225
142440201300000,SE 220,Residential,41240,160815,0,202055
142440201400000,SE 220,Residential,43904,161247,0,205151
142440201500000,SE 220,Residential,42397,203919,0,246316
142440201600000,SE 220,Residential,42960,145343,0,188303
142440201700000,SE 220,Residential,46862,152651,0,199513
142440201800000,SE 220,Residential,46400,158664,0,205064
142440300100000,SE 220,Residential,34048,182232,0,216280
142440300200000,SE 220,Residential,39342,230944,0,270286
142440400100000,SE 220,Residential,33317,153597,0,186914
142440400200000,SE 220,Residential,46683,120920,0,167603
142440400300000,SE 220,Residential,41885,185525,0,227410
142440400400000,SE 220,Residential,38443,210273,0,248716
142440400500000,SE 220,Residential,35733,244134,0,279867
142440400600000,SE 220,Residential,34920,157754,0,192674
142440400700000,SE 220,Residential,33618,162230,0,195848
142440400800000,SE 220,Residential,38216,212167,0,250383
142440400900000,SE 220,Residential,37060,205727,0,242787
142440401000000,SE 220,Residential,39324,282656,0,321980
142440401100000,SE 220,Residential,4900,0,0,4900
142440401200000,SE 220,Residential,40624,212060,0,252684
142440401300000,SE 220,Residential,37595,151561,0,189156
142442600200000,SE 220,Residential,80070,213951,0,294021
142442600400000,SE 220,Residential,72320,288196,0,360516
142442600500000,SE 220,Residential,100600,296756,0,397356
142442600600000,SE 220,Residential,91300,258581,0,349881
142442600700000,SE 220,Residential,106200,263666,0,369866
142442600800000,SE 220,Residential,103920,264095,0,368015
142442600900000,SE 220,Residential,98520,235459,0,333979
142442601000000,SE 220,Residential,99800,937564,0,1037364
142442601100000,SE 220,Residential,120650,392406,0,513056
142442700100000,SE 221,Residential,37674,140949,0,178623
142442700200000,SE 221,Residential,35390,151084,0,186474
142442700300000,SE 221,Residential,33647,133279,0,166926
142442700400000,SE 221,Residential,33711,154950,0,188661
142442700500000,SE 221,Residential,32000,110978,0,142978
142442700600000,SE 221,Residential,75457,232287,0,307744
142442700700000,SE 221,Residential,50520,0,0,50520
142442700800000,SE 221,Residential,68513,255074,0,323587
142442700900000,SE 221,Residential,65726,233826,0,299552
142442701000000,SE 221,Residential,70640,270149,0,340789
142442701100000,SE 221,Residential,65767,287704,0,353471
142442701200000,SE 223,Residential,50000,114209,0,164209
142442701600000,SE 221,Residential,52380,0,0,52380
142442701800000,SE 221,Residential,34144,53931,0,88075
142442701900000,SE 221,Residential,33696,121201,0,154897
142442702200000,SE 221,Residential,61150,364427,0,425577
142442702400000,SE 221,Residential,32000,142307,0,174307
142442702500000,SE 221,Residential,32000,154381,0,186381
142442702600000,SE 221,Residential,32500,121685,0,154185
142442702700000,SE 221,Residential,35401,148599,0,184000
142442702800000,SE 221,Residential,38548,156429,0,194977
142442702900000,SE 221,Residential,38455,133391,0,171846
142442703000000,SE 221,Residential,20,0,0,20
142442703100000,SE 221,Residential,20,0,0,20
142442703400000,SE 221,Residential,62800,215400,0,278200
142442800100000,SE 223,Residential,56450,45908,0,102358
142442800200000,E-15 CITY,Exempt,0,0,0,0
142445100100000,SE 220,Residential,101120,374193,0,475313
142445100200000,SE 220,Residential,103820,335421,0,439241
142445100300000,SE 220,Residential,106820,279089,0,385909
142445100400000,SE 220,Residential,102520,335252,0,437772
142445100501000,CONDO 501,Residential,14000,175947,0,189947
142445100501001,CONDO 501,Residential,12000,160321,0,172321
142445100501002,CONDO 501,Residential,14000,182531,0,196531
142445100501003,CONDO 501,Residential,7000,113926,0,120926
142445100501004,CONDO 501,Residential,13000,148312,0,161312
142445100501005,CONDO 501,Residential,7000,117065,0,124065
142445100501006,CONDO 501,Residential,11000,121643,0,132643
142445100501007,CONDO 501,Residential,10000,138817,0,148817
142445100501008,CONDO 501,Residential,10000,143761,0,153761
142445100501009,CONDO 501,Residential,12000,141175,0,153175
142445100501010,CONDO 501,Residential,16000,207647,0,223647
142445100501011,CONDO 501,Residential,16000,195241,0,211241
142445100501012,CONDO 501,Residential,14000,185319,0,199319
142445100501013,CONDO 501,Residential,13000,160118,0,173118
142445100501014,CONDO 501,Residential,13000,158734,0,171734
142445100501015,CONDO 501,Residential,12000,152324,0,164324
142445100501016,CONDO 501,Residential,12000,163281,0,175281
142445100601000,CONDO 501,Residential,27000,262516,0,289516
142445100601001,CONDO 501,Residential,27000,317391,0,344391
142445100601002,CONDO 501,Residential,27000,213809,0,240809
142445100601003,CONDO 501,Residential,27000,207527,0,234527
142445100601004,CONDO 501,Residential,27000,221979,0,248979
142445100601005,CONDO 501,Residential,27000,173430,0,200430
142445100601006,CONDO 501,Residential,27000,171965,0,198965
142445100601007,CONDO 501,Residential,27000,224597,0,251597
142445100601008,CONDO 501,Residential,27000,193947,0,220947
142445100601009,CONDO 501,Residential,27000,168119,0,195119
142445100601010,CONDO 501,Residential,27000,119050,0,146050
142445100601011,CONDO 501,Residential,27000,176805,0,203805
142445100601012,CONDO 501,Residential,27000,191849,0,218849
142445100601013,CONDO 501,Residential,27000,186241,0,213241
142445100601014,CONDO 501,Residential,27000,128083,0,155083
142445100601015,CONDO 501,Residential,27000,110878,0,137878
142445100601016,CONDO 501,Residential,27000,137497,0,164497
142445100601017,CONDO 501,Residential,27000,146559,0,173559
142445100601018,CONDO 501,Residential,27000,165303,0,192303
142445100601019,CONDO 501,Exempt,27000,0,133465,160465
142445100601020,CONDO 501,Residential,27000,134869,0,161869
142445100601021,CONDO 501,Residential,27000,136428,0,163428
142445100601022,CONDO 501,Residential,27000,121013,0,148013
142445100601023,CONDO 501,Residential,27000,176330,0,203330
142445100700000,SE 220,Residential,101120,395400,0,496520
142445100800000,SE 220,Residential,85820,375886,0,461706
142445100900000,SE 220,Residential,82340,360267,0,442607
142445200101000,CONDO 501,Residential,15000,103022,0,118022
142445200101001,CONDO 501,Residential,15000,102422,0,117422
142445200101002,CONDO 501,Residential,15000,102422,0,117422
142445200101003,CONDO 501,Residential,15000,103154,0,118154
142445200101004,CONDO 501,Residential,15000,104383,0,119383
142445200101005,CONDO 501,Residential,15000,102422,0,117422
142445200101006,CONDO 501,Residential,15000,104383,0,119383
142445200101007,CONDO 501,Residential,15000,104383,0,119383
142445200101008,CONDO 501,Residential,15000,104383,0,119383
142445200101009,CONDO 501,Residential,15000,104383,0,119383
142445200101010,CONDO 501,Residential,15000,104383,0,119383
142445200101011,CONDO 501,Residential,15000,104383,0,119383
142445200101012,CONDO 501,Residential,15000,141616,0,156616
142445200101013,CONDO 501,Residential,15000,137177,0,152177
142445200101014,CONDO 501,Residential,15000,103154,0,118154
142445200101015,CONDO 501,Residential,15000,102422,0,117422
142445200101016,CONDO 501,Residential,15000,136082,0,151082
142445200101017,CONDO 501,Residential,15000,133162,0,148162
142445200101018,CONDO 501,Residential,15000,115692,0,130692
142445200101019,CONDO 501,Residential,15000,138741,0,153741
142445200101020,CONDO 501,Residential,15000,140309,0,155309
142445200101021,CONDO 501,Residential,15000,141693,0,156693
142445200101022,CONDO 501,Residential,15000,133424,0,148424
142445200101023,CONDO 501,Residential,15000,131793,0,146793
142445200101024,CONDO 501,Residential,15000,151525,0,166525
142445200101025,CONDO 501,Residential,15000,130067,0,145067
142445200101026,CONDO 501,Residential,15000,130616,0,145616
142445200200000,SE 223,Residential,5200,0,0,5200
142445200300000,SE 223,Residential,30084,70153,0,100237
142445200400000,SE 223,Residential,29627,89282,0,118909
142445200500000,SE 223,Residential,31108,103886,0,134994
142445200600000,SE 223,Residential,32832,124202,0,157034
142445200800000,SE 221,Residential,32148,134991,0,167139
142445300100000,SE 223,Residential,27589,155535,0,183124
142445300200000,SE 223,Residential,27619,143291,0,170910
142445300300000,SE 222,Residential,28408,148417,0,176825
142445300400000,SE 223,Residential,28125,163119,0,191244
142445300500000,SE 223,Residential,28215,93487,0,121702
142445300600000,SE 223,Residential,27032,93118,0,120150
142445300700000,SE 223,Residential,26784,97131,0,123915
142445300800000,SE 223,Residential,26288,107357,0,133645
142445300900000,SE 223,Residential,26932,114406,0,141338
142445400100000,SE 222,Residential,24710,118336,0,143046
142445400200000,SE 223,Residential,23775,105904,0,129679
142445400300000,SE 223,Residential,23775,108537,0,132312
142445400400000,SE 223,Residential,23775,93320,0,117095
142445400500000,SE 223,Residential,23678,99174,0,122852
142445400600000,SE 223,Residential,23873,76359,0,100232
142445400700000,SE 223,Residential,24328,119848,0,144176
142445400800000,SE 223,Residential,24328,53336,0,77664
142445400900000,SE 223,Residential,24328,91659,0,115987
142445401000000,SE 223,Residential,24230,73400,0,97630
142447600100000,SE 220,Residential,40128,193926,0,234054
142447600200000,SE 220,Residential,42933,222607,0,265540
142447600300000,SE 220,Residential,34200,239594,0,273794
142447600400000,SE 220,Residential,45798,172083,0,217881
142447600500000,SE 220,Residential,26700,316057,0,342757
142447600600000,SE 220,Residential,30386,0,0,30386
142447600700000,SE 220,Residential,42372,183348,0,225720
142447600800000,SE 220,Residential,37579,135359,0,172938
142447600900000,SE 220,Residential,33368,129394,0,162762
142447601000000,SE 220,Residential,32703,129581,0,162284
142447601100000,SE 220,Residential,43180,227977,0,271157
142447601200000,SE 233,Residential,43656,131964,0,175620
142447601300000,SE 233,Residential,1200,0,0,1200
142447601400000,COMM SE,Commercial,74768,0,39936,114704
142447601700000,SE 233,Residential,12400,26378,0,38778
142447601800000,SE 233,Residential,11600,19992,0,31592
142447601900000,SE 233,Residential,695,0,0,695
142447602000000,SE 233,Residential,20240,0,0,20240
142447700100000,SE 220,Residential,40115,178922,0,219037
142447700200000,SE 220,Residential,140020,615285,0,755305
142447700300000,SE 220,Residential,100720,326244,0,426964
142447700400000,SE 220,Residential,82320,556537,0,638857
142447700500000,SE 220,Residential,100920,247750,0,348670
142447700600000,SE 220,Residential,119820,392817,0,512637
142447700700000,SE 220,Residential,102820,287180,0,390000
142447700800000,SE 220,Residential,78420,348822,0,427242
142447700900000,E-15 CITY,Exempt,0,0,0,0
142447700902000,COMM SE,Commercial,0,0,36731,36731
142447700902001,COMM SE,Commercial,0,0,84918,84918
142447701000000,SE 233,Residential,40950,83342,0,124292
142447701100000,SE 233,Residential,40200,45817,0,86017
142447701300000,SE 220,Residential,41040,228947,0,269987
142447701400000,SE 220,Residential,41269,214542,0,255811
142447701500000,SE 220,Residential,39179,141357,0,180536
142447701600000,SE 220,Residential,39200,143442,0,182642
142447701700000,SE 220,Residential,39200,148058,0,187258
142447701800000,SE 220,Residential,39200,152272,0,191472
142510100400000,SE 233,Residential,37640,0,0,37640
142510100700000,SE 233,Residential,36500,0,0,36500
142510100800000,SE 233,Residential,37000,210189,0,247189
142510100900000,SE 233,Residential,37000,0,0,37000
142510101000000,SE 233,Residential,37500,0,0,37500
142510101100000,SE 233,Residential,37350,248031,0,285381
142510101200000,SE 233,Residential,37350,0,0,37350
142510101300000,SE 233,Residential,52450,185572,0,238022
142512600100000,COMM SE,Commercial,92500,0,0,92500
142512600300000,COMM SE,Commercial,257364,0,436602,693966
142512600400000,COMM SE,Commercial,110717,0,144159,254876
142512600500000,COMM SE,Commercial,99250,0,0,99250
142512600600000,COMM SE,Commercial,152582,0,519580,672162
142515100200000,SE 246,Residential,152200,0,0,152200
142515100700000,SE 246,Residential,74356,315477,0,389833
142515100800000,SE 246,Residential,73566,542437,0,616003
142515100900000,SE 246,Residential,92610,286640,0,379250
142515101000000,SE 246,Residential,74670,250062,0,324732
142515101100000,SE 246,Residential,67900,256482,0,324382
142515101200000,SE 246,Residential,70700,276549,0,347249
142520100100000,COMM SE,Commercial,223020,0,0,223020
142520100200000,COMM SE,Commercial,681210,0,2844790,3526000
142520100300000,COMM SE,Commercial,226503,0,151540,378043
142520100400000,COMM SE,Commercial,362880,0,736463,1099343
142520100500000,SE 234,Residential,19075,47829,0,66904
142520100600000,SE 234,Residential,16975,44302,0,61277
142520100700000,SE 234,Residential,16975,49534,0,66509
142520100800000,SE 234,Residential,16800,53900,0,70700
142520100900000,SE 234,Residential,21571,58343,0,79914
142520101000000,SE 234,Residential,20939,64382,0,85321
142520101100000,SE 234,Residential,22000,69630,0,91630
142520101200000,SE 234,Residential,21200,81780,0,102980
142520101300000,SE 234,Residential,19800,65433,0,85233
142520101400000,SE 234,Residential,18587,65386,0,83973
142520101501000,CONDO 504,Residential,22000,114342,0,136342
142520101501001,CONDO 504,Residential,22000,124592,0,146592
142520101501002,CONDO 504,Residential,22000,133715,0,155715
142520101501003,CONDO 504,Residential,22000,126621,0,148621
142520101501004,CONDO 504,Residential,22000,126655,0,148655
142520101501005,CONDO 504,Residential,22000,144411,0,166411
142520101501006,CONDO 504,Residential,22000,131740,0,153740
142520101501007,CONDO 504,Exempt,22000,0,120662,142662
142520101501008,CONDO 504,Residential,22000,140601,0,162601
142520101501009,CONDO 504,Residential,22000,134191,0,156191
142520101501010,CONDO 504,Residential,22000,140388,0,162388
142520101501011,CONDO 504,Residential,22000,115410,0,137410
142520101501012,CONDO 504,Residential,22000,136650,0,158650
142520101501013,CONDO 504,Residential,22000,123842,0,145842
142520101501014,CONDO 504,Residential,22000,141964,0,163964
142520101501015,CONDO 504,Residential,22000,142895,0,164895
142520101501016,CONDO 504,Residential,22000,146768,0,168768
142520101501017,CONDO 504,Residential,22000,143006,0,165006
142520101501018,CONDO 504,Residential,22000,124569,0,146569
142520101501020,CONDO 504,Residential,22000,141996,0,163996
142520101501021,CONDO 504,Residential,22000,120030,0,142030
142520101501022,CONDO 504,Residential,22000,120103,0,142103
142520101501023,CONDO 504,Residential,22000,126643,0,148643
142520101600000,SE 234,Residential,22000,70068,0,92068
142520101700000,SE 234,Residential,23560,75157,0,98717
142520101800000,SE 234,Residential,24480,75779,0,100259
142520101900000,SE 234,Residential,24113,74021,0,98134
142520102000000,SE 234,Residential,22240,85610,0,107850
142520102100000,SE 234,Residential,23714,74738,0,98452
142520102200000,SE 234,Residential,23760,75481,0,99241
142520102300000,SE 234,Residential,23760,86579,0,110339
142520102400000,SE 234,Residential,23760,66137,0,89897
142520102500000,SE 234,Residential,23760,83764,0,107524
142520102600000,SE 234,Residential,23760,77267,0,101027
142520102700000,SE 234,Residential,23760,67350,0,91110
142520102800000,SE 234,Residential,23760,88364,0,112124
142520102900000,E-73 LOW RENT HOUSE,Exempt,302400,0,2114617,2417017
142520200100000,SE 234,Residential,17325,66102,0,83427
142520200200000,SE 234,Residential,17500,58347,0,75847
142520200300000,SE 234,Residential,17500,55694,0,73194
142520200400000,SE 234,Residential,18594,54021,0,72615
142520200500000,SE 234,Residential,20000,78579,0,98579
142520200600000,SE 234,Residential,20000,71367,0,91367
142520200700000,SE 234,Residential,20000,59381,0,79381
142520200800000,SE 234,Residential,20000,66779,0,86779
142520200900000,SE 234,Residential,20000,61285,0,81285
142520201000000,SE 234,Residential,20000,74483,0,94483
142520201100000,SE 234,Residential,19800,73010,0,92810
142520201200000,SE 234,Residential,19800,62881,0,82681
142520201300000,SE 234,Residential,20000,62176,0,82176
142520201400000,SE 234,Residential,20000,76297,0,96297
142520201500000,SE 234,Residential,20000,75161,0,95161
142520201600000,SE 234,Residential,20000,63529,0,83529
142520201700000,SE 234,Residential,22991,80303,0,103294
142520201800000,SE 234,Residential,23112,76849,0,99961
142520300100000,SE 234,Residential,22405,69424,0,91829
142520300200000,SE 234,Residential,22458,65874,0,88332
142520300300000,SE 234,Residential,22053,82693,0,104746
142520300400000,SE 234,Residential,22053,71210,0,93263
142520300500000,SE 234,Residential,24049,75191,0,99240
142520300600000,SE 234,Residential,24000,84842,0,108842
142520300700000,SE 234,Residential,24000,83926,0,107926
142520300800000,SE 234,Residential,24000,79139,0,103139
142520300900000,SE 234,Residential,24000,77293,0,101293
142520301000000,SE 234,Residential,24000,76601,0,100601
142520301100000,SE 234,Residential,24000,73703,0,97703
142520301200000,SE 234,Residential,24000,81151,0,105151
142520301300000,E-10 COUNTY,Exempt,0,0,0,0
142522600100000,SE 234,Residential,26507,54610,0,81117
142522600200000,SE 234,Residential,22800,55476,0,78276
142522600300000,SE 234,Residential,20000,75938,0,95938
142522600400000,SE 234,Residential,20000,69220,0,89220
142522700100000,SE 234,Residential,27057,53550,0,80607
142522700200000,SE 234,Residential,20506,48312,0,68818
142522700300000,SE 234,Residential,21609,48296,0,69905
142522700400000,SE 234,Residential,21829,66131,0,87960
142522700500000,SE 234,Residential,21829,70721,0,92550
142522700600000,E-70 CHARITY OTHER,Exempt,181710,0,141594,323304
142522700700000,COMM SE,Commercial,69984,0,93876,163860
142522700800000,SE 234,Residential,23940,96045,0,119985
142522700900000,SE 234,Residential,22464,69865,0,92329
142522701000000,SE 234,Residential,23055,86683,0,109738
142522701100000,SE 234,Residential,22600,77575,0,100175
142522701200000,SE 234,Residential,22600,89254,0,111854
142522701300000,SE 234,Residential,22721,81147,0,103868
142522701400000,SE 234,Residential,27600,55953,0,83553
142522701500000,SE 234,Residential,23000,79776,0,102776
142522701600000,SE 234,Residential,23000,81332,0,104332
142522701700000,SE 234,Residential,23000,60538,0,83538
142522701800000,SE 234,Residential,23000,85228,0,108228
142522701900000,SE 234,Residential,24399,63534,0,87933
142522702000000,SE 234,Residential,24453,86614,0,111067
142522702100000,SE 234,Residential,28679,95397,0,124076
142522702200000,SE 234,Residential,27120,90522,0,117642
142522702300000,SE 234,Residential,27120,68740,0,95860
142522702400000,SE 234,Residential,27225,93356,0,120581
142522702500000,SE 234,Residential,24039,89110,0,113149
142522702600000,SE 234,Residential,23575,91864,0,115439
142522702700000,SE 234,Residential,23387,85279,0,108666
142522702800000,SE 234,Residential,23970,81754,0,105724
142522702900000,SE 234,Residential,23218,83169,0,106387
142522703000000,SE 234,Residential,23218,76418,0,99636
142522703100000,SE 234,Residential,23218,62964,0,86182
142522703200000,SE 234,Residential,23465,84920,0,108385
142522703300000,SE 234,Residential,24206,70376,0,94582
142522703400000,SE 234,Residential,24700,80801,0,105501
142522703500000,SE 234,Residential,24000,73622,0,97622
142522703600000,SE 234,Residential,24000,61369,0,85369
142522703700000,SE 234,Residential,24000,69974,0,93974
142522703800000,SE 234,Residential,24000,63275,0,87275
142522703900000,SE 234,Residential,24000,77169,0,101169
142522704000000,SE 234,Residential,25200,79265,0,104465
142522704100000,SE 234,Residential,26293,89386,0,115679
142522704200000,SE 234,Residential,26520,88146,0,114666
142522704300000,SE 234,Residential,28576,75244,0,103820
142522704400000,SE 234,Residential,26550,81241,0,107791
142522704500000,SE 234,Residential,24192,59419,0,83611
142522704600000,SE 234,Residential,23407,53347,0,76754
142522800100000,COMM SE,Commercial,615600,0,760011,1375611
142522800200000,COMM SE,Commercial,191797,0,248158,439955
142522800300000,SE 234,Residential,28930,93889,0,122819
142522800400000,SE 234,Residential,28854,137994,0,166848
142522800500000,SE 234,Residential,30143,112280,0,142423
142522800600000,SE 234,Residential,23575,110580,0,134155
142522800700000,SE 234,Residential,25219,81705,0,106924
142522800800000,SE 234,Residential,26208,88870,0,115078
142522800900000,SE 234,Residential,26083,89104,0,115187
142522801000000,SE 234,Residential,25110,101732,0,126842
142522801100000,SE 234,Residential,23465,107771,0,131236
142522801200000,SE 234,Residential,24054,84611,0,108665
142522801300000,SE 234,Residential,28600,72512,0,101112
142522801400000,SE 234,Residential,23333,79006,0,102339
142522801500000,SE 234,Residential,29359,106098,0,135457
142522801600000,SE 234,Residential,28080,113230,0,141310
142522801700000,SE 234,Residential,29948,89668,0,119616
142522802700000,SE 234,Residential,24027,78562,0,102589
142522900100000,SE 234,Residential,28000,92010,0,120010
142522900200000,SE 234,Residential,24700,67289,0,91989
142522900300000,SE 234,Residential,24700,74319,0,99019
142522900400000,SE 234,Residential,25242,61700,0,86942
142522900500000,SE 234,Residential,25068,70158,0,95226
142522900600000,SE 234,Residential,25200,63367,0,88567
142522900700000,SE 234,Residential,22564,70764,0,93328
142522900800000,SE 234,Residential,22996,84208,0,107204
142522900900000,SE 234,Residential,23200,72608,0,95808
142522901000000,SE 234,Residential,23200,66890,0,90090
142522901100000,SE 234,Residential,23200,80529,0,103729
142522901200000,SE 234,Residential,23786,91486,0,115272
142522901300000,SE 234,Residential,23546,84487,0,108033
142522901400000,SE 234,Residential,23546,73652,0,97198
142522901500000,SE 234,Residential,23546,80898,0,104444
142522901600000,SE 234,Residential,23040,85101,0,108141
142522901700000,SE 234,Residential,23040,73659,0,96699
142522901800000,SE 234,Residential,23040,76555,0,99595
142522901900000,SE 234,Residential,23008,86765,0,109773
142522902100000,SE 234,Residential,24768,81966,0,106734
142522902200000,SE 234,Residential,23040,75507,0,98547
142522902300000,SE 234,Residential,23040,72501,0,95541
142522902400000,SE 234,Residential,23040,84433,0,107473
142522902500000,SE 234,Residential,23040,80839,0,103879
142522902600000,SE 234,Residential,22825,75757,0,98582
142522902700000,SE 234,Residential,23786,80231,0,104017
142522902900000,SE 234,Residential,23200,64586,0,87786
142522903000000,SE 234,Residential,23200,75545,0,98745
142522903100000,SE 234,Residential,23200,73515,0,96715
142522903200000,SE 234,Residential,23160,49600,0,72760
142522903300000,SE 234,Residential,22400,66378,0,88778
142522903400000,SE 234,Residential,25568,62955,0,88523
142522903500000,SE 234,Residential,25704,65769,0,91473
142522903600000,SE 234,Residential,31680,69031,0,100711
142523000100000,SE 234,Residential,22714,67740,0,90454
142523000200000,SE 234,Residential,24816,72323,0,97139
142523000300000,SE 234,Residential,24109,75273,0,99382
142523000400000,SE 234,Residential,20680,69177,0,89857
142523000500000,SE 234,Residential,21340,56060,0,77400
142523000600000,SE 234,Residential,21780,69555,0,91335
142523000700000,SE 234,Residential,25200,69080,0,94280
142523000800000,SE 234,Residential,26460,77083,0,103543
142523000900000,SE 234,Residential,27165,124957,0,152122
142523001000000,Empty,Exempt,0,0,0,0
142523100100000,SE 234,Residential,23814,103242,0,127056
142523100200000,SE 234,Residential,22504,136108,0,158612
142523100300000,SE 234,Residential,23814,80316,0,104130
142523100400000,SE 234,Residential,25715,77329,0,103044
142523100500000,SE 234,Residential,25957,96528,0,122485
142523100600000,SE 234,Residential,25761,96685,0,122446
142523100700000,SE 234,Residential,23800,99058,0,122858
142523100800000,SE 234,Residential,24816,103226,0,128042
142523100900000,SE 234,Residential,25285,85124,0,110409
142523101000000,SE 234,Residential,37578,152894,0,190472
142523101100000,SE 234,Residential,38112,168792,0,206904
142523101200000,SE 234,Residential,35910,0,0,35910
142523101300000,SE 234,Residential,12631,0,0,12631
142523101400000,SE 234,Residential,24826,100359,0,125185
142523101500000,SE 234,Residential,24361,96615,0,120976
142523101600000,SE 234,Residential,24361,129349,0,153710
142523101700000,SE 234,Residential,25567,106705,0,132272
142523101800000,SE 234,Residential,30780,105911,0,136691
142523200100000,SE 234,Residential,21357,0,0,21357
142523200200000,SE 234,Residential,35213,318000,0,353213
142523200300000,SE 234,Residential,1156,0,0,1156
142525100100000,SE 234,Residential,26160,71589,0,97749
142525100200000,SE 234,Residential,26880,84901,0,111781
142525100300000,SE 234,Residential,27600,82175,0,109775
142525100400000,SE 234,Residential,25920,70276,0,96196
142525100500000,SE 234,Residential,25626,75413,0,101039
142525200100000,SE 234,Residential,26695,76305,0,103000
142525200200000,SE 234,Residential,22708,66950,0,89658
142525300100000,SE 234,Residential,25600,77196,0,102796
142525300200000,SE 234,Residential,24480,84137,0,108617
142525300300000,SE 234,Residential,24279,83184,0,107463
142525300400000,SE 234,Residential,24000,83822,0,107822
142525300500000,SE 234,Residential,24304,79492,0,103796
142525300600000,SE 234,Residential,24056,87418,0,111474
142525300700000,SE 234,Residential,24704,90691,0,115395
142525300800000,SE 234,Residential,24954,83165,0,108119
142525300900000,SE 234,Residential,23333,84271,0,107604
142525301000000,SE 234,Residential,24077,75294,0,99371
142525301100000,SE 234,Residential,23773,105088,0,128861
142525301200000,SE 234,Residential,23773,90911,0,114684
142525301300000,SE 234,Residential,23773,83080,0,106853
142525301400000,SE 234,Residential,25080,102457,0,127537
142525301500000,SE 234,Residential,25330,91588,0,116918
142525301600000,SE 234,Residential,24960,88355,0,113315
142525301700000,SE 234,Residential,24000,90926,0,114926
142525301800000,SE 234,Residential,24800,77321,0,102121
142525301900000,SE 234,Residential,24667,81779,0,106446
142525302000000,SE 234,Residential,24303,81216,0,105519
142525302100000,SE 234,Residential,23746,90566,0,114312
142525302200000,SE 234,Residential,23959,87392,0,111351
142525302300000,SE 234,Residential,23959,109347,0,133306
142525302400000,SE 234,Residential,23959,85321,0,109280
142525302500000,SE 234,Residential,23959,70209,0,94168
142525302600000,SE 234,Residential,22861,88361,0,111222
142525302700000,SE 234,Residential,22887,80642,0,103529
142525302800000,SE 234,Residential,23099,78463,0,101562
142525302900000,SE 234,Residential,22982,65731,0,88713
142525303000000,SE 234,Residential,22983,68811,0,91794
142525303100000,SE 234,Residential,23347,83957,0,107304
142525400100000,SE 234,Residential,22610,96206,0,118816
142525400200000,SE 234,Residential,34240,175746,0,209986
142525400300000,SE 234,Residential,25680,0,0,25680
142525400400000,SE 234,Residential,25680,144159,0,169839
142525400500000,SE 234,Residential,25680,133940,0,159620
142525400600000,SE 234,Residential,25680,153508,0,179188
142525400700000,SE 234,Residential,25680,125583,0,151263
142525400800000,SE 234,Residential,27820,0,0,27820
142525400900000,SE 234,Residential,27989,0,0,27989
142525401000000,SE 234,Residential,28627,165241,0,193868
142525401100000,SE 234,Residential,39421,190133,0,229554
142525401200000,SE 234,Residential,26854,82987,0,109841
142525401300000,SE 234,Residential,29462,112403,0,141865
142525401400000,SE 234,Residential,27506,104759,0,132265
142525401500000,SE 234,Residential,23520,92267,0,115787
142525401600000,SE 234,Residential,25220,72042,0,97262
142525401700000,SE 234,Residential,25440,70986,0,96426
142525401800000,SE 234,Residential,27600,116250,0,143850
142525401900000,SE 234,Residential,29040,86014,0,115054
142525402000000,SE 234,Residential,27600,84607,0,112207
142525402100000,SE 234,Residential,23760,74138,0,97898
142525402200000,SE 234,Residential,25714,76379,0,102093
142525402300000,SE 234,Residential,25273,84816,0,110089
142525402400000,SE 234,Residential,24000,70184,0,94184
142525402500000,SE 234,Residential,24000,63630,0,87630
142525402600000,SE 234,Residential,24000,70658,0,94658
142525402700000,SE 234,Residential,24000,70664,0,94664
142525402800000,SE 234,Residential,25213,69123,0,94336
142525402900000,SE 234,Residential,24948,102217,0,127165
142525403000000,SE 234,Residential,24192,101195,0,125387
142525403100000,SE 234,Residential,23688,83022,0,106710
142525403200000,SE 234,Residential,22685,83509,0,106194
142525403300000,SE 234,Residential,22560,90604,0,113164
142525403400000,SE 234,Residential,22560,73638,0,96198
142525403500000,SE 234,Residential,22560,90860,0,113420
142525500100000,SE 234,Residential,34880,203581,0,238461
142525500200000,SE 234,Residential,26160,190631,0,216791
142525500300000,SE 234,Residential,26160,0,0,26160
142525500400000,SE 234,Residential,26160,203629,0,229789
142525500500000,SE 234,Residential,26160,194033,0,220193
142525500600000,SE 234,Residential,26160,174289,0,200449
142525500700000,SE 234,Residential,28340,182384,0,210724
142525500800000,SE 234,Residential,28340,150651,0,178991
142525500900000,SE 234,Residential,27508,204997,0,232505
142525501000000,SE 234,Residential,24767,0,0,24767
142525501100000,SE 234,Residential,24240,107189,0,131429
142525501200000,SE 234,Residential,24420,82392,0,106812
142525600100000,SE 234,Residential,23579,73933,0,97512
142525600200000,SE 234,Residential,23728,70979,0,94707
142525600300000,SE 234,Residential,24043,86340,0,110383
142525600400000,SE 234,Residential,24515,74052,0,98567
142525600500000,SE 234,Residential,24515,82991,0,107506
142525600600000,SE 234,Residential,24231,69442,0,93673
142525600700000,SE 234,Residential,24607,84696,0,109303
142525600800000,SE 234,Residential,25004,86290,0,111294
142525600900000,SE 234,Residential,25293,94705,0,119998
142525601000000,SE 234,Residential,25425,73750,0,99175
142525601100000,SE 234,Residential,23968,67023,0,90991
142525601200000,SE 234,Residential,23760,80618,0,104378
142525601300000,SE 234,Residential,25536,88450,0,113986
142525601400000,SE 234,Residential,26387,92933,0,119320
142525601500000,SE 234,Residential,25200,72652,0,97852
142525601600000,SE 234,Residential,24192,78261,0,102453
142525601700000,SE 234,Residential,27973,78663,0,106636
142525601800000,SE 234,Residential,29678,109703,0,139381
142525601900000,SE 234,Residential,27472,91937,0,119409
142525602000000,SE 234,Residential,26502,124681,0,151183
142525602100000,SE 234,Residential,27720,115210,0,142930
142525602200000,SE 234,Residential,27133,113136,0,140269
142525602300000,SE 234,Residential,23688,105920,0,129608
142525602400000,SE 234,Residential,24473,94639,0,119112
142525602500000,SE 234,Residential,25519,80929,0,106448
142525602600000,SE 234,Residential,23465,86468,0,109933
142525602700000,SE 234,Residential,23280,81461,0,104741
142525602800000,SE 234,Residential,23760,59550,0,83310
142525700100000,SE 234,Residential,25920,68811,0,94731
142525700200000,SE 234,Residential,26160,71080,0,97240
142525700300000,SE 234,Residential,27032,76052,0,103084
142525700400000,SE 234,Residential,26219,72550,0,98769
142525700500000,SE 234,Residential,26232,64424,0,90656
142525700600000,SE 234,Residential,25920,91511,0,117431
142525700700000,SE 234,Residential,25200,80526,0,105726
142525700800000,SE 234,Residential,27058,78345,0,105403
142525700900000,SE 234,Residential,26600,69508,0,96108
142525701000000,SE 234,Residential,25800,88783,0,114583
142525701100000,SE 234,Residential,92400,0,0,92400
142525701201000,CONDO 501,Residential,12000,158442,0,170442
142525701201001,CONDO 501,Residential,12000,133625,0,145625
142525701201002,CONDO 501,Residential,12000,143000,0,155000
142525701201003,CONDO 501,Residential,12000,189004,0,201004
142525701201004,CONDO 501,Residential,12000,0,0,12000
142525701201005,CONDO 501,Residential,12000,0,0,12000
142525701201006,CONDO 501,Residential,12000,0,0,12000
142525701201007,CONDO 501,Residential,12000,0,0,12000
142525701201008,CONDO 501,Residential,12000,0,0,12000
142525701201009,CONDO 501,Residential,12000,0,0,12000
142525701201010,CONDO 501,Residential,12000,0,0,12000
142525701201011,CONDO 501,Residential,12000,0,0,12000
142525701201012,CONDO 501,Residential,12000,0,0,12000
142525701201013,CONDO 501,Residential,12000,0,0,12000
142525701201014,CONDO 501,Residential,12000,154438,0,166438
142525701201015,CONDO 501,Residential,12000,159418,0,171418
142525800100000,SE 234,Residential,24000,97177,0,121177
142525800200000,SE 234,Residential,24000,88598,0,112598
142525800300000,SE 234,Residential,24000,69175,0,93175
142525800400000,SE 234,Residential,24000,90034,0,114034
142525800500000,SE 234,Residential,24000,95751,0,119751
142525800600000,SE 234,Residential,23520,93115,0,116635
142525800700000,SE 234,Residential,24000,91902,0,115902
142525800800000,SE 234,Residential,24000,86587,0,110587
142525800900000,SE 234,Residential,24000,135539,0,159539
142525801000000,SE 234,Residential,23853,95455,0,119308
142525801100000,SE 234,Residential,23760,93130,0,116890
142525801200000,SE 234,Residential,23760,78596,0,102356
142527600100000,SE 234,Residential,26803,64169,0,90972
142527600200000,SE 234,Residential,24966,118976,0,143942
142527600300000,SE 234,Residential,22861,95719,0,118580
142527600400000,SE 234,Residential,22560,83472,0,106032
142527600500000,SE 234,Residential,23688,81805,0,105493
142527600600000,SE 234,Residential,22861,97894,0,120755
142527600700000,SE 234,Residential,22504,104733,0,127237
142527600800000,SE 234,Residential,22504,107773,0,130277
142527600900000,SE 234,Residential,22861,102619,0,125480
142527601000000,SE 234,Residential,22504,79503,0,102007
142527601100000,SE 234,Residential,23182,87061,0,110243
142527700100000,SE 234,Residential,23932,100783,0,124715
142527700200000,SE 234,Residential,23760,75482,0,99242
142527700300000,SE 234,Residential,23760,74477,0,98237
142527700400000,SE 234,Residential,23760,98373,0,122133
142527700500000,SE 234,Residential,23760,67527,0,91287
142527700600000,SE 234,Residential,23760,72574,0,96334
142527700700000,SE 234,Residential,25021,84484,0,109505
142527700800000,SE 234,Residential,24310,81379,0,105689
142527700900000,SE 234,Residential,16352,84569,0,100921
142527701000000,SE 234,Residential,16900,5092,0,21992
142527701100000,SE 234,Residential,24700,95609,0,120309
142527701200000,SE 234,Residential,24453,99549,0,124002
142527800100000,SE 234,Residential,24000,82744,0,106744
142527800200000,SE 234,Residential,24000,81059,0,105059
142527800300000,SE 234,Residential,24000,64489,0,88489
142527800400000,SE 234,Residential,24000,72987,0,96987
142527800500000,SE 234,Residential,24400,65740,0,90140
142527800600000,SE 234,Residential,24566,74454,0,99020
142527900100000,SE 234,Residential,24169,71800,0,95969
142527900200000,SE 234,Residential,25155,105590,0,130745
142527900300000,SE 234,Residential,24662,102215,0,126877
142527900400000,SE 234,Residential,23429,85071,0,108500
142527900500000,SE 234,Residential,23182,81066,0,104248
142527900600000,SE 234,Residential,23485,97463,0,120948
142527900700000,SE 234,Residential,23182,84714,0,107896
142527900800000,SE 234,Residential,23182,102518,0,125700
142527900900000,SE 234,Residential,23182,81671,0,104853
142527901000000,SE 234,Residential,23182,132225,0,155407
142527901100000,SE 234,Residential,23676,91619,0,115295
142527901200000,SE 234,Residential,23397,76877,0,100274
142527901300000,SE 234,Residential,23778,78937,0,102715
142527901400000,SE 234,Residential,23643,76225,0,99868
142527901500000,SE 234,Residential,25160,70210,0,95370
142527901600000,SE 234,Residential,24800,86200,0,111000
142527901700000,SE 234,Residential,24304,94070,0,118374
142527901800000,SE 234,Residential,24185,80799,0,104984
142527901900000,SE 234,Residential,24674,108690,0,133364
142527902000000,SE 234,Residential,24370,103075,0,127445
142527902100000,SE 234,Residential,24824,74289,0,99113
142527902200000,SE 234,Residential,26107,106196,0,132303
142527902300000,SE 234,Residential,25217,46193,0,71410
142527902400000,SE 234,Residential,29900,62789,0,92689
142527902500000,SE 234,Residential,23654,86346,0,110000
142528000100000,SE 234,Residential,24000,11477,0,35477
142528000200000,SE 234,Residential,24000,86731,0,110731
142528000300000,SE 234,Residential,25432,80260,0,105692
142528000400000,SE 234,Residential,26964,115286,0,142250
142528000500000,SE 234,Residential,26969,88723,0,115692
142528000600000,SE 234,Residential,28548,77099,0,105647
142528000700000,SE 234,Residential,28477,79317,0,107794
142528000800000,SE 234,Residential,28477,86784,0,115261
142528000900000,SE 234,Residential,28220,102848,0,131068
142528001000000,SE 234,Residential,28304,85913,0,114217
142528001100000,SE 234,Residential,27600,89804,0,117404
142528001200000,SE 234,Residential,27251,70389,0,97640
142528001300000,SE 234,Residential,24832,73213,0,98045
142528001400000,SE 234,Residential,27044,73522,0,100566
142528001500000,SE 234,Residential,45850,0,0,45850
142528001600000,SE 234,Residential,61040,0,0,61040
142528001700000,SE 234,Residential,53410,0,0,53410
142528001800000,SE 234,Residential,53900,0,0,53900
142528001900000,SE 234,Residential,53900,248102,0,302002
142528002000000,SE 234,Residential,53900,0,0,53900
142528002100000,SE 234,Residential,32000,0,0,32000
142528002200000,SE 234,Residential,51839,281603,0,333442
142528002300000,SE 234,Residential,32000,0,0,32000
142528002400000,SE 234,Residential,32000,0,0,32000
142528002500000,SE 234,Residential,57899,335077,0,392976
142528002600000,SE 234,Residential,55327,296423,0,351750
142528002700000,SE 234,Residential,56479,0,0,56479
142528002800000,SE 234,Residential,60480,308913,0,369393
142528002900000,SE 234,Residential,60480,332304,0,392784
142528003000000,SE 234,Residential,55000,0,0,55000
142528003100000,SE 234,Residential,52430,264592,0,317022
142528003200000,SE 234,Residential,59360,285771,0,345131
142528003300000,E-15 CITY,Exempt,0,0,0,0
142528100100000,SE 234,Residential,28053,68645,0,96698
142528100200000,SE 234,Residential,23192,84209,0,107401
142528100300000,SE 234,Residential,23760,60859,0,84619
142528100400000,SE 234,Residential,23760,59752,0,83512
142528100500000,SE 234,Residential,23760,85485,0,109245
142528100600000,SE 234,Residential,23760,74126,0,97886
142528100700000,SE 234,Residential,23760,97971,0,121731
142528100800000,SE 234,Residential,23760,59942,0,83702
142528100900000,SE 234,Residential,23760,68601,0,92361
142528101000000,SE 234,Residential,28349,77980,0,106329
142528101100000,SE 234,Residential,25600,72667,0,98267
142528101200000,SE 234,Residential,32950,0,0,32950
142528200100000,SE 234,Residential,25106,80383,0,105489
142528200200000,SE 234,Residential,24000,79239,0,103239
142528200300000,SE 234,Residential,24000,78131,0,102131
142528200400000,SE 234,Residential,23760,72346,0,96106
142528200500000,SE 234,Residential,23760,76484,0,100244
142528200600000,SE 234,Residential,23760,72068,0,95828
142528200700000,SE 234,Residential,23760,72954,0,96714
142528200800000,SE 234,Residential,23760,75999,0,99759
142528300100000,SE 234,Residential,23760,74186,0,97946
142528300200000,SE 234,Residential,23760,69850,0,93610
142528400100000,SE 234,Residential,23760,71421,0,95181
142528400200000,SE 234,Residential,27574,103678,0,131252
142530100100000,SE 239,Residential,59100,0,0,59100
142530100300000,SE 239,Residential,71875,175049,0,246924
142530100400000,SE 239,Residential,71875,9557,0,81432
142530100500000,SE 239,Residential,47781,234058,0,281839
142530100600000,SE 239,Residential,42420,183531,0,225951
142530100700000,SE 239,Residential,50400,288247,0,338647
142530100800000,SE 239,Residential,53125,214988,0,268113
142530100900000,SE 239,Residential,63913,215982,0,279895
142530101000000,SE 239,Residential,60646,253655,0,314301
142530101100000,SE 239,Residential,66299,286527,0,352826
142530101200000,SE 239,Residential,61086,308880,0,369966
142530101300000,SE 239,Residential,62160,286366,0,348526
142530101400000,SE 239,Residential,54390,243427,0,297817
142530101500000,SE 246,Residential,62905,227218,0,290123
142530101600000,SE 246,Residential,59916,0,0,59916
142530101700000,SE 246,Residential,54920,208397,0,263317
142530101800000,SE 246,Residential,58853,9016,0,67869
142530101900000,SE 246,Residential,57818,267303,0,325121
142530102000000,E-15 CITY,Exempt,0,0,0,0
142530102100000,SE 246,Residential,54075,289967,0,344042
142530102200000,SE 246,Residential,56700,227589,0,284289
142530102300000,SE 246,Residential,56021,259955,0,315976
142530200100000,SE 239,Residential,45816,0,0,45816
142530200200000,SE 246,Residential,74200,0,0,74200
142530300100000,SE 246,Residential,55578,304376,0,359954
142530300200000,SE 246,Residential,52020,241341,0,293361
142530300300000,SE 246,Residential,53104,256868,0,309972
142530300400000,SE 246,Residential,52675,223404,0,276079
142530300500000,SE 246,Residential,57117,249785,0,306902
142530300600000,SE 246,Residential,57120,202303,0,259423
142530300700000,SE 246,Residential,55162,285436,0,340598
142530300800000,SE 246,Residential,55064,221122,0,276186
142530300900000,SE 246,Residential,51461,0,0,51461
142530301000000,SE 246,Residential,50190,0,0,50190
142532600100000,SE 239,Residential,125700,0,0,125700
142532600300000,SE 239,Residential,49600,60870,0,110470
142532600600000,SE 239,Residential,49550,123343,0,172893
142532600700000,SE 239,Residential,49800,89734,0,139534
142532600800000,SE 239,Residential,59300,137673,0,196973
142532600900000,SE 239,Residential,40000,109487,0,149487
142532601001000,CONDO 501,Residential,12000,92930,0,104930
142532601001001,CONDO 501,Residential,12000,91320,0,103320
142532601001002,CONDO 501,Residential,12000,98717,0,110717
142532601001003,CONDO 501,Residential,12000,89932,0,101932
142532601001004,CONDO 501,Residential,12000,0,0,12000
142532601001005,CONDO 501,Residential,12000,0,0,12000
142532601001006,CONDO 501,Residential,12000,0,0,12000
142532601001007,CONDO 501,Residential,12000,0,0,12000
142532601001008,CONDO 501,Residential,12000,0,0,12000
142532601001009,CONDO 501,Residential,12000,0,0,12000
142532601001010,CONDO 501,Residential,12000,0,0,12000
142532601001011,CONDO 501,Residential,12000,0,0,12000
142532601001012,CONDO 501,Residential,12000,0,0,12000
142532601001013,CONDO 501,Residential,12000,0,0,12000
142532601001014,CONDO 501,Residential,12000,227685,0,239685
142532601001015,CONDO 501,Residential,12000,0,0,12000
142532601001016,CONDO 501,Residential,12000,0,0,12000
142532601001017,CONDO 501,Residential,12000,199562,0,211562
142532601001018,CONDO 501,Residential,12000,0,0,12000
142532601001019,CONDO 501,Residential,12000,0,0,12000
142532601001020,CONDO 501,Residential,12000,0,0,12000
142532601001021,CONDO 501,Residential,12000,0,0,12000
142532601001022,CONDO 501,Residential,12000,5123,0,17123
142532601001023,CONDO 501,Residential,12000,5123,0,17123
142532601001024,CONDO 501,Residential,12000,5123,0,17123
142532601001025,CONDO 501,Residential,12000,5123,0,17123
142532601100000,SE 239,Residential,8949,0,0,8949
142532601200000,SE 239,Residential,8949,0,0,8949
142532601300000,SE 239,Residential,6861,0,0,6861
142532601400000,SE 239,Residential,66126,164068,0,230194
142532601500000,SE 239,Residential,54023,190547,0,244570
142532601600000,SE 239,Residential,10739,0,0,10739
142532601700000,SE 239,Residential,8353,0,0,8353
142532601800000,SE 239,Residential,6861,0,0,6861
142532601900000,SE 239,Residential,8054,0,0,8054
142540100500000,SE 246,Residential,79867,109957,0,189824
142540100600000,SE 246,Residential,77093,0,0,77093
142540100700000,SE 246,Residential,73320,0,0,73320
142540100800000,SE 246,Residential,71879,382242,0,454121
142540100900000,SE 246,Residential,71265,0,0,71265
142540101000000,SE 246,Residential,73283,0,0,73283
142540101100000,SE 246,Residential,71658,358703,0,430361
142540101200000,SE 246,Residential,115855,306053,0,421908
142540101300000,SE 246,Residential,87668,265204,0,352872
142540101400000,SE 246,Residential,86036,385719,0,471755
142540101500000,SE 246,Residential,82311,0,0,82311
142540101700000,SE 246,Residential,85061,288117,0,373178
142540101800000,SE 246,Residential,88307,274536,0,362843
142540101900000,SE 246,Residential,125740,641243,0,766983
142540200100000,SE 246,Residential,83026,309191,0,392217
142540200200000,SE 246,Residential,92232,283721,0,375953
142540200300000,SE 246,Residential,82047,268689,0,350736
142540200400000,SE 246,Residential,9982,0,0,9982
142540200500000,SE 246,Residential,5942,0,0,5942
142540200600000,SE 246,Residential,5986,0,0,5986
142540200700000,SE 246,Residential,5264,0,0,5264
142540200800000,SE 246,Residential,5533,0,0,5533
142540200900000,SE 246,Residential,9556,0,0,9556
142540201000000,SE 246,Residential,6906,0,0,6906
142540201100000,SE 246,Residential,4834,0,0,4834
142540201200000,SE 246,Residential,5469,0,0,5469
142540201300000,SE 246,Residential,97378,300822,0,398200
142540201400000,SE 246,Residential,7927,0,0,7927
142540201500000,SE 246,Residential,5620,0,0,5620
142540201600000,SE 246,Residential,5733,0,0,5733
142540201700000,SE 246,Residential,8019,0,0,8019
142540201800000,SE 246,Residential,11614,0,0,11614
142542600100000,SE 246,Residential,72143,233857,0,306000
142542600200000,SE 246,Residential,69767,357097,0,426864
142542600300000,SE 246,Residential,77880,268787,0,346667
142542600400000,SE 246,Residential,73383,230334,0,303717
142542600500000,SE 246,Residential,64492,257777,0,322269
142542600600000,SE 246,Residential,55500,0,0,55500
142542700100000,SE 246,Residential,71140,284976,0,356116
142542700200000,SE 246,Residential,56862,262680,0,319542
142542700300000,SE 246,Residential,55283,271590,0,326873
142542700400000,SE 246,Residential,60067,321390,0,381457
142542700500000,SE 246,Residential,71383,376523,0,447906
142542700600000,SE 246,Residential,73523,320355,0,393878
142542700700000,SE 246,Residential,71370,269436,0,340806
142542700800000,SE 246,Residential,71797,285949,0,357746
142542800100000,SE 246,Residential,80784,287081,0,367865
142542800200000,SE 246,Residential,100100,344098,0,444198
142542800300000,SE 246,Residential,57720,308744,0,366464
142542800400000,SE 246,Residential,57068,339795,0,396863
142542800500000,SE 246,Residential,58240,285982,0,344222
142542800600000,SE 246,Residential,60600,298125,0,358725
142542900100000,SE 246,Residential,55500,0,0,55500
142542900200000,SE 246,Residential,90020,282420,0,372440
142542900300000,SE 246,Residential,125800,0,0,125800
142542900400000,SE 246,Residential,60473,227623,0,288096
142542900500000,SE 246,Residential,68950,234522,0,303472
142542900600000,SE 246,Residential,66640,220976,0,287616
142542900700000,SE 246,Residential,49000,341779,0,390779
142542900800000,SE 246,Residential,49000,229952,0,278952
142542900900000,SE 246,Residential,51000,250958,0,301958
142542901000000,SE 246,Residential,53500,249417,0,302917
142542901100000,E-15 CITY,Exempt,0,0,0,0
142610100100000,COMM SE,Commercial,220438,0,340122,560560
142610100200000,COMM SE,Commercial,175932,0,585,176517
142610100300000,COMM SE,Commercial,129470,0,318936,448406
142610100400000,SE 234,Residential,25200,66800,0,92000
142610100500000,SE 234,Residential,21000,73263,0,94263
142610100600000,SE 234,Residential,23280,98434,0,121714
142610100700000,SE 234,Residential,24444,75262,0,99706
142610100800000,SE 234,Residential,21728,83995,0,105723
142610100900000,SE 234,Residential,20176,76565,0,96741
142610101000000,SE 234,Residential,23956,85551,0,109507
142610101100000,SE 234,Residential,24266,80123,0,104389
142610200100000,COMM SE,Commercial,64994,0,97910,162904
142610200200000,SE 234,Residential,15604,61916,0,77520
142610200300000,SE 234,Residential,15246,60657,0,75903
142610200400000,SE 234,Residential,15581,71671,0,87252
142610200500000,SE 234,Residential,18720,65844,0,84564
142610200600000,SE 234,Residential,18720,65266,0,83986
142610200700000,SE 234,Residential,20800,74874,0,95674
142610200800000,SE 234,Residential,22680,72391,0,95071
142610200900000,SE 234,Residential,22680,43660,0,66340
142610300100000,COMM SE,Commercial,38404,0,102225,140629
142610300200000,COMM SE,Commercial,199800,0,387843,587643
142610300800000,SE 234,Residential,15593,36886,0,52479
142610300900000,SE 234,Residential,17487,47513,0,65000
142610301000000,SE 234,Residential,23280,81562,0,104842
142610301100000,SE 234,Residential,21340,55318,0,76658
142610301200000,SE 234,Residential,27518,95356,0,122874
142610301300000,SE 234,Residential,22562,76942,0,99504
142610301400000,SE 234,Residential,19614,102736,0,122350
142610301500000,SE 234,Residential,19879,74704,0,94583
142610301600000,SE 234,Residential,16820,64854,0,81674
142610400100000,SE 234,Residential,61800,102251,0,164051
142610400200000,SE 234,Residential,18931,115540,0,134471
142610400300000,SE 234,Residential,20792,0,0,20792
142610400400000,SE 234,Residential,25654,101370,0,127024
142610400500000,SE 234,Residential,25856,105735,0,131591
142610400600000,SE 234,Residential,25856,103683,0,129539
142610400700000,SE 234,Residential,25856,104492,0,130348
142610400800000,SE 234,Residential,25856,86562,0,112418
142610400900000,SE 234,Residential,26300,126361,0,152661
142610401000000,SE 233,Residential,23956,81930,0,105886
142610401100000,SE 234,Residential,24266,68745,0,93011
142610401200000,SE 234,Residential,22176,74445,0,96621
142610401300000,SE 234,Residential,22070,75315,0,97385
142610401400000,SE 234,Residential,22070,80861,0,102931
142610401500000,SE 234,Residential,22070,85703,0,107773
142610401600000,SE 234,Residential,22070,68844,0,90914
142610401700000,SE 234,Residential,22070,97886,0,119956
142610401800000,SE 234,Residential,55000,156186,0,211186
142610401900000,SE 234,Residential,22070,84994,0,107064
142610402000000,SE 234,Residential,22070,74032,0,96102
142610402100000,SE 234,Residential,22070,74993,0,97063
142610402200000,SE 234,Residential,22070,80596,0,102666
142610402300000,SE 234,Residential,22070,108920,0,130990
142610402400000,SE 234,Residential,22176,100757,0,122933
142610402500000,SE 234,Residential,21000,99398,0,120398
142610402600000,SE 234,Residential,21000,62413,0,83413
142610402700000,SE 234,Residential,21000,41245,0,62245
142610402800000,SE 234,Residential,21000,71061,0,92061
142610402900000,SE 234,Residential,21000,94569,0,115569
142610403000000,SE 234,Residential,21000,66324,0,87324
142610403100000,SE 234,Residential,21000,60718,0,81718
142610403200000,SE 234,Residential,21000,66693,0,87693
142610403300000,SE 234,Residential,21000,105483,0,126483
142610403400000,SE 234,Residential,21000,62981,0,83981
142610403500000,SE 234,Residential,29400,109108,0,138508
142610403600000,SE 234,Residential,21000,93986,0,114986
142610403700000,SE 234,Residential,27703,60050,0,87753
142610403800000,SE 234,Residential,26880,77634,0,104514
142610403900000,SE 234,Residential,26775,77510,0,104285
142610404000000,SE 234,Residential,35700,85911,0,121611
142610500100000,SE 234,Residential,24000,65362,0,89362
142610500200000,SE 234,Residential,24000,58621,0,82621
142610500300000,SE 234,Residential,24000,71745,0,95745
142610500400000,SE 234,Residential,24307,47475,0,71782
142610500500000,SE 234,Residential,20800,70871,0,91671
142610500600000,SE 234,Residential,20160,77619,0,97779
142610500700000,SE 234,Residential,21600,72283,0,93883
142610500800000,SE 234,Residential,22000,83755,0,105755
142610500900000,SE 234,Residential,22200,62517,0,84717
142610501000000,SE 234,Residential,28305,104192,0,132497
142610501100000,SE 234,Residential,28050,89228,0,117278
142610501200000,SE 234,Residential,26683,97160,0,123843
142610501300000,SE 234,Residential,26656,65881,0,92537
142610501400000,SE 234,Residential,21400,59864,0,81264
142610501500000,SE 234,Residential,21400,47122,0,68522
142610501600000,SE 234,Residential,21400,76188,0,97588
142610501700000,SE 234,Residential,21400,65636,0,87036
142610501800000,SE 234,Residential,21400,70601,0,92001
142610501900000,SE 234,Residential,21400,65669,0,87069
142610502000000,SE 234,Residential,21400,75793,0,97193
142610502100000,SE 234,Residential,21400,76167,0,97567
142610502200000,SE 234,Residential,21400,63968,0,85368
142610600100000,SE 234,Residential,25167,100588,0,125755
142610600200000,SE 234,Residential,28050,94362,0,122412
142610600300000,SE 234,Residential,24780,80472,0,105252
142610600400000,SE 234,Residential,30570,109204,0,139774
142610600500000,SE 234,Residential,23038,63625,0,86663
142610600600000,SE 234,Residential,21542,74355,0,95897
142610600700000,SE 234,Residential,19740,62283,0,82023
142610600800000,SE 234,Residential,22793,60980,0,83773
142610600900000,SE 234,Residential,22971,73831,0,96802
142610601000000,SE 234,Residential,19260,80940,0,100200
142610601100000,SE 234,Residential,19440,56828,0,76268
142610601200000,SE 234,Residential,24288,97888,0,122176
142610601300000,SE 234,Residential,24402,75956,0,100358
142610700100000,SE 234,Residential,25582,70838,0,96420
142610700200000,SE 234,Residential,20400,53570,0,73970
142610700300000,SE 234,Residential,20400,76076,0,96476
142610700400000,SE 234,Residential,20800,67749,0,88549
142610700500000,SE 234,Residential,21000,67790,0,88790
142610700600000,SE 234,Residential,21600,100225,0,121825
142610700700000,SE 234,Residential,26964,113815,0,140779
142610700800000,SE 234,Residential,26964,66480,0,93444
142610700900000,SE 234,Residential,23540,67272,0,90812
142610701000000,SE 234,Residential,23320,71976,0,95296
142610701100000,SE 234,Residential,41796,104665,0,146461
142610800100000,SE 234,Residential,20160,74342,0,94502
142610800200000,SE 234,Residential,29131,87978,0,117109
142610800300000,SE 234,Residential,25376,85388,0,110764
142610800400000,SE 234,Residential,25256,103489,0,128745
142610800500000,SE 234,Residential,26123,125658,0,151781
142610800600000,SE 234,Residential,25000,72598,0,97598
142610800700000,SE 234,Residential,35464,119851,0,155315
142610800800000,SE 234,Residential,34720,98910,0,133630
142610800900000,SE 234,Residential,21400,70861,0,92261
142610801000000,SE 234,Residential,27285,87203,0,114488
142610801100000,SE 234,Residential,27285,98699,0,125984
142610801200000,SE 234,Residential,29325,105500,0,134825
142610801300000,SE 234,Residential,29325,73337,0,102662
142612600100000,COMM SE,Commercial,89813,0,280179,369992
142612600200000,COMM SE,Commercial,163039,0,312808,475847
142612600300000,COMM SE,Commercial,163296,0,194138,357434
142612600400000,SE 234,Residential,27709,106315,0,134024
142612600500000,COMM SE,Commercial,134784,0,50728,185512
142612600600000,COMM SE,Commercial,48853,0,95827,144680
142612600700000,COMM SE,Commercial,70308,0,383805,454113
142612600800000,SE 234,Residential,36960,58040,0,95000
142612600900000,SE 234,Residential,23199,76327,0,99526
142612601000000,SE 234,Residential,25440,89226,0,114666
142612601100000,SE 234,Residential,24480,107914,0,132394
142612601200000,SE 234,Residential,24480,124426,0,148906
142612601300000,SE 234,Residential,23261,108454,0,131715
142612601400000,SE 234,Residential,24863,128814,0,153677
142612601500000,SE 234,Residential,24499,88563,0,113062
142612601600000,SE 234,Residential,25024,117855,0,142879
142612601700000,SE 234,Residential,24558,132229,0,156787
142612601800000,SE 234,Residential,22932,93965,0,116897
142612601900000,SE 234,Residential,23218,107554,0,130772
142612602000000,SE 234,Residential,23220,100260,0,123480
142612602100000,SE 234,Residential,25688,80619,0,106307
142612602200000,SE 234,Residential,22880,81447,0,104327
142612602300000,SE 234,Residential,22880,92851,0,115731
142612602400000,SE 234,Residential,22880,107716,0,130596
142612602500000,SE 234,Residential,22880,109815,0,132695
142612602600000,SE 234,Residential,22880,85134,0,108014
142612602700000,SE 234,Residential,22880,68893,0,91773
142612602800000,SE 234,Residential,22880,95067,0,117947
142612602900000,SE 234,Residential,22880,82321,0,105201
142612603000000,SE 234,Residential,22880,66967,0,89847
142612603100000,SE 234,Residential,22880,84643,0,107523
142612603200000,SE 234,Residential,22880,50472,0,73352
142612603300000,SE 234,Residential,22880,73413,0,96293
142612603400000,E-15 CITY,Exempt,0,0,0,0
142612603500000,SE 234,Residential,24505,65649,0,90154
142612603600000,SE 234,Residential,23512,93261,0,116773
142612603700000,SE 234,Residential,23512,83808,0,107320
142612603800000,SE 234,Residential,23512,55220,0,78732
142612603900000,SE 234,Residential,23512,60437,0,83949
142612604000000,SE 234,Residential,23512,76183,0,99695
142612604100000,SE 234,Residential,23512,82734,0,106246
142612604200000,SE 234,Residential,24235,72706,0,96941
142612604300000,SE 234,Residential,24480,95734,0,120214
142612604400000,SE 234,Residential,25208,77040,0,102248
142612604500000,SE 234,Residential,25386,64894,0,90280
142612604600000,SE 234,Residential,25149,70870,0,96019
142612604700000,SE 234,Residential,25080,74996,0,100076
142612604800000,SE 234,Residential,24970,75142,0,100112
142612604900000,SE 234,Residential,26160,63481,0,89641
142612605000000,SE 234,Residential,25816,121005,0,146821
142612605100000,SE 234,Residential,25246,96705,0,121951
142612605200000,SE 234,Residential,25579,105019,0,130598
142612605300000,SE 234,Residential,27342,122958,0,150300
142612605400000,SE 234,Residential,23715,73081,0,96796
142612605500000,SE 234,Residential,24192,78793,0,102985
142612605600000,SE 234,Residential,23959,84702,0,108661
142612605700000,SE 234,Residential,24453,68561,0,93014
142612605800000,SE 234,Residential,25080,60679,0,85759
142612605900000,SE 234,Residential,40500,127103,0,167603
142612606000000,SE 234,Residential,29400,99657,0,129057
142612606100000,SE 234,Residential,26347,94410,0,120757
142612700100000,COMM SE,Commercial,36288,0,28679,64967
142612700200000,COMM SE,Commercial,748440,0,873871,1622311
142612700300000,COMM SE,Commercial,89910,0,216567,306477
142612700400000,APTS SE,Commercial,144720,0,1505280,1650000
142612700500000,SE 234,Residential,35355,48999,0,84354
142612700600000,SE 234,Residential,31099,70034,0,101133
142612700700000,SE 234,Residential,31099,75073,0,106172
142612700800000,SE 234,Residential,31099,88645,0,119744
142612700900000,SE 234,Residential,30347,92052,0,122399
142612701000000,SE 234,Residential,24391,106488,0,130879
142612701100000,SE 234,Residential,23712,93484,0,117196
142612701200000,SE 234,Residential,26208,86985,0,113193
142612701300000,SE 234,Residential,25688,81491,0,107179
142612701400000,SE 234,Residential,24960,98702,0,123662
142612701500000,SE 234,Residential,24960,74040,0,99000
142612701600000,SE 234,Residential,24960,78538,0,103498
142612701700000,SE 234,Residential,24960,77951,0,102911
142612701800000,SE 234,Residential,25688,101708,0,127396
142612701900000,SE 234,Residential,26544,82926,0,109470
142612702000000,SE 234,Residential,26208,81159,0,107367
142612702100000,SE 234,Residential,29400,67759,0,97159
142612702200000,SE 234,Residential,25935,114882,0,140817
142612702300000,Empty,Other,0,0,0,0
142612702400000,COMM SE,Commercial,9979,0,2381,12360
142612702500000,COMM SE,Commercial,45814,0,7795,53609
142612702600000,SE 234,Residential,28350,49276,0,77626
142612702700000,APTS SE,Commercial,10935,0,134715,145650
142612800100000,SE 234,Residential,28162,88313,0,116475
142612800200000,SE 234,Residential,25585,79575,0,105160
142612800300000,SE 234,Residential,26894,132738,0,159632
142612800400000,SE 234,Residential,26742,73172,0,99914
142612800500000,SE 234,Residential,25608,84924,0,110532
142612800600000,SE 234,Residential,23587,106847,0,130434
142612800700000,SE 234,Residential,27151,100953,0,128104
142612800800000,SE 234,Residential,28787,88359,0,117146
142612800900000,SE 234,Residential,23030,90795,0,113825
142612801000000,SE 234,Residential,23280,94972,0,118252
142612801100000,SE 234,Residential,23760,65261,0,89021
142612801200000,SE 234,Residential,24240,80887,0,105127
142612801300000,SE 234,Residential,24480,71539,0,96019
142612801400000,SE 234,Residential,24960,74751,0,99711
142612801500000,SE 234,Residential,26206,84081,0,110287
142612801600000,SE 234,Residential,25688,64212,0,89900
142612801700000,SE 234,Residential,25935,81962,0,107897
142612801800000,SE 234,Residential,25935,67116,0,93051
142612801900000,SE 234,Residential,25666,91100,0,116766
142612802000000,SE 234,Residential,25502,89084,0,114586
142615100100000,SE 234,Residential,25523,81783,0,107306
142615100200000,SE 234,Residential,24960,81140,0,106100
142615100300000,SE 234,Residential,24960,90078,0,115038
142615100400000,SE 234,Residential,24960,74096,0,99056
142615100500000,SE 234,Residential,24960,75010,0,99970
142615100600000,SE 234,Residential,24960,101095,0,126055
142615100700000,SE 234,Residential,24960,76070,0,101030
142615100800000,SE 234,Residential,24960,71155,0,96115
142615100900000,SE 234,Residential,27981,92382,0,120363
142615101000000,SE 234,Residential,24061,63300,0,87361
142615101100000,SE 234,Residential,24544,84358,0,108902
142615101200000,SE 234,Residential,24544,64704,0,89248
142615101300000,SE 234,Residential,25068,66280,0,91348
142615101400000,SE 234,Residential,23383,73847,0,97230
142615101500000,SE 234,Residential,27961,102748,0,130709
142615101600000,SE 234,Residential,24960,87504,0,112464
142615101700000,SE 234,Residential,24960,99274,0,124234
142615101800000,SE 234,Residential,24960,100433,0,125393
142615101900000,SE 234,Residential,24960,94169,0,119129
142615102000000,SE 234,Residential,24960,72540,0,97500
142615102100000,SE 234,Residential,24960,110259,0,135219
142615102200000,SE 234,Residential,24960,79742,0,104702
142615102300000,SE 234,Residential,24000,102467,0,126467
142615102400000,SE 234,Residential,24000,70012,0,94012
142615102500000,SE 234,Residential,25523,93812,0,119335
142615200100000,SE 234,Residential,22405,85978,0,108383
142615200200000,SE 234,Residential,23940,93405,0,117345
142615200300000,SE 234,Residential,24381,74957,0,99338
142615200400000,SE 234,Residential,22800,92891,0,115691
142615200500000,SE 234,Residential,22800,101572,0,124372
142615200600000,SE 234,Residential,19000,66170,0,85170
142615200700000,SE 234,Residential,23732,83913,0,107645
142615300100000,SE 234,Residential,24752,80534,0,105286
142615300200000,SE 234,Residential,26279,57145,0,83424
142615300300000,SE 234,Residential,25709,75047,0,100756
142615300400000,SE 234,Residential,26624,113269,0,139893
142615300500000,SE 234,Residential,24832,93007,0,117839
142615300600000,SE 234,Residential,22528,89598,0,112126
142615300700000,SE 234,Residential,19466,77040,0,96506
142615300800000,SE 234,Residential,23520,81038,0,104558
142615300900000,SE 234,Residential,22050,57215,0,79265
142615301000000,SE 234,Residential,24766,69503,0,94269
142615301100000,SE 234,Residential,29088,87548,0,116636
142615301200000,SE 234,Residential,24398,80463,0,104861
142615301300000,SE 234,Residential,24868,89893,0,114761
142615301400000,SE 234,Residential,24496,85170,0,109666
142615301500000,SE 234,Residential,24000,47662,0,71662
142615301600000,SE 234,Residential,24000,70124,0,94124
142615301700000,SE 234,Residential,24000,87582,0,111582
142615301800000,SE 234,Residential,24000,86408,0,110408
142615400100000,SE 234,Residential,23195,81489,0,104684
142615400200000,SE 234,Residential,22800,75952,0,98752
142615400300000,SE 234,Residential,22800,88237,0,111037
142615400400000,SE 234,Residential,22800,84738,0,107538
142615400500000,SE 234,Residential,22800,66506,0,89306
142615400600000,SE 234,Residential,22800,86780,0,109580
142615400700000,SE 234,Residential,22969,86584,0,109553
142615400800000,SE 234,Residential,25108,111958,0,137066
142615400900000,SE 234,Residential,27432,100607,0,128039
142615401000000,SE 234,Residential,25500,97791,0,123291
142615401100000,SE 234,Residential,25160,71812,0,96972
142615401200000,SE 234,Residential,27600,94381,0,121981
142615401300000,SE 234,Residential,25916,110330,0,136246
142615401400000,SE 234,Residential,25704,110107,0,135811
142615401500000,SE 234,Residential,25114,68112,0,93226
142615500100000,SE 234,Residential,22400,85905,0,108305
142615500200000,SE 234,Residential,22400,99189,0,121589
142615500300000,SE 234,Residential,26432,85353,0,111785
142615500400000,SE 234,Residential,30976,134510,0,165486
142615500500000,SE 234,Residential,36600,123429,0,160029
142615500600000,SE 234,Residential,40425,160162,0,200587
142615500700000,SE 234,Residential,40125,142039,0,182164
142615500800000,SE 234,Residential,24121,133189,0,157310
142615500900000,SE 234,Residential,26129,73609,0,99738
142615501000000,SE 234,Residential,31411,92612,0,124023
142615501100000,SE 234,Residential,42650,188099,0,230749
142615501200000,SE 234,Residential,29200,177108,0,206308
142615501300000,SE 234,Residential,32274,95438,0,127712
142615501400000,SE 234,Residential,27000,106215,0,133215
142615501500000,SE 234,Residential,24968,100180,0,125148
142615501600000,SE 234,Residential,25024,78887,0,103911
142615501700000,SE 234,Residential,25704,120960,0,146664
142615501800000,SE 234,Residential,29648,76687,0,106335
142615501900000,SE 234,Residential,30375,87531,0,117906
142615502000000,SE 234,Residential,22741,74004,0,96745
142615502100000,SE 234,Residential,22893,76959,0,99852
142615502200000,SE 234,Residential,40650,73773,0,114423
142615502300000,SE 234,Residential,27680,154931,0,182611
142615502400000,SE 234,Residential,41575,273947,0,315522
142615502500000,SE 234,Residential,46975,55135,0,102110
142615502600000,SE 234,Residential,31232,66356,0,97588
142615502700000,SE 234,Residential,41075,44554,0,85629
142615502800000,SE 234,Residential,35864,40038,0,75902
142615502900000,SE 234,Residential,24700,72356,0,97056
142615503000000,SE 234,Residential,24700,72788,0,97488
142617600100000,SE 234,Residential,31090,152493,0,183583
142617600200000,SE 234,Residential,20480,64009,0,84489
142617600300000,SE 234,Residential,26237,89655,0,115892
142617600400000,SE 234,Residential,36375,129064,0,165439
142617600500000,SE 234,Residential,38050,132848,0,170898
142617600600000,SE 234,Residential,36125,97895,0,134020
142617600700000,SE 234,Residential,27708,148605,0,176313
142617600800000,SE 234,Residential,28253,101236,0,129489
142617600900000,SE 234,Residential,26203,77913,0,104116
142617601000000,SE 234,Residential,26334,125485,0,151819
142617601100000,SE 234,Residential,25582,82190,0,107772
142617601200000,SE 234,Residential,27086,95226,0,122312
142617601300000,E-15 CITY,Exempt,0,0,0,0
142617601400000,SE 234,Residential,21120,115265,0,136385
142617601500000,SE 234,Residential,21120,120008,0,141128
142617601600000,SE 234,Residential,21018,89674,0,110692
142617601700000,SE 234,Residential,23760,81998,0,105758
142617601800000,SE 234,Residential,23868,81516,0,105384
142617601900000,SE 234,Residential,27664,95894,0,123558
142617602000000,SE 234,Residential,25200,77912,0,103112
142617602100000,SE 234,Residential,25410,109139,0,134549
142617602200000,SE 234,Residential,39816,95886,0,135702
142617602300000,SE 234,Residential,33566,57745,0,91311
142617602400000,SE 234,Residential,36655,134742,0,171397
142617602500000,SE 234,Residential,31752,129255,0,161007
142617602600000,SE 234,Residential,35046,127865,0,162911
142617602701000,CONDO 500,Residential,7500,69925,0,77425
142617602701001,CONDO 500,Residential,3500,48468,0,51968
142617602701002,CONDO 500,Residential,4500,50020,0,54520
142617602701003,CONDO 500,Residential,3500,51823,0,55323
142617602801000,CONDO 500,Residential,4500,47695,0,52195
142617602801001,CONDO 500,Residential,4500,63067,0,67567
142617602801002,CONDO 500,Residential,4500,48004,0,52504
142617602801003,CONDO 500,Residential,4500,50218,0,54718
142617602901000,CONDO 500,Residential,4500,47289,0,51789
142617602901001,CONDO 500,Residential,4500,55265,0,59765
142617602901002,CONDO 500,Residential,4500,48430,0,52930
142617602901003,CONDO 500,Residential,4500,50682,0,55182
142617603001000,CONDO 500,Residential,4500,47094,0,51594
142617603001001,CONDO 500,Residential,4500,55070,0,59570
142617603001002,CONDO 500,Residential,4500,48235,0,52735
142617603001003,CONDO 500,Residential,4500,50487,0,54987
142617603100000,SE 234,Residential,29073,98356,0,127429
142617603200000,SE 234,Residential,29400,100899,0,130299
142617603300000,APTS SE,Commercial,40932,0,505701,546633
142617603400000,Empty,Exempt,0,0,0,0
142617603500000,SE 234,Residential,28277,154083,0,182360
142617603600000,SE 234,Residential,27292,0,0,27292
142617603700000,SE 234,Residential,28546,0,0,28546
142617603800000,SE 234,Residential,24267,0,0,24267
142617603900000,SE 234,Residential,24220,120357,0,144577
142617604000000,SE 234,Residential,22213,111708,0,133921
142617700100000,SE 234,Residential,28904,84648,0,113552
142617700200000,SE 234,Residential,26520,104157,0,130677
142617700300000,SE 234,Residential,28771,72029,0,100800
142617700400000,SE 234,Residential,29772,101303,0,131075
142617700500000,SE 234,Residential,29640,81123,0,110763
142617700600000,SE 234,Residential,31573,70635,0,102208
142617700700000,SE 234,Residential,29440,138820,0,168260
142617700900000,SE 234,Residential,25560,105913,0,131473
142617701000000,SE 234,Residential,25200,100837,0,126037
142617701100000,SE 234,Residential,22187,114637,0,136824
142617701200000,SE 234,Residential,23120,62552,0,85672
142617701400000,SE 234,Residential,30512,68946,0,99458
142617701500000,SE 234,Residential,26520,60386,0,86906
142617800100000,SE 234,Residential,27257,100804,0,128061
142617800200000,SE 234,Residential,24947,69710,0,94657
142617800300000,SE 234,Residential,24888,107262,0,132150
142617800400000,SE 234,Residential,24936,74660,0,99596
142617800500000,SE 234,Residential,23667,68629,0,92296
142617800600000,SE 234,Residential,23586,64225,0,87811
142617800700000,SE 234,Residential,23959,81493,0,105452
142617800800000,SE 234,Residential,24591,77534,0,102125
142617800900000,SE 234,Residential,24616,67451,0,92067
142617801000000,SE 234,Residential,25200,80323,0,105523
142617801100000,SE 234,Residential,24422,88497,0,112919
142617801200000,SE 234,Residential,25459,61818,0,87277
142617801300000,SE 234,Residential,25506,83160,0,108666
142617801400000,SE 234,Residential,26880,111772,0,138652
142620100100000,COMM SE,Commercial,272160,0,145203,417363
142620100200000,SE 235,Residential,17500,70755,0,88255
142620100300000,SE 235,Residential,17500,67016,0,84516
142620100400000,SE 235,Residential,17500,99562,0,117062
142620100500000,SE 235,Residential,31248,78461,0,109709
142620100600000,SE 235,Residential,28215,88346,0,116561
142620100700000,SE 235,Residential,28842,74751,0,103593
142620100800000,SE 235,Residential,28842,140835,0,169677
142620100900000,SE 235,Residential,32291,86260,0,118551
142620101000000,SE 235,Residential,32291,103398,0,135689
142620101100000,SE 235,Residential,26010,86053,0,112063
142620101200000,SE 235,Residential,31622,67994,0,99616
142620101300000,SE 235,Residential,33672,78987,0,112659
142620101400000,SE 235,Residential,49840,93902,0,143742
142620101500000,SE 235,Residential,30520,76990,0,107510
142620101600000,SE 235,Residential,30515,72140,0,102655
142620101700000,SE 235,Residential,30510,61371,0,91881
142620101800000,SE 235,Residential,30505,52169,0,82674
142620101900000,SE 235,Residential,30361,88346,0,118707
142620102000000,SE 235,Residential,25832,18424,0,44256
142620102100000,SE 235,Residential,25832,78755,0,104587
142620102200000,SE 235,Residential,22766,140864,0,163630
142620102300000,SE 235,Residential,29394,107398,0,136792
142620102400000,SE 235,Residential,28340,120354,0,148694
142620200100000,SE 235,Residential,15030,53130,0,68160
142620200200000,SE 235,Residential,16957,69472,0,86429
142620200300000,SE 235,Residential,21168,63625,0,84793
142620200400000,SE 235,Residential,21168,92352,0,113520
142620200500000,SE 235,Residential,24333,87052,0,111385
142620200600000,SE 235,Residential,25000,81712,0,106712
142620200700000,SE 235,Residential,25000,118137,0,143137
142620200800000,SE 235,Residential,25000,92634,0,117634
142620200900000,SE 235,Residential,25000,104329,0,129329
142620201000000,SE 235,Residential,25000,70136,0,95136
142620201100000,SE 235,Residential,25000,93615,0,118615
142620201200000,SE 235,Residential,25000,98612,0,123612
142620201300000,SE 235,Residential,25000,81330,0,106330
142620201400000,SE 235,Residential,25000,66046,0,91046
142620201500000,SE 235,Residential,25000,57798,0,82798
142620201600000,SE 235,Residential,25000,79494,0,104494
142620201700000,SE 235,Residential,25667,84942,0,110609
142620201800000,SE 235,Residential,945,0,0,945
142620201900000,SE 235,Residential,8650,0,0,8650
142620202000000,SE 235,Residential,54700,238216,0,292916
142620202100000,SE 235,Residential,31957,102796,0,134753
142620202200000,SE 235,Residential,28350,99400,0,127750
142620202300000,SE 235,Residential,28125,77833,0,105958
142620202400000,SE 235,Residential,28125,95745,0,123870
142620202500000,SE 235,Residential,24750,65461,0,90211
142620202600000,SE 235,Residential,27787,91006,0,118793
142620202700000,SE 235,Residential,24750,96231,0,120981
142620202800000,SE 235,Residential,24750,94637,0,119387
142620202900000,SE 235,Residential,25200,90073,0,115273
142620300100000,SE 235,Residential,18371,73252,0,91623
142620300200000,SE 235,Residential,17108,81329,0,98437
142620300300000,SE 235,Residential,18835,63803,0,82638
142620300400000,SE 235,Residential,19058,118365,0,137423
142620300500000,SE 235,Residential,27830,82006,0,109836
142620300600000,SE 235,Residential,27600,95183,0,122783
142620300700000,SE 235,Residential,27600,76341,0,103941
142620300800000,SE 235,Residential,27600,88052,0,115652
142620300900000,SE 235,Residential,27600,82710,0,110310
142620301000000,SE 235,Residential,27600,90014,0,117614
142620301100000,SE 235,Residential,27600,84859,0,112459
142620301200000,SE 235,Residential,27600,104185,0,131785
142620301300000,SE 235,Residential,27600,99234,0,126834
142620301400000,SE 235,Residential,27600,114924,0,142524
142620301500000,SE 235,Residential,27231,101059,0,128290
142620301600000,SE 235,Residential,26400,85644,0,112044
142620301700000,SE 235,Residential,1082,0,0,1082
142620301800000,SE 235,Residential,36518,208103,0,244621
142620301900000,SE 235,Residential,32456,96009,0,128465
142620302000000,SE 235,Residential,22725,79681,0,102406
142620302100000,SE 235,Residential,25250,99162,0,124412
142620302200000,SE 235,Residential,25250,81974,0,107224
142620302300000,SE 235,Residential,25250,86928,0,112178
142620302400000,SE 235,Residential,25250,84690,0,109940
142620302500000,SE 235,Residential,25250,71898,0,97148
142620302600000,SE 235,Residential,25250,90396,0,115646
142620302700000,SE 235,Residential,25250,86829,0,112079
142620302800000,SE 235,Residential,25250,115669,0,140919
142620302900000,SE 235,Residential,25250,112486,0,137736
142620303000000,SE 235,Residential,25250,112802,0,138052
142620303100000,SE 235,Residential,37902,92194,0,130096
142620303200000,SE 235,Residential,21500,80971,0,102471
142620400100000,SE 235,Residential,19058,58928,0,77986
142620400200000,COMM SE,Commercial,342900,0,338890,681790
142620400300000,APTS SE,Commercial,15390,0,79610,95000
142620400400000,APTS SE,Commercial,16913,0,101858,118771
142620400500000,APTS SE,Commercial,16103,0,91288,107391
142620400600000,APTS SE,Commercial,17337,0,77663,95000
142620400700000,SE 235,Residential,27210,109256,0,136466
142620400800000,SE 235,Residential,27000,85341,0,112341
142620400900000,SE 235,Residential,27000,82302,0,109302
142620401000000,SE 235,Residential,27000,94259,0,121259
142620401100000,SE 235,Residential,26790,92884,0,119674
142620500100000,SE 235,Residential,26790,93958,0,120748
142620500200000,SE 235,Residential,21488,80040,0,101528
142620500300000,SE 235,Residential,23500,70145,0,93645
142620500400000,SE 235,Residential,23970,86036,0,110006
142620500500000,SE 235,Residential,23500,100193,0,123693
142620500600000,SE 235,Residential,24957,103664,0,128621
142620500700000,SE 235,Residential,38100,145317,0,183417
142620500800000,SE 235,Residential,42049,146246,0,188295
142620500900000,SE 235,Residential,4240,0,0,4240
142620501000000,SE 235,Residential,27723,124924,0,152647
142620501100000,SE 235,Residential,27000,93082,0,120082
142620501200000,SE 235,Residential,27000,68439,0,95439
142620501300000,SE 235,Residential,27000,60896,0,87896
142620501400000,SE 235,Residential,27000,88301,0,115301
142622600100000,COMM SE,Commercial,294300,0,398566,692866
142622600200000,SE 235,Residential,25486,83748,0,109234
142622600300000,SE 235,Residential,15397,55194,0,70591
142622600400000,SE 235,Residential,14994,66608,0,81602
142622600500000,SE 235,Residential,22500,53128,0,75628
142622600600000,SE 235,Residential,22500,74307,0,96807
142622600700000,SE 235,Residential,21600,49145,0,70745
142622600800000,SE 235,Residential,22500,76580,0,99080
142622600900000,SE 235,Residential,27880,99341,0,127221
142622601000000,SE 235,Residential,26250,85140,0,111390
142622601100000,SE 235,Exempt,25626,0,74345,99971
142622601200000,SE 235,Residential,28700,80580,0,109280
142622700100000,SE 235,Residential,16625,81758,0,98383
142622700200000,SE 235,Residential,19332,61056,0,80388
142622700300000,SE 235,Residential,16461,53782,0,70243
142622700400000,SE 235,Residential,22968,63490,0,86458
142622700500000,SE 235,Residential,24404,71602,0,96006
142622700600000,SE 235,Residential,19140,76041,0,95181
142622700700000,SE 235,Residential,24283,78237,0,102520
142622700800000,SE 235,Residential,20380,76118,0,96498
142622700900000,SE 235,Residential,19600,80757,0,100357
142622701000000,SE 235,Residential,16632,55478,0,72110
142622701100000,SE 235,Residential,30600,89501,0,120101
142622701200000,SE 235,Residential,25500,69712,0,95212
142622701300000,SE 235,Residential,25500,72961,0,98461
142622800100000,SE 235,Residential,21538,55281,0,76819
142622800200000,SE 235,Residential,22500,68663,0,91163
142622800300000,SE 235,Residential,21805,68762,0,90567
142622800400000,SE 235,Residential,21805,71190,0,92995
142622800500000,SE 235,Residential,21805,77844,0,99649
142622800600000,SE 235,Residential,21805,74478,0,96283
142622800700000,SE 235,Residential,21805,64454,0,86259
142622800800000,SE 235,Residential,22250,62685,0,84935
142622800900000,SE 235,Residential,22250,100138,0,122388
142622801000000,SE 235,Residential,28200,110456,0,138656
142622801100000,SE 235,Residential,28200,63580,0,91780
142622801200000,SE 235,Residential,28200,72800,0,101000
142622801300000,SE 235,Residential,25850,88411,0,114261
142622900100000,SE 235,Residential,21750,70541,0,92291
142622900200000,SE 235,Residential,21750,67570,0,89320
142622900300000,SE 235,Residential,21750,69160,0,90910
142622900400000,SE 235,Residential,23100,89322,0,112422
142622900500000,SE 235,Residential,22050,70868,0,92918
142622900600000,SE 235,Residential,22050,69765,0,91815
142622900700000,SE 235,Residential,22050,73175,0,95225
142622900800000,SE 235,Residential,22500,81207,0,103707
142622900900000,SE 235,Residential,22250,63683,0,85933
142622901000000,SE 235,Residential,22250,73010,0,95260
142622901100000,SE 235,Residential,22500,55568,0,78068
142622901200000,SE 235,Residential,22050,58017,0,80067
142622901300000,SE 235,Residential,22050,69998,0,92048
142622901400000,SE 235,Residential,22050,79563,0,101613
142623000100000,SE 235,Residential,29362,70978,0,100340
142623000200000,SE 235,Residential,510,0,0,510
142623000300000,SE 235,Residential,28323,88416,0,116739
142623000400000,SE 235,Residential,28547,110688,0,139235
142623000500000,SE 235,Residential,29003,79981,0,108984
142623000600000,SE 235,Residential,37625,89452,0,127077
142623000700000,SE 235,Residential,27567,113138,0,140705
142623000800000,SE 235,Residential,37625,86038,0,123663
142623000900000,SE 235,Residential,40075,97036,0,137111
142623001000000,SE 235,Residential,28175,92224,0,120399
142623001100000,SE 235,Residential,21250,87150,0,108400
142623001200000,SE 235,Residential,23970,55609,0,79579
142623001300000,SE 235,Residential,24480,72179,0,96659
142623001400000,SE 235,Residential,24480,62986,0,87466
142623001500000,SE 235,Residential,26010,64168,0,90178
142623001600000,E-15 CITY,Exempt,0,0,0,0
142623001700000,E-10 COUNTY,Exempt,0,0,0,0
142623001800000,Empty,Other,0,0,0,0
142623001900000,Empty,Other,0,0,0,0
142623002000000,SE 235,Residential,39800,153983,0,193783
142623002100000,SE 235,Residential,39800,103717,0,143517
142625100100000,E-15 CITY,Exempt,0,0,0,0
142627600100000,SE 236,Residential,32640,81521,0,114161
142627600200000,SE 236,Residential,36397,139249,0,175646
142627600300000,SE 236,Residential,35462,133133,0,168595
142627600400000,SE 236,Residential,32810,104768,0,137578
142627600500000,SE 236,Residential,29591,98409,0,128000
142627600600000,SE 236,Residential,23436,99911,0,123347
142627600700000,SE 236,Residential,25048,79534,0,104582
142627600800000,SE 236,Residential,32736,107423,0,140159
142627600900000,SE 236,Residential,27880,89880,0,117760
142627601000000,SE 236,Residential,26400,98922,0,125322
142627601100000,SE 236,Residential,25480,114896,0,140376
142627601200000,SE 236,Residential,26320,99442,0,125762
142627601300000,SE 236,Residential,30132,135966,0,166098
142627601400000,SE 236,Residential,26600,83016,0,109616
142627601500000,SE 236,Residential,24960,95459,0,120419
142627601600000,SE 236,Residential,24444,95644,0,120088
142627601700000,SE 236,Residential,25931,84641,0,110572
142627601800000,SE 236,Residential,25996,89305,0,115301
142627601900000,SE 236,Residential,24341,88840,0,113181
142627602000000,SE 236,Residential,25220,83246,0,108466
142627602100000,SE 236,Residential,25220,74235,0,99455
142627602200000,SE 236,Residential,25996,76748,0,102744
142627602300000,SE 236,Residential,24960,82633,0,107593
142627700100000,SE 236,Residential,36980,160890,0,197870
142627700200000,SE 236,Residential,34608,124728,0,159336
142627700300000,SE 236,Residential,31620,110371,0,141991
142627700400000,SE 236,Residential,23797,88103,0,111900
142627700500000,SE 236,Residential,23074,96455,0,119529
142627700600000,SE 236,Residential,22811,102616,0,125427
142627700700000,SE 236,Residential,22196,77884,0,100080
142627700800000,SE 236,Residential,24800,104409,0,129209
142627700900000,SE 236,Residential,27560,100514,0,128074
142627701000000,SE 236,Residential,31040,94212,0,125252
142627701100000,SE 236,Residential,28000,98340,0,126340
142627701200000,SE 236,Residential,27936,90916,0,118852
142627701300000,SE 236,Residential,26240,89845,0,116085
142627701400000,SE 236,Residential,28200,117039,0,145239
142627701500000,SE 236,Residential,27900,86417,0,114317
142627701600000,SE 236,Residential,28800,85431,0,114231
142627701700000,SE 236,Residential,30000,113323,0,143323
142627701800000,SE 236,Residential,31724,92295,0,124019
142627701900000,SE 236,Residential,30430,115467,0,145897
142627702000000,SE 236,Residential,31848,112590,0,144438
142627702100000,SE 236,Residential,30611,109465,0,140076
142627800100000,SE 236,Residential,23184,96325,0,119509
142627800200000,SE 236,Residential,27720,95064,0,122784
142627800300000,SE 236,Residential,25721,90642,0,116363
142627800400000,SE 236,Residential,27720,94534,0,122254
142627800500000,SE 236,Residential,26069,92043,0,118112
142627800600000,SE 236,Residential,24552,107380,0,131932
142627800700000,SE 236,Residential,26320,100595,0,126915
142627800800000,SE 236,Residential,30031,108012,0,138043
142627800900000,SE 236,Residential,31416,93925,0,125341
142627801000000,SE 236,Residential,48125,106461,0,154586
142627801100000,SE 236,Residential,30600,132044,0,162644
142627801200000,SE 236,Residential,30264,98558,0,128822
142627801300000,SE 237,Residential,26280,86865,0,113145
142627801400000,SE 236,Residential,28812,98569,0,127381
142627801500000,SE 236,Residential,29564,100764,0,130328
142627801600000,SE 236,Residential,31952,114138,0,146090
142627801700000,SE 236,Residential,36309,135775,0,172084
142627801800000,SE 236,Residential,30520,95973,0,126493
142627900100000,SE 236,Residential,26320,78077,0,104397
142627900200000,SE 236,Residential,26400,96822,0,123222
142627900300000,SE 236,Residential,26000,96576,0,122576
142627900400000,SE 236,Residential,26067,88985,0,115052
142627900500000,SE 236,Residential,26260,93540,0,119800
142627900600000,SE 236,Residential,26520,97450,0,123970
142627900700000,SE 236,Residential,27733,92235,0,119968
142627900800000,SE 236,Residential,26901,88806,0,115707
142627900900000,SE 236,Residential,28560,76709,0,105269
142627901000000,SE 236,Residential,28280,84351,0,112631
142627901100000,SE 236,Residential,27720,107022,0,134742
142627901200000,SE 236,Residential,27160,86336,0,113496
142627901300000,SE 236,Residential,28500,91684,0,120184
142627901400000,SE 236,Residential,29269,106236,0,135505
142627901500000,SE 236,Residential,27680,114114,0,141794
142627901600000,SE 236,Residential,29779,104582,0,134361
142627901700000,SE 236,Residential,34340,106288,0,140628
142627901800000,SE 236,Residential,34680,138711,0,173391
142627901900000,SE 236,Residential,33503,107548,0,141051
142627902000000,SE 236,Residential,29508,99208,0,128716
142627902100000,SE 236,Residential,30940,93140,0,124080
142627902200000,SE 236,Residential,31061,106834,0,137895
142627902300000,SE 236,Residential,29376,119093,0,148469
142627902400000,SE 236,Residential,29333,83799,0,113132
142627902500000,SE 236,Residential,22072,82900,0,104972
142627902600000,SE 236,Residential,24440,79227,0,103667
142627902700000,SE 236,Residential,24440,70156,0,94596
142628000100000,SE 236,Residential,22344,99343,0,121687
142628000200000,SE 236,Residential,24375,129617,0,153992
142628000300000,SE 236,Residential,23280,83048,0,106328
142628000400000,SE 236,Residential,22280,60952,0,83232
142628000500000,SE 236,Residential,23280,86550,0,109830
142628000600000,SE 236,Residential,23280,118613,0,141893
142628000700000,SE 236,Residential,24942,105017,0,129959
142628000800000,SE 236,Residential,24450,64461,0,88911
142628000900000,SE 236,Residential,24426,97265,0,121691
142628001000000,SE 236,Residential,24426,92269,0,116695
142628001100000,SE 236,Residential,23197,73027,0,96224
142628001200000,SE 236,Residential,24396,82822,0,107218
142628001300000,SE 236,Residential,7975,0,0,7975
142628100100000,SE 236,Residential,27984,95142,0,123126
142628100200000,SE 236,Residential,25693,92677,0,118370
142628100300000,SE 236,Residential,25668,100345,0,126013
142628100400000,SE 236,Residential,23432,82851,0,106283
142628100500000,SE 236,Residential,23200,78765,0,101965
142628100600000,SE 236,Residential,23200,85415,0,108615
142628100700000,SE 236,Residential,23200,77654,0,100854
142628100800000,SE 236,Residential,24267,102744,0,127011
142628100900000,SE 236,Residential,27160,92104,0,119264
142628101000000,SE 236,Residential,25802,82719,0,108521
142628101100000,SE 236,Residential,26384,90863,0,117247
142628101200000,SE 236,Residential,24573,82850,0,107423
142628200100000,SE 236,Residential,29100,100136,0,129236
142628200200000,SE 236,Residential,30184,95470,0,125654
142628200300000,SE 236,Residential,30639,85956,0,116595
142628200400000,SE 236,Residential,30042,101155,0,131197
142628200500000,SE 236,Residential,30135,95902,0,126037
142628200600000,SE 236,Residential,30380,90372,0,120752
142628200700000,SE 236,Residential,31518,100214,0,131732
142628200800000,SE 236,Residential,31800,113159,0,144959
142628200900000,SE 236,Residential,25440,93866,0,119306
142628201000000,SE 236,Residential,24720,107660,0,132380
142628201100000,SE 236,Residential,23760,87021,0,110781
142628201200000,SE 236,Residential,23040,81013,0,104053
142628201300000,SE 236,Residential,23437,80011,0,103448
142628201400000,SE 236,Residential,23040,91145,0,114185
142630100100000,SE 240,Residential,27353,104002,0,131355
142630100200000,SE 240,Residential,28560,109395,0,137955
142630100300000,SE 240,Residential,28560,86465,0,115025
142630100400000,SE 240,Residential,28560,89896,0,118456
142630100500000,SE 240,Residential,35476,108031,0,143507
142630100600000,SE 240,Residential,48307,154301,0,202608
142630200100000,SE 240,Residential,34079,89080,0,123159
142630200200000,SE 240,Residential,18857,0,0,18857
142630200300000,SE 240,Residential,40950,0,0,40950
142630200400000,SE 240,Residential,59325,247135,0,306460
142630200500000,SE 240,Residential,22247,2753,0,25000
142630200600000,SE 240,Residential,20994,5229,0,26223
142630200700000,SE 240,Residential,20570,4680,0,25250
142630200800000,SE 240,Residential,37696,100332,0,138028
142630200900000,SE 240,Residential,46100,0,0,46100
142630201000000,SE 240,Residential,40450,134047,0,174497
142630201100000,SE 240,Residential,32544,103749,0,136293
142630201200000,SE 240,Residential,42475,0,0,42475
142630201300000,SE 240,Residential,42775,156015,0,198790
142630201400000,SE 240,Residential,36288,103001,0,139289
142630201500000,SE 240,Residential,35243,72938,0,108181
142630201600000,SE 240,Residential,35640,123222,0,158862
142630201700000,SE 240,Residential,34344,99281,0,133625
142630201800000,SE 240,Residential,32724,97478,0,130202
142630300100000,SE 240,Residential,43276,142558,0,185834
142630300200000,SE 240,Residential,38311,71288,0,109599
142630300300000,SE 240,Residential,38111,156021,0,194132
142632600100000,SE 240,Residential,67800,223868,0,291668
142632600200000,E-15 CITY,Exempt,0,0,0,0
142632600300000,SE 240,Residential,39190,22319,0,61509
142632601100000,SE 240,Residential,44667,114365,0,159032
142632602100000,SE 240,Residential,43701,153964,0,197665
142635100100000,SE 242,Residential,10000,0,0,10000
142635100200000,SE 242,Ag Dwelling,12065,50855,1889,64809
142637600100000,SE 240,Residential,33650,0,0,33650
142637600200000,SE 240,Residential,40000,118933,0,158933
142637700100000,SE 240,Residential,41950,62293,0,104243
142637700200000,SE 240,Residential,34650,0,0,34650
142637700300000,E-15 CITY,Exempt,0,0,0,0
142637700400000,E-15 CITY,Exempt,0,0,0,0
142637700500000,SE 240,Residential,45275,134250,0,179525
142637700600000,SE 240,Residential,35251,76206,0,111457
142637700700000,SE 240,Residential,46525,110202,0,156727
142637700800000,SE 240,Residential,42375,116817,0,159192
142640100100000,APTS SE,Commercial,54540,0,462768,517308
142640100200000,APTS SE,Commercial,49680,0,475105,524785
142640100300000,APTS SE,Commercial,224640,0,1208053,1432693
142640100400000,SE 239,Residential,37760,90106,0,127866
142640100500000,SE 239,Residential,51650,146803,0,198453
142640100600000,E-40 CHURCHES,Exempt,30537,0,54001,84538
142640100700000,SE 239,Residential,53475,76043,0,129518
142640100800000,SE 239,Residential,50724,0,0,50724
142640100900000,SE 239,Residential,50724,0,0,50724
142640101201000,CONDO 500,Residential,4000,34914,0,38914
142640101201001,CONDO 500,Residential,4000,34914,0,38914
142640101201002,CONDO 500,Residential,4000,34914,0,38914
142640101201003,CONDO 500,Residential,4000,34914,0,38914
142640101201004,CONDO 500,Residential,4000,34914,0,38914
142640101201005,CONDO 500,Residential,4000,34914,0,38914
142640101201006,CONDO 500,Residential,4000,34914,0,38914
142640101201007,CONDO 500,Residential,4000,34914,0,38914
142640101201008,CONDO 500,Residential,4000,34914,0,38914
142640101201009,CONDO 500,Residential,4000,34914,0,38914
142640101201010,CONDO 500,Residential,4000,34914,0,38914
142640101201011,CONDO 500,Residential,4000,34914,0,38914
142640101201012,CONDO 500,Residential,4000,34914,0,38914
142640101201013,CONDO 500,Residential,4000,34914,0,38914
142640101201014,CONDO 500,Residential,4000,34914,0,38914
142640101201015,CONDO 500,Residential,4000,34914,0,38914
142640101201016,CONDO 500,Residential,4000,34914,0,38914
142640101201017,CONDO 500,Residential,4000,34914,0,38914
142640101201018,CONDO 500,Residential,4000,34914,0,38914
142640101201019,CONDO 500,Residential,4000,34914,0,38914
142640101301000,CONDO 500,Residential,4000,36752,0,40752
142640101301001,CONDO 500,Residential,4000,36752,0,40752
142640101301002,CONDO 500,Residential,4000,36752,0,40752
142640101301003,CONDO 500,Residential,4000,36752,0,40752
142640101301004,CONDO 500,Residential,4000,36752,0,40752
142640101301005,CONDO 500,Residential,4000,36752,0,40752
142640101301006,CONDO 500,Residential,4000,36752,0,40752
142640101301007,CONDO 500,Residential,4000,36752,0,40752
142640101301008,CONDO 500,Residential,4000,36752,0,40752
142640101301009,CONDO 500,Residential,4000,36752,0,40752
142640101301010,CONDO 500,Residential,4000,36752,0,40752
142640101301011,CONDO 500,Residential,4000,36752,0,40752
142640101301012,CONDO 500,Residential,4000,36752,0,40752
142640101301013,CONDO 500,Residential,4000,36752,0,40752
142640101301014,CONDO 500,Residential,4000,36752,0,40752
142640101301015,CONDO 500,Residential,4000,36752,0,40752
142640101301016,CONDO 500,Residential,4000,36752,0,40752
142640101301017,CONDO 500,Residential,4000,36752,0,40752
142640101301018,CONDO 500,Residential,4000,36752,0,40752
142640101301019,CONDO 500,Residential,4000,36752,0,40752
142640101301020,CONDO 500,Residential,4000,36752,0,40752
142640101301021,CONDO 500,Residential,4000,36752,0,40752
142640101301022,CONDO 500,Residential,4000,36752,0,40752
142640101301023,CONDO 500,Residential,4000,36752,0,40752
142640101301024,CONDO 500,Residential,4000,36752,0,40752
142640101301025,CONDO 500,Residential,4000,36752,0,40752
142640200100000,SE 239,Exempt,19852,93697,0,113549
142640200200000,SE 239,Residential,18768,100584,0,119352
142640200300000,SE 239,Residential,20424,86955,0,107379
142640200400000,SE 239,Residential,20424,89097,0,109521
142640200500000,SE 239,Residential,19731,92653,0,112384
142640200600000,SE 239,Residential,19425,0,0,19425
142640300100000,SE 239,Residential,53175,144536,0,197711
142642600100000,SE 239,Residential,50025,0,0,50025
142642600200000,SE 239,Residential,60800,0,0,60800
142642600300000,SE 239,Residential,65360,52823,0,118183
142642600400000,SE 239,Residential,32000,67050,0,99050
142642600500000,SE 239,Residential,24400,73889,0,98289
142642600600000,SE 239,Residential,7000,0,0,7000
142642600700000,SE 239,Residential,53675,0,0,53675
142642600800000,SE 239,Residential,14250,0,0,14250
142642600900000,SE 240,Residential,56775,0,0,56775
142642601000000,SE 240,Residential,48250,237364,0,285614
142642601200000,SE 240,Residential,44444,156120,0,200564
142642601300000,SE 240,Residential,44441,202386,0,246827
142642601400000,SE 240,Residential,44660,145739,0,190399
142642601500000,SE 240,Residential,40619,134381,0,175000
142642601600000,SE 240,Residential,60400,159600,0,220000
142642601700000,SE 240,Residential,53100,169863,0,222963
142642601800000,SE 240,Residential,49266,128734,0,178000
142642601900000,SE 240,Residential,49680,140320,0,190000
142642602000000,SE 240,Residential,44607,134390,0,178997
142642700100000,SE 239,Residential,50225,117775,0,168000
142642700200000,SE 239,Residential,18958,0,0,18958
142645100100000,SE 239,Residential,18000,0,0,18000
142645100200000,SE 239,Residential,50000,80979,0,130979
142645100300000,SE 240,Residential,55650,139154,0,194804
142645100400000,SE 240,Residential,45900,110242,0,156142
142645100500000,SE 240,Residential,47325,46436,0,93761
142645100600000,SE 240,Residential,52075,0,0,52075
142645100700000,SE 240,Residential,52225,0,0,52225
142645100800000,SE 240,Residential,36400,40613,0,77013
142645100900000,SE 239,Residential,55140,179,0,55319
142645101000000,SE 239,Residential,28028,49195,0,77223
142645101100000,SE 239,Residential,26565,64804,0,91369
142647600100000,SE 239,Residential,66125,0,0,66125
142647600200000,SE 239,Residential,31484,101037,0,132521
142647600300000,SE 239,Residential,36452,42594,0,79046
142647600400000,SE 239,Residential,72275,189359,0,261634
142647600500000,SE 239,Residential,68000,109485,0,177485
142647600600000,SE 239,Residential,42375,33227,0,75602
142647600700000,SE 239,Residential,53520,0,0,53520
142647600800000,E-10 COUNTY,Exempt,0,0,0,0
142647600900000,SE 239,Residential,4979,0,0,4979
142710100100000,SE 235,Residential,17100,44856,0,61956
142710100200000,SE 235,Residential,19237,54296,0,73533
142710100300000,SE 235,Residential,23760,80759,0,104519
142710100400000,SE 235,Residential,23760,64587,0,88347
142710100500000,SE 235,Residential,24717,56738,0,81455
142710100600000,SE 235,Residential,20057,50129,0,70186
142710100700000,SE 235,Residential,47520,110174,0,157694
142710100800000,SE 235,Residential,71280,0,0,71280
142710100900000,SE 235,Residential,26928,82490,0,109418
142710101000000,SE 235,Residential,25344,111622,0,136966
142710101100000,SE 235,Residential,27720,54177,0,81897
142710101200000,SE 235,Residential,23760,89860,0,113620
142710101300000,SE 235,Residential,23760,97971,0,121731
142710101400000,SE 235,Residential,28512,84726,0,113238
142710101500000,SE 235,Residential,28500,0,0,28500
142710200100000,SE 235,Residential,24057,76819,0,100876
142710200200000,SE 235,Residential,13837,77459,0,91296
142710200300000,SE 235,Residential,13253,64308,0,77561
142710200400000,SE 235,Residential,12672,84342,0,97014
142710200500000,SE 235,Residential,20000,75686,0,95686
142710200600000,SE 235,Residential,20000,77337,0,97337
142710200700000,SE 235,Residential,20000,116922,0,136922
142710200800000,SE 235,Residential,20000,99062,0,119062
142710200900000,SE 235,Residential,20000,72252,0,92252
142710201000000,SE 235,Residential,20000,77776,0,97776
142710201100000,SE 235,Residential,20000,75583,0,95583
142710201200000,SE 235,Residential,20000,83518,0,103518
142710201300000,SE 235,Residential,17573,74383,0,91956
142710201400000,SE 235,Residential,15200,80175,0,95375
142710201500000,SE 235,Residential,20480,65907,0,86387
142710201600000,SE 235,Residential,25344,47989,0,73333
142710201700000,SE 235,Residential,17820,75225,0,93045
142710201800000,SE 235,Residential,23760,115225,0,138985
142710201900000,SE 235,Residential,23760,73584,0,97344
142710202000000,SE 235,Residential,23760,86522,0,110282
142710202100000,SE 235,Residential,17820,55298,0,73118
142710300100000,SE 235,Residential,18899,92484,0,111383
142710300200000,SE 235,Residential,19353,95839,0,115192
142710300300000,SE 235,Residential,25585,104514,0,130099
142710300400000,SE 235,Residential,18900,58986,0,77886
142710300500000,SE 235,Residential,10500,53719,0,64219
142710300600000,SE 235,Residential,10500,60733,0,71233
142710300700000,SE 235,Residential,17262,0,0,17262
142710300800000,COMM SE,Commercial,32113,0,35253,67366
142710300900000,COMM SE,Commercial,7920,0,22080,30000
142710301000000,SE 235,Residential,18090,34541,0,52631
142710301100000,SE 235,Residential,24120,28901,0,53021
142710301200000,SE 235,Residential,24000,48819,0,72819
142710301300000,SE 235,Residential,27000,41356,0,68356
142710301400000,SE 235,Residential,16800,54325,0,71125
142710301500000,SE 235,Residential,23756,91973,0,115729
142710301600000,SE 235,Residential,26343,17488,0,43831
142710301700000,SE 235,Residential,26343,44509,0,70852
142710301800000,SE 235,Residential,19472,52030,0,71502
142710301900000,SE 235,Residential,19472,58072,0,77544
142710302000000,SE 235,Residential,19472,48596,0,68068
142710302100000,SE 235,Residential,19472,31922,0,51394
142710302200000,SE 235,Residential,18720,56879,0,75599
142710302300000,SE 235,Residential,19053,55920,0,74973
142710302400000,SE 235,Residential,19472,39870,0,59342
142710302500000,SE 235,Residential,19472,65996,0,85468
142710302600000,SE 235,Residential,16640,45793,0,62433
142710302700000,SE 235,Residential,20303,82970,0,103273
142710302800000,SE 235,Residential,28143,55463,0,83606
142710302900000,SE 235,Residential,28143,43503,0,71646
142710303000000,SE 235,Residential,16000,69446,0,85446
142710303100000,SE 235,Residential,16000,58334,0,74334
142710303200000,SE 235,Residential,18079,46735,0,64814
142710303300000,SE 235,Residential,25631,109274,0,134905
142710303400000,SE 235,Residential,22533,79497,0,102030
142710303500000,SE 235,Residential,20000,67348,0,87348
142710303600000,SE 235,Residential,20000,61389,0,81389
142710303700000,SE 235,Residential,20000,66495,0,86495
142710303800000,SE 235,Residential,20000,69389,0,89389
142710303900000,SE 235,Residential,20000,88427,0,108427
142710304000000,SE 235,Residential,20000,61279,0,81279
142710304100000,SE 235,Residential,20000,66815,0,86815
142710304200000,SE 235,Residential,20000,100333,0,120333
142710304300000,SE 235,Residential,20000,81675,0,101675
142710304400000,SE 235,Residential,20000,92978,0,112978
142710304500000,SE 235,Residential,20000,95945,0,115945
142710304600000,SE 235,Residential,20000,101885,0,121885
142710304700000,SE 235,Residential,20000,102820,0,122820
142710304800000,SE 235,Residential,20000,27927,0,47927
142710400100000,COMM SE,Commercial,30845,0,1620,32465
142710400200000,SE 235,Residential,15232,0,0,15232
142710400300000,SE 235,Residential,15150,69485,0,84635
142710400400000,SE 235,Residential,28280,36185,0,64465
142710400500000,SE 235,Residential,20200,54842,0,75042
142710400600000,SE 235,Residential,20200,26428,0,46628
142710400700000,Empty,Exempt,0,0,0,0
142710400800000,SE 235,Residential,20200,48167,0,68367
142710400900000,SE 235,Residential,20200,53372,0,73572
142710401000000,SE 235,Residential,20200,18333,0,38533
142710401100000,SE 235,Residential,20200,29207,0,49407
142710401200000,SE 235,Residential,25856,52384,0,78240
142710401300000,SE 235,Residential,20200,53647,0,73847
142710401400000,SE 235,Residential,20200,63479,0,83679
142710401500000,SE 235,Residential,20200,26805,0,47005
142710401600000,SE 235,Residential,24240,64068,0,88308
142710401700000,SE 235,Residential,28280,98903,0,127183
142710401800000,SE 235,Residential,20200,29228,0,49428
142710401900000,SE 235,Residential,20000,69147,0,89147
142710402000000,SE 235,Residential,19439,64814,0,84253
142710500100000,SE 235,Residential,21216,64492,0,85708
142710500200000,SE 235,Residential,22000,94000,0,116000
142710500300000,SE 235,Residential,22000,68564,0,90564
142710500400000,SE 235,Residential,23436,94935,0,118371
142710500500000,SE 235,Residential,22932,88819,0,111751
142710500600000,SE 235,Residential,22572,69631,0,92203
142710500700000,SE 235,Residential,23760,68797,0,92557
142710500800000,SE 235,Residential,24627,61454,0,86081
142710500900000,SE 235,Residential,41151,82437,0,123588
142710501000000,SE 235,Residential,31292,108809,0,140101
142710501100000,SE 235,Residential,25168,49841,0,75009
142710501200000,SE 235,Residential,22464,68845,0,91309
142710501300000,SE 235,Residential,24295,77799,0,102094
142710501400000,SE 235,Residential,24000,72527,0,96527
142710501500000,SE 235,Residential,23200,109517,0,132717
142712600100000,Empty,Exempt,0,0,0,0
142712600200000,SE 249,Residential,17338,74455,0,91793
142712600300000,SE 249,Residential,17566,77582,0,95148
142712600400000,SE 249,Residential,17876,78790,0,96666
142712600500000,SE 249,Residential,11794,73553,0,85347
142712600600000,SE 249,Residential,16848,70630,0,87478
142712600700000,SE 249,Residential,16848,90960,0,107808
142712600800000,SE 249,Residential,16848,70426,0,87274
142712600900000,SE 249,Residential,11794,23593,0,35387
142712601000000,SE 249,Residential,16848,79070,0,95918
142712601100000,SE 249,Residential,16848,74403,0,91251
142712601200000,SE 249,Residential,16848,67935,0,84783
142712601300000,SE 249,Residential,16848,72545,0,89393
142712601400000,SE 249,Residential,17781,76469,0,94250
142712601500000,SE 249,Residential,17632,69074,0,86706
142712601600000,SE 249,Residential,17533,76536,0,94069
142712601700000,SE 249,Residential,17544,70812,0,88356
142712700100000,SE 249,Residential,17322,85793,0,103115
142712700200000,SE 249,Residential,17123,76758,0,93881
142712700300000,SE 249,Residential,17123,76112,0,93235
142712700400000,SE 249,Residential,17123,82213,0,99336
142712700500000,SE 249,Residential,17123,72369,0,89492
142712700600000,SE 249,Residential,17123,78183,0,95306
142712700700000,SE 249,Residential,17123,89009,0,106132
142712700800000,SE 249,Residential,17123,66800,0,83923
142712700900000,SE 249,Residential,17316,89498,0,106814
142715100100000,Empty,Exempt,0,0,0,0
142715200100000,SE 237,Residential,12000,62217,0,74217
142715200200000,SE 237,Residential,10000,58044,0,68044
142715200300000,SE 237,Residential,10000,44624,0,54624
142715200400000,SE 237,Residential,10000,25000,0,35000
142715200500000,SE 237,Residential,10000,53521,0,63521
142715200600000,SE 237,Residential,10244,26103,0,36347
142715200700000,SE 237,Residential,7627,26049,0,33676
142715200800000,SE 237,Residential,7200,17584,0,24784
142715200900000,SE 237,Residential,9627,36771,0,46398
142715201000000,SE 237,Residential,10000,60967,0,70967
142715201100000,SE 237,Residential,10000,43858,0,53858
142715201200000,SE 237,Residential,10000,84546,0,94546
142715201300000,SE 237,Residential,10000,55114,0,65114
142715201400000,SE 237,Residential,10000,42705,0,52705
142715201500000,SE 237,Residential,10000,44936,0,54936
142715201600000,SE 237,Residential,10000,27475,0,37475
142715300100000,SE 237,Residential,8000,58495,0,66495
142715300200000,SE 237,Residential,8000,36798,0,44798
142715300300000,SE 237,Residential,11200,34294,0,45494
142715300400000,SE 237,Residential,8000,54768,0,62768
142715300500000,SE 237,Residential,10000,56528,0,66528
142715300600000,SE 237,Residential,10000,69316,0,79316
142715300700000,SE 237,Residential,8000,49033,0,57033
142715300800000,SE 237,Residential,10073,26853,0,36926
142715300900000,SE 237,Residential,10386,43213,0,53599
142715301000000,SE 237,Residential,8000,28724,0,36724
142715301100000,SE 237,Residential,8000,50408,0,58408
142715301200000,SE 237,Residential,8000,28600,0,36600
142715301300000,SE 237,Residential,12000,13267,0,25267
142715301400000,SE 237,Residential,12000,29877,0,41877
142715400100000,SE 237,Residential,23200,52719,0,75919
142715400200000,SE 237,Residential,5400,15930,0,21330
142715400300000,E-40 CHURCHES,Exempt,14580,0,20266,34846
142715400400000,E-47 RELIG OTHER,Exempt,34020,0,60,34080
142715400500000,SE 237,Residential,19200,0,0,19200
142715500100000,SE 237,Residential,8800,72640,0,81440
142715500200000,SE 237,Residential,8800,80167,0,88967
142715500300000,SE 237,Residential,8800,66097,0,74897
142715500400000,SE 237,Residential,10000,80215,0,90215
142715500500000,SE 237,Residential,10000,80810,0,90810
142715500600000,SE 237,Residential,10000,74866,0,84866
142715500700000,SE 237,Residential,12000,76648,0,88648
142715500800000,E-15 CITY,Exempt,0,0,0,0
142715500900000,SE 237,Residential,10000,0,0,10000
142715501000000,SE 237,Residential,10000,62917,0,72917
142715501100000,SE 237,Residential,10000,0,0,10000
142715501200000,E-15 CITY,Exempt,0,0,0,0
142715600100000,SE 237,Residential,10000,47463,0,57463
142715600200000,SE 237,Residential,10000,46893,0,56893
142715600300000,SE 237,Residential,12000,49136,0,61136
142715600400000,SE 237,Residential,10000,33748,0,43748
142715600500000,SE 237,Residential,10000,43604,0,53604
142715600600000,SE 237,Residential,11200,37158,0,48358
142715600700000,E-15 CITY,Exempt,0,0,0,0
142715700100000,E-15 CITY,Exempt,0,0,0,0
142717600100000,E-15 CITY,Exempt,0,0,0,0
142720100100000,E-15 CITY,Exempt,0,0,0,0
142720100200000,SE 237,Residential,9750,0,0,9750
142720100300000,SE 237,Residential,9600,42151,0,51751
142720100400000,SE 237,Residential,8000,23121,0,31121
142720100500000,SE 237,Residential,10200,32730,0,42930
142720100600000,SE 237,Residential,8000,48093,0,56093
142720100700000,SE 237,Residential,8000,43420,0,51420
142720100800000,Empty,Exempt,0,0,0,0
142720200100000,SE 237,Residential,8000,52362,0,60362
142720200200000,SE 237,Residential,8000,23481,0,31481
142720200300000,SE 237,Residential,8000,56446,0,64446
142720200400000,E-15 CITY,Exempt,0,0,0,0
142720200500000,SE 237,Residential,8000,0,0,8000
142720200600000,SE 237,Residential,8000,18760,0,26760
142720200700000,SE 237,Residential,7920,28104,0,36024
142720200800000,SE 237,Residential,9504,33351,0,42855
142720200900000,SE 237,Residential,7920,34404,0,42324
142720201000000,SE 237,Residential,9052,49303,0,58355
142720201100000,SE 237,Residential,7920,12469,0,20389
142720201200000,SE 237,Residential,7920,47311,0,55231
142720201300000,SE 237,Residential,7920,54273,0,62193
142720201400000,SE 237,Residential,8000,27476,0,35476
142720201500000,SE 237,Residential,8000,35886,0,43886
142720201600000,SE 237,Residential,8000,55322,0,63322
142720201700000,SE 237,Residential,8170,24341,0,32511
142720201800000,SE 237,Residential,8550,43224,0,51774
142720201900000,SE 237,Residential,7000,31756,0,38756
142720202000000,SE 237,Residential,8000,16365,0,24365
142720202100000,SE 237,Residential,8000,40344,0,48344
142720202200000,E-15 CITY,Exempt,0,0,0,0
142720202300000,SE 237,Residential,11790,43773,0,55563
142720300100000,COMM SE,Commercial,47002,0,78569,125571
142720300200000,COMM SE,Commercial,71913,0,108562,180475
142720300202000,COMM SE,Commercial,0,0,16664,16664
142720300300000,COMM SE,Commercial,95876,0,23338,119214
142720300400000,COMM SE,Commercial,14515,0,4188,18703
142720300500000,COMM SE,Commercial,5949,0,152,6101
142720300600000,COMM SE,Commercial,26471,0,89348,115819
142720300700000,SE 237,Residential,7600,16351,0,23951
142720300800000,SE 237,Exempt,7600,0,0,7600
142720300900000,E-70 CHARITY OTHER,Exempt,13608,0,0,13608
142720301000000,SE 237,Exempt,6000,0,0,6000
142720301100000,SE 237,Exempt,6000,0,0,6000
142720301200000,SE 237,Exempt,6300,0,0,6300
142720301300000,SE 237,Exempt,5700,0,0,5700
142720301400000,SE 237,Exempt,2400,0,0,2400
142720301500000,SE 237,Residential,13500,82759,0,96259
142720301600000,SE 237,Residential,5200,26704,0,31904
142720301700000,SE 237,Residential,5200,30157,0,35357
142720301800000,SE 237,Residential,4950,26173,0,31123
142720301900000,SE 237,Residential,6204,19695,0,25899
142720302000000,SE 237,Residential,5800,46068,0,51868
142720302100000,E-15 CITY,Exempt,0,0,0,0
142720302200000,E-15 CITY,Exempt,0,0,0,0
142720302300000,E-15 CITY,Exempt,0,0,0,0
142720302400000,SE 237,Residential,5840,21312,0,27152
142720302500000,SE 237,Residential,8240,118069,0,126309
142720302600000,SE 237,Residential,7743,0,0,7743
142720302700000,SE 237,Residential,12000,111551,0,123551
142720302800000,SE 237,Residential,12000,21556,0,33556
142720302900000,SE 237,Residential,6000,21190,0,27190
142720303000000,SE 237,Residential,6000,30430,0,36430
142720303100000,SE 237,Residential,6000,19099,0,25099
142720303200000,SE 237,Residential,6000,28665,0,34665
142720303300000,SE 237,Residential,8400,0,0,8400
142720303400000,SE 237,Residential,8680,0,0,8680
142720303500000,COMM SE,Commercial,47002,0,33822,80824
142720400100000,Empty,Other,0,0,0,0
142720400200000,SE 237,Residential,6000,17818,0,23818
142720400300000,SE 237,Residential,6000,55066,0,61066
142720400400000,SE 237,Residential,6000,26640,0,32640
142720400500000,SE 237,Residential,6000,35782,0,41782
142720400600000,SE 237,Residential,8000,37880,0,45880
142720400700000,COMM SE,Commercial,8467,0,35746,44213
142720400800000,SE 237,Residential,8000,29792,0,37792
142720400900000,SE 237,Residential,8000,27650,0,35650
142720401000000,SE 237,Residential,8000,20901,0,28901
142720401100000,SE 237,Residential,8000,41924,0,49924
142720401200000,SE 237,Residential,8000,41906,0,49906
142720401300000,SE 237,Residential,9600,52478,0,62078
142720401400000,SE 237,Residential,7650,35251,0,42901
142720401500000,SE 237,Residential,2766,0,0,2766
142720401600000,SE 237,Residential,12460,51255,0,63715
142720401800000,SE 237,Residential,8000,77238,0,85238
142720401900000,SE 237,Residential,8000,0,0,8000
142720402000000,SE 237,Residential,8000,75044,0,83044
142720402100000,SE 237,Residential,8000,27067,0,35067
142720402200000,SE 237,Residential,8000,47160,0,55160
142720402300000,SE 237,Residential,8000,56514,0,64514
142720402400000,SE 237,Residential,8000,30171,0,38171
142720402500000,SE 237,Residential,8000,63517,0,71517
142720402600000,CONVERSIONS,Commercial,9072,0,39218,48290
142720402700000,E-15 CITY,Exempt,0,0,0,0
142720500100000,SE 237,Exempt,0,0,0,0
142720600100000,SE 237,Residential,8400,100696,0,109096
142720600200000,SE 237,Residential,8246,99740,0,107986
142720600300000,SE 237,Residential,6000,50197,0,56197
142720600400000,SE 237,Residential,6000,42387,0,48387
142720600500000,SE 237,Residential,8400,35762,0,44162
142720600600000,SE 237,Residential,8400,33234,0,41634
142720600700000,SE 237,Residential,8400,87544,0,95944
142720600800000,SE 237,Residential,8100,31051,0,39151
142720600900000,SE 237,Residential,8000,68558,0,76558
142720601000000,E-15 CITY,Exempt,0,0,0,0
142720601100000,SE 237,Residential,6600,40980,0,47580
142720601200000,SE 237,Residential,8400,50676,0,59076
142720601300000,SE 237,Residential,8000,36109,0,44109
142720601400000,SE 237,Residential,8177,58438,0,66615
142720601500000,SE 237,Residential,3823,29348,0,33171
142720601600000,COMM SE,Commercial,8624,0,49702,58326
142720601700000,SE 237,Residential,5236,18715,0,23951
142720601800000,SE 237,Residential,4200,28285,0,32485
142720601900000,SE 237,Residential,5600,37974,0,43574
142720602000000,SE 237,Residential,8917,48517,0,57434
142720602100000,SE 237,Residential,6580,46993,0,53573
142720602200000,SE 237,Residential,4986,0,0,4986
142720602300000,SE 237,Residential,8000,38082,0,46082
142720602400000,SE 237,Residential,7400,27244,0,34644
142720602500000,SE 237,Residential,8160,46052,0,54212
142720602600000,SE 237,Exempt,0,0,0,0
142720602700000,SE 237,Residential,8500,5810,0,14310
142720602800000,SE 237,Residential,8000,52760,0,60760
142720602900000,SE 237,Residential,8000,87907,0,95907
142720603000000,SE 237,Residential,6000,44036,0,50036
142720603100000,SE 237,Residential,6000,47839,0,53839
142720700100000,SE 237,Residential,6000,23456,0,29456
142720700200000,SE 237,Residential,6000,23907,0,29907
142720700300000,SE 237,Residential,8000,26826,0,34826
142720700400000,SE 237,Residential,8000,0,0,8000
142720700500000,SE 237,Residential,8000,32496,0,40496
142720700600000,SE 237,Residential,8000,40916,0,48916
142720700700000,SE 237,Residential,8256,36027,0,44283
142720700800000,SE 237,Residential,6840,49532,0,56372
142720700900000,E-15 CITY,Exempt,0,0,0,0
142720701000000,SE 237,Residential,11185,47605,0,58790
142720701100000,SE 237,Residential,8000,26871,0,34871
142720701200000,SE 237,Residential,8000,99051,0,107051
142720701300000,SE 237,Residential,8000,44359,0,52359
142720701400000,SE 237,Residential,8000,104810,0,112810
142720701500000,SE 237,Residential,8000,104238,0,112238
142720701600000,SE 237,Residential,8000,109364,0,117364
142720701700000,SE 237,Residential,8000,104238,0,112238
142720701800000,SE 237,Residential,8000,41406,0,49406
142720701900000,SE 237,Residential,8000,37058,0,45058
142720702000000,SE 237,Residential,3040,0,0,3040
142720702100000,COMM SE,Commercial,4990,0,21212,26202
142720702200000,SE 237,Residential,8000,34552,0,42552
142720702300000,SE 237,Residential,4800,0,0,4800
142720702400000,SE 237,Residential,4800,41935,0,46735
142720702500000,E-15 CITY,Exempt,0,0,0,0
142720702600000,SE 237,Residential,8000,41790,0,49790
142720702700000,SE 237,Residential,8000,0,0,8000
142720800100000,SE 237,Residential,6300,31167,0,37467
142720800200000,SE 237,Residential,6000,37776,0,43776
142720800300000,SE 237,Exempt,0,0,0,0
142720800400000,SE 237,Exempt,0,0,0,0
142720800500000,SE 237,Exempt,0,0,0,0
142720800600000,SE 237,Exempt,0,0,0,0
142720800700000,SE 237,Exempt,0,0,0,0
142720800800000,SE 237,Exempt,0,0,0,0
142720800900000,SE 237,Exempt,0,0,0,0
142720801000000,SE 237,Exempt,0,0,0,0
142722700100000,COMM SE,Commercial,251640,0,1082839,1334479
142722700200000,COMM SE,Commercial,37584,0,2130,39714
142722700300000,COMM SE,Commercial,251640,0,2369937,2621577
142722800100000,E-60 HOSPITAL,Exempt,27216,0,7978,35194
142722900100000,SE 237,Residential,8208,50157,0,58365
142722900200000,E-15 CITY,Exempt,0,0,0,0
142722900300000,SE 237,Residential,5580,57477,0,63057
142722900400000,SE 237,Residential,4980,35251,0,40231
142722900500000,SE 237,Residential,4980,32090,0,37070
142722900600000,COMM SE,Commercial,10206,0,0,10206
142722900700000,SE 237,Residential,7200,45406,0,52606
142722900800000,SE 237,Residential,6300,35399,0,41699
142722900900000,SE 237,Residential,7200,56639,0,63839
142722901000000,SE 237,Residential,7221,60713,0,67934
142722901100000,E-40 CHURCHES,Exempt,2703,0,19576,22279
142722901200000,E-15 CITY,Exempt,0,0,0,0
142722901300000,SE 237,Exempt,0,0,0,0
142722901400000,SE 237,Residential,7440,15019,0,22459
142722901500000,SE 237,Residential,6000,51334,0,57334
142722901600000,SE 237,Residential,6000,20670,0,26670
142722901700000,SE 237,Residential,6000,0,0,6000
142722901800000,SE 237,Residential,6000,0,0,6000
142722901900000,SE 237,Residential,9000,0,0,9000
142723000100000,COMM SE,Commercial,251640,0,44976,296616
142723000200000,E-40 CHURCHES,Exempt,230580,0,224215,454795
142723000300000,SE 238,Residential,1984,0,0,1984
142723000400000,SE 238,Residential,1984,0,0,1984
142723100400000,COMM SE,Commercial,440340,0,1157665,1598005
142723200100000,SE 237,Residential,6390,0,0,6390
142723200200000,SE 237,Residential,1538,0,0,1538
142723200300000,SE 237,Exempt,0,0,0,0
142723200500000,SE 237,Exempt,0,0,0,0
142723200600000,SE 237,Residential,7200,0,0,7200
142723200700000,SE 237,Residential,7200,72579,0,79779
142723200800000,SE 237,Residential,5400,33663,0,39063
142723200900000,SE 237,Residential,2400,0,0,2400
142723201000000,SE 237,Residential,5670,18454,0,24124
142723201100000,SE 237,Residential,5859,45990,0,51849
142723201200000,SE 237,Residential,7208,95075,0,102283
142723201300000,SE 237,Residential,9355,86586,0,95941
142723201400000,SE 237,Residential,5400,52178,0,57578
142723201500000,SE 237,Residential,5000,0,0,5000
142723201600000,SE 237,Exempt,0,0,0,0
142723201700000,SE 237,Residential,5040,29898,0,34938
142723201800000,SE 237,Residential,8000,113543,0,121543
142723201900000,E-15 CITY,Exempt,0,0,0,0
142723300100000,COMM SE,Commercial,145800,0,16524,162324
142723300200000,COMM SE,Commercial,186030,0,518208,704238
142723300300000,COMM SE,Commercial,13608,0,5054,18662
142723300400000,COMM SE,Commercial,54432,0,18711,73143
142723400100000,E-15 CITY,Exempt,0,0,0,0
142723400200000,SE 237,Residential,6000,24663,0,30663
142723500100000,E-15 CITY,Exempt,0,0,0,0
142723500200000,SE 237,Residential,3323,0,0,3323
142723500300000,SE 237,Residential,5022,29821,0,34843
142723500400000,SE 237,Residential,6156,69647,0,75803
142723500500000,SE 237,Residential,8400,17352,0,25752
142723500600000,SE 237,Residential,6000,24373,0,30373
142723500700000,SE 237,Residential,6000,13851,0,19851
142723500800000,SE 237,Residential,6226,56222,0,62448
142723500900000,SE 237,Residential,5774,41422,0,47196
142723501000000,SE 237,Residential,8400,63686,0,72086
142723501100000,SE 237,Residential,8400,74306,0,82706
142723501200000,SE 237,Residential,6000,30356,0,36356
142723501300000,SE 237,Residential,6000,43099,0,49099
142723501400000,SE 237,Residential,8400,58249,0,66649
142723501500000,SE 237,Residential,7560,37586,0,45146
142723501600000,E-15 CITY,Exempt,0,0,0,0
142723600100000,SE 237,Residential,5130,0,0,5130
142723600800000,SE 237,Residential,5000,0,0,5000
142723600900000,E-70 CHARITY OTHER,Exempt,20412,0,176233,196645
142723601200000,APTS SE,Commercial,82080,0,846549,928629
142723700100000,COMM SE,Commercial,120960,0,407758,528718
142723700700000,SE 238,Commercial,22680,0,0,22680
142723700800000,SE 238,Residential,5000,0,0,5000
142723700900000,COMM SE,Commercial,71734,0,22508,94242
142723701000000,SE 238,Residential,8400,45696,0,54096
142723701100000,CONVERSIONS,Residential,7140,48074,0,55214
142723701200000,SE 238,Residential,4960,52796,0,57756
142723800100000,SE 237,Residential,6510,35235,0,41745
142723800200000,SE 237,Exempt,0,0,0,0
142723800300000,SE 237,Exempt,0,0,0,0
142723800400000,SE 237,Residential,9000,72152,0,81152
142723900100000,E-65 YWCA,Exempt,34020,0,296451,330471
142723900200000,SE 237,Residential,2480,0,0,2480
142723900300000,COMM SE,Commercial,2843,0,2595,5438
142723900400000,SE 237,Residential,4980,0,0,4980
142723900500000,SE 237,Residential,6750,19231,0,25981
142723900600000,SE 237,Residential,6750,0,0,6750
142723900900000,SE 237,Residential,6750,85364,0,92114
142723901000000,E-68 FRATERNAL ORG,Exempt,13608,0,24120,37728
142723901100000,SE 237,Residential,5468,26269,0,31737
142723901200000,SE 237,Residential,5670,32483,0,38153
142723901300000,SE 237,Residential,4350,0,0,4350
142723901400000,SE 237,Residential,4650,0,0,4650
142723901500000,SE 237,Residential,5400,28498,0,33898
142724000100000,E-40 CHURCHES,Exempt,24601,0,170806,195407
142724000200000,SE 237,Residential,5899,14587,0,20486
142724000300000,SE 237,Residential,5019,21711,0,26730
142724000400000,SE 237,Residential,5000,41856,0,46856
142724000500000,SE 237,Residential,5000,33397,0,38397
142724000600000,SE 237,Residential,288,0,0,288
142724000700000,SE 237,Residential,5000,18749,0,23749
142724000800000,SE 237,Residential,5000,11944,0,16944
142724000900000,SE 237,Residential,5000,6696,0,11696
142724001000000,SE 237,Residential,1984,0,0,1984
142724001100000,SE 237,Residential,5000,0,0,5000
142724001200000,SE 237,Residential,5000,0,0,5000
142724001300000,SE 237,Residential,6750,0,0,6750
142724001400000,SE 237,Residential,6750,0,0,6750
142724001500000,SE 237,Residential,6750,17601,0,24351
142724001600000,SE 237,Residential,5000,0,0,5000
142724001700000,SE 237,Residential,1840,0,0,1840
142724100100000,E-15 CITY,Exempt,0,0,0,0
142724100200000,E-15 CITY,Exempt,0,0,0,0
142724100300000,SE 237,Residential,5000,0,0,5000
142724100400000,E-15 CITY,Exempt,0,0,0,0
142724200200000,Empty,Exempt,0,0,0,0
142725100100000,SE 237,Residential,7110,0,0,7110
142725100200000,SE 237,Residential,5555,0,0,5555
142725100300000,SE 237,Residential,2700,0,0,2700
142725100400000,SE 237,Residential,5000,0,0,5000
142725100500000,SE 237,Residential,5000,12417,0,17417
142725100600000,SE 237,Residential,6960,63578,0,70538
142725100700000,SE 237,Residential,5000,6432,0,11432
142725100800000,SE 237,Residential,5000,0,0,5000
142725100900000,SE 237,Residential,5000,25141,0,30141
142725101000000,SE 237,Residential,5000,0,0,5000
142725101100000,SE 237,Residential,1080,8042,0,9122
142725101200000,SE 237,Residential,7920,75544,0,83464
142725101300000,SE 237,Residential,6600,34640,0,41240
142725101400000,SE 237,Residential,5400,32706,0,38106
142725101500000,SE 237,Residential,6000,25157,0,31157
142725101600000,SE 237,Residential,6000,18434,0,24434
142725101700000,SE 237,Residential,6000,39040,0,45040
142725101800000,SE 237,Residential,6000,59624,0,65624
142725200100000,E-10 COUNTY,Exempt,0,0,0,0
142725300100000,E-15 CITY,Exempt,0,0,0,0
142725300200000,SE 237,Residential,5000,0,0,5000
142725300300000,SE 237,Residential,5000,0,0,5000
142725300400000,SE 237,Residential,5000,0,0,5000
142725400100000,Empty,Exempt,0,0,0,0
142725400200000,Empty,Exempt,0,0,0,0
142725500100000,SE 237,Residential,5000,44327,0,49327
142725500200000,E-10 COUNTY,Exempt,0,0,0,0
142725500300000,E-10 COUNTY,Exempt,0,0,0,0
142725500400000,SE 237,Residential,5000,0,0,5000
142725500500000,E-15 CITY,Exempt,0,0,0,0
142725501200000,E-15 CITY,Exempt,0,0,0,0
142725501300000,E-15 CITY,Exempt,0,0,0,0
142725501400000,E-15 CITY,Exempt,0,0,0,0
142725501500000,SE 237,Residential,5000,0,0,5000
142725501600000,E-15 CITY,Exempt,0,0,0,0
142725501700000,SE 237,Residential,5000,0,0,5000
142725501800000,SE 237,Residential,5000,0,0,5000
142725600100000,E-40 CHURCHES,Exempt,13608,0,20929,34537
142725600200000,SE 237,Residential,5000,0,0,5000
142725600300000,E-15 CITY,Exempt,0,0,0,0
142725600400000,COMM SE,Commercial,15515,0,4125,19640
142725600500000,SE 237,Residential,5000,22096,0,27096
142725600600000,SE 237,Residential,5000,0,0,5000
142725600700000,COMM SE,Commercial,9072,0,0,9072
142725600800000,COMM SE,Commercial,15120,0,1000,16120
142725600900000,SE 237,Residential,6000,0,0,6000
142725601000000,SE 237,Residential,6000,12188,0,18188
142725601100000,SE 237,Residential,6000,0,0,6000
142725601200000,SE 237,Residential,6000,0,0,6000
142725601300000,SE 237,Residential,6000,0,0,6000
142725700100000,E-15 CITY,Exempt,0,0,0,0
142725700200000,E-15 CITY,Exempt,0,0,0,0
142725700300000,E-15 CITY,Exempt,0,0,0,0
142725700500000,SE 237,Residential,5559,25310,0,30869
142725700600000,SE 237,Residential,4646,0,0,4646
142725800700000,COMM SE,Commercial,131220,0,0,131220
142725801000000,Empty,Other,0,0,0,0
142725900100000,E-15 CITY,Exempt,0,0,0,0
142725900200000,Empty,Other,0,0,0,0
142726000200000,E-40 CHURCHES,Exempt,291600,0,417676,709276
142726000602000,COMM SE,Commercial,0,0,8081,8081
142726000800000,E-15 CITY,Exempt,0,0,0,0
142726100100000,E-45 CONVENT-DORMS,Exempt,130950,0,5493,136443
142726100300000,E-15 CITY,Exempt,0,0,0,0
142726100400000,SE 237,Residential,3150,0,0,3150
142726100500000,E-46 RELIG PARKING,Exempt,22950,0,0,22950
142726100700000,SE 237,Residential,2700,0,0,2700
142726100800000,SE 237,Residential,2700,0,0,2700
142726100900000,SE 237,Residential,2700,0,0,2700
142726101000000,SE 237,Residential,2520,0,0,2520
142726101100000,SE 237,Residential,2295,0,0,2295
142726101200000,SE 237,Residential,2115,0,0,2115
142726101300000,SE 237,Residential,2160,0,0,2160
142726101400000,E-15 CITY,Exempt,0,0,0,0
142726200100000,COMM SE,Commercial,72560,0,55189,127749
142727600100000,APTS SE,Commercial,115560,0,510526,626086
142727600200000,SE 237,Residential,11000,115460,0,126460
142727700100000,APTS SE,Commercial,325620,0,2011704,2337324
142727700200000,E-40 CHURCHES,Exempt,26055,0,118934,144989
142727700300000,E-46 RELIG PARKING,Exempt,145800,0,3711,149511
142727700400000,E-15 CITY,Exempt,0,0,0,0
142727700500000,E-15 CITY,Exempt,0,0,0,0
142727700600000,E-70 CHARITY OTHER,Exempt,104490,0,1460463,1564953
142727700700000,E-15 CITY,Exempt,0,0,0,0
142727700800000,E-15 CITY,Exempt,0,0,0,0
142727700900000,APTS SE,Commercial,64260,0,255085,319345
142727800100000,E-15 CITY,Exempt,0,0,0,0
142727900100000,SE 237,Exempt,0,0,0,0
142727900200000,E-15 CITY,Exempt,0,0,0,0
142728000100000,SE 237,Residential,9894,67965,0,77859
142728000200000,SE 237,Residential,9894,73545,0,83439
142728000300000,SE 237,Residential,9894,75044,0,84938
142728000400000,SE 237,Residential,9894,71246,0,81140
142728000500000,APTS SE,Commercial,68580,0,252845,321425
142728100100000,SE 237,Residential,5000,40095,0,45095
142728100200000,SE 237,Residential,1332,0,0,1332
142728100300000,SE 237,Residential,3330,37596,0,40926
142728100400000,COMM SE,Commercial,52488,0,89828,142316
142728100500000,SE 237,Residential,720,0,0,720
142728100600000,SE 237,Residential,2040,0,0,2040
142728100700000,SE 237,Residential,3240,0,0,3240
142728100800000,SE 237,Residential,5000,0,0,5000
142728100900000,INDUSTRIAL,Industrial,6642,0,0,6642
142728200100000,SE 237,Residential,3808,0,0,3808
142728200200000,SE 237,Residential,3852,35084,0,38936
142728200300000,SE 237,Residential,3232,19678,0,22910
142728200400000,SE 237,Residential,3060,34124,0,37184
142728200500000,SE 237,Residential,6691,16231,0,22922
142728200600000,SE 237,Residential,3880,18287,0,22167
142728200700000,SE 237,Residential,2838,35259,0,38097
142728200800000,SE 237,Residential,5000,0,0,5000
142728200900000,SE 237,Residential,5000,0,0,5000
142728300100000,COMM SE,Commercial,6804,0,0,6804
142728300200000,SE 237,Residential,3000,0,0,3000
142728300300000,COMM SE,Commercial,8845,0,0,8845
142728300400000,SE 237,Residential,5000,13460,0,18460
142728300500000,SE 237,Residential,5000,40825,0,45825
142728300600000,SE 237,Residential,5000,0,0,5000
142728300700000,SE 237,Residential,5000,0,0,5000
142730100200000,INDUSTRIAL,Industrial,27750,0,5603,33353
142730200100000,SE 237,Residential,3000,0,0,3000
142730200200000,SE 237,Residential,3000,0,0,3000
142730200300000,SE 237,Residential,5000,0,0,5000
142730200400000,SE 237,Residential,5000,9491,0,14491
142730200500000,SE 237,Residential,5000,0,0,5000
142730200600000,SE 237,Residential,5000,0,0,5000
142730300100000,SE 237,Residential,2728,0,0,2728
142730300200000,SE 237,Residential,5000,0,0,5000
142730300300000,SE 237,Residential,1200,0,0,1200
142730300400000,SE 237,Residential,5000,1310,0,6310
142730300500000,SE 237,Residential,5000,0,0,5000
142730300600000,COMM SE,Commercial,5103,0,0,5103
142730300700000,COMM SE,Commercial,5103,0,0,5103
142730300800000,SE 237,Residential,2666,0,0,2666
142730300900000,SE 237,Residential,3286,0,0,3286
142730301000000,SE 237,Residential,3000,0,0,3000
142730400100000,SE 237,Residential,4980,0,0,4980
142730400200000,SE 237,Residential,5000,0,0,5000
142730400300000,SE 237,Residential,3000,0,0,3000
142730400400000,SE 237,Residential,3000,0,0,3000
142730400500000,SE 237,Residential,3000,0,0,3000
142730400600000,SE 237,Residential,3000,0,0,3000
142730400700000,SE 237,Residential,3000,0,0,3000
142730400800000,SE 237,Residential,3000,0,0,3000
142730400900000,SE 237,Residential,1200,0,0,1200
142730401000000,SE 237,Residential,3000,0,0,3000
142730401100000,SE 237,Residential,3100,8805,0,11905
142730500100000,Empty,Other,0,0,0,0
142730500200000,E-15 CITY,Exempt,0,0,0,0
142730600600000,INDUSTRIAL,Industrial,44145,0,398412,442557
142730700100000,SE 237,Residential,3800,884,0,4684
142730700200000,SE 237,Residential,3800,0,0,3800
142730700300000,SE 237,Residential,3800,0,0,3800
142730700400000,SE 237,Residential,5000,11835,0,16835
142730700500000,SE 237,Residential,2944,0,0,2944
142730700600000,SE 237,Residential,2944,0,0,2944
142730700700000,SE 237,Residential,3800,3122,0,6922
142730700800000,SE 237,Residential,1253,0,0,1253
142730700900000,SE 237,Residential,2628,0,0,2628
142730701000000,COMM SE,Commercial,9072,0,0,9072
142732600100000,COMM SE,Commercial,40646,0,48832,89478
142732600200000,COMM SE,Commercial,23814,0,2606,26420
142732700100000,SE 237,Residential,800,0,0,800
142732700800000,COMM SE,Commercial,13608,0,0,13608
142732700900000,COMM SE,Commercial,17690,0,13103,30793
142732701000000,SE 237,Residential,5000,0,0,5000
142732701200000,SE 237,Residential,3000,0,0,3000
142732701300000,SE 237,Residential,2500,0,0,2500
142732701400000,SE 237,Residential,3500,0,0,3500
142732701500000,COMM SE,Commercial,17985,0,12075,30060
142732701600000,SE 237,Residential,5000,0,0,5000
142732701700000,SE 237,Residential,3000,0,0,3000
142732701800000,SE 237,Residential,3000,0,0,3000
142732701900000,SE 237,Residential,3000,0,0,3000
142732702000000,SE 237,Residential,1200,0,0,1200
142732702100000,SE 237,Residential,1280,886,0,2166
142732702200000,SE 237,Residential,2800,0,0,2800
142732800100000,E-15 CITY,Exempt,0,0,0,0
142732800102000,COMM SE,Commercial,0,0,9589,9589
142732800200000,COMM SE,Commercial,57477,0,83328,140805
142732800300000,COMM SE,Commercial,21324,0,48294,69618
142732800600000,COMM SE,Commercial,18954,0,1074,20028
142732800700000,COMM SE,Commercial,29160,0,1936,31096
142732800800000,COMM SE,Commercial,20655,0,1313,21968
142732800900000,COMM SE,Commercial,29160,0,3937,33097
142732801000000,COMM SE,Commercial,29160,0,3937,33097
142732900100000,SE 237,Residential,3000,0,0,3000
142732900200000,SE 237,Residential,3000,0,0,3000
142732900300000,SE 237,Residential,1360,0,0,1360
142732900400000,SE 237,Residential,2600,0,0,2600
142732900500000,COMM SE,Commercial,19515,0,23067,42582
142732900600000,COMM SE,Commercial,10163,0,1956,12119
142733000100000,COMM SE,Commercial,44963,0,20600,65563
142733000200000,COMM SE,Commercial,14580,0,0,14580
142733000300000,COMM SE,Commercial,47385,0,87666,135051
142733000400000,COMM SE,Commercial,13288,0,27440,40728
142733000500000,COMM SE,Commercial,8886,0,0,8886
142733000600000,COMM SE,Commercial,6847,0,18010,24857
142733000700000,COMM SE,Commercial,8483,0,42728,51211
142733000800000,COMM SE,Commercial,21617,0,18163,39780
142733000900000,COMM SE,Commercial,22097,0,0,22097
142733001000000,SE 237,Residential,5000,0,0,5000
142733001100000,SE 237,Residential,5000,0,0,5000
142733001200000,SE 237,Residential,5508,0,0,5508
142733001300000,SE 237,Residential,3060,0,0,3060
142733001400000,SE 237,Residential,3060,0,0,3060
142733001500000,SE 237,Residential,1224,0,0,1224
142733001600000,SE 237,Residential,3060,0,0,3060
142733001700000,SE 237,Residential,4590,0,0,4590
142733001800000,SE 237,Residential,2121,0,0,2121
142733001900000,E-15 CITY,Exempt,0,0,0,0
142733100100000,E-15 CITY,Exempt,0,0,0,0
142733100200000,SE 237,Residential,3030,0,0,3030
142733100300000,SE 237,Residential,4000,0,0,4000
142733100400000,SE 237,Residential,4000,0,0,4000
142733100500000,SE 237,Residential,3000,0,0,3000
142733100600000,SE 237,Residential,3000,0,0,3000
142733100700000,SE 237,Residential,4000,0,0,4000
142733100800000,E-15 CITY,Exempt,0,0,0,0
142733100900000,COMM SE,Commercial,5897,0,6116,12013
142733101000000,SE 237,Residential,4000,0,0,4000
142733101100000,SE 237,Residential,4000,0,0,4000
142733101200000,SE 237,Residential,2560,0,0,2560
142733101300000,SE 237,Residential,3440,0,0,3440
142733101400000,SE 237,Residential,3440,0,0,3440
142733101500000,SE 237,Residential,3440,0,0,3440
142733101600000,COMM SE,Commercial,5832,0,3525,9357
142733101700000,INDUSTRIAL,Industrial,4800,0,2890,7690
142733101800000,INDUSTRIAL,Industrial,4800,0,2765,7565
142733101900000,E-15 CITY,Exempt,0,0,0,0
142733102000000,E-15 CITY,Exempt,0,0,0,0
142733200100000,APTS SE,Commercial,7476,0,25406,32882
142735100100000,Empty,Exempt,0,0,0,0
142735200100000,COMM SW,Commercial,56092,0,33480,89572
142735200200000,COMM SW,Commercial,15418,0,23061,38479
142735300100000,COMM SW,Commercial,17656,0,4330,21986
142735300200000,SW 412,Residential,5000,0,0,5000
142735300300000,SW 412,Residential,10700,0,0,10700
142735300400000,SW 412,Residential,5000,0,0,5000
142735300500000,SW 412,Residential,5000,0,0,5000
142735300600000,SW 412,Residential,5000,0,0,5000
142735300700000,SW 412,Residential,9600,0,0,9600
142735400100000,E-10 COUNTY,Exempt,0,0,0,0
142735400200000,SW 402,Residential,5000,0,0,5000
142735400300000,SW 402,Residential,9500,0,0,9500
142735400400000,SW 402,Residential,5000,0,0,5000
142735400500000,SW 402,Residential,5000,0,0,5000
142735400600000,SW 402,Residential,5000,0,0,5000
142735400700000,SW 402,Residential,10000,0,0,10000
142735400800000,SW 402,Residential,5000,0,0,5000
142735400900000,SW 402,Residential,5000,0,0,5000
142735401000000,SW 402,Residential,10000,0,0,10000
142735401100000,SW 402,Residential,10000,0,0,10000
142735401200000,SW 402,Residential,5000,0,0,5000
142735401300000,SW 402,Residential,5000,0,0,5000
142737600100000,Empty,Exempt,0,0,0,0
142740100100000,Empty,Other,0,0,0,0
142742600100000,INDUSTRIAL,Industrial,321975,0,7048248,7370223
142745100100000,Empty,Exempt,0,0,0,0
142747600100000,Empty,Other,0,0,0,0
142810100100000,E-01 FEDERAL,Exempt,0,0,0,0
142810300100000,COMM SE,Commercial,15876,0,100505,116381
142810300200000,CONVERSIONS,Commercial,3062,0,36012,39074
142810300300000,COMM SE,Commercial,133229,0,99159,232388
142810300500000,COMM SE,Commercial,91125,0,558277,649402
142810300600000,COMM SE,Commercial,13608,0,14561,28169
142810300700000,COMM SE,Commercial,27216,0,0,27216
142810400100000,COMM SE,Commercial,70762,0,128874,199636
142810400200000,COMM SE,Commercial,140330,0,673920,814250
142810500100000,E-70 CHARITY OTHER,Exempt,19157,0,281489,300646
142810500300000,COMM SE,Commercial,39150,0,0,39150
142810500400000,Empty,Exempt,0,0,0,0
142810500500000,COMM SE,Commercial,25447,0,58682,84129
142810500600000,COMM SE,Commercial,15187,0,0,15187
142810500700000,COMM SE,Commercial,16672,0,0,16672
142810500800000,COMM SE,Commercial,63450,0,43835,107285
142810500900000,COMM SE,Commercial,8775,0,0,8775
142810501000000,COMM SE,Commercial,11583,0,4792,16375
142810501100000,Empty,Exempt,0,0,0,0
142810600100000,COMM SE,Commercial,81648,0,408529,490177
142810600200000,COMM SE,Commercial,35381,0,208979,244360
142810600400000,COMM SE,Commercial,134784,0,1015527,1150311
142810700100000,COMM SE,Commercial,66252,0,480619,546871
142810700200000,COMM SE,Commercial,83011,0,293141,376152
142810700300000,INDUSTRIAL,Industrial,31200,0,140110,171310
142810800100000,COMM SE,Commercial,54432,0,275726,330158
142810900100000,COMM SE,Commercial,74250,0,16566,90816
142810900300000,COMM SE,Commercial,11794,0,64448,76242
142810900400000,COMM SE,Commercial,29484,0,41658,71142
142810900500000,COMM SE,Commercial,29484,0,32213,61697
142810900600000,CONVERSIONS,Commercial,5400,0,0,5400
142810900700000,E-70 CHARITY OTHER,Exempt,93053,0,36562,129615
142810900800000,SE 238,Residential,3952,0,0,3952
142810900900000,SE 238,Residential,3458,0,0,3458
142810901000000,SE 238,Residential,5000,22120,0,27120
142811000100000,COMM SE,Commercial,84240,0,164652,248892
142811000400000,COMM SE,Commercial,90720,0,8631,99351
142811000402000,COMM SE,Commercial,0,0,53378,53378
142811000500000,COMM SE,Commercial,29484,0,12173,41657
142811000600000,COMM SE,Commercial,29484,0,34598,64082
142811000700000,COMM SE,Commercial,14742,0,24316,39058
142811000800000,COMM SE,Commercial,8845,0,46007,54852
142811000900000,Empty,Other,0,0,0,0
142811100100000,COMM CTRL CORE,Commercial,31059,0,8294,39353
142811100200000,COMM CTRL CORE,Commercial,21773,0,1956,23729
142811100300000,COMM CTRL CORE,Commercial,38102,0,112762,150864
142811100400000,COMM CTRL CORE,Commercial,27174,0,4358,31532
142811200100000,SE 237,Residential,5000,0,0,5000
142811300100000,COMM SE,Commercial,58968,0,130116,189084
142811300200000,COMM SE,Commercial,88452,0,222067,310519
142811300300000,E-70 CHARITY OTHER,Exempt,81648,0,719329,800977
142811400100000,COMM CTRL CORE,Commercial,9264,0,1213,10477
142811400200000,COMM CTRL CORE,Commercial,49669,0,14449,64118
142811400300000,COMM CTRL CORE,Commercial,9526,0,34370,43896
142811400400000,COMM CTRL CORE,Commercial,35925,0,34838,70763
142811400500000,COMM CTRL CORE,Commercial,19129,0,46783,65912
142811400600000,COMM CTRL CORE,Commercial,31752,0,0,31752
142811400700000,COMM CTRL CORE,Commercial,31752,0,5552,37304
142811400800000,COMM CTRL CORE,Commercial,41674,0,6841,48515
142811400900000,Empty,Exempt,0,0,0,0
142811500100000,COMM SE,Commercial,23328,0,31608,54936
142812600100000,COMM CTRL CORE,Commercial,128498,0,1096607,1225105
142812600200000,COMM CTRL CORE,Commercial,149990,0,59452,209442
142812600300000,COMM CTRL CORE,Commercial,97200,0,24937,122137
142812700100000,COMM CTRL CORE,Commercial,89813,0,346825,436638
142812700200000,COMM CTRL CORE,Commercial,126036,0,769030,895066
142812700300000,COMM CTRL CORE,Commercial,163296,0,547883,711179
142812700400000,COMM CTRL CORE,Commercial,69624,0,549748,619372
142812700500000,COMM CTRL CORE,Commercial,187986,0,368554,556540
142812700600000,Empty,Exempt,0,0,0,0
142812800100000,COMM CTRL CORE,Commercial,86184,0,507099,593283
142812800200000,COMM CTRL CORE,Commercial,172368,0,1325230,1497598
142812800300000,COMM CTRL CORE,Commercial,183859,0,928077,1111936
142812800400000,COMM CTRL CORE,Commercial,290153,0,1348971,1639124
142812800402000,COMM CTRL CORE,Commercial,0,0,22,22
142812900100000,Empty,Exempt,0,0,0,0
142812900200000,COMM CTRL CORE,Commercial,182196,0,17079,199275
142812900300000,COMM CTRL CORE,Commercial,9355,0,10382,19737
142812900400000,COMM CTRL CORE,Commercial,63220,0,5453,68673
142812900500000,APTS SE,Commercial,50544,0,2339855,2390399
142813000100000,COMM CTRL CORE,Commercial,560196,0,5505792,6065988
142813000200000,COMM CTRL CORE,Commercial,363696,0,2692593,3056289
142813000300000,COMM CTRL CORE,Commercial,326592,0,520982,847574
142813000400000,COMM CTRL CORE,Commercial,144666,0,1494301,1638967
142813000500000,COMM CTRL CORE,Commercial,20412,0,1167,21579
142813100101000,COMM CTRL CORE,Commercial,20677,0,61099,81776
142813100101001,COMM CTRL CORE,Commercial,13797,0,26776,40573
142813100101002,COMM CTRL CORE,Commercial,29565,0,116133,145698
142813100101003,COMM CTRL CORE,Commercial,31995,0,133339,165334
142813100101004,COMM CTRL CORE,Commercial,19699,0,104801,124500
142813100101005,COMM CTRL CORE,Commercial,57861,0,231200,289061
142813100101006,COMM CTRL CORE,Commercial,57861,0,78252,136113
142813100102000,Empty,Exempt,0,0,0,0
142813100200000,E-55 LIBRARY/ART,Exempt,73872,0,332850,406722
142813100300000,COMM CTRL CORE,Commercial,33242,0,73634,106876
142813100400000,COMM CTRL CORE,Commercial,63504,0,103801,167305
142813100500000,COMM CTRL CORE,Commercial,63504,0,104873,168377
142813100600000,COMM CTRL CORE,Commercial,63504,0,93152,156656
142813100700000,Empty,Exempt,0,0,0,0
142813100800000,Empty,Exempt,0,0,0,0
142813100900000,COMM CTRL CORE,Commercial,157853,0,0,157853
142813100904000,Empty,Exempt,0,0,0,0
142813200100000,COMM CTRL CORE,Commercial,17496,0,1711,19207
142813200200000,COMM CTRL CORE,Commercial,45360,0,6786,52146
142813200300000,COMM CTRL CORE,Commercial,15120,0,2056,17176
142813200400000,COMM CTRL CORE,Commercial,68040,0,372775,440815
142813200500000,INDUSTRIAL,Industrial,20160,0,89659,109819
142813200600000,COMM CTRL CORE,Commercial,47628,0,32028,79656
142813200700000,COMM CTRL CORE,Commercial,140551,0,897562,1038113
142813300100000,COMM CTRL CORE,Commercial,86184,0,1645679,1731863
142813300200000,COMM CTRL CORE,Commercial,63504,0,29346,92850
142813300300000,COMM CTRL CORE,Commercial,81648,0,1012819,1094467
142813300400000,Empty,Exempt,0,0,0,0
142813300500000,E-76 EDU CLASS BLDG,Exempt,0,0,0,0
142813300501000,COMM CTRL CORE,Commercial,0,0,620794,620794
142813300501001,COMM CTRL CORE,Commercial,0,0,320688,320688
142813300501002,COMM CTRL CORE,Commercial,0,0,164282,164282
142813300501003,COMM CTRL CORE,Commercial,0,0,205353,205353
142813300501004,COMM CTRL CORE,Commercial,0,0,318978,318978
142813300501005,COMM CTRL CORE,Commercial,0,0,164282,164282
142813300501006,COMM CTRL CORE,Commercial,0,0,164282,164282
142813300501007,COMM CTRL CORE,Commercial,0,0,150000,150000
142813300501008,COMM CTRL CORE,Commercial,0,0,150000,150000
142813300501009,COMM CTRL CORE,Commercial,0,0,300000,300000
142813300501010,COMM CTRL CORE,Commercial,0,0,620794,620794
142813300501011,COMM CTRL CORE,Commercial,0,0,620794,620794
142813300501012,COMM CTRL CORE,Commercial,0,0,318978,318978
142813300501013,COMM CTRL CORE,Commercial,0,0,318978,318978
142813300501014,COMM CTRL CORE,Commercial,0,0,620794,620794
142813300501015,COMM CTRL CORE,Commercial,0,0,620794,620794
142813300501016,COMM CTRL CORE,Commercial,0,0,620794,620794
142813300501017,COMM CTRL CORE,Commercial,0,0,620794,620794
142813300501018,COMM CTRL CORE,Commercial,0,0,639715,639715
142813300501019,COMM CTRL CORE,Commercial,0,0,317132,317132
142813300501020,COMM CTRL CORE,Commercial,0,0,274456,274456
142813300501021,CONDO 500,Residential,0,65657,0,65657
142813300501022,CONDO 500,Residential,0,56883,0,56883
142813300501023,CONDO 500,Residential,0,57019,0,57019
142813300501025,CONDO 500,Residential,0,57019,0,57019
142813300501027,CONDO 500,Residential,0,57019,0,57019
142813300501028,CONDO 500,Residential,0,47103,0,47103
142813300501029,CONDO 500,Residential,0,57019,0,57019
142813300501030,CONDO 500,Residential,0,49186,0,49186
142813300501031,CONDO 500,Residential,0,48322,0,48322
142813300501032,CONDO 500,Residential,0,57019,0,57019
142813300501033,CONDO 500,Residential,0,57019,0,57019
142813300501034,CONDO 500,Residential,0,57019,0,57019
142813300501035,CONDO 500,Residential,0,57019,0,57019
142813300501036,CONDO 500,Residential,0,57019,0,57019
142813300501037,CONDO 500,Residential,0,57019,0,57019
142813300501038,CONDO 500,Residential,0,47103,0,47103
142813300501039,CONDO 500,Residential,0,57019,0,57019
142813300501040,CONDO 500,Residential,0,49186,0,49186
142813300501041,CONDO 500,Residential,0,48322,0,48322
142813300501042,CONDO 500,Residential,0,57019,0,57019
142813300501043,CONDO 500,Residential,0,57019,0,57019
142813300501044,CONDO 500,Residential,0,57019,0,57019
142813300501045,CONDO 500,Residential,0,57019,0,57019
142813300501046,CONDO 500,Residential,0,57019,0,57019
142813300501047,CONDO 500,Residential,0,57019,0,57019
142813300501048,CONDO 500,Residential,0,47103,0,47103
142813300501049,CONDO 500,Residential,0,57019,0,57019
142813300501050,CONDO 500,Residential,0,49186,0,49186
142813300501051,CONDO 500,Residential,0,102822,0,102822
142813300501052,CONDO 500,Residential,0,57019,0,57019
142813300501053,CONDO 500,Residential,0,95873,0,95873
142813300501054,CONDO 500,Residential,0,57019,0,57019
142813300501055,CONDO 500,Residential,0,95873,0,95873
142813300501056,CONDO 500,Residential,0,57019,0,57019
142813300501057,CONDO 500,Residential,0,95873,0,95873
142813300501058,CONDO 500,Residential,0,95873,0,95873
142813300501059,CONDO 500,Residential,0,47103,0,47103
142813300501060,CONDO 500,Residential,0,95873,0,95873
142813300501061,CONDO 500,Residential,0,49186,0,49186
142813300501062,CONDO 500,Residential,0,95873,0,95873
142813300700000,COMM CTRL CORE,Commercial,148716,0,793947,942663
142813300800000,E-70 CHARITY OTHER,Exempt,38880,0,99285,138165
142813400100000,COMM CTRL CORE,Commercial,281151,0,2846331,3127482
142813400200000,COMM SE,Commercial,222831,0,1537698,1760529
142813400300000,E-70 CHARITY OTHER,Exempt,71747,0,733901,805648
142813400400000,COMM CTRL CORE,Commercial,223206,0,11113,234319
142813400500000,E-64 YMCA,Exempt,125107,0,57576,182683
142813400600000,COMM CTRL CORE,Commercial,50719,0,23519,74238
142813500100000,Empty,Exempt,0,0,0,0
142813600100000,COMM CTRL CORE,Commercial,37179,0,177279,214458
142813600200000,E-83 EDU OTHER,Exempt,52978,0,110773,163751
142813600400000,E-55 LIBRARY/ART,Exempt,82305,0,876287,958592
142813600500000,Empty,Exempt,0,0,0,0
142813600600000,Empty,Exempt,0,0,0,0
142813600700000,E-55 LIBRARY/ART,Exempt,43821,0,0,43821
142813600800000,E-55 LIBRARY/ART,Exempt,4909,0,0,4909
142813700100000,COMM CTRL CORE,Commercial,31104,0,2240,33344
142813700200000,COMM CTRL CORE,Commercial,19051,0,23316,42367
142813700300000,COMM CTRL CORE,Commercial,32659,0,248584,281243
142813700400000,COMM CTRL CORE,Commercial,44453,0,90039,134492
142815100200000,E-64 YMCA,Exempt,437980,0,6827576,7265556
142815200100000,Empty,Exempt,0,0,0,0
142815200200000,COMM CTRL CORE,Commercial,68947,0,416491,485438
142815200300000,COMM CTRL CORE,Commercial,133623,0,52917,186540
142815300100000,Empty,Exempt,0,0,0,0
142815300200000,COMM CTRL CORE,Commercial,204120,0,79839,283959
142815300300000,Empty,Exempt,0,0,0,0
142815300400000,COMM CTRL CORE,Commercial,269325,0,12556378,12825703
142815400100000,Empty,Exempt,0,0,0,0
142815500100000,Empty,Exempt,0,0,0,0
142815600100000,Empty,Exempt,0,0,0,0
142815600300000,Empty,Exempt,0,0,0,0
142815700100000,Empty,Exempt,0,0,0,0
142815800100000,E-10 COUNTY,Exempt,0,0,0,0
142815800200000,Empty,Exempt,0,0,0,0
142816400202000,COMM CTRL CORE,Commercial,0,0,24545,24545
142816400902000,COMM CTRL CORE,Commercial,0,0,22,22
142817600100000,SE 237,Residential,2400,0,0,2400
142817600200000,SE 237,Residential,1860,0,0,1860
142817600300000,COMM SE,Commercial,10595,0,0,10595
142817600400000,SE 237,Residential,3348,0,0,3348
142817600500000,SE 237,Residential,3683,0,0,3683
142817600600000,SE 237,Residential,3596,0,0,3596
142817600700000,SE 237,Residential,5000,0,0,5000
142817600800000,SE 237,Residential,5000,20287,0,25287
142817700100000,COMM SE,Commercial,17690,0,67041,84731
142817700200000,COMM SE,Commercial,17690,0,49345,67035
142817800100000,COMM CTRL CORE,Commercial,31752,0,0,31752
142817800200000,COMM CTRL CORE,Commercial,31752,0,49675,81427
142817900200000,COMM CTRL CORE,Commercial,26890,0,28732,55622
142817900202000,COMM CTRL CORE,Commercial,0,0,10581,10581
142818000300000,Empty,Other,0,0,0,0
142818000400000,INDUSTRIAL,Industrial,64577,0,309296,373873
142818000500000,COMM SE,Commercial,6804,0,0,6804
142818000600000,COMM SE,Commercial,27216,0,2333,29549
142818000700000,COMM SE,Commercial,13608,0,2216,15824
142818000800000,COMM SE,Commercial,13608,0,2216,15824
142818000900000,SE 237,Residential,5000,0,0,5000
142818001000000,SE 237,Residential,5000,0,0,5000
142818001100000,SE 237,Residential,5000,0,0,5000
142818001200000,Empty,Other,0,0,0,0
142818001300000,Empty,Other,0,0,0,0
142818100100000,COMM CTRL CORE,Commercial,25175,0,84140,109315
142818100300000,Empty,Other,0,0,0,0
142818200100000,COMM CTRL CORE,Commercial,202608,0,250476,453084
142818200102000,COMM CTRL CORE,Commercial,0,0,7011,7011
142818200300000,Empty,Other,0,0,0,0
142818300100000,COMM SE,Commercial,4036,0,6951,10987
142818300200000,COMM SE,Commercial,26851,0,31613,58464
142818300300000,COMM SE,Commercial,8424,0,11834,20258
142818300400000,COMM SE,Commercial,44226,0,21328,65554
142818300500000,COMM SE,Commercial,9990,0,257,10247
142818300600000,COMM SE,Commercial,3780,0,1307,5087
142818300700000,COMM SE,Commercial,25359,0,11501,36860
142818300800000,COMM SE,Commercial,87480,0,18186,105666
142818300900000,COMM SE,Commercial,1037,0,261,1298
142818400100000,COMM CTRL CORE,Commercial,45595,0,484,46079
142818400200000,COMM CTRL CORE,Commercial,62664,0,0,62664
142818400300000,COMM CTRL CORE,Commercial,57154,0,141864,199018
142818400400000,COMM CTRL CORE,Commercial,91098,0,311605,402703
142818500100000,COMM SE,Commercial,59213,0,293712,352925
142818500200000,COMM SE,Commercial,13608,0,0,13608
142818500300000,SE 237,Residential,5000,0,0,5000
142818500400000,COMM SE,Commercial,11794,0,22774,34568
142818500500000,COMM SE,Commercial,11794,0,14635,26429
142818500600000,COMM SE,Commercial,23587,0,39166,62753
142818500700000,COMM SE,Commercial,11794,0,7640,19434
142818500800000,COMM SE,Commercial,35381,0,56937,92318
142818600101000,CONDO 500,Residential,15000,60455,0,75455
142818600101001,CONDO 500,Residential,15000,41908,0,56908
142818600101002,CONDO 500,Residential,15000,54765,0,69765
142818600101003,CONDO 500,Residential,15000,68023,0,83023
142818600101004,CONDO 500,Residential,15000,62182,0,77182
142818600101005,CONDO 500,Residential,15000,71248,0,86248
142818600101006,CONDO 500,Residential,15000,65783,0,80783
142818600101007,CONDO 500,Residential,15000,86579,0,101579
142818600101008,CONDO 500,Residential,15000,69285,0,84285
142818600101009,CONDO 500,Residential,15000,144747,0,159747
142818600101010,CONDO 500,Residential,15000,86579,0,101579
142818600101011,CONDO 500,Residential,15000,71983,0,86983
142818600101012,CONDO 500,Residential,15000,42317,0,57317
142818600101013,CONDO 500,Residential,15000,59296,0,74296
142818600101014,CONDO 500,Residential,15000,86579,0,101579
142818600101015,CONDO 500,Residential,15000,72610,0,87610
142818600101016,CONDO 500,Residential,15000,72610,0,87610
142818600101017,CONDO 500,Residential,15000,86579,0,101579
142818600101018,CONDO 500,Residential,15000,80446,0,95446
142818600101019,CONDO 500,Residential,15000,137438,0,152438
142818600101020,CONDO 500,Residential,15000,86579,0,101579
142818600101021,CONDO 500,Residential,15000,68738,0,83738
142818600101022,CONDO 500,Residential,15000,68738,0,83738
142818600101023,CONDO 500,Residential,15000,86579,0,101579
142818600101024,CONDO 500,Residential,15000,71983,0,86983
142818600101025,CONDO 500,Residential,15000,42317,0,57317
142818600101026,CONDO 500,Residential,15000,59296,0,74296
142818600101027,CONDO 500,Residential,15000,86579,0,101579
142818600101028,CONDO 500,Residential,15000,72610,0,87610
142818600101029,CONDO 500,Residential,15000,72610,0,87610
142818600101030,CONDO 500,Residential,15000,86579,0,101579
142818600101031,CONDO 500,Residential,15000,80446,0,95446
142818600101032,CONDO 500,Residential,15000,140557,0,155557
142818600101033,CONDO 500,Residential,15000,187087,0,202087
142818600101034,CONDO 500,Residential,15000,148028,0,163028
142818600101035,CONDO 500,Residential,15000,148028,0,163028
142818600101036,CONDO 500,Residential,15000,187087,0,202087
142818600101037,CONDO 500,Residential,15000,157362,0,172362
142818600101038,CONDO 500,Residential,15000,91602,0,106602
142818600101039,CONDO 500,Residential,15000,127156,0,142156
142818600101040,CONDO 500,Residential,15000,195529,0,210529
142818600101041,CONDO 500,Residential,15000,155145,0,170145
142818600101042,CONDO 500,Residential,15000,155145,0,170145
142818600101043,CONDO 500,Residential,15000,195529,0,210529
142818600101044,CONDO 500,Residential,15000,171324,0,186324
142818600101045,CONDO 500,Residential,15000,68382,0,83382
142818600101046,CONDO 500,Residential,15000,89594,0,104594
142818600101047,CONDO 500,Residential,15000,71472,0,86472
142818600101048,CONDO 500,Residential,15000,73440,0,88440
142818600101049,CONDO 500,Residential,15000,89594,0,104594
142818600101050,CONDO 500,Residential,15000,74717,0,89717
142818600101051,CONDO 500,Residential,15000,44331,0,59331
142818600101052,CONDO 500,Residential,15000,61771,0,76771
142818600101053,CONDO 500,Residential,15000,95624,0,110624
142818600101054,CONDO 500,Residential,15000,75479,0,90479
142818600101055,CONDO 500,Residential,15000,75479,0,90479
142818600101056,CONDO 500,Residential,15000,95624,0,110624
142818600101057,CONDO 500,Residential,15000,83461,0,98461
142818600201000,COMM SE,Commercial,8775,0,43026,51801
142818600201001,COMM SE,Commercial,8775,0,39679,48454
142818600201002,COMM SE,Commercial,8775,0,27499,36274
142818600201003,COMM SE,Commercial,17550,0,111047,128597
142818600201004,CONDO 502,Residential,15000,176156,0,191156
142818600201005,CONDO 502,Residential,15000,117741,0,132741
142818600201006,CONDO 502,Residential,15000,159626,0,174626
142818600201007,CONDO 502,Residential,15000,143036,0,158036
142818600201008,CONDO 502,Residential,15000,157067,0,172067
142818600201009,CONDO 502,Residential,15000,161746,0,176746
142818600201010,CONDO 502,Residential,15000,178463,0,193463
142818600201011,CONDO 502,Residential,15000,160569,0,175569
142818600201012,CONDO 502,Residential,15000,245076,0,260076
142818600201013,CONDO 502,Residential,15000,168750,0,183750
142818600201014,CONDO 502,Residential,15000,175078,0,190078
142818600201015,CONDO 502,Residential,15000,121018,0,136018
142818600201016,CONDO 502,Residential,15000,156349,0,171349
142818600201017,CONDO 502,Residential,15000,142677,0,157677
142818600201018,CONDO 502,Residential,15000,160344,0,175344
142818600201019,CONDO 502,Residential,15000,154629,0,169629
142818600201020,CONDO 502,Residential,15000,185039,0,200039
142818600201021,CONDO 502,Residential,15000,154271,0,169271
142818600201022,CONDO 502,Residential,15000,232709,0,247709
142818600201023,CONDO 502,Residential,15000,169882,0,184882
142818600201024,CONDO 502,Residential,15000,172275,0,187275
142818600201025,CONDO 502,Residential,15000,123938,0,138938
142818600201026,CONDO 502,Residential,15000,169753,0,184753
142818600201027,CONDO 502,Residential,15000,151319,0,166319
142818600201028,CONDO 502,Residential,15000,167597,0,182597
142818600201029,CONDO 502,Residential,15000,167942,0,182942
142818600201030,CONDO 502,Residential,15000,185308,0,200308
142818600201031,CONDO 502,Residential,15000,162767,0,177767
142818600201032,CONDO 502,Residential,15000,237573,0,252573
142818600201033,CONDO 502,Residential,15000,178129,0,193129
142818600201034,CONDO 502,Residential,15000,291394,0,306394
142818600201036,CONDO 502,Residential,15000,382151,0,397151
142818600201038,CONDO 502,Residential,15000,391976,0,406976
142818600201039,CONDO 502,Residential,15000,323563,0,338563
142818600201040,CONDO 502,Residential,15000,292845,0,307845
142818600201041,CONDO 502,Residential,15000,374371,0,389371
142818600201042,CONDO 502,Residential,15000,352055,0,367055
142818600201043,CONDO 502,Residential,15000,158866,0,173866
142818600201044,CONDO 502,Residential,15000,393786,0,408786
142818600201045,CONDO 502,Residential,15000,324931,0,339931
142818600201046,CONDO 502,Residential,15000,386172,0,401172
142818600201047,CONDO 502,Residential,15000,385868,0,400868
142818600201048,CONDO 502,Residential,15000,354887,0,369887
142818600201049,CONDO 502,Residential,15000,385771,0,400771
142818600201050,CONDO 502,Residential,15000,380000,0,395000
142818600300000,COMM SE,Commercial,36504,0,23179,59683
142818600400000,COMM SE,Commercial,31860,0,0,31860
142818700100000,Empty,Exempt,0,0,0,0
142818700200000,Empty,Exempt,0,0,0,0
142818700300000,Empty,Exempt,0,0,0,0
142818700400000,Empty,Exempt,0,0,0,0
142818700500000,Empty,Exempt,0,0,0,0
142818700600000,Empty,Exempt,0,0,0,0
142818700700000,Empty,Exempt,0,0,0,0
142818800100000,E-70 CHARITY OTHER,Exempt,36288,0,693,36981
142818800200000,E-70 CHARITY OTHER,Exempt,27216,0,710,27926
142818800300000,E-70 CHARITY OTHER,Exempt,27216,0,0,27216
142818800400000,SE 237,Residential,5000,0,0,5000
142818800500000,SE 237,Residential,5000,0,0,5000
142818800600000,SE 237,Residential,5000,0,0,5000
142818800700000,SE 237,Residential,5000,0,0,5000
142818800800000,SE 237,Exempt,0,0,0,0
142818800900000,COMM SE,Commercial,23587,0,37967,61554
142818801000000,SE 237,Residential,2400,0,0,2400
142818801100000,SE 237,Residential,5000,0,0,5000
142818801200000,CONVERSIONS,Commercial,5400,0,0,5400
142818801300000,SE 237,Exempt,6000,0,0,6000
142818801400000,SE 237,Exempt,6000,0,0,6000
142818801500000,E-70 CHARITY OTHER,Exempt,18144,0,201,18345
142818900100000,COMM SE,Commercial,17690,0,37760,55450
142818900200000,COMM SE,Commercial,17690,0,52988,70678
142819000100000,COMM SE,Commercial,31450,0,77468,108918
142819000200000,SE 237,Residential,5000,0,0,5000
142819000300000,SE 237,Residential,5000,0,0,5000
142819100100000,Empty,Other,0,0,0,0
142820100100000,COMM CTRL CORE,Commercial,245009,0,1165216,1410225
142820100200000,COMM CTRL CORE,Commercial,90720,0,5391,96111
142820100300000,COMM CTRL CORE,Other,0,0,0,0
142820100400000,COMM CTRL CORE,Commercial,26827,0,49358,76185
142820100500000,COMM CTRL CORE,Commercial,184680,0,775320,960000
142820100600000,COMM CTRL CORE,Commercial,172368,0,614369,786737
142820100700000,COMM CTRL CORE,Commercial,110304,0,0,110304
142820100800000,COMM CTRL CORE,Commercial,48989,0,35661,84650
142820200100000,COMM CTRL CORE,Commercial,158760,0,9828,168588
142820200200000,COMM CTRL CORE,Commercial,295060,0,25815,320875
142820300100000,E-01 FEDERAL,Exempt,0,0,0,0
142820400100000,Empty,Exempt,0,0,0,0
142820400107000,COMM NE,Commercial,0,0,4941536,4941536
142820400107001,COMM NE,Commercial,0,0,78329,78329
142820400107002,COMM NE,Commercial,0,0,1254898,1254898
142820400107003,COMM NE,Commercial,0,0,1568759,1568759
142820400107004,COMM NE,Commercial,0,0,936351,936351
142820400107005,COMM NE,Commercial,0,0,28869,28869
142820500100000,Empty,Exempt,0,0,0,0
142820600100000,COMM CTRL CORE,Commercial,81784,0,28059,109843
142820600200000,COMM CTRL CORE,Commercial,108728,0,78041,186769
142820700100000,COMM CTRL CORE,Commercial,448766,0,1439288,1888054
142820800100000,E-10 COUNTY,Exempt,0,0,0,0
142820900100000,Empty,Exempt,0,0,0,0
142821000100000,COMM CTRL CORE,Commercial,157594,0,2103183,2260777
142822600100000,Empty,Exempt,0,0,0,0
142822700100000,Empty,Exempt,0,0,0,0
142822800100000,COMM CTRL CORE,Commercial,18522,0,16114,34636
142822800200000,NW 318,Residential,5000,0,0,5000
142822800300000,NW 318,Residential,5000,0,0,5000
142822800400000,COMM NW,Commercial,5443,0,2890,8333
142822800500000,COMM NW,Commercial,5400,0,0,5400
142822800600000,COMM NW,Commercial,37244,0,33788,71032
142822800700000,COMM NW,Commercial,64589,0,58331,122920
142822800800000,COMM CTRL CORE,Commercial,114307,0,81835,196142
142822800900000,COMM CTRL CORE,Commercial,44982,0,69232,114214
142822900100000,COMM NW,Commercial,16067,0,3689,19756
142822900300000,COMM NW,Commercial,25061,0,40009,65070
142823000100000,Empty,Exempt,0,0,0,0
142823100100000,COMM CTRL CORE,Commercial,122601,0,491333,613934
142823100200000,COMM SW,Commercial,25920,0,4957,30877
142823100300000,COMM SW,Commercial,25920,0,5361,31281
142823100400000,COMM SW,Commercial,31104,0,0,31104
142823100500000,COMM SW,Commercial,8281,0,914,9195
142823100600000,COMM SW,Commercial,24313,0,2948,27261
142823100700000,SW 401,Residential,6000,34303,0,40303
142823100800000,COMM SW,Commercial,6048,0,40572,46620
142823100900000,COMM SW,Commercial,12096,0,76375,88471
142823101000000,SW 401,Residential,5000,1999,0,6999
142823101100000,SW 401,Residential,5000,0,0,5000
142823101200000,COMM CTRL CORE,Commercial,76205,0,26871,103076
142823200100000,COMM SW,Commercial,54613,0,52450,107063
142823200102000,COMM SW,Commercial,0,0,27247,27247
142823200200000,E-46 RELIG PARKING,Exempt,26853,0,3956,30809
142823200300000,E-40 CHURCHES,Exempt,108864,0,171391,280255
142823200400000,COMM SW,Commercial,5346,0,22981,28327
142823200500000,Empty,Commercial,9979,0,0,9979
142823200600000,COMM SW,Commercial,18144,0,21680,39824
142823200800000,E-46 RELIG PARKING,Exempt,108864,0,51944,160808
142823201100000,COMM SW,Commercial,5000,0,0,5000
142823300300000,E-10 COUNTY,Exempt,0,0,0,0
142823300400000,E-05 STATE,Exempt,0,0,0,0
142823300500000,E-05 STATE,Exempt,0,0,0,0
142823400100000,COMM CTRL CORE,Commercial,138753,0,395610,534363
142823400200000,COMM CTRL CORE,Commercial,54432,0,5552,59984
142823400300000,Empty,Exempt,0,0,0,0
142823400500000,COMM CTRL CORE,Commercial,54432,0,52708,107140
142823400700000,COMM CTRL CORE,Commercial,10161,0,20556,30717
142823400800000,COMM CTRL CORE,Commercial,7620,0,66810,74430
142823400900000,COMM CTRL CORE,Commercial,10842,0,53549,64391
142823401000000,COMM CTRL CORE,Commercial,6034,0,24466,30500
142823401100000,COMM SW,Commercial,21569,0,42205,63774
142823500100000,COMM SW,Commercial,18144,0,25305,43449
142823500200000,COMM SW,Commercial,18144,0,0,18144
142823500300000,COMM SW,Commercial,36288,0,4899,41187
142823500400000,COMM SW,Commercial,18144,0,2449,20593
142823500500000,COMM SW,Commercial,20563,0,0,20563
142823500600000,SW 401,Residential,5000,0,0,5000
142823500700000,SW 401,Residential,6360,0,0,6360
142823500800000,SW 401,Residential,6840,0,0,6840
142823500900000,COMM SW,Commercial,18144,0,3084,21228
142823501000000,COMM SW,Commercial,12096,0,25730,37826
142823501100000,COMM SW,Commercial,24192,0,74046,98238
142823600100000,COMM CTRL CORE,Commercial,54621,0,1121274,1175895
142823700200000,SW 401,Residential,13202,0,0,13202
142823700300000,SW 401,Residential,5000,0,0,5000
142823900100000,INDUSTRIAL,Industrial,12864,0,25803,38667
142825100100000,COMM CTRL CORE,Commercial,72954,0,21974,94928
142825100200000,COMM CTRL CORE,Commercial,101871,0,190293,292164
142825100300000,COMM CTRL CORE,Commercial,7560,0,1083,8643
142825200100000,COMM SW,Commercial,36288,0,23642,59930
142825300100000,SW 401,Residential,5000,0,0,5000
142825300200000,COMM SW,Commercial,37260,0,6301,43561
142825300300000,COMM SW,Commercial,13608,0,12179,25787
142825300302000,COMM SW,Commercial,0,0,43064,43064
142825300400000,COMM SW,Commercial,18144,0,65222,83366
142825400100000,Empty,Exempt,0,0,0,0
142825400200000,E-40 CHURCHES,Exempt,90720,0,278964,369684
142825400300000,COMM SW,Commercial,30104,0,67233,97337
142825500100000,INDUSTRIAL,Industrial,44800,0,193606,238406
142825500200000,COMM SW,Commercial,6048,0,80544,86592
142825500300000,COMM SW,Commercial,18144,0,64129,82273
142825500400000,COMM SW,Commercial,18144,0,74186,92330
142825500500000,COMM SW,Commercial,18144,0,23292,41436
142825500502000,COMM SW,Commercial,0,0,11729,11729
142825500600000,INDUSTRIAL,Industrial,32760,0,0,32760
142825500700000,COMM SW,Commercial,38102,0,6415,44517
142825500800000,SW 401,Residential,5000,0,0,5000
142825500900000,SW 401,Residential,5000,0,0,5000
142825501000000,COMM SW,Commercial,7776,0,40274,48050
142825600100000,SW 401,Residential,5000,0,0,5000
142825600200000,SW 401,Residential,5000,0,0,5000
142825600300000,SW 401,Residential,11250,23174,0,34424
142825600400000,SW 401,Residential,5000,0,0,5000
142825600500000,COMM SW,Commercial,15309,0,113080,128389
142825600600000,SW 401,Residential,5000,0,0,5000
142825600700000,SW 401,Residential,5000,37074,0,42074
142825600800000,SW 401,Residential,5000,0,0,5000
142825600900000,SW 401,Residential,5000,0,0,5000
142825601000000,SW 401,Residential,5580,0,0,5580
142825601100000,COMM SW,Commercial,4860,0,32863,37723
142825601200000,CONVERSIONS,Commercial,10206,0,24196,34402
142825601300000,COMM SW,Commercial,6804,0,20732,27536
142825601400000,SW 401,Residential,6750,27679,0,34429
142825601500000,CONVERSIONS,Commercial,5400,0,0,5400
142825601600000,SW 401,Residential,5000,0,0,5000
142825601700000,CONVERSIONS,Commercial,4860,0,0,4860
142825601800000,SW 401,Residential,5000,0,0,5000
142825601900000,SW 401,Residential,5000,0,0,5000
142825602000000,SW 401,Residential,5000,24405,0,29405
142825602100000,SW 401,Residential,5000,12833,0,17833
142825700100000,COMM SW,Commercial,30240,0,204736,234976
142825700200000,COMM SW,Commercial,15120,0,65918,81038
142825700300000,COMM SW,Commercial,30240,0,12566,42806
142825700400000,COMM SW,Commercial,26503,0,0,26503
142825700500000,SW 401,Residential,11250,21273,0,32523
142825700600000,SW 401,Residential,11250,24968,0,36218
142825700700000,SW 401,Residential,5000,0,0,5000
142825700800000,APTS SW,Commercial,7371,0,50233,57604
142825700900000,SW 401,Residential,6750,0,0,6750
142825701000000,SW 401,Residential,11025,29089,0,40114
142825701100000,COMM SW,Commercial,8316,0,1323,9639
142825800100000,SW 401,Residential,5000,0,0,5000
142825800200000,SW 401,Residential,7031,0,0,7031
142825800300000,SW 401,Exempt,5000,0,0,5000
142825800400000,SW 401,Exempt,6750,0,0,6750
142825800500000,SW 401,Exempt,5000,0,0,5000
142825800600000,E-70 CHARITY OTHER,Exempt,17496,0,24505,42001
142825800700000,SW 401,Residential,5000,0,0,5000
142825800800000,SW 401,Residential,5000,0,0,5000
142825800900000,SW 401,Residential,5000,0,0,5000
142825801000000,SW 401,Residential,7965,25364,0,33329
142825801100000,SW 401,Residential,6750,13796,0,20546
142825801200000,SW 401,Residential,6750,32387,0,39137
142825801300000,CONVERSIONS,Commercial,5400,0,0,5400
142825900100000,SW 401,Residential,7560,34686,0,42246
142825900200000,SW 401,Residential,14175,66903,0,81078
142825900300000,SW 401,Residential,5000,0,0,5000
142825900400000,SW 401,Residential,11250,9800,0,21050
142825900500000,SW 401,Residential,11250,47820,0,59070
142825900600000,APTS SW,Commercial,7371,0,69016,76387
142825900700000,CONVERSIONS,Commercial,8505,0,30748,39253
142825900800000,SW 401,Residential,5000,0,0,5000
142825900900000,SW 401,Residential,8505,30425,0,38930
142825901000000,SW 401,Residential,5000,0,0,5000
142825901100000,SW 401,Residential,5000,0,0,5000
142825901200000,CONVERSIONS,Commercial,5294,0,0,5294
142825901300000,COMM SW,Commercial,17393,0,3961,21354
142825901400000,SW 401,Residential,5000,0,0,5000
142825901500000,SW 401,Residential,5000,0,0,5000
142825901600000,SW 401,Residential,11250,19291,0,30541
142825901700000,SW 401,Residential,11250,35741,0,46991
142825901800000,SW 401,Residential,11250,33622,0,44872
142825901900000,SW 401,Residential,5456,25364,0,30820
142825902000000,SW 401,Residential,5000,0,0,5000
142825902100000,SW 401,Residential,11250,33181,0,44431
142825902200000,SW 401,Residential,5625,24880,0,30505
142825902300000,SW 401,Residential,5625,22627,0,28252
142825902400000,SW 401,Residential,5000,0,0,5000
142825902500000,CONVERSIONS,Commercial,5400,0,0,5400
142825902600000,SW 401,Residential,5000,20106,0,25106
142825902700000,SW 401,Residential,5000,27364,0,32364
142825902800000,SW 401,Residential,7672,39705,0,47377
142826000100000,SW 403,Residential,10040,24993,0,35033
142826000200000,SW 403,Residential,5906,50232,0,56138
142826000300000,SW 403,Residential,5850,24899,0,30749
142826000400000,SW 403,Residential,5000,0,0,5000
142826000500000,SW 403,Residential,5000,0,0,5000
142826000600000,SW 403,Residential,5000,0,0,5000
142826000700000,SW 403,Residential,5000,0,0,5000
142826100100000,SW 401,Residential,10251,31507,0,41758
142827600100000,Empty,Exempt,0,0,0,0
142827600200000,Empty,Exempt,0,0,0,0
142827600300000,Empty,Exempt,0,0,0,0
142827600400000,Empty,Exempt,0,0,0,0
142827700100000,COMM CTRL CORE,Commercial,127764,0,106828,234592
142827800100000,COMM SW,Commercial,8165,0,28518,36683
142827800200000,SW 401,Commercial,8748,0,4649,13397
142827800300000,SW 401,Residential,5000,0,0,5000
142827800400000,COMM SW,Commercial,56700,0,34254,90954
142827800500000,COMM SW,Commercial,16884,0,0,16884
142827800600000,COMM SW,Commercial,13608,0,752,14360
142827800700000,COMM SW,Commercial,6804,0,5097,11901
142827800800000,COMM SW,Commercial,13608,0,6301,19909
142827800900000,COMM SW,Commercial,6424,0,0,6424
142827801000000,COMM SW,Commercial,5400,0,0,5400
142827801100000,SW 401,Residential,5000,0,0,5000
142827801200000,COMM SW,Commercial,7344,0,0,7344
142827801300000,COMM SW,Commercial,7708,0,0,7708
142827801400000,COMM SW,Commercial,27888,0,0,27888
142827801500000,APTS SW,Commercial,8845,0,0,8845
142827900100000,COMM CTRL CORE,Commercial,72171,0,37438,109609
142827900200000,Empty,Exempt,0,0,0,0
142827900300000,COMM CTRL CORE,Commercial,33254,0,0,33254
142827900400000,COMM CTRL CORE,Commercial,14256,0,1361,15617
142827900500000,COMM CTRL CORE,Commercial,28512,0,0,28512
142827900600000,E-10 COUNTY,Exempt,0,0,0,0
142827900700000,COMM CTRL CORE,Commercial,22453,0,81876,104329
142827900800000,E-10 COUNTY,Exempt,0,0,0,0
142828000100000,COMM SW,Commercial,3600,0,31531,35131
142828000200000,SW 401,Residential,5000,0,0,5000
142828000300000,SW 401,Residential,5000,0,0,5000
142828000400000,SW 401,Residential,5000,0,0,5000
142828000500000,SW 401,Residential,5000,0,0,5000
142828000600000,SW 401,Residential,5000,0,0,5000
142828000700000,SW 401,Residential,5000,0,0,5000
142828000800000,SW 401,Residential,6000,29305,0,35305
142828000900000,SW 401,Residential,5000,0,0,5000
142828001000000,SW 401,Residential,5000,0,0,5000
142828001100000,CONVERSIONS,Commercial,5103,0,27246,32349
142828001200000,SW 401,Residential,6750,17013,0,23763
142828001300000,SW 401,Residential,5000,22370,0,27370
142828001400000,SW 401,Residential,5000,17175,0,22175
142828001500000,COMM SW,Commercial,63504,0,116057,179561
142828002000000,SW 401,Residential,5000,0,0,5000
142828002100000,SW 401,Residential,5000,0,0,5000
142828100100000,SW 401,Residential,5161,45592,0,50753
142828100200000,SW 401,Residential,5000,39436,0,44436
142828100300000,SW 401,Residential,7481,45476,0,52957
142828100400000,SW 401,Residential,7481,33802,0,41283
142828100500000,SW 401,Residential,2700,1068,0,3768
142828100600000,CONVERSIONS,Commercial,2551,0,40554,43105
142828100700000,SW 401,Residential,6750,13980,0,20730
142828100800000,CONVERSIONS,Commercial,6269,0,52936,59205
142828100900000,CONVERSIONS,Commercial,3937,0,30187,34124
142828200100000,Empty,Exempt,0,0,0,0
142828300100000,CONVERSIONS,Commercial,8748,0,46974,55722
142828300200000,SW 401,Residential,6696,38682,0,45378
142828300300000,SW 401,Exempt,18000,0,85877,103877
142828300700000,COMM SW,Commercial,101628,0,304578,406206
142828301000000,COMM SW,Commercial,72576,0,57269,129845
142828301200000,COMM SW,Commercial,36288,0,57357,93645
142828301300000,COMM SW,Commercial,9072,0,25047,34119
142828301400000,SW 401,Residential,8100,39767,0,47867
142828400100000,Empty,Exempt,0,0,0,0
142830100100000,SW 401,Residential,7031,30659,0,37690
142830100200000,Empty,Exempt,0,0,0,0
142830200100000,COMM SW,Commercial,79834,0,163779,243613
142830200200000,SW 401,Residential,8078,23601,0,31679
142830200500000,SW 401,Residential,15147,37255,0,52402
142830200600000,SW 401,Residential,13500,58562,0,72062
142830200700000,SW 401,Residential,13500,52943,0,66443
142830200800000,SW 401,Residential,13500,34335,0,47835
142830200900000,COMM SW,Commercial,26006,0,9911,35917
142830201000000,COMM SW,Commercial,2708,0,0,2708
142830201100000,SW 401,Residential,4109,29880,0,33989
142830201200000,COMM SW,Commercial,5638,0,0,5638
142830201300000,COMM SW,Commercial,10212,0,0,10212
142830201400000,COMM SW,Commercial,6382,0,0,6382
142830201500000,COMM SW,Commercial,30240,0,0,30240
142830300100000,SW 401,Residential,12020,64061,0,76081
142830300200000,SW 401,Residential,12182,58590,0,70772
142830300300000,SW 401,Residential,5000,0,0,5000
142830300400000,SW 401,Residential,5000,0,0,5000
142830300500000,SW 401,Residential,5000,0,0,5000
142830300600000,SW 401,Residential,5000,0,0,5000
142830300700000,SW 401,Residential,5000,0,0,5000
142830400100000,INDUSTRIAL,Industrial,217125,0,582646,799771
142830500100000,COMM SW,Commercial,15552,0,24282,39834
142830500500000,Empty,Other,0,0,0,0
142830500600000,COMM SW,Commercial,1782,0,0,1782
142830500700000,COMM SW,Commercial,31104,0,6721,37825
142830500800000,COMM SW,Commercial,118973,0,505654,624627
142830600100000,COMM SW,Commercial,2948,0,19036,21984
142830600200000,SW 401,Residential,9275,37812,0,47087
142830600300000,SW 401,Residential,6445,30578,0,37023
142830600400000,SW 401,Residential,5000,0,0,5000
142830600500000,SW 401,Residential,5000,0,0,5000
142830600600000,SW 401,Residential,5000,0,0,5000
142830600800000,SW 401,Residential,5000,0,0,5000
142830600900000,APTS SW,Commercial,8845,0,50345,59190
142830601000000,COMM SW,Commercial,6350,0,14797,21147
142830601100000,SW 401,Residential,5000,0,0,5000
142830601200000,SW 401,Residential,11880,28940,0,40820
142830601300000,SW 401,Residential,5000,0,0,5000
142830601400000,SW 401,Residential,3348,0,0,3348
142830601500000,SW 401,Residential,7533,33645,0,41178
142830601600000,SW 401,Residential,8370,28773,0,37143
142830601700000,SW 401,Residential,8100,45182,0,53282
142830601800000,SW 401,Residential,8100,52577,0,60677
142830601900000,SW 401,Residential,10800,45674,0,56474
142830602000000,SW 401,Residential,10800,65621,0,76421
142830602100000,SW 401,Residential,14836,40062,0,54898
142830700100000,E-10 COUNTY,Exempt,0,0,0,0
142830700200000,E-10 COUNTY,Exempt,0,0,0,0
142830700300000,E-10 COUNTY,Exempt,0,0,0,0
142830700400000,COMM SW,Commercial,7776,0,0,7776
142830700500000,E-10 COUNTY,Exempt,0,0,0,0
142830700600000,E-10 COUNTY,Exempt,0,0,0,0
142830700700000,E-10 COUNTY,Exempt,0,0,0,0
142830700800000,E-10 COUNTY,Exempt,0,0,0,0
142830700900000,E-10 COUNTY,Exempt,0,0,0,0
142830701000000,E-10 COUNTY,Exempt,0,0,0,0
142830701100000,E-10 COUNTY,Exempt,0,0,0,0
142830800100000,INDUSTRIAL,Industrial,9930,0,452325,462255
142830800200000,E-10 COUNTY,Exempt,0,0,0,0
142830900100000,COMM SW,Commercial,27216,0,0,27216
142830900102000,COMM SW,Commercial,0,0,142319,142319
142830900200000,COMM SW,Commercial,10964,0,0,10964
142830900300000,E-10 COUNTY,Exempt,0,0,0,0
142830900400000,E-10 COUNTY,Exempt,0,0,0,0
142830900500000,COMM SW,Commercial,11340,0,8155,19495
142830900600000,SW 402,Residential,5000,0,0,5000
142830900700000,SW 402,Residential,5000,0,0,5000
142830900800000,COMM SW,Commercial,13608,0,34390,47998
142830900900000,COMM SW,Commercial,27216,0,360,27576
142830901000000,E-10 COUNTY,Exempt,0,0,0,0
142831000100000,INDUSTRIAL,Industrial,14250,0,44991,59241
142831000200000,INDUSTRIAL,Industrial,16350,0,58219,74569
142831100100000,SW 402,Residential,5000,0,0,5000
142831100200000,SW 402,Residential,5000,0,0,5000
142831100300000,SW 402,Residential,5000,0,0,5000
142831100400000,SW 402,Residential,5000,0,0,5000
142831100500000,SW 402,Residential,5000,0,0,5000
142831100600000,SW 402,Residential,5000,0,0,5000
142831100700000,SW 402,Residential,5925,0,0,5925
142831100800000,SW 402,Residential,7878,0,0,7878
142831100900000,SW 402,Residential,8200,0,0,8200
142831101000000,SW 402,Residential,5000,0,0,5000
142831101100000,E-70 CHARITY OTHER,Exempt,19440,0,53779,73219
142831200100000,COMM SW,Commercial,18144,0,37192,55336
142831300100000,Empty,Other,0,0,0,0
142832600100000,E-05 STATE,Exempt,0,0,0,0
142832600200000,SW 401,Residential,11576,25995,0,37571
142832600300000,SW 401,Residential,5000,0,0,5000
142832600400000,SW 401,Residential,5000,0,0,5000
142832600500000,E-05 STATE,Exempt,0,0,0,0
142832700100000,SW 403,Residential,5000,0,0,5000
142832700200000,SW 403,Residential,3110,0,0,3110
142832700300000,CONVERSIONS,Commercial,5103,0,52101,57204
142832700400000,SW 403,Residential,5000,0,0,5000
142832700500000,SW 403,Residential,5000,0,0,5000
142832700600000,SW 403,Residential,5000,0,0,5000
142832700700000,SW 403,Residential,5000,0,0,5000
142832700800000,SW 403,Residential,6817,30363,0,37180
142832700900000,SW 403,Residential,5000,0,0,5000
142832701000000,SW 403,Residential,5000,0,0,5000
142832701100000,COMM SW,Commercial,26341,0,60123,86464
142832701200000,COMM SW,Commercial,12960,0,8097,21057
142832701300000,COMM SW,Commercial,25097,0,99877,124974
142832800100000,SW 403,Residential,5000,0,0,5000
142832800200000,SW 403,Residential,7726,24087,0,31813
142832800300000,SW 403,Residential,5000,0,0,5000
142832800400000,SW 403,Residential,10302,57546,0,67848
142832800500000,SW 403,Residential,9425,57493,0,66918
142832800600000,CONVERSIONS,Commercial,4406,0,35574,39980
142832800700000,SW 403,Residential,8568,20345,0,28913
142832800800000,SW 403,Residential,6247,50203,0,56450
142832800900000,CONVERSIONS,Commercial,6377,0,48992,55369
142832801000000,SW 403,Residential,12465,44554,0,57019
142832801100000,SW 403,Residential,11589,65066,0,76655
142832801200000,SW 403,Residential,7726,46112,0,53838
142832801300000,SW 403,Residential,5000,0,0,5000
142832801400000,SW 403,Residential,7478,38572,0,46050
142832801500000,SW 403,Residential,5000,0,0,5000
142832801600000,SW 403,Residential,5000,0,0,5000
142832801700000,SW 403,Residential,5000,0,0,5000
142832900100000,SW 403,Residential,5000,0,0,5000
142832900200000,SW 403,Residential,5000,0,0,5000
142832900300000,SW 403,Residential,5000,0,0,5000
142832900400000,SW 403,Residential,5000,0,0,5000
142832900500000,SW 403,Residential,5000,0,0,5000
142832900600000,CONVERSIONS,Commercial,9040,0,39470,48510
142832900700000,CONVERSIONS,Commercial,9040,0,33315,42355
142832900800000,SW 403,Residential,7272,51038,0,58310
142832900900000,SW 403,Residential,14572,50651,0,65223
142832901000000,SW 403,Residential,5000,0,0,5000
142832901100000,SW 403,Residential,6457,29121,0,35578
142833000100000,SW 403,Residential,10908,55365,0,66273
142833000200000,COMM SW,Commercial,24106,0,0,24106
142833000300000,SW 403,Residential,10908,35161,0,46069
142833000400000,SW 403,Residential,6817,59409,0,66226
142833000500000,SW 403,Residential,5000,0,0,5000
142833000600000,SW 403,Residential,5000,0,0,5000
142833000700000,SW 403,Residential,9408,0,0,9408
142833000800000,SW 403,Residential,6817,34058,0,40875
142833000900000,SW 403,Residential,6817,34003,0,40820
142833001000000,COMM SW,Commercial,12053,0,33056,45109
142833001100000,CONVERSIONS,Commercial,2856,0,14493,17349
142833001200000,SW 403,Residential,6817,32912,0,39729
142833001300000,CONVERSIONS,Commercial,6853,0,45127,51980
142833001400000,SW 403,Residential,5000,0,0,5000
142833100100000,SW 403,Residential,5000,0,0,5000
142833100200000,SW 403,Residential,5000,0,0,5000
142833100300000,SW 403,Residential,12139,37462,0,49601
142833100400000,SW 403,Residential,10945,59163,0,70108
142833100500000,SW 403,Residential,11590,81362,0,92952
142833100600000,SW 403,Residential,11314,67262,0,78576
142833100700000,SW 403,Residential,7140,55741,0,62881
142833100800000,SW 403,Residential,7715,37824,0,45539
142833100900000,SW 403,Residential,5000,0,0,5000
142833101000000,SW 403,Residential,10945,26386,0,37331
142833101100000,SW 403,Residential,5000,0,0,5000
142833101200000,SW 403,Residential,5000,0,0,5000
142833101300000,SW 403,Residential,5000,0,0,5000
142833101400000,SW 403,Residential,10302,43636,0,53938
142833101500000,SW 403,Residential,10180,42076,0,52256
142833101600000,SW 403,Residential,5000,0,0,5000
142833101700000,SW 403,Residential,9562,35364,0,44926
142833101800000,SW 403,Residential,13254,48787,0,62041
142833101900000,SW 403,Residential,5000,0,0,5000
142833102000000,SW 403,Residential,12049,51253,0,63302
142833102100000,SW 403,Residential,8032,27417,0,35449
142833102200000,SW 403,Residential,5000,0,0,5000
142833200100000,CONVERSIONS,Commercial,9040,0,48980,58020
142833200200000,SW 403,Residential,10908,38551,0,49459
142833200300000,SW 403,Residential,5000,0,0,5000
142833200400000,SW 403,Residential,7499,0,0,7499
142833200500000,SW 403,Residential,6817,25403,0,32220
142833200600000,SW 403,Residential,5000,0,0,5000
142833200700000,CONVERSIONS,Commercial,5400,0,0,5400
142833200800000,CONVERSIONS,Commercial,8587,0,38910,47497
142833200900000,SW 403,Residential,9090,54194,0,63284
142833201000000,SW 403,Residential,5000,0,0,5000
142833201100000,SW 403,Residential,5000,0,0,5000
142833201200000,SW 403,Residential,5000,0,0,5000
142833201300000,SW 403,Residential,9983,33768,0,43751
142833201400000,SW 403,Residential,5000,0,0,5000
142833201500000,CONVERSIONS,Commercial,5400,0,0,5400
142833201600000,SW 403,Residential,5670,27899,0,33569
142833201700000,SW 403,Residential,5000,0,0,5000
142833201800000,SW 403,Residential,9090,53178,0,62268
142833201900000,SW 403,Residential,9090,33779,0,42869
142833202000000,SW 403,Residential,9090,36470,0,45560
142833202100000,SW 403,Residential,9090,23242,0,32332
142833202200000,SW 403,Residential,5000,0,0,5000
142833202300000,SW 403,Residential,5000,0,0,5000
142833202400000,SW 403,Residential,5000,0,0,5000
142833202500000,SW 403,Residential,9090,36324,0,45414
142833202600000,SW 403,Residential,10908,58855,0,69763
142833202700000,SW 403,Residential,5000,0,0,5000
142833300100000,E-40 CHURCHES,Exempt,27216,0,115331,142547
142833300200000,SW 403,Residential,8160,32064,0,40224
142833300300000,SW 403,Residential,9282,45349,0,54631
142833300400000,SW 403,Residential,5000,0,0,5000
142833300500000,SW 403,Residential,10608,65669,0,76277
142833300600000,SW 403,Residential,5000,0,0,5000
142833300700000,COMM SW,Commercial,22919,0,0,22919
142833300800000,E-46 RELIG PARKING,Exempt,15139,0,3424,18563
142833300900000,E-46 RELIG PARKING,Exempt,15185,0,2959,18144
142833301000000,SW 403,Residential,5000,0,0,5000
142833301100000,E-46 RELIG PARKING,Exempt,19505,0,4728,24233
142833400100000,SW 403,Residential,7140,58140,0,65280
142833400200000,SW 403,Residential,8323,52342,0,60665
142833400300000,SW 403,Residential,10302,51780,0,62082
142833400400000,SW 403,Residential,5000,0,0,5000
142833400500000,SW 403,Residential,10302,62289,0,72591
142833400600000,SW 403,Residential,10302,12637,0,22939
142833400700000,SW 403,Residential,10302,43754,0,54056
142833400800000,SW 403,Residential,5000,0,0,5000
142833400900000,SW 403,Residential,5000,0,0,5000
142833401000000,COMM SW,Commercial,17486,0,37308,54794
142833401100000,SW 403,Residential,15110,95113,0,110223
142833401200000,SW 403,Residential,10302,54123,0,64425
142833401300000,SW 403,Residential,10302,58891,0,69193
142833401400000,SW 403,Residential,10302,31898,0,42200
142833401500000,SW 403,Residential,10302,24013,0,34315
142833401600000,SW 403,Residential,10302,46877,0,57179
142833500100000,SW 403,Residential,11907,65363,0,77270
142833500200000,SW 403,Residential,9090,32101,0,41191
142833500300000,SW 403,Residential,9090,60329,0,69419
142833500400000,SW 403,Residential,9090,54968,0,64058
142833500500000,SW 403,Residential,9090,53093,0,62183
142833500600000,SW 403,Residential,5000,0,0,5000
142833500700000,SW 403,Residential,9090,31755,0,40845
142833500800000,SW 403,Residential,5000,0,0,5000
142833500900000,CONVERSIONS,Commercial,5400,0,0,5400
142833501000000,SW 403,Residential,9090,41888,0,50978
142833501100000,SW 403,Residential,5000,0,0,5000
142833501200000,SW 403,Residential,9090,29869,0,38959
142833501300000,SW 403,Residential,9544,30273,0,39817
142833501400000,SW 403,Residential,9443,0,0,9443
142833501500000,SW 403,Residential,9544,44152,0,53696
142833501600000,SW 403,Residential,5000,0,0,5000
142833501700000,SW 403,Residential,9090,25790,0,34880
142833501800000,SW 403,Residential,5000,0,0,5000
142833501900000,SW 403,Residential,5000,0,0,5000
142833502000000,SW 403,Residential,9090,63292,0,72382
142833502100000,SW 403,Residential,5000,0,0,5000
142833502200000,SW 403,Residential,9090,29426,0,38516
142833502300000,SW 403,Residential,9090,30729,0,39819
142833502400000,SW 403,Residential,9090,57453,0,66543
142833502500000,SW 403,Residential,9090,69331,0,78421
142833502600000,SW 403,Residential,9090,35825,0,44915
142833502700000,SW 403,Residential,9090,46091,0,55181
142833502800000,SW 403,Residential,7499,32606,0,40105
142833502900000,SW 403,Residential,6817,48597,0,55414
142833503000000,SW 403,Residential,5000,0,0,5000
142833600100000,COMM SW,Commercial,14493,0,0,14493
142833600200000,SW 403,Residential,8100,15142,0,23242
142833600300000,SW 403,Residential,8640,64500,0,73140
142833600400000,SW 403,Residential,8959,20265,0,29224
142833600500000,SW 403,Residential,5000,0,0,5000
142833600600000,SW 403,Residential,9090,37584,0,46674
142833600700000,SW 403,Residential,9090,32220,0,41310
142833600800000,SW 403,Residential,5000,0,0,5000
142833600900000,SW 403,Residential,9090,59813,0,68903
142833601000000,SW 403,Residential,9090,57960,0,67050
142833601100000,SW 403,Residential,9090,31369,0,40459
142833601200000,SW 403,Residential,5000,0,0,5000
142833601300000,COMM SW,Commercial,22499,0,1224,23723
142833700100000,COMM SW,Commercial,196425,0,11346,207771
142833700200000,Empty,Other,0,0,0,0
142833700300000,Empty,Other,0,0,0,0
142835100100000,COMM SW,Commercial,32938,0,0,32938
142835100200000,SW 403,Residential,12240,3464,0,15704
142835100300000,SW 403,Residential,9584,0,0,9584
142835100400000,SW 403,Residential,14688,3027,0,17715
142835100500000,SW 403,Residential,12240,42627,0,54867
142835100600000,SW 403,Residential,5000,0,0,5000
142835100700000,SW 403,Residential,5000,0,0,5000
142835100800000,SW 403,Residential,5526,4356,0,9882
142835100900000,SW 403,Residential,10710,34592,0,45302
142835101000000,SW 403,Residential,7141,32507,0,39648
142835101100000,SW 403,Residential,5000,0,0,5000
142835101200000,SW 403,Residential,5000,0,0,5000
142835101400000,SW 403,Residential,10710,22688,0,33398
142835101500000,SW 403,Residential,7500,0,0,7500
142835101600000,SW 403,Residential,5000,0,0,5000
142835101700000,SW 403,Residential,10710,20586,0,31296
142835101800000,COMM SW,Commercial,16459,0,0,16459
142835200100000,SW 403,Residential,12120,4918,0,17038
142835200200000,SW 403,Residential,5000,0,0,5000
142835200300000,SW 403,Residential,5000,0,0,5000
142835200400000,SW 403,Residential,5000,0,0,5000
142835200500000,SW 403,Residential,5000,0,0,5000
142835200600000,SW 403,Residential,10605,28408,0,39013
142835200700000,SW 403,Residential,10605,26561,0,37166
142835200800000,SW 403,Residential,10605,37901,0,48506
142835200900000,SW 403,Residential,10605,31536,0,42141
142835201000000,SW 403,Residential,10605,56084,0,66689
142835201100000,SW 403,Residential,5000,0,0,5000
142835201200000,SW 403,Residential,6160,0,0,6160
142835201300000,SW 403,Residential,12120,31133,0,43253
142835201400000,SW 403,Residential,5000,0,0,5000
142835201500000,SW 403,Residential,7272,374,0,7646
142835201600000,SW 403,Residential,5000,0,0,5000
142835201700000,SW 403,Residential,6160,0,0,6160
142835201800000,SW 403,Residential,6160,0,0,6160
142835300100000,Empty,Other,0,0,0,0
142835300400000,Empty,Exempt,0,0,0,0
142835300500000,Empty,Exempt,0,0,0,0
142835300600000,Empty,Exempt,0,0,0,0
142835300700000,Empty,Exempt,0,0,0,0
142835400100000,COMM SW,Commercial,6204,0,0,6204
142835400200000,COMM SW,Commercial,48384,0,12106,60490
142835400300000,Empty,Other,0,0,0,0
142835500100000,SW 403,Residential,6065,0,0,6065
142835500200000,SW 403,Residential,5000,0,0,5000
142835500300000,SW 403,Residential,5000,0,0,5000
142835500400000,SW 403,Residential,5000,0,0,5000
142835500500000,SW 403,Residential,5000,0,0,5000
142835500600000,SW 403,Residential,13872,45001,0,58873
142835500700000,SW 403,Residential,5000,0,0,5000
142835500800000,SW 403,Residential,16265,44396,0,60661
142835500900000,SW 403,Residential,13872,51070,0,64942
142835501000000,SW 403,Residential,5000,0,0,5000
142835501100000,SW 403,Residential,5000,0,0,5000
142835501200000,SW 403,Residential,13872,40801,0,54673
142835501300000,COMM SW,Commercial,8230,0,4185,12415
142835501400000,SW 403,Residential,12896,21439,0,34335
142835501500000,SW 403,Residential,5172,0,0,5172
142835501600000,SW 403,Residential,5000,0,0,5000
142835501700000,SW 403,Residential,12138,45968,0,58106
142835501800000,SW 403,Residential,12138,55889,0,68027
142835501900000,SW 403,Residential,5000,0,0,5000
142835502000000,SW 403,Residential,14566,37737,0,52303
142835502100000,SW 403,Residential,12138,58567,0,70705
142835502200000,SW 403,Residential,12138,17662,0,29800
142835502300000,SW 403,Residential,12138,21067,0,33205
142835502400000,SW 403,Residential,5000,0,0,5000
142835600100000,SW 403,Residential,16226,74041,0,90267
142835600200000,SW 403,Residential,9089,0,0,9089
142835600300000,SW 403,Residential,12019,33228,0,45247
142835600400000,SW 403,Residential,5000,0,0,5000
142835600500000,SW 403,Residential,12019,33919,0,45938
142835600600000,SW 403,Residential,5000,0,0,5000
142835600700000,SW 403,Residential,12019,56495,0,68514
142835600800000,SW 403,Residential,12019,43956,0,55975
142835600900000,SW 403,Residential,12019,50560,0,62579
142835601000000,SW 403,Residential,5000,0,0,5000
142835601100000,SW 403,Residential,11418,9910,0,21328
142835601200000,SW 403,Residential,14062,36353,0,50415
142835601300000,SW 403,Residential,14594,50411,0,65005
142835601400000,SW 403,Residential,13736,57110,0,70846
142835601500000,SW 403,Residential,6160,0,0,6160
142835601600000,SW 403,Residential,6160,0,0,6160
142835601700000,SW 403,Residential,6160,0,0,6160
142835601800000,SW 403,Residential,6160,0,0,6160
142835601900000,SW 403,Residential,13736,29810,0,43546
142835602000000,SW 403,Residential,5000,0,0,5000
142835602100000,SW 403,Residential,5000,0,0,5000
142835700100000,SW 403,Residential,16524,65088,0,81612
142835700200000,SW 403,Residential,5000,0,0,5000
142835700300000,SW 403,Residential,16524,20384,0,36908
142835700400000,SW 403,Residential,13770,49671,0,63441
142835700500000,SW 403,Residential,13770,55033,0,68803
142835700600000,SW 403,Residential,13770,40829,0,54599
142835700700000,SW 403,Residential,13770,45483,0,59253
142835700800000,SW 403,Residential,16524,36349,0,52873
142835700900000,SW 403,Residential,16524,42211,0,58735
142835701000000,SW 403,Residential,14688,52847,0,67535
142835701100000,SW 403,Residential,14688,40249,0,54937
142835701200000,SW 403,Residential,14688,50758,0,65446
142835701300000,SW 403,Residential,14688,43549,0,58237
142835701400000,SW 403,Residential,14688,43082,0,57770
142835800100000,SW 403,Residential,13635,40844,0,54479
142835800200000,SW 403,Residential,14316,85797,0,100113
142835800300000,SW 403,Residential,14316,40907,0,55223
142835800400000,SW 403,Residential,14316,47939,0,62255
142835800500000,SW 403,Residential,14316,56057,0,70373
142835800600000,SW 403,Residential,14316,42392,0,56708
142835800700000,SW 403,Residential,14316,81476,0,95792
142835800800000,SW 403,Residential,18180,58318,0,76498
142835800900000,SW 403,Residential,18180,55325,0,73505
142835801000000,SW 403,Residential,18180,41437,0,59617
142835801100000,SW 403,Residential,13635,44345,0,57980
142835801200000,SW 403,Residential,13635,35247,0,48882
142835801300000,SW 403,Residential,5150,0,0,5150
142837600100000,SW 402,Residential,10800,55327,0,66127
142837600200000,SW 402,Residential,21600,62923,0,84523
142837600300000,SW 402,Residential,10800,40049,0,50849
142837600400000,SW 402,Residential,12600,28652,0,41252
142837600500000,SW 402,Residential,9765,40619,0,50384
142837600600000,SW 402,Residential,9000,51264,0,60264
142837600700000,SW 402,Residential,13500,45201,0,58701
142837600800000,SW 402,Residential,13500,15947,0,29447
142837600900000,SW 402,Residential,18000,0,0,18000
142837601000000,SW 402,Residential,9000,13875,0,22875
142837601100000,SW 402,Residential,5000,0,0,5000
142837700100000,SW 402,Residential,5000,0,0,5000
142837700200000,SW 402,Residential,6840,0,0,6840
142837700300000,CONVERSIONS,Commercial,5400,0,0,5400
142837700400000,SW 402,Residential,8190,43052,0,51242
142837700500000,SW 402,Residential,5000,0,0,5000
142837700600000,E-70 CHARITY OTHER,Exempt,15552,0,130026,145578
142837700700000,CONVERSIONS,Commercial,5832,0,25140,30972
142837700800000,SW 402,Residential,14880,23488,0,38368
142837700900000,SW 402,Residential,6510,0,0,6510
142837701000000,SW 402,Residential,5000,0,0,5000
142837701100000,SW 402,Residential,5000,13030,0,18030
142837701200000,SW 402,Residential,5000,0,0,5000
142837701300000,SW 402,Residential,7500,0,0,7500
142837701400000,SW 402,Residential,10500,58749,0,69249
142837701500000,SW 402,Residential,8000,0,0,8000
142837701600000,SW 402,Residential,5000,0,0,5000
142837701700000,SW 402,Residential,5000,0,0,5000
142837800100000,COMM SW,Commercial,17496,0,0,17496
142837800200000,SW 402,Residential,5000,0,0,5000
142837800300000,SW 402,Residential,5000,0,0,5000
142837800400000,SW 402,Residential,7573,26687,0,34260
142837800500000,SW 402,Residential,7573,28033,0,35606
142837800600000,COMM SW,Commercial,6561,0,39690,46251
142837900100000,SW 402,Residential,14100,43895,0,57995
142837900200000,SW 402,Residential,5000,0,0,5000
142837900300000,SW 402,Residential,12000,66173,0,78173
142837900400000,SW 402,Residential,12600,26753,0,39353
142838000100000,SW 402,Residential,5000,0,0,5000
142838000200000,SW 402,Residential,10650,26642,0,37292
142838000300000,SW 402,Residential,5000,0,0,5000
142838000400000,SW 402,Residential,5000,0,0,5000
142838000500000,SW 402,Residential,5784,0,0,5784
142838000600000,SW 402,Residential,6000,0,0,6000
142838000700000,SW 402,Residential,5000,0,0,5000
142838000800000,SW 402,Residential,5000,0,0,5000
142838000900000,SW 402,Residential,9000,21907,0,30907
142838001000000,SW 402,Residential,6750,1332,0,8082
142838001100000,SW 402,Residential,8000,0,0,8000
142838001200000,SW 402,Residential,18000,59956,0,77956
142838001300000,SW 402,Residential,7667,0,0,7667
142838001400000,SW 402,Residential,13662,53476,0,67138
142838001500000,SW 402,Residential,5000,0,0,5000
142838001600000,SW 402,Residential,9672,24081,0,33753
142838100100000,SW 402,Residential,5000,0,0,5000
142838100200000,SW 402,Residential,7440,32688,0,40128
142838100300000,SW 402,Residential,6510,36636,0,43146
142838100400000,SW 402,Residential,12144,75147,0,87291
142838100500000,SW 402,Residential,9294,39274,0,48568
142838100600000,CONVERSIONS,Commercial,5400,0,0,5400
142838100700000,SW 402,Residential,5000,0,0,5000
142838100800000,SW 402,Residential,11840,0,0,11840
142838100900000,SW 402,Residential,6840,0,0,6840
142838101000000,SW 402,Residential,6840,0,0,6840
142838101100000,SW 402,Residential,18000,47334,0,65334
142838101200000,SW 402,Residential,5000,0,0,5000
142838101300000,SW 402,Residential,9000,42462,0,51462
142838101400000,SW 402,Residential,18000,62883,0,80883
142838101500000,SW 402,Residential,18000,42877,0,60877
142838200100000,SW 402,Residential,5000,0,0,5000
142838200200000,SW 402,Residential,5000,0,0,5000
142838200300000,SW 402,Residential,13023,47954,0,60977
142838200400000,SW 402,Residential,9149,22451,0,31600
142838200500000,SW 402,Residential,5000,0,0,5000
142838200600000,SW 402,Residential,5000,0,0,5000
142838200700000,SW 402,Residential,5000,0,0,5000
142838200800000,SW 402,Residential,5000,0,0,5000
142838200900000,SW 402,Residential,5000,0,0,5000
142838201000000,SW 402,Residential,10472,33759,0,44231
142838300100000,SW 402,Residential,5000,0,0,5000
142838300200000,SW 402,Residential,5000,0,0,5000
142838300300000,SW 402,Residential,5000,0,0,5000
142838300400000,SW 402,Residential,7500,0,0,7500
142838300500000,SW 402,Residential,10500,44652,0,55152
142838300600000,SW 402,Residential,18000,28944,0,46944
142838300700000,SW 402,Residential,5000,0,0,5000
142838300800000,SW 402,Residential,5000,0,0,5000
142838300900000,SW 402,Residential,5000,0,0,5000
142838301000000,SW 402,Residential,5000,0,0,5000
142838301100000,SW 402,Residential,18360,25791,0,44151
142838301200000,SW 402,Residential,9180,35364,0,44544
142838301300000,SW 402,Residential,5000,0,0,5000
142838301400000,SW 402,Residential,8808,63262,0,72070
142838301500000,SW 402,Residential,5000,0,0,5000
142838301600000,SW 402,Residential,14480,0,0,14480
142838400100000,SW 402,Residential,18000,56220,0,74220
142838400200000,SW 402,Residential,10920,30711,0,41631
142838400300000,SW 402,Residential,5000,0,0,5000
142838400400000,SW 402,Residential,5000,0,0,5000
142838400500000,SW 402,Residential,14490,19109,0,33599
142838400600000,SW 402,Residential,2520,0,0,2520
142838400700000,SW 402,Residential,14742,41110,0,55852
142838400800000,SW 402,Residential,16805,82164,0,98969
142838400900000,SW 402,Residential,5000,0,0,5000
142838401000000,E-40 CHURCHES,Exempt,54432,0,25639,80071
142838401100000,SW 402,Residential,9000,0,0,9000
142838401200000,SW 402,Residential,18000,17493,0,35493
142838500100000,SW 402,Residential,5000,0,0,5000
142838500200000,SW 402,Residential,11900,60415,0,72315
142838500300000,SW 402,Residential,12239,68298,0,80537
142838500400000,SW 402,Residential,7021,42862,0,49883
142838500500000,SW 402,Residential,10647,0,0,10647
142838500600000,SW 402,Residential,12352,42904,0,55256
142838500700000,SW 402,Residential,15552,50523,0,66075
142838500800000,SW 402,Residential,15552,52958,0,68510
142838500900000,SW 402,Residential,10829,33529,0,44358
142838600100000,SW 402,Residential,18360,34955,0,53315
142838600200000,CONVERSIONS,Commercial,10206,0,35230,45436
142838600300000,SW 402,Residential,6000,0,0,6000
142838600400000,SW 402,Residential,12000,36799,0,48799
142838600500000,SW 402,Residential,13500,46972,0,60472
142838600600000,SW 402,Residential,19890,42329,0,62219
142838600700000,SW 402,Residential,18360,46168,0,64528
142838700100000,SW 402,Residential,16416,63212,0,79628
142838700200000,SW 402,Residential,11718,68689,0,80407
142838700300000,SW 402,Residential,11340,52947,0,64287
142838700400000,SW 402,Residential,11340,53983,0,65323
142838700500000,SW 402,Residential,20412,64229,0,84641
142838700600000,SW 402,Residential,13104,67958,0,81062
142838700700000,SW 402,Residential,12449,52303,0,64752
142838700800000,SW 402,Residential,23400,69261,0,92661
142838700900000,SW 402,Residential,21600,53069,0,74669
142838800100000,SW 402,Residential,15390,65435,0,80825
142838800200000,SW 402,Residential,15390,55212,0,70602
142838800300000,SW 402,Residential,15390,52096,0,67486
142838800400000,SW 402,Residential,17230,104098,0,121328
142840100100000,COMM SE,Commercial,88452,0,108717,197169
142840200100000,COMM SE,Commercial,19165,0,48207,67372
142840200200000,COMM SE,Commercial,8845,0,65154,73999
142840200300000,SE 237,Residential,5000,0,0,5000
142840200400000,SE 237,Residential,6750,0,0,6750
142840200500000,SE 237,Residential,5000,0,0,5000
142840200600000,SE 237,Residential,2400,0,0,2400
142840200700000,COMM SE,Commercial,27216,0,0,27216
142840200800000,SE 237,Residential,5000,0,0,5000
142840200900000,COMM SE,Commercial,6008,0,26892,32900
142840201000000,COMM SE,Commercial,23587,0,36420,60007
142840201100000,COMM SE,Commercial,8229,0,12861,21090
142840300100000,Empty,Exempt,0,0,0,0
142840300200000,Empty,Other,0,0,0,0
142840400200000,COMM SE,Commercial,159003,0,306766,465769
142840400300000,SE 237,Residential,3000,0,0,3000
142840400400000,SE 237,Residential,3000,0,0,3000
142840400500000,SE 237,Residential,3000,0,0,3000
142840400600000,COMM SE,Commercial,17690,0,70243,87933
142840400700000,COMM SE,Commercial,17690,0,15278,32968
142840400800000,COMM SE,Commercial,17690,0,27413,45103
142840500100000,SE 237,Residential,5346,16247,0,21593
142840500200000,COMM SE,Commercial,16524,0,0,16524
142840500300000,COMM SE,Commercial,14969,0,0,14969
142840500400000,SE 237,Residential,2700,0,0,2700
142840500500000,SE 237,Residential,3000,0,0,3000
142840500600000,SE 237,Residential,3000,0,0,3000
142840500700000,COMM SE,Commercial,19459,0,28908,48367
142840600100000,Empty,Exempt,0,0,0,0
142840600200000,E-70 CHARITY OTHER,Exempt,166860,0,852797,1019657
142840600300000,Empty,Exempt,0,0,0,0
142840600400000,COMM SE,Exempt,0,0,0,0
142840600500000,Empty,Exempt,0,0,0,0
142840600600000,SE 237,Exempt,0,0,0,0
142840600700000,Empty,Exempt,0,0,0,0
142840600800000,COMM SE,Commercial,84591,0,227072,311663
142840600900000,SE 237,Residential,3300,0,0,3300
142840601000000,SE 237,Residential,3300,0,0,3300
142840601100000,SE 237,Residential,3000,0,0,3000
142840601200000,SE 237,Residential,2100,0,0,2100
142840601300000,SE 237,Residential,2100,0,0,2100
142840601400000,SE 237,Residential,5000,0,0,5000
142840601500000,SE 237,Residential,3000,0,0,3000
142840601600000,COMM SE,Commercial,26536,0,27821,54357
142840700100000,Empty,Exempt,0,0,0,0
142840700200000,INDUSTRIAL,Industrial,78637,0,57445,136082
142840700202000,COMM SE,Commercial,0,0,2182,2182
142840700300000,Empty,Exempt,0,0,0,0
142842600100000,INDUSTRIAL,Industrial,573435,0,8323339,8896774
142842700100000,INDUSTRIAL,Industrial,45090,0,1134966,1180056
142842800100000,CTRL CORE PERIP,Other,0,0,0,0
142845100100000,Empty,Exempt,0,0,0,0
142845100200000,INDUSTRIAL,Industrial,8115,0,23888,32003
142845200100000,SW 402,Residential,21600,75539,0,97139
142845200200000,SW 402,Residential,21600,55772,0,77372
142845300100000,SW 402,Residential,5000,0,0,5000
142845300200000,SW 402,Residential,13080,52358,0,65438
142845300300000,SW 402,Residential,12720,41499,0,54219
142845300400000,SW 402,Residential,15150,37015,0,52165
142845300500000,SW 402,Residential,13950,23120,0,37070
142845300600000,SW 402,Residential,5000,0,0,5000
142845400100000,COMM SW,Commercial,9112,0,0,9112
142845400200000,SW 402,Residential,9821,30695,0,40516
142845400300000,SW 402,Residential,15372,28298,0,43670
142845400400000,SW 402,Residential,11167,33961,0,45128
142845400500000,SW 402,Residential,14159,0,0,14159
142845400600000,SW 402,Residential,13140,54532,0,67672
142845400700000,SW 402,Residential,15840,45379,0,61219
142845400800000,COMM SW,Commercial,32400,0,0,32400
142845400900000,COMM SW,Commercial,34506,0,101235,135741
142845500100000,SW 402,Residential,20160,66200,0,86360
142845500200000,SW 402,Residential,5400,4812,0,10212
142845500300000,SW 402,Residential,5000,0,0,5000
142845500400000,SW 402,Residential,20400,48510,0,68910
142845500500000,SW 402,Residential,13392,64636,0,78028
142845500600000,SW 402,Residential,8755,58483,0,67238
142845500700000,SW 402,Residential,7661,53485,0,61146
142845500800000,SW 402,Residential,10800,70191,0,80991
142845500900000,SW 402,Residential,10800,46116,0,56916
142845501000000,SW 402,Residential,21600,83265,0,104865
142845501100000,SW 402,Residential,21888,76311,0,98199
142845600100000,Empty,Exempt,0,0,0,0
142845600200000,SW 402,Residential,12453,0,0,12453
142845600300000,SW 402,Residential,17028,93411,0,110439
142845600400000,SW 402,Residential,13266,56090,0,69356
142845600500000,COMM SW,Commercial,54778,0,108735,163513
142845700100000,SW 402,Residential,9180,25386,0,34566
142845700200000,SW 402,Residential,18360,57872,0,76232
142845700300000,SW 402,Residential,18360,86480,0,104840
142845700400000,APTS SW,Commercial,7897,0,50955,58852
142845700500000,SW 402,Residential,15840,29044,0,44884
142845700600000,SW 402,Residential,15840,76120,0,91960
142845700700000,SW 402,Residential,15840,42481,0,58321
142845700800000,SW 402,Residential,15840,58037,0,73877
142845700900000,SW 402,Residential,11088,51185,0,62273
142845701000000,SW 402,Residential,20592,53081,0,73673
142845701100000,SW 402,Residential,18360,60705,0,79065
142845701200000,SW 402,Residential,18360,64502,0,82862
142845701300000,SW 402,Residential,18360,56494,0,74854
142845701400000,SW 402,Residential,18360,37545,0,55905
142845701500000,CONVERSIONS,Commercial,12093,0,47031,59124
142845701600000,SW 402,Residential,14508,49316,0,63824
142845701700000,SW 402,Residential,14760,41732,0,56492
142845701800000,SW 402,Residential,14952,40435,0,55387
142845701900000,SW 402,Residential,15048,28638,0,43686
142845800100000,SW 402,Residential,5000,0,0,5000
142845800200000,SW 402,Residential,12900,35322,0,48222
142845800300000,SW 402,Residential,13305,29630,0,42935
142845800400000,SW 402,Residential,5000,0,0,5000
142845800500000,SW 402,Residential,5000,0,0,5000
142845800600000,SW 402,Residential,11550,29179,0,40729
142845800700000,SW 402,Residential,5000,0,0,5000
142845800800000,SW 402,Residential,13040,0,0,13040
142845800900000,SW 402,Residential,11160,37461,0,48621
142845801000000,SW 402,Residential,14880,60836,0,75716
142845801100000,SW 402,Residential,5000,0,0,5000
142845801200000,SW 402,Residential,14122,38086,0,52208
142845801300000,CONVERSIONS,Commercial,8420,0,70329,78749
142845801400000,SW 402,Residential,19847,59050,0,78897
142845801500000,SW 402,Residential,14305,47781,0,62086
142845801600000,SW 402,Residential,7788,40150,0,47938
142845801700000,SW 402,Residential,5000,0,0,5000
142845801800000,SW 402,Residential,8928,41042,0,49970
142845801900000,SW 402,Residential,425,0,0,425
142845900100000,Empty,Exempt,0,0,0,0
142845900200000,Empty,Exempt,0,0,0,0
142845900300000,Empty,Exempt,0,0,0,0
142845900400000,SW 402,Residential,12672,0,0,12672
142845900500000,SW 402,Residential,12672,0,0,12672
142845900600000,SW 402,Residential,25298,69731,0,95029
142845900700000,SW 402,Residential,15696,56583,0,72279
142845900800000,SW 402,Residential,14145,64035,0,78180
142845900900000,SW 402,Residential,12528,55379,0,67907
142845901000000,SW 402,Residential,12672,68781,0,81453
142845901100000,Empty,Exempt,0,0,0,0
142845901200000,Empty,Exempt,0,0,0,0
142845901300000,Empty,Exempt,0,0,0,0
142845901400000,SW 402,Residential,21600,77804,0,99404
142845901500000,SW 402,Residential,12587,29351,0,41938
142845901600000,SW 402,Residential,12587,41159,0,53746
142846000100000,SW 402,Residential,13392,63846,0,77238
142846000200000,SW 402,Residential,8928,65827,0,74755
142846000300000,SW 402,Residential,23940,57956,0,81896
142846000400000,SW 402,Residential,13680,50352,0,64032
142846000500000,SW 402,Residential,10080,48883,0,58963
142846000600000,SW 402,Residential,10080,49946,0,60026
142846000700000,SW 402,Residential,13680,66701,0,80381
142846000800000,SW 402,Residential,23940,95789,0,119729
142846000900000,SW 402,Residential,13680,59230,0,72910
142846001000000,SW 402,Residential,20520,68060,0,88580
142846001100000,SW 402,Residential,17856,61136,0,78992
142846001200000,SW 402,Residential,17928,62832,0,80760
142846001300000,SW 402,Residential,23328,59515,0,82843
142846001400000,SW 402,Residential,11664,53650,0,65314
142846001500000,SW 402,Residential,11592,53324,0,64916
142846001600000,SW 402,Residential,7730,33620,0,41350
142846001700000,SW 402,Residential,11278,39261,0,50539
142846100100000,SW 402,Residential,19110,73006,0,92116
142846100200000,SW 402,Residential,16174,63619,0,79793
142846100300000,SW 402,Residential,14280,21511,0,35791
142846100400000,SW 402,Residential,11832,0,0,11832
142846100500000,SW 402,Residential,14400,27074,0,41474
142846100600000,SW 402,Residential,7100,0,0,7100
142846100700000,SW 402,Residential,12825,17726,0,30551
142846100800000,SW 402,Residential,12825,47971,0,60796
142846100900000,SW 402,Residential,12330,39174,0,51504
142846101000000,SW 402,Residential,13110,48622,0,61732
142846101100000,SW 402,Residential,13110,46006,0,59116
142846101200000,SW 402,Residential,13248,58661,0,71909
142846101300000,SW 402,Residential,15916,30554,0,46470
142846200100000,SW 402,Residential,8400,17821,0,26221
142846200200000,SW 402,Residential,8742,26698,0,35440
142846200300000,SW 402,Residential,5000,24929,0,29929
142846300100000,SW 412,Residential,20520,58142,0,78662
142846300200000,SW 402,Residential,12672,49932,0,62604
142846300300000,SW 402,Residential,20275,39126,0,59401
142846300400000,SW 402,Residential,11016,24470,0,35486
142846300500000,SW 402,Residential,19080,45691,0,64771
142846300600000,SW 402,Residential,19080,50644,0,69724
142846300700000,SW 402,Residential,19080,50221,0,69301
142846300800000,SW 402,Residential,19080,53542,0,72622
142846400100000,SW 402,Residential,15675,39983,0,55658
142846500100000,SW 402,Residential,5000,0,0,5000
142846500200000,SW 402,Residential,5000,0,0,5000
142846500300000,SW 402,Residential,8232,0,0,8232
142846500400000,SW 402,Residential,18000,75766,0,93766
142847600100000,Empty,Exempt,0,0,0,0
142847600200000,Empty,Exempt,0,0,0,0
142847700100000,E-55 LIBRARY/ART,Exempt,37260,0,27473,64733
142847700200000,E-55 LIBRARY/ART,Exempt,207900,0,887921,1095821
142847700300000,E-55 LIBRARY/ART,Exempt,0,0,0,0
142847800100000,Empty,Exempt,0,0,0,0
142847800200000,Empty,Exempt,0,0,0,0
142847800300000,E-55 LIBRARY/ART,Exempt,70502,0,0,70502
142847800400000,Empty,Exempt,0,0,0,0
142847800500000,SW 402,Residential,14175,0,0,14175
142847800600000,COMM SW,Commercial,12109,0,0,12109
142847800700000,COMM SW,Commercial,17496,0,36599,54095
142847800800000,Empty,Exempt,0,0,0,0
142847800900000,COMM SW,Commercial,16091,0,50327,66418
142847801000000,Empty,Exempt,0,0,0,0
142847801100000,COMM SW,Commercial,16848,0,206024,222872
142847801200000,COMM SW,Commercial,8424,0,8598,17022
142847801300000,COMM SW,Commercial,8424,0,8104,16528
142847900100000,COMM SW,Exempt,40608,0,27033,67641
142847900200000,E-67 SALVATION ARMY,Exempt,38880,0,74848,113728
142847900300000,E-67 SALVATION ARMY,Exempt,32400,0,4430,36830
142847900400000,COMM SW,Commercial,117720,0,114186,231906
142847900500000,COMM SW,Commercial,10822,0,41121,51943
142847900600000,COMM SW,Commercial,8618,0,46284,54902
142847900800000,COMM SW,Commercial,16200,0,28742,44942
142847900900000,E-83 EDU OTHER,Exempt,19926,0,57230,77156
142847901000000,COMM SW,Commercial,6237,0,6685,12922
142847901100000,COMM SW,Commercial,16200,0,38586,54786
142847901200000,E-70 CHARITY OTHER,Exempt,32400,0,133223,165623
142847901300000,COMM SW,Commercial,26091,0,55420,81511
142847901400000,COMM SW,Commercial,9856,0,34102,43958
142847901500000,SW 402,Residential,5000,0,0,5000
142847901600000,COMM SW,Commercial,11232,0,52397,63629
142847901800000,Empty,Exempt,0,0,0,0
142847901900000,Empty,Exempt,0,0,0,0
142847902000000,Empty,Exempt,0,0,0,0
142847902100000,Empty,Exempt,0,0,0,0
142847902200000,Empty,Exempt,0,0,0,0
142847902300000,Empty,Exempt,0,0,0,0
142847902400000,Empty,Exempt,0,0,0,0
142847902500000,COMM SW,Commercial,8100,0,4712,12812
142848000100000,Empty,Exempt,0,0,0,0
142848000200000,Empty,Exempt,0,0,0,0
142848000300000,Empty,Exempt,0,0,0,0
142848000400000,Empty,Exempt,0,0,0,0
142848000500000,COMM SW,Commercial,8100,0,34282,42382
142848000600000,Empty,Exempt,0,0,0,0
142848000700000,COMM SW,Commercial,9936,0,4595,14531
142848000800000,COMM SW,Commercial,8748,0,2283,11031
142848000900000,Empty,Exempt,0,0,0,0
142848001000000,COMM SW,Commercial,12960,0,23779,36739
142848001100000,COMM SW,Commercial,16200,0,18564,34764
142848001200000,COMM SW,Commercial,12960,0,28696,41656
142848001300000,COMM SW,Commercial,6480,0,35182,41662
142848001400000,COMM SW,Commercial,9818,0,56429,66247
142848001500000,COMM SW,Commercial,6565,0,10284,16849
142848001600000,COMM SW,Commercial,12960,0,20256,33216
142848001700000,COMM SW,Commercial,16200,0,26461,42661
142848001800000,COMM SW,Commercial,32400,0,24497,56897
142848001900000,COMM SW,Commercial,14580,0,19929,34509
142848100100000,Empty,Exempt,0,0,0,0
142848100200000,Empty,Exempt,0,0,0,0
142848100300000,SW 402,Residential,11120,0,0,11120
142848100400000,SW 402,Residential,7600,0,0,7600
142848100500000,SW 402,Residential,7600,0,0,7600
142848100600000,SW 402,Residential,7700,0,0,7700
142848100700000,SW 402,Residential,5400,0,0,5400
142848100800000,SW 402,Residential,5000,0,0,5000
142848100900000,SW 402,Residential,5000,0,0,5000
142848101000000,SW 402,Residential,6940,0,0,6940
142848200300000,SW 402,Residential,5000,0,0,5000
142848200400000,SW 402,Residential,7472,0,0,7472
142848200500000,SW 402,Residential,8800,14681,0,23481
142848200600000,SW 402,Residential,7600,0,0,7600
142848200700000,SW 402,Residential,5000,0,0,5000
142848200800000,SW 402,Residential,7600,0,0,7600
142848200900000,SW 402,Residential,8800,0,0,8800
142848201000000,SW 402,Residential,5000,0,0,5000
142848201100000,SW 402,Residential,5000,0,0,5000
142848201200000,SW 402,Residential,5000,0,0,5000
142848201300000,SW 402,Residential,5000,0,0,5000
142848201400000,SW 402,Residential,5000,0,0,5000
142848201500000,SW 402,Residential,7600,0,0,7600
142848201600000,SW 402,Residential,5000,0,0,5000
142848201700000,SW 402,Residential,5000,0,0,5000
142848300100000,Empty,Exempt,0,0,0,0
142848300200000,SW 402,Residential,5000,0,0,5000
142848300300000,COMM SW,Commercial,5000,0,0,5000
142848300400000,SW 402,Residential,5000,0,0,5000
142848300500000,SW 402,Residential,5000,0,0,5000
142848300600000,SW 402,Residential,5400,0,0,5400
142848300700000,SW 402,Residential,5000,0,0,5000
142848300800000,SW 402,Residential,5000,0,0,5000
142848300900000,SW 402,Residential,5400,0,0,5400
142848301000000,COMM SW,Commercial,16200,0,0,16200
142848301100000,SW 402,Residential,5000,0,0,5000
142848301200000,SW 402,Residential,5000,0,0,5000
142848301300000,SW 402,Residential,7600,0,0,7600
142848301400000,SW 402,Residential,7600,0,0,7600
142848301500000,SW 402,Residential,7600,0,0,7600
142848301600000,SW 402,Residential,5000,0,0,5000
142848301700000,SW 402,Residential,5000,0,0,5000
142848400100000,SW 402,Residential,8360,0,0,8360
142848400200000,SW 402,Residential,5000,0,0,5000
142848400300000,SW 402,Residential,7600,0,0,7600
142848400400000,SW 402,Residential,11120,0,0,11120
142848400500000,SW 402,Residential,5400,0,0,5400
142848500100000,SW 402,Residential,13200,0,0,13200
142848500200000,SW 402,Residential,5000,0,0,5000
142848500300000,SW 402,Residential,7600,0,0,7600
142848500400000,SW 402,Residential,5000,0,0,5000
142848500500000,SW 402,Residential,5000,0,0,5000
142848500600000,SW 402,Residential,5000,0,0,5000
142848500700000,SW 402,Residential,7600,0,0,7600
142848500800000,SW 402,Residential,13200,62576,0,75776
142848500900000,SW 402,Residential,5000,0,0,5000
142848501000000,SW 402,Residential,5000,0,0,5000
142848501100000,SW 402,Residential,7600,0,0,7600
142848501200000,SW 402,Residential,7600,0,0,7600
142848600100000,SW 402,Residential,5000,0,0,5000
142848600200000,SW 402,Residential,5000,0,0,5000
142848600300000,SW 402,Residential,5400,0,0,5400
142848600400000,SW 402,Residential,5000,0,0,5000
142848600500000,SW 402,Residential,5400,0,0,5400
142848600600000,COMM SW,Commercial,10800,0,23276,34076
142848600700000,SW 402,Residential,5000,0,0,5000
142848600800000,SW 402,Residential,13200,65841,0,79041
142848600900000,SW 402,Residential,7600,0,0,7600
142848601000000,SW 402,Residential,5000,0,0,5000
142848601100000,SW 402,Residential,5000,0,0,5000
142848601200000,SW 402,Residential,5000,0,0,5000
142848700100000,COMM SW,Commercial,14291,0,10762,25053
142848700200000,COMM SW,Commercial,8668,0,8867,17535
142848700300000,SW 402,Residential,17000,46496,0,63496
142848700400000,SW 402,Residential,18020,53043,0,71063
142848700500000,Empty,Exempt,0,0,0,0
142848700600000,COMM SW,Commercial,21600,0,30303,51903
142848700700000,COMM SW,Commercial,59616,0,113665,173281
142848700800000,SW 402,Residential,11288,44766,0,56054
142848700900000,SW 402,Residential,21270,106779,0,128049
142848701000000,SW 402,Residential,26163,0,0,26163
142848800100000,COMM SW,Commercial,11340,0,30239,41579
142848800200000,SW 402,Residential,20060,27115,0,47175
142848800300000,SW 402,Residential,23460,1170,0,24630
142910100100000,COMM NW,Commercial,9288,0,15661,24949
142910100200000,NW 318,Residential,5000,0,0,5000
142910100300000,CONVERSIONS,Commercial,5400,0,0,5400
142910100400000,COMM NW,Commercial,7722,0,15907,23629
142910100500000,COMM NW,Commercial,12744,0,71869,84613
142910100600000,COMM NW,Commercial,9936,0,3999,13935
142910100700000,NW 318,Residential,5000,0,0,5000
142910100800000,NW 318,Residential,5000,0,0,5000
142910100900000,NW 318,Residential,5000,0,0,5000
142910101000000,NW 318,Residential,5000,0,0,5000
142910200100000,NW 318,Residential,5000,0,0,5000
142910200200000,NW 318,Residential,6750,16526,0,23276
142910200300000,NW 318,Residential,5000,0,0,5000
142910200400000,NW 318,Residential,5000,0,0,5000
142910200500000,NW 318,Residential,5000,0,0,5000
142910200600000,NW 318,Residential,5000,0,0,5000
142910200700000,NW 318,Residential,5000,0,0,5000
142910200800000,NW 318,Residential,5000,26963,0,31963
142910200900000,NW 318,Residential,5000,0,0,5000
142910201000000,NW 318,Residential,13500,30601,0,44101
142910201100000,E-70 CHARITY OTHER,Exempt,9072,0,43097,52169
142910201200000,NW 318,Residential,5000,0,0,5000
142910201300000,NW 318,Residential,9000,29309,0,38309
142910201400000,NW 318,Residential,5000,0,0,5000
142910201500000,NW 318,Residential,9450,32109,0,41559
142910201600000,NW 318,Residential,5000,0,0,5000
142910201700000,NW 318,Residential,6556,38830,0,45386
142910300100000,Empty,Exempt,0,0,0,0
142910400100000,COMM NW,Commercial,6048,0,15483,21531
142910400200000,COMM NW,Commercial,2171,0,1104,3275
142910400300000,COMM NW,Commercial,5000,0,0,5000
142910400400000,Empty,Other,0,0,0,0
142910400500000,NW 318,Residential,5000,0,0,5000
142910400600000,NW 318,Residential,5000,0,0,5000
142910400700000,NW 318,Residential,5000,0,0,5000
142910400800000,NW 318,Residential,5000,0,0,5000
142910500300000,Empty,Other,0,0,0,0
142910600100000,Empty,Exempt,0,0,0,0
142910700100000,NW 318,Residential,3348,0,0,3348
142910700200000,NW 318,Residential,5000,0,0,5000
142910700300000,NW 318,Residential,5000,0,0,5000
142910700400000,NW 318,Residential,13500,28781,0,42281
142910700500000,NW 318,Residential,5000,26750,0,31750
142910700600000,NW 318,Residential,5000,33437,0,38437
142910700700000,NW 318,Residential,5580,20361,0,25941
142910700800000,NW 318,Residential,5000,0,0,5000
142910700900000,NW 318,Residential,4650,0,0,4650
142910701000000,NW 318,Residential,5000,0,0,5000
142910701100000,NW 318,Residential,10260,26299,0,36559
142910701200000,NW 318,Residential,9000,20016,0,29016
142910701300000,NW 318,Residential,9000,39478,0,48478
142910701400000,NW 318,Residential,5000,0,0,5000
142910701500000,COMM NW,Commercial,5400,0,0,5400
142910701600000,NW 318,Residential,9450,29569,0,39019
142910701700000,NW 318,Residential,5000,0,0,5000
142910701800000,NW 318,Residential,5000,0,0,5000
142910701900000,NW 318,Residential,5000,0,0,5000
142910702000000,NW 318,Residential,5000,0,0,5000
142910702100000,NW 318,Residential,2530,0,0,2530
142910800100000,NW 318,Residential,5000,0,0,5000
142910800200000,NW 318,Residential,5000,0,0,5000
142910800300000,APTS NW,Commercial,11794,0,181431,193225
142910800400000,COMM NW,Commercial,27095,0,2644,29739
142910800500000,Empty,Exempt,0,0,0,0
142910800600000,INDUSTRIAL,Industrial,1237,0,0,1237
142910800700000,COMM NW,Commercial,7339,0,8654,15993
142910800800000,NW 318,Residential,13500,63272,0,76772
142910800900000,CONVERSIONS,Commercial,5400,0,0,5400
142910801000000,NW 318,Residential,9000,43487,0,52487
142910801100000,NW 318,Residential,9000,44039,0,53039
142910801200000,NW 318,Residential,5000,28181,0,33181
142910801300000,NW 318,Residential,8550,28680,0,37230
142910801400000,NW 318,Residential,10507,34099,0,44606
142910801500000,NW 318,Residential,9765,50043,0,59808
142910900100000,Empty,Exempt,0,0,0,0
142910900200000,Empty,Exempt,0,0,0,0
142910900300000,Empty,Exempt,0,0,0,0
142911000100000,NW 318,Residential,5000,0,0,5000
142911000200000,NW 318,Residential,5000,0,0,5000
142911000300000,NW 318,Residential,9225,52871,0,62096
142911000400000,APTS NW,Commercial,6339,0,118454,124793
142911000500000,APTS NW,Commercial,6678,0,116955,123633
142911000600000,NW 318,Residential,5000,0,0,5000
142911000700000,NW 318,Residential,5000,0,0,5000
142911000800000,NW 318,Residential,5000,20857,0,25857
142911000900000,NW 318,Residential,5000,15968,0,20968
142911001000000,COMM NW,Commercial,39010,0,31993,71003
142911001300000,NW 318,Residential,5000,0,0,5000
142911001400000,NW 318,Residential,5000,0,0,5000
142911001500000,Empty,Exempt,0,0,0,0
142911001600000,CONVERSIONS,Commercial,4156,0,0,4156
142911001700000,CONDO 502,Commercial,66799,0,210557,277356
142911100100000,NW 318,Residential,5000,34667,0,39667
142911100200000,NW 318,Residential,5000,0,0,5000
142911100300000,NW 318,Residential,9000,30254,0,39254
142911100400000,NW 318,Residential,9000,44500,0,53500
142911100500000,NW 318,Residential,5000,0,0,5000
142911100600000,NW 318,Residential,6750,13180,0,19930
142911100700000,NW 318,Residential,5000,0,0,5000
142911100800000,NW 318,Residential,13500,25268,0,38768
142911101100000,E-40 CHURCHES,Exempt,341345,0,2116848,2458193
142911101200000,E-46 RELIG PARKING,Exempt,8370,0,2165,10535
142911101400000,COMM NW,Commercial,13608,0,33401,47009
142911101500000,NW 318,Residential,9000,25452,0,34452
142911102100000,NW 318,Residential,5000,0,0,5000
142911102200000,NW 318,Residential,5000,0,0,5000
142911102300000,NW 318,Residential,5000,0,0,5000
142911102400000,NW 318,Residential,5000,0,0,5000
142911200100000,COMM NW,Commercial,48735,0,54376,103111
142911200200000,INDUSTRIAL,Industrial,2280,0,0,2280
142911200300000,NW 318,Residential,5000,0,0,5000
142911200400000,NW 318,Residential,5000,0,0,5000
142911200500000,NW 318,Residential,5000,0,0,5000
142911200600000,NW 318,Residential,9000,18946,0,27946
142911200700000,NW 318,Residential,6750,1579,0,8329
142911200800000,NW 318,Residential,5000,0,0,5000
142911200900000,NW 318,Residential,5000,0,0,5000
142911201000000,NW 318,Residential,9000,28339,0,37339
142911201100000,COMM NW,Commercial,18144,0,4113,22257
142911300100000,INDUSTRIAL,Industrial,20160,0,8377,28537
142911400100000,Empty,Exempt,0,0,0,0
142911400200000,COMM SW,Commercial,24630,0,79656,104286
142911400300000,COMM SW,Commercial,68613,0,145974,214587
142911400400000,COMM SW,Commercial,2624,0,17112,19736
142911500100000,NW 318,Residential,9000,29002,0,38002
142911500200000,NW 318,Residential,9000,38635,0,47635
142911500300000,NW 318,Residential,9000,41601,0,50601
142911500400000,NW 318,Residential,5000,0,0,5000
142911500500000,NW 318,Residential,8775,48028,0,56803
142911500600000,NW 318,Residential,9000,44047,0,53047
142911500700000,NW 318,Residential,9000,53317,0,62317
142911500800000,CONVERSIONS,Commercial,6804,0,91249,98053
142911500900000,APTS NW,Commercial,5897,0,33900,39797
142911501000000,INDUSTRIAL,Industrial,11250,0,1234,12484
142911501100000,COMM NW,Commercial,15120,0,59202,74322
142911501200000,COMM NW,Commercial,15120,0,47200,62320
142911501300000,NW 318,Residential,14000,50435,0,64435
142911501400000,NW 318,Residential,5000,0,0,5000
142911501500000,NW 318,Residential,5000,0,0,5000
142911501600000,COMM NW,Commercial,20736,0,3788,24524
142911501700000,COMM NW,Commercial,9072,0,24362,33434
142911501800000,NW 318,Residential,7087,39904,0,46991
142912700100000,COMM NW,Commercial,6048,0,0,6048
142912700200000,NW 311,Residential,9520,0,0,9520
142912700300000,NW 311,Residential,5000,0,0,5000
142912700400000,NW 311,Residential,4800,0,0,4800
142912700500000,NW 311,Residential,13600,68208,0,81808
142912700600000,NW 311,Residential,13600,58889,0,72489
142912700700000,NW 311,Residential,13600,47099,0,60699
142912700800000,NW 311,Residential,9928,50807,0,60735
142912700900000,NW 311,Residential,9520,41543,0,51063
142912701000000,NW 311,Residential,5000,0,0,5000
142912701100000,NW 311,Residential,7913,60777,0,68690
142912701200000,NW 311,Residential,7913,46581,0,54494
142912701300000,NW 311,Residential,7913,48080,0,55993
142912701400000,NW 311,Residential,7140,67168,0,74308
142912701500000,NW 311,Residential,5000,0,0,5000
142912701600000,NW 311,Residential,10200,38077,0,48277
142912701700000,NW 311,Residential,5000,0,0,5000
142912701800000,NW 311,Residential,10200,51569,0,61769
142912701900000,NW 311,Residential,10200,52773,0,62973
142912702000000,NW 311,Residential,5000,0,0,5000
142912702100000,NW 311,Residential,9200,36478,0,45678
142912702200000,NW 311,Residential,10174,35949,0,46123
142912702300000,NW 311,Residential,5000,0,0,5000
142912702400000,NW 311,Residential,5000,0,0,5000
142912800100000,CONVERSIONS,Commercial,11227,0,72211,83438
142912800200000,NW 311,Residential,19800,84561,0,104361
142912800300000,NW 311,Residential,22680,92863,0,115543
142912800400000,NW 311,Residential,15804,94545,0,110349
142912800500000,NW 311,Residential,11056,58908,0,69964
142912800600000,NW 311,Residential,12757,62713,0,75470
142912800700000,NW 311,Residential,13500,72608,0,86108
142912800800000,NW 311,Residential,13500,54395,0,67895
142912800900000,NW 311,Residential,13500,12450,0,25950
142912801000000,NW 311,Residential,12150,38328,0,50478
142912801100000,NW 311,Residential,5953,69507,0,75460
142912900100000,NW 311,Residential,14940,46549,0,61489
142912900200000,NW 311,Residential,18000,34573,0,52573
142912900300000,NW 311,Residential,18000,46368,0,64368
142912900400000,NW 311,Residential,18000,40354,0,58354
142912900500000,NW 311,Residential,18000,78153,0,96153
142912900600000,NW 311,Residential,18720,50486,0,69206
142912900700000,NW 311,Residential,16170,73654,0,89824
142912900800000,NW 311,Residential,15750,91666,0,107416
142912900900000,NW 311,Residential,15750,59661,0,75411
142912901000000,NW 311,Residential,12600,51373,0,63973
142912901100000,NW 311,Residential,15750,78049,0,93799
142912901200000,NW 311,Residential,18900,75597,0,94497
142912901300000,NW 311,Residential,8505,78064,0,86569
142913000100000,Empty,Exempt,0,0,0,0
142913000200000,NW 311,Residential,8032,18748,0,26780
142913000300000,NW 311,Residential,5000,0,0,5000
142913000400000,NW 311,Residential,5000,0,0,5000
142913000500000,NW 311,Residential,5000,0,0,5000
142913000600000,NW 311,Residential,7459,28485,0,35944
142913000700000,NW 311,Residential,7650,29269,0,36919
142913000800000,NW 311,Exempt,0,0,0,0
142913100100000,NW 311,Residential,10200,47288,0,57488
142913100200000,NW 311,Residential,5000,0,0,5000
142913100300000,NW 311,Residential,5000,0,0,5000
142913100400000,NW 311,Residential,5000,0,0,5000
142913100500000,NW 311,Residential,5000,0,0,5000
142913100600000,NW 311,Residential,8925,40670,0,49595
142913100700000,NW 311,Residential,10200,41162,0,51362
142913100800000,NW 311,Residential,5000,0,0,5000
142913100900000,NW 311,Residential,5865,54406,0,60271
142913101000000,NW 311,Residential,5482,44772,0,50254
142913101100000,CONVERSIONS,Commercial,5400,0,0,5400
142913101200000,NW 311,Residential,7650,44243,0,51893
142913101300000,NW 311,Residential,10200,44377,0,54577
142913101400000,NW 311,Residential,5000,0,0,5000
142913101500000,NW 311,Residential,15300,61967,0,77267
142913101600000,Empty,Exempt,0,0,0,0
142913101700000,Empty,Exempt,0,0,0,0
142913200100000,CONVERSIONS,Commercial,10206,0,116072,126278
142913200200000,NW 311,Residential,13500,82062,0,95562
142913200300000,NW 311,Residential,13500,62922,0,76422
142913200400000,NW 311,Residential,13500,69332,0,82832
142913200500000,NW 311,Residential,7290,62807,0,70097
142913200600000,NW 311,Residential,7290,36317,0,43607
142913200700000,NW 311,Residential,5832,54915,0,60747
142913200800000,NW 311,Residential,13500,53166,0,66666
142913200900000,NW 311,Residential,9450,39606,0,49056
142913201000000,NW 311,Residential,9450,0,0,9450
142913201100000,APTS NW,Commercial,7371,0,77495,84866
142913201200000,NW 311,Residential,13500,75793,0,89293
142913300100000,NW 311,Residential,13122,59618,0,72740
142913300200000,NW 311,Residential,14143,82694,0,96837
142913300300000,NW 311,Residential,15750,63237,0,78987
142913300400000,NW 311,Residential,15750,49730,0,65480
142913300500000,NW 311,Residential,14017,58711,0,72728
142913300600000,NW 311,Residential,11214,27836,0,39050
142913300700000,NW 311,Residential,14017,24800,0,38817
142913300800000,E-67 SALVATION ARMY,Exempt,130545,0,256359,386904
142913300900000,NW 311,Residential,10260,93303,0,103563
142913400100000,INDUSTRIAL,Industrial,77355,0,729510,806865
142913500100000,NW 311,Residential,7752,65727,0,73479
142913500200000,NW 311,Residential,10200,62661,0,72861
142913500300000,NW 311,Residential,10200,59549,0,69749
142913500400000,NW 311,Residential,15300,46051,0,61351
142913500500000,NW 311,Residential,15300,53614,0,68914
142913500600000,NW 311,Residential,10200,39854,0,50054
142913500700000,NW 311,Residential,5000,0,0,5000
142913500800000,NW 311,Residential,5000,0,0,5000
142913500900000,NW 311,Residential,12476,45205,0,57681
142913501000000,NW 311,Residential,5000,0,0,5000
142913501100000,COMM NW,Commercial,15624,0,28392,44016
142913501200000,NW 311,Residential,6885,82753,0,89638
142913600100000,NW 311,Residential,9450,65415,0,74865
142913600200000,NW 311,Residential,9720,48684,0,58404
142913600300000,NW 311,Residential,10800,61657,0,72457
142913600400000,NW 311,Residential,8100,72052,0,80152
142913600500000,NW 311,Residential,10800,33637,0,44437
142913600600000,NW 311,Residential,11880,63989,0,75869
142913600700000,NW 311,Residential,5832,58761,0,64593
142913600800000,NW 311,Residential,13500,66860,0,80360
142913600900000,NW 311,Residential,13500,54554,0,68054
142913601000000,NW 311,Residential,13500,63277,0,76777
142913601100000,NW 311,Residential,13500,51120,0,64620
142913601200000,NW 311,Residential,13500,111090,0,124590
142913601400000,NW 311,Residential,7843,62276,0,70119
142913601500000,NW 311,Residential,5103,48675,0,53778
142913700100000,NW 311,Residential,15750,54865,0,70615
142913700200000,NW 311,Residential,15750,65741,0,81491
142913700300000,NW 311,Residential,15750,72086,0,87836
142913700400000,NW 311,Residential,13500,49400,0,62900
142913700500000,NW 311,Residential,14175,54660,0,68835
142913700600000,NW 311,Residential,14490,51597,0,66087
142913700700000,NW 311,Residential,18900,54700,0,73600
142913700800000,NW 311,Residential,12600,53147,0,65747
142913700900000,NW 311,Residential,12600,68013,0,80613
142913701000000,NW 311,Residential,8190,34390,0,42580
142913701100000,NW 311,Residential,8190,40834,0,49024
142913701200000,NW 311,Residential,15120,53062,0,68182
142913701300000,NW 311,Residential,15750,56954,0,72704
142913800100000,COMM NW,Commercial,75600,0,353877,429477
142913900100000,NW 311,Residential,11167,55685,0,66852
142913900200000,NW 311,Residential,13500,62445,0,75945
142913900300000,E-40 CHURCHES,Exempt,22680,0,238763,261443
142913900400000,NW 311,Residential,10930,59905,0,70835
142913900500000,NW 311,Residential,11167,54792,0,65959
142914000100000,E-43 RELIG RECREAT'N,Exempt,22453,0,397351,419804
142914000200000,Empty,Other,0,0,0,0
142914000300000,NW 311,Residential,15750,57535,0,73285
142914000400000,NW 311,Residential,14525,59860,0,74385
142914000500000,NW 311,Residential,13072,62047,0,75119
142914000600000,NW 311,Residential,10458,52307,0,62765
142915100100000,INDUSTRIAL,Industrial,92745,0,294807,387552
142915100200000,COMM NW,Commercial,60412,0,75477,135889
142915100300000,COMM NW,Commercial,11340,0,7398,18738
142915100400000,NW 311,Residential,5000,0,0,5000
142915100500000,NW 311,Residential,9850,49584,0,59434
142915100600000,NW 311,Residential,9439,47166,0,56605
142915100700000,NW 311,Residential,13680,49677,0,63357
142915100800000,COMM NW,Commercial,24192,0,11632,35824
142915100900000,COMM NW,Commercial,22680,0,103637,126317
142915101000000,COMM NW,Commercial,9720,0,991,10711
142915101100000,COMM NW,Commercial,4320,0,0,4320
142915200100000,COMM NW,Commercial,8505,0,240,8745
142915200200000,NW 311,Residential,8392,28849,0,37241
142915200300000,NW 311,Residential,8824,31951,0,40775
142915200400000,NW 311,Residential,10044,27717,0,37761
142915200500000,NW 311,Residential,11760,0,0,11760
142915300100000,NW 311,Residential,9507,70240,0,79747
142915300200000,NW 311,Residential,1681,0,0,1681
142915300300000,NW 311,Residential,7780,51511,0,59291
142915300400000,CONVERSIONS,Commercial,6160,0,49497,55657
142915300500000,NW 311,Residential,9922,34618,0,44540
142915300600000,NW 311,Residential,8626,41312,0,49938
142915300700000,NW 311,Residential,9450,32064,0,41514
142915300800000,NW 311,Residential,5000,0,0,5000
142915300900000,NW 311,Residential,6750,44662,0,51412
142915301000000,NW 311,Residential,11880,53769,0,65649
142915301100000,NW 311,Residential,5000,0,0,5000
142915301200000,NW 311,Residential,7560,54348,0,61908
142915301300000,NW 311,Residential,6998,65159,0,72157
142915400100000,E-47 RELIG OTHER,Exempt,18979,0,22749,41728
142915400200000,NW 311,Residential,17388,36826,0,54214
142915400300000,NW 311,Residential,8694,62592,0,71286
142915400400000,NW 311,Residential,8694,40952,0,49646
142915400500000,NW 311,Residential,8694,74924,0,83618
142915400600000,NW 311,Residential,8694,32889,0,41583
142915400700000,NW 311,Residential,8694,48220,0,56914
142915401000000,NW 311,Residential,10458,56405,0,66863
142915401100000,NW 311,Residential,15400,69750,0,85150
142915401200000,NW 311,Residential,11088,44959,0,56047
142915401300000,NW 311,Residential,15750,55547,0,71297
142915401400000,NW 311,Residential,15750,68870,0,84620
142915401500000,NW 311,Residential,15750,64530,0,80280
142915401600000,E-10 COUNTY,Exempt,0,0,0,0
142915401700000,NW 311,Residential,12172,48091,0,60263
142915500100000,Empty,Exempt,0,0,0,0
142915500200000,NW 311,Residential,8640,58562,0,67202
142915500300000,NW 311,Residential,14000,65655,0,79655
142915500400000,NW 311,Residential,14000,60487,0,74487
142915500500000,NW 311,Residential,12960,70040,0,83000
142915500600000,NW 311,Residential,8640,57683,0,66323
142915600100000,NW 311,Residential,9045,61235,0,70280
142915600200000,NW 311,Residential,13500,72067,0,85567
142915600300000,NW 311,Residential,8100,56731,0,64831
142915600400000,NW 311,Residential,5000,0,0,5000
142915600500000,NW 311,Residential,9450,45122,0,54572
142915600600000,NW 311,Residential,13500,52156,0,65656
142915600700000,NW 311,Residential,7290,43056,0,50346
142915600800000,COMM NW,Commercial,31050,0,73254,104304
142915600900000,COMM NW,Commercial,18900,0,83426,102326
142915601000000,COMM NW,Commercial,27000,0,49783,76783
142915601100000,NW 311,Residential,9504,40794,0,50298
142915601200000,NW 311,Residential,5103,58671,0,63774
142915601300000,NW 311,Residential,5832,51843,0,57675
142915700100000,NW 311,Residential,10206,63665,0,73871
142915700200000,NW 311,Residential,12757,51459,0,64216
142915700300000,NW 311,Residential,15750,71133,0,86883
142915700400000,NW 311,Residential,17500,83273,0,100773
142915700500000,NW 311,Residential,14000,75400,0,89400
142915700600000,NW 311,Residential,5513,51512,0,57025
142915700700000,NW 311,Residential,13230,73732,0,86962
142915700800000,NW 311,Residential,18000,101843,0,119843
142915700900000,NW 311,Residential,18000,0,0,18000
142915701000000,NW 311,Residential,18000,0,0,18000
142915701100000,COMM NW,Commercial,24840,0,60707,85547
142915701200000,NW 311,Residential,6998,54092,0,61090
142915701300000,NW 311,Residential,9968,61943,0,71911
142915701400000,NW 311,Residential,5103,44913,0,50016
142915800100000,NW 311,Residential,12128,56966,0,69094
142915800200000,NW 311,Residential,10500,79274,0,89774
142915800300000,NW 311,Residential,10640,61843,0,72483
142915800400000,NW 311,Residential,20000,68593,0,88593
142915800500000,NW 311,Residential,400,0,0,400
142915800600000,NW 311,Residential,20400,68328,0,88728
142915800700000,NW 311,Residential,16320,57208,0,73528
142915800800000,NW 311,Residential,20400,76100,0,96500
142915800900000,NW 311,Residential,20400,98184,0,118584
142915801000000,NW 311,Residential,20400,95334,0,115734
142915801100000,APTS NW,Residential,9720,98169,0,107889
142915801200000,NW 311,Residential,10850,100629,0,111479
142915801300000,NW 311,Residential,11753,61893,0,73646
142915801400000,NW 311,Residential,11554,64533,0,76087
142915900100000,COMM SW,Commercial,115560,0,14940,130500
142915900200000,COMM SW,Commercial,19810,0,1490,21300
142916000100000,COMM SW,Commercial,37800,0,48011,85811
142916000102000,COMM SW,Commercial,0,0,20100,20100
142916000200000,COMM SW,Commercial,117720,0,150651,268371
142916000300000,COMM SW,Commercial,73575,0,132973,206548
142916100100000,COMM SW,Commercial,30240,0,89658,119898
142916100200000,NW 311,Residential,8000,64263,0,72263
142916100300000,NW 311,Residential,8000,584,0,8584
142916100400000,COMM SW,Commercial,30240,0,66340,96580
142916100500000,APTS SW,Commercial,7371,0,72416,79787
142916100600000,COMM SW,Commercial,18144,0,0,18144
142916100700000,COMM SW,Commercial,11340,0,13803,25143
142916100800000,NW 311,Residential,15000,51653,0,66653
142916100900000,NW 311,Residential,7075,44478,0,51553
142916101000000,NW 311,Residential,7209,51929,0,59138
142916101100000,NW 311,Residential,8396,59402,0,67798
142916200100000,NW 311,Residential,19920,93962,0,113882
142916200200000,NW 311,Residential,20000,83752,0,103752
142916200300000,NW 311,Residential,20000,70211,0,90211
142916200400000,NW 311,Residential,20000,88058,0,108058
142916200500000,NW 311,Residential,20000,73227,0,93227
142916200600000,NW 311,Residential,16000,82799,0,98799
142916200700000,CONVERSIONS,Commercial,13608,0,94824,108432
142916200800000,NW 311,Residential,7290,69806,0,77096
142916200900000,NW 311,Residential,11400,56094,0,67494
142916201000000,NW 311,Residential,15132,91448,0,106580
142916201100000,NW 311,Residential,15000,59591,0,74591
142916201200000,NW 311,Residential,15000,56402,0,71402
142916201300000,NW 311,Residential,15000,47092,0,62092
142916201400000,NW 311,Residential,15000,70291,0,85291
142916201500000,NW 311,Residential,13680,45702,0,59382
142916201600000,COMM SW,Commercial,11664,0,84399,96063
142916201700000,NW 311,Residential,9300,43839,0,53139
142916300100000,COMM SW,Commercial,46710,0,136040,182750
142916300200000,COMM SW,Commercial,23134,0,0,23134
142916300300000,COMM SW,Commercial,30252,0,85845,116097
142916300400000,COMM SW,Commercial,9498,0,9960,19458
142916300500000,NW 318,Residential,5000,0,0,5000
142916300600000,NW 318,Residential,8662,37635,0,46297
142916300700000,NW 318,Residential,8580,0,0,8580
142916400100000,COMM SW,Commercial,12015,0,0,12015
142916400200000,COMM SW,Commercial,30847,0,81395,112242
142916400300000,COMM SW,Commercial,20925,0,4357,25282
142916400400000,COMM SW,Commercial,9450,0,1385,10835
142916400500000,COMM SW,Commercial,11745,0,2203,13948
142916400600000,COMM SW,Commercial,11745,0,292,12037
142916400700000,COMM SW,Commercial,5872,0,159754,165626
142916400800000,NW 311,Residential,10050,56892,0,66942
142916400900000,NW 311,Residential,7560,55723,0,63283
142916401000000,NW 311,Residential,11288,53375,0,64663
142916401100000,NW 311,Residential,6222,50432,0,56654
142916401200000,NW 311,Residential,8501,43561,0,52062
142916401300000,NW 311,Residential,10950,53054,0,64004
142916401400000,NW 311,Residential,10576,55095,0,65671
142916401500000,COMM SW,Commercial,15660,0,3383,19043
142916401600000,COMM SW,Commercial,35842,0,94337,130179
142916401700000,COMM SW,Commercial,9315,0,0,9315
142917600100000,Empty,Exempt,0,0,0,0
142917700100000,COMM SW,Commercial,54335,0,15670,70005
142917700200000,COMM SW,Commercial,18112,0,54089,72201
142917700202000,COMM SW,Commercial,0,0,12954,12954
142917700300000,COMM SW,Commercial,53914,0,63128,117042
142917700400000,SW 401,Residential,5000,0,0,5000
142917700500000,COMM SW,Commercial,9072,0,15907,24979
142917700600000,COMM SW,Commercial,16704,0,16669,33373
142917700700000,SW 401,Residential,5000,0,0,5000
142917700800000,SW 401,Residential,5000,0,0,5000
142917700900000,CONVERSIONS,Commercial,7290,0,26844,34134
142917701000000,CONVERSIONS,Commercial,7290,0,53119,60409
142917701100000,SW 401,Residential,9180,0,0,9180
142917800100000,COMM NW,Commercial,15120,0,36766,51886
142917800200000,NW 318,Residential,5000,0,0,5000
142917800300000,COMM NW,Commercial,30240,0,4113,34353
142917800400000,COMM NW,Commercial,15120,0,62839,77959
142917800500000,COMM NW,Commercial,30240,0,5878,36118
142917800600000,COMM NW,Commercial,30240,0,5878,36118
142917800700000,COMM NW,Commercial,30240,0,106392,136632
142917800800000,NW 318,Residential,87480,193950,0,281430
142917900100000,Empty,Exempt,0,0,0,0
142917900200000,SW 401,Residential,5000,0,0,5000
142917900300000,SW 401,Residential,5000,0,0,5000
142917900400000,CONVERSIONS,Commercial,5400,0,0,5400
142917900500000,E-46 RELIG PARKING,Exempt,12960,0,3195,16155
142917900600000,E-40 CHURCHES,Exempt,45506,0,156108,201614
142917900700000,E-46 RELIG PARKING,Exempt,18144,0,19907,38051
142917900800000,E-46 RELIG PARKING,Exempt,18144,0,106056,124200
142917900900000,E-40 CHURCHES,Exempt,18144,0,2209,20353
142917901000000,E-40 CHURCHES,Exempt,9072,0,19467,28539
142917901100000,SW 401,Residential,5000,0,0,5000
142917901200000,COMM SW,Commercial,9072,0,13730,22802
142917901300000,CONVERSIONS,Commercial,5400,0,0,5400
142917901400000,E-10 COUNTY,Exempt,0,0,0,0
142917901500000,SW 401,Residential,9207,52696,0,61903
142917901600000,Empty,Exempt,0,0,0,0
142918000100000,NW 318,Residential,7350,45909,0,53259
142918000200000,CONVERSIONS,Commercial,3826,0,38181,42007
142918000300000,E-40 CHURCHES,Exempt,84672,0,71832,156504
142918000400000,COMM SW,Commercial,15120,0,28952,44072
142918000500000,COMM SW,Commercial,14364,0,69546,83910
142918000600000,NW 318,Residential,5512,0,0,5512
142918000700000,COMM SW,Commercial,7938,0,5670,13608
142918000800000,NW 318,Residential,5000,0,0,5000
142918000900000,NW 318,Residential,5000,39345,0,44345
142918001000000,NW 318,Residential,5000,0,0,5000
142918001100000,CONVERSIONS,Commercial,5400,0,0,5400
142918001200000,E-46 RELIG PARKING,Exempt,13608,0,7620,21228
142918001300000,E-46 RELIG PARKING,Exempt,27216,0,15241,42457
142918001400000,E-46 RELIG PARKING,Exempt,13608,0,7620,21228
142918001500000,CONVERSIONS,Commercial,5400,0,0,5400
142918001600000,CONVERSIONS,Commercial,5400,0,0,5400
142918001700000,NW 318,Residential,5301,24489,0,29790
142918001800000,NW 318,Residential,5000,0,0,5000
142918001900000,NW 318,Residential,5000,0,0,5000
142918100100000,COMM SW,Commercial,40824,0,6604,47428
142918100200000,COMM SW,Commercial,41688,0,116632,158320
142918100300000,COMM SW,Commercial,27864,0,4000,31864
142918100400000,COMM SW,Commercial,15120,0,24664,39784
142918100500000,COMM SW,Commercial,15120,0,32817,47937
142918100600000,COMM SW,Commercial,16728,0,972,17700
142918100700000,NW 318,Residential,5000,0,0,5000
142918100800000,NW 318,Residential,9000,30357,0,39357
142918100900000,NW 318,Residential,9000,17249,0,26249
142918101000000,NW 318,Residential,9000,45215,0,54215
142918101100000,NW 318,Residential,5000,0,0,5000
142918101200000,NW 318,Residential,9000,0,0,9000
142918101300000,CONVERSIONS,Commercial,6804,0,15239,22043
142918101400000,CONVERSIONS,Commercial,6804,0,47235,54039
142918101500000,NW 318,Residential,5000,0,0,5000
142918101600000,NW 318,Residential,5000,0,0,5000
142918101700000,NW 318,Residential,6075,41754,0,47829
142918101800000,NW 318,Residential,5000,0,0,5000
142918200100000,COMM SW,Commercial,69530,0,332881,402411
142918200300000,COMM SW,Commercial,21724,0,0,21724
142918200400000,COMM SW,Commercial,10344,0,0,10344
142918200500000,SW 401,Residential,5000,0,0,5000
142918300100000,NW 318,Residential,5371,29167,0,34538
142918300200000,COMM SW,Commercial,40824,0,82334,123158
142918300300000,NW 318,Residential,5000,12241,0,17241
142918300400000,COMM SW,Commercial,3402,0,26826,30228
142918300500000,NW 318,Residential,5000,0,0,5000
142918300600000,NW 318,Residential,5000,38637,0,43637
142918300700000,NW 318,Residential,5000,20995,0,25995
142918300800000,NW 318,Residential,5000,0,0,5000
142918300900000,NW 318,Residential,5000,23019,0,28019
142918301000000,NW 318,Residential,5000,30331,0,35331
142918301100000,NW 318,Residential,5602,51282,0,56884
142918301200000,COMM SW,Commercial,18468,0,1542,20010
142918301300000,COMM SW,Commercial,68040,0,11996,80036
142918301400000,COMM SW,Commercial,34020,0,36597,70617
142918301500000,NW 318,Residential,5000,12905,0,17905
142918301600000,NW 318,Residential,5000,0,0,5000
142918301700000,NW 318,Residential,5161,35408,0,40569
142918400100000,NW 318,Residential,7492,17703,0,25195
142918400200000,NW 318,Residential,6570,17670,0,24240
142918400300000,NW 318,Residential,9000,41067,0,50067
142918400400000,NW 318,Residential,5000,0,0,5000
142918400500000,NW 318,Residential,9000,21609,0,30609
142918400600000,NW 318,Residential,9000,25170,0,34170
142918400700000,NW 318,Residential,9000,35429,0,44429
142918400800000,NW 318,Residential,6075,17048,0,23123
142918400900000,NW 318,Residential,5000,0,0,5000
142918401000000,NW 318,Residential,9000,17665,0,26665
142918401200000,NW 318,Residential,18000,38574,0,56574
142918401300000,NW 318,Residential,6300,37913,0,44213
142918401400000,NW 318,Residential,7200,51907,0,59107
142918401500000,NW 318,Residential,5000,0,0,5000
142918401600000,NW 318,Residential,5580,40092,0,45672
142918401700000,COMM SW,Commercial,3370,0,21122,24492
142918401800000,NW 318,Residential,5000,0,0,5000
142918500100000,NW 318,Residential,5000,0,0,5000
142918500200000,NW 318,Residential,9000,34128,0,43128
142918500300000,NW 318,Residential,9000,12347,0,21347
142918500400000,NW 318,Residential,9000,29373,0,38373
142918500500000,NW 318,Residential,5000,0,0,5000
142918500600000,COMM SW,Commercial,8707,0,67568,76275
142918500700000,CONVERSIONS,Commercial,4983,0,0,4983
142918500800000,NW 318,Residential,8977,28886,0,37863
142918500900000,NW 318,Residential,5000,0,0,5000
142918501000000,NW 318,Residential,9000,36258,0,45258
142918501100000,NW 318,Residential,5000,0,0,5000
142918501200000,APTS SW,Commercial,5897,0,53786,59683
142918501300000,NW 318,Residential,9000,21221,0,30221
142918501400000,NW 318,Residential,9000,0,0,9000
142918501500000,NW 318,Residential,9000,15280,0,24280
142918600100000,NW 318,Residential,8010,36740,0,44750
142918600200000,NW 318,Residential,5000,0,0,5000
142918600300000,NW 318,Residential,5000,0,0,5000
142918600400000,COMM SW,Commercial,18144,0,0,18144
142918600500000,NW 318,Residential,5000,0,0,5000
142918600600000,NW 318,Residential,5000,0,0,5000
142918600700000,NW 318,Residential,11250,60845,0,72095
142918600800000,NW 318,Residential,5000,0,0,5000
142918600900000,NW 318,Residential,5434,35762,0,41196
142918601000000,NW 318,Residential,5000,32725,0,37725
142918601100000,NW 318,Residential,5814,69779,0,75593
142918601200000,NW 318,Residential,7200,39353,0,46553
142918601300000,NW 318,Residential,7650,36900,0,44550
142918601400000,NW 318,Residential,7650,34080,0,41730
142918601500000,NW 318,Residential,7200,18517,0,25717
142918601600000,NW 318,Residential,6750,40109,0,46859
142918601700000,NW 318,Residential,5512,21212,0,26724
142918601800000,NW 318,Residential,5000,0,0,5000
142918601900000,NW 318,Residential,5512,12705,0,18217
142918602000000,NW 318,Residential,5000,0,0,5000
142918602100000,NW 318,Residential,5000,46304,0,51304
142918700100000,COMM SW,Commercial,8640,0,19576,28216
142918700200000,NW 318,Residential,5000,0,0,5000
142918700300000,NW 318,Residential,5000,0,0,5000
142918700400000,NW 318,Residential,5000,0,0,5000
142918700500000,NW 318,Residential,5440,13166,0,18606
142918700600000,NW 318,Residential,5747,12672,0,18419
142918700700000,NW 318,Residential,7603,1198,0,8801
142918700800000,NW 318,Residential,5920,29568,0,35488
142918700900000,NW 318,Residential,6432,46549,0,52981
142918701000000,NW 318,Residential,5000,0,0,5000
142918701100000,NW 318,Residential,5000,0,0,5000
142918701200000,NW 318,Residential,7824,39169,0,46993
142918701300000,NW 318,Residential,5000,0,0,5000
142918701400000,NW 318,Residential,5000,0,0,5000
142918701500000,NW 318,Residential,5000,0,0,5000
142918800100000,NW 318,Residential,9000,35948,0,44948
142918800200000,NW 318,Residential,9000,75178,0,84178
142918800300000,NW 318,Residential,5000,0,0,5000
142918800400000,NW 318,Residential,9000,25953,0,34953
142918800500000,NW 318,Residential,9000,31974,0,40974
142918800600000,NW 318,Residential,9000,54026,0,63026
142918800700000,NW 318,Residential,6300,39424,0,45724
142918800800000,NW 318,Residential,5000,0,0,5000
142918800900000,NW 318,Residential,8721,32703,0,41424
142918801000000,NW 318,Residential,6300,42014,0,48314
142918801100000,NW 318,Residential,7470,39926,0,47396
142918801200000,NW 318,Residential,8820,28418,0,37238
142918801300000,NW 318,Residential,720,768,0,1488
142918801400000,Empty,Other,0,0,0,0
142918801500000,NW 318,Residential,9000,52868,0,61868
142918801600000,NW 318,Residential,5000,0,0,5000
142918801700000,NW 318,Residential,5000,0,0,5000
142918801800000,NW 318,Residential,5000,0,0,5000
142918900100000,NW 318,Residential,6030,28099,0,34129
142918900200000,NW 318,Residential,5000,0,0,5000
142918900300000,NW 318,Residential,8550,0,0,8550
142918900400000,NW 318,Residential,5000,0,0,5000
142918900500000,CONVERSIONS,Commercial,34020,0,0,34020
142918900600000,COMM SW,Commercial,10000,0,0,10000
142918900700000,COMM SW,Commercial,9414,0,31584,40998
142918900702000,COMM SW,Commercial,0,0,8496,8496
142918900800000,Empty,Exempt,0,0,0,0
142918900900000,NW 318,Residential,6750,34928,0,41678
142918901000000,NW 318,Residential,5000,0,0,5000
142918901100000,NW 318,Residential,8460,18933,0,27393
142918901200000,NW 318,Residential,5569,25032,0,30601
142920100100000,E-10 COUNTY,Exempt,0,0,0,0
142920100200000,Empty,Exempt,0,0,0,0
142920100300000,CONVERSIONS,Commercial,8933,0,79606,88539
142920100400000,NW 311,Residential,16337,62004,0,78341
142920100500000,NW 311,Residential,16000,71398,0,87398
142920100600000,NW 311,Residential,16000,55039,0,71039
142920100700000,NW 311,Residential,16000,73050,0,89050
142920100800000,NW 311,Residential,16000,79140,0,95140
142920100900000,NW 311,Residential,16000,72938,0,88938
142920101000000,NW 311,Residential,16000,70396,0,86396
142920101100000,NW 311,Residential,16000,72302,0,88302
142920101200000,NW 311,Residential,16000,66986,0,82986
142920101300000,NW 311,Residential,16000,69415,0,85415
142920101400000,NW 311,Residential,16000,67334,0,83334
142920101500000,NW 311,Residential,16000,71736,0,87736
142920101600000,NW 311,Residential,15019,67968,0,82987
142920101700000,NW 311,Residential,14047,66863,0,80910
142920101800000,NW 311,Residential,9920,36988,0,46908
142920200100000,Empty,Exempt,0,0,0,0
142920300100000,NW 311,Residential,11200,83758,0,94958
142920300200000,NW 311,Residential,16000,82781,0,98781
142920300300000,NW 311,Residential,16000,72340,0,88340
142920300400000,Empty,Exempt,0,0,0,0
142920300500000,Empty,Exempt,0,0,0,0
142920300600000,Empty,Exempt,0,0,0,0
142920300700000,NW 311,Residential,16000,48483,0,64483
142920300800000,NW 311,Residential,16000,46093,0,62093
142920300900000,NW 311,Residential,16000,56763,0,72763
142920301000000,NW 311,Residential,16000,76537,0,92537
142920301100000,NW 311,Residential,16000,69882,0,85882
142920301200000,NW 311,Residential,20800,56162,0,76962
142920301300000,NW 311,Residential,14080,56010,0,70090
142920301400000,NW 311,Residential,14080,93064,0,107144
142920301500000,NW 311,Residential,12160,58167,0,70327
142920301600000,NW 311,Residential,16000,58285,0,74285
142920301700000,NW 311,Residential,16000,59093,0,75093
142920301800000,NW 311,Residential,12600,84894,0,97494
142920301900000,NW 311,Residential,12800,89674,0,102474
142920302000000,NW 311,Residential,12160,81368,0,93528
142920302100000,NW 311,Residential,13440,66640,0,80080
142920302200000,NW 311,Residential,13000,49564,0,62564
142920302300000,NW 311,Residential,17510,67594,0,85104
142920302400000,NW 311,Residential,11400,56455,0,67855
142920302500000,NW 311,Residential,16000,67972,0,83972
142920302600000,NW 311,Residential,16000,47033,0,63033
142920302700000,NW 311,Residential,16000,59039,0,75039
142920302800000,NW 311,Residential,16000,50283,0,66283
142920302900000,NW 311,Residential,16000,71434,0,87434
142920303000000,NW 311,Residential,20800,73081,0,93881
142920303100000,NW 311,Residential,11340,58088,0,69428
142920400100000,NW 311,Residential,16000,78211,0,94211
142920400200000,NW 311,Residential,10800,70853,0,81653
142920400300000,NW 311,Residential,11200,43836,0,55036
142920400400000,NW 311,Residential,15680,87879,0,103559
142920400500000,NW 311,Residential,15680,63761,0,79441
142920400600000,NW 311,Residential,15680,39746,0,55426
142920400700000,NW 311,Residential,16000,51895,0,67895
142920400800000,NW 311,Residential,16000,62823,0,78823
142920400900000,NW 311,Residential,16000,80292,0,96292
142920500100000,NW 311,Residential,13680,67986,0,81666
142920500200000,NW 311,Residential,11160,62469,0,73629
142920500300000,NW 311,Residential,14790,43547,0,58337
142920500400000,NW 311,Residential,15300,84082,0,99382
142920500500000,NW 311,Residential,15045,63795,0,78840
142920500600000,NW 311,Residential,16000,44555,0,60555
142920500700000,NW 311,Residential,18000,58713,0,76713
142920600100000,NW 320,Residential,16800,78932,0,95732
142920600200000,NW 320,Residential,16416,57147,0,73563
142920600300000,NW 320,Residential,13880,82813,0,96693
142920600400000,NW 320,Residential,11400,60473,0,71873
142920600500000,NW 320,Residential,16000,52990,0,68990
142920600600000,NW 320,Residential,16000,55882,0,71882
142920600700000,NW 320,Residential,16000,54162,0,70162
142920600800000,NW 320,Residential,16000,61489,0,77489
142920600900000,NW 320,Residential,16000,55065,0,71065
142920601000000,NW 320,Residential,16000,72173,0,88173
142920601100000,NW 320,Residential,16000,65930,0,81930
142920601200000,NW 320,Residential,16000,76388,0,92388
142920601300000,NW 320,Residential,14000,67778,0,81778
142920601400000,NW 320,Residential,16000,64578,0,80578
142920601500000,NW 320,Residential,16000,55464,0,71464
142920601600000,NW 320,Residential,16000,49843,0,65843
142922600100000,NW 320,Residential,25620,73289,0,98909
142922600200000,NW 320,Residential,26318,62886,0,89204
142922600300000,NW 320,Residential,22491,65577,0,88068
142922600400000,NW 320,Residential,29450,102106,0,131556
142922600500000,NW 320,Residential,18570,81407,0,99977
142922600600000,NW 320,Residential,18207,66731,0,84938
142922600700000,NW 320,Residential,17493,75999,0,93492
142922600800000,NW 320,Residential,29890,0,0,29890
142922600900000,NW 320,Residential,29890,86274,0,116164
142922601000000,NW 320,Residential,17325,43019,0,60344
142922601100000,NW 320,Residential,18900,61263,0,80163
142922601200000,NW 320,Residential,28175,112969,0,141144
142922601300000,NW 320,Residential,18725,87069,0,105794
142922601400000,NW 320,Residential,19474,136099,0,155573
142922601500000,NW 320,Residential,21221,92563,0,113784
142922601600000,NW 320,Residential,21168,82942,0,104110
142922601700000,NW 320,Residential,21221,94841,0,116062
142922601800000,NW 320,Residential,24547,77385,0,101932
142922601900000,NW 320,Residential,24723,78894,0,103617
142922602000000,NW 320,Residential,25135,93872,0,119007
142922602100000,NW 320,Residential,50800,127405,0,178205
142922602200000,Empty,Exempt,0,0,0,0
142922602300000,NW 320,Residential,24225,92302,0,116527
142922602400000,NW 320,Residential,24939,112289,0,137228
142922602500000,NW 320,Residential,25529,105303,0,130832
142922602600000,NW 320,Residential,20143,71731,0,91874
142922602700000,NW 320,Residential,24200,107029,0,131229
142922602800000,NW 320,Residential,24200,74103,0,98303
142922602900000,NW 320,Residential,24200,99249,0,123449
142922603000000,NW 320,Residential,24200,107336,0,131536
142922603100000,NW 320,Residential,51050,122482,0,173532
142922603200000,NW 320,Residential,50800,124055,0,174855
142922603300000,NW 320,Residential,50000,112786,0,162786
142922603400000,NW 320,Residential,26400,108359,0,134759
142922603500000,NW 320,Residential,27000,112000,0,139000
142922603600000,NW 320,Residential,24600,89567,0,114167
142922603700000,NW 320,Residential,31365,95607,0,126972
142922603800000,NW 320,Residential,31365,82666,0,114031
142922603900000,NW 320,Residential,26840,74947,0,101787
142922604000000,NW 320,Residential,51750,85075,0,136825
142922604100000,NW 320,Residential,30110,68036,0,98146
142922604200000,NW 320,Residential,30110,81787,0,111897
142922604300000,NW 320,Residential,30640,57920,0,88560
142922700100000,NW 320,Residential,19227,80488,0,99715
142922700200000,NW 320,Residential,16000,63997,0,79997
142922700300000,NW 320,Residential,16000,61024,0,77024
142922700400000,NW 320,Residential,16000,49951,0,65951
142922700500000,NW 320,Residential,16000,53016,0,69016
142922700600000,NW 320,Residential,18816,71425,0,90241
142922700700000,NW 320,Residential,11760,68587,0,80347
142922700800000,NW 320,Residential,11620,62412,0,74032
142922700900000,NW 320,Residential,11060,70412,0,81472
142922701000000,NW 320,Residential,18590,82432,0,101022
142922701100000,NW 320,Residential,14800,78979,0,93779
142922701200000,NW 320,Residential,16000,63865,0,79865
142922701300000,NW 320,Residential,16000,78653,0,94653
142922701400000,NW 320,Residential,16000,74496,0,90496
142922701500000,NW 320,Residential,16000,63020,0,79020
142922701600000,NW 320,Residential,14728,61964,0,76692
142922701700000,NW 320,Residential,12000,42125,0,54125
142922800100000,NW 320,Residential,21905,75950,0,97855
142922800200000,NW 320,Residential,16000,65976,0,81976
142922800300000,NW 320,Residential,14000,71954,0,85954
142922800400000,NW 320,Residential,16000,86947,0,102947
142922800500000,NW 320,Residential,16000,80339,0,96339
142922800600000,NW 320,Residential,14000,85682,0,99682
142922800700000,NW 320,Residential,16000,69370,0,85370
142922800800000,NW 320,Residential,16000,73432,0,89432
142922800900000,NW 320,Residential,20240,109559,0,129799
142922801000000,NW 320,Residential,21480,57647,0,79127
142922801100000,NW 320,Residential,16000,45967,0,61967
142922801200000,NW 320,Residential,16000,44327,0,60327
142922801300000,NW 320,Residential,14000,82180,0,96180
142922801400000,NW 320,Residential,16000,82000,0,98000
142922801500000,NW 320,Residential,16000,57603,0,73603
142922801600000,NW 320,Residential,14000,65037,0,79037
142922801700000,NW 320,Residential,16000,74227,0,90227
142922801800000,NW 320,Residential,14080,77319,0,91399
142922801900000,NW 320,Residential,18660,84386,0,103046
142922802000000,NW 320,Residential,13440,68002,0,81442
142922802100000,NW 320,Residential,9240,51972,0,61212
142922900100000,NW 320,Residential,21500,114057,0,135557
142922900200000,NW 320,Residential,16000,66369,0,82369
142922900300000,NW 320,Residential,16000,22379,0,38379
142922900400000,NW 320,Residential,16000,68858,0,84858
142922900500000,NW 320,Residential,16000,100071,0,116071
142922900600000,NW 320,Residential,16000,52312,0,68312
142922900700000,NW 320,Residential,16000,85878,0,101878
142922900800000,NW 320,Residential,16000,70125,0,86125
142922900900000,NW 320,Residential,16000,77828,0,93828
142922901000000,NW 320,Residential,21133,79250,0,100383
142922901100000,NW 320,Residential,20210,45509,0,65719
142922901200000,COMM NW,Commercial,14124,0,34789,48913
142922901300000,COMM NW,Commercial,14548,0,27429,41977
142922901400000,NW 320,Residential,16000,72959,0,88959
142922901500000,NW 320,Residential,16000,78725,0,94725
142922901600000,NW 320,Residential,16000,59587,0,75587
142922901700000,NW 320,Residential,16000,80178,0,96178
142922901800000,NW 320,Residential,16000,51199,0,67199
142922901900000,NW 320,Residential,16000,70207,0,86207
142922902000000,NW 320,Residential,16000,66137,0,82137
142922902100000,NW 320,Residential,15443,51091,0,66534
142922902200000,NW 320,Residential,13440,63778,0,77218
142923000100000,NW 320,Residential,19600,84520,0,104120
142923000200000,NW 320,Residential,19880,59179,0,79059
142923000300000,NW 320,Residential,19320,79301,0,98621
142923000400000,NW 320,Residential,19320,77116,0,96436
142923000500000,NW 320,Residential,16000,81157,0,97157
142923000600000,NW 320,Residential,16000,68686,0,84686
142923000700000,NW 320,Residential,16000,62189,0,78189
142923000800000,NW 320,Residential,16000,74799,0,90799
142923100100000,NW 320,Residential,19727,72620,0,92347
142923100200000,NW 320,Residential,19852,70823,0,90675
142923100300000,NW 320,Residential,16000,84098,0,100098
142923100400000,NW 320,Residential,16000,68326,0,84326
142923100500000,NW 320,Residential,15200,76647,0,91847
142923100600000,NW 320,Residential,16000,76911,0,92911
142923100700000,NW 320,Residential,16000,55022,0,71022
142923100800000,NW 320,Residential,15200,66010,0,81210
142923100900000,NW 320,Residential,16000,76551,0,92551
142923101000000,NW 320,Residential,16000,61816,0,77816
142923101100000,NW 320,Residential,15776,59019,0,74795
142923101200000,NW 320,Residential,17100,65710,0,82810
142923101300000,NW 320,Residential,15660,65395,0,81055
142923101400000,NW 320,Residential,20550,75471,0,96021
142923101500000,NW 320,Residential,13069,58105,0,71174
142923101600000,NW 320,Residential,15008,85327,0,100335
142923101700000,NW 320,Residential,17275,97149,0,114424
142923101800000,NW 320,Residential,17920,99927,0,117847
142923200100000,COMM NW,Commercial,11858,0,31348,43206
142923200200000,Empty,Other,0,0,0,0
142923200300000,COMM NW,Commercial,9684,0,16062,25746
142923200400000,E-70 CHARITY OTHER,Exempt,16848,0,175697,192545
142923200500000,E-70 CHARITY OTHER,Exempt,24002,0,3672,27674
142925100100000,NW 320,Residential,16000,58228,0,74228
142925100200000,NW 320,Residential,16000,99862,0,115862
142925100300000,NW 320,Residential,16000,83338,0,99338
142925100400000,NW 320,Residential,19740,91914,0,111654
142925100500000,NW 320,Residential,20160,110594,0,130754
142925100600000,NW 320,Residential,19320,69725,0,89045
142925100700000,NW 320,Residential,19600,83080,0,102680
142925100800000,NW 320,Residential,16000,66269,0,82269
142925200100000,NW 320,Residential,19292,87091,0,106383
142925200200000,NW 320,Residential,19600,109950,0,129550
142925200300000,NW 320,Residential,16000,83389,0,99389
142925200400000,NW 320,Residential,16000,85136,0,101136
142925200500000,NW 320,Residential,16000,99307,0,115307
142925200600000,NW 320,Residential,16000,87531,0,103531
142925200700000,NW 320,Residential,16000,66022,0,82022
142925200800000,NW 320,Residential,16000,81056,0,97056
142925200900000,NW 320,Residential,16000,69502,0,85502
142925201000000,NW 320,Residential,16373,71171,0,87544
142925201100000,NW 320,Residential,21798,102309,0,124107
142925201200000,NW 320,Residential,20242,72411,0,92653
142925201300000,NW 320,Residential,18576,54704,0,73280
142925300100000,NW 320,Residential,21006,70130,0,91136
142925300200000,COMM NW,Commercial,19907,0,64827,84734
142925300300000,NW 320,Residential,20680,62261,0,82941
142925300400000,NW 320,Residential,19980,80050,0,100030
142925300500000,NW 320,Residential,20513,76773,0,97286
142925300600000,NW 320,Residential,19980,89540,0,109520
142925300700000,NW 320,Residential,20160,86343,0,106503
142925300800000,NW 320,Residential,20160,77127,0,97287
142925300900000,NW 320,Residential,20160,81050,0,101210
142925301000000,NW 320,Residential,18080,85525,0,103605
142925301100000,NW 320,Residential,20340,85817,0,106157
142925301200000,NW 320,Residential,20340,96771,0,117111
142925301300000,NW 320,Residential,20520,67968,0,88488
142925301400000,NW 320,Residential,20520,94220,0,114740
142925301500000,NW 320,Residential,20520,64356,0,84876
142925301600000,NW 320,Residential,19000,62289,0,81289
142925301700000,NW 320,Residential,19206,84455,0,103661
142925301800000,NW 320,Residential,21295,81772,0,103067
142925301900000,NW 320,Residential,20520,99910,0,120430
142925302000000,NW 320,Residential,22942,108933,0,131875
142925302100000,NW 320,Residential,42760,143921,0,186681
142925302200000,NW 320,Residential,20794,146940,0,167734
142925302300000,NW 320,Residential,20700,106830,0,127530
142925302400000,NW 320,Residential,21059,111701,0,132760
142925302500000,NW 320,Residential,20875,107701,0,128576
142925302600000,NW 320,Residential,20689,102742,0,123431
142925302700000,NW 320,Residential,20646,87399,0,108045
142925302800000,NW 320,Residential,20646,95987,0,116633
142925302900000,NW 320,Residential,20274,103075,0,123349
142925303000000,NW 320,Residential,20088,89970,0,110058
142925303100000,NW 320,Residential,19970,93876,0,113846
142925303200000,NW 320,Residential,20216,68061,0,88277
142925303300000,NW 320,Residential,20107,124888,0,144995
142925303400000,NW 320,Residential,18988,71704,0,90692
142925303500000,NW 320,Residential,19072,48958,0,68030
142925303600000,NW 320,Residential,20517,31422,0,51939
142925400100000,NW 320,Residential,17031,56865,0,73896
142925400200000,NW 320,Residential,19379,74911,0,94290
142925400300000,NW 320,Residential,18600,71188,0,89788
142925400400000,NW 320,Residential,17211,57789,0,75000
142925400500000,NW 320,Residential,16640,64645,0,81285
142925400600000,NW 320,Residential,13860,113983,0,127843
142925400700000,NW 320,Residential,14416,74511,0,88927
142925400800000,NW 320,Residential,13860,66664,0,80524
142925400900000,NW 320,Residential,18720,103866,0,122586
142925401000000,NW 320,Residential,19180,83703,0,102883
142925401100000,NW 320,Residential,13872,81835,0,95707
142925401200000,NW 320,Residential,13332,79815,0,93147
142925401300000,NW 320,Residential,13068,85845,0,98913
142925401400000,NW 320,Residential,19025,81435,0,100460
142925401500000,NW 320,Residential,11480,89700,0,101180
142925401600000,NW 320,Residential,13500,88001,0,101501
142925401700000,NW 320,Residential,18848,99193,0,118041
142925401800000,NW 320,Residential,19151,103702,0,122853
142925401900000,NW 320,Residential,17520,92934,0,110454
142925402000000,NW 320,Residential,12221,49506,0,61727
142925402100000,NW 320,Residential,12703,89160,0,101863
142925402200000,NW 320,Residential,17820,89817,0,107637
142925402300000,NW 320,Residential,13350,100850,0,114200
142925402400000,NW 320,Residential,13950,44309,0,58259
142925402500000,NW 320,Residential,19400,85832,0,105232
142925402600000,NW 320,Residential,18176,83458,0,101634
142925402700000,NW 320,Residential,18180,94022,0,112202
142925402800000,NW 320,Residential,18887,79674,0,98561
142925402900000,NW 320,Residential,18000,65263,0,83263
142925403000000,NW 320,Residential,18000,74251,0,92251
142925403100000,NW 320,Residential,13646,83436,0,97082
142925500100000,NW 320,Residential,21294,82552,0,103846
142925500200000,NW 320,Residential,19754,102285,0,122039
142925500300000,NW 320,Residential,11200,71712,0,82912
142925500400000,NW 320,Residential,18880,70567,0,89447
142925500500000,NW 320,Residential,15040,79283,0,94323
142925500600000,NW 320,Residential,22670,101206,0,123876
142925500700000,NW 320,Residential,18744,101767,0,120511
142925500800000,NW 320,Residential,19215,123854,0,143069
142925500900000,NW 320,Residential,19221,98183,0,117404
142925501000000,NW 320,Residential,17709,81502,0,99211
142925501100000,NW 320,Residential,19581,82109,0,101690
142925501200000,NW 320,Residential,19207,101977,0,121184
142925501300000,NW 320,Residential,19094,90205,0,109299
142925501400000,NW 320,Residential,21120,73088,0,94208
142925501500000,NW 320,Residential,20886,69173,0,90059
142925501600000,NW 320,Residential,19669,81085,0,100754
142925501700000,NW 320,Residential,19400,67524,0,86924
142925501800000,NW 320,Residential,17820,79934,0,97754
142925501900000,NW 320,Residential,18000,89848,0,107848
142925502000000,NW 320,Residential,18000,65455,0,83455
142925502100000,NW 320,Residential,25200,118600,0,143800
142925502200000,NW 320,Residential,13320,63403,0,76723
142925502300000,NW 320,Residential,13080,65856,0,78936
142925502400000,NW 320,Residential,18360,106817,0,125177
142925502500000,NW 320,Residential,19080,73722,0,92802
142925502600000,NW 320,Residential,16640,83049,0,99689
142925502700000,NW 320,Residential,21634,113642,0,135276
142925502800000,NW 320,Residential,18727,108206,0,126933
142925502900000,NW 320,Residential,18720,91799,0,110519
142925503000000,NW 320,Residential,19179,111608,0,130787
142925503100000,NW 320,Residential,19360,74015,0,93375
142925600100000,Empty,Exempt,0,0,0,0
142925700100000,E-40 CHURCHES,Exempt,437400,0,427186,864586
142925700400000,NW 320,Residential,26928,140202,0,167130
142925700500000,COMM NW,Commercial,48600,0,125468,174068
142925800100000,NW 320,Residential,18000,100656,0,118656
142925800200000,NW 320,Residential,14140,91832,0,105972
142925800300000,NW 320,Residential,12240,107429,0,119669
142925800400000,NW 320,Residential,14420,105225,0,119645
142925800500000,NW 320,Residential,18720,119973,0,138693
142925800600000,NW 320,Residential,18720,93622,0,112342
142925800700000,NW 320,Residential,18720,82749,0,101469
142925800800000,NW 320,Residential,17860,85560,0,103420
142925800900000,NW 320,Residential,8640,66555,0,75195
142925801000000,NW 320,Residential,17820,92852,0,110672
142925801100000,NW 320,Residential,18000,95147,0,113147
142925801200000,NW 320,Residential,18000,96904,0,114904
142925801300000,NW 320,Residential,18000,91871,0,109871
142925801400000,NW 320,Residential,18000,85082,0,103082
142925801500000,NW 320,Residential,18000,83083,0,101083
142925801600000,NW 320,Residential,18000,113594,0,131594
142925900100000,NW 320,Residential,18180,74431,0,92611
142925900200000,NW 320,Residential,17820,74466,0,92286
142925900300000,NW 320,Residential,17820,73813,0,91633
142925900400000,NW 320,Residential,17820,68514,0,86334
142925900500000,NW 320,Residential,17820,79495,0,97315
142925900600000,NW 320,Residential,17820,75110,0,92930
142925900700000,NW 320,Residential,17000,60539,0,77539
142925900800000,NW 320,Residential,17719,62794,0,80513
142925900900000,NW 320,Residential,14400,54412,0,68812
142925901000000,NW 320,Residential,18651,107471,0,126122
142925901100000,NW 320,Residential,17820,102745,0,120565
142925901200000,NW 320,Residential,17820,72784,0,90604
142925901300000,NW 320,Residential,17820,74965,0,92785
142925901400000,NW 320,Residential,17820,77340,0,95160
142925901500000,NW 320,Residential,17820,88237,0,106057
142925901600000,NW 320,Residential,17820,51533,0,69353
142925901700000,NW 320,Residential,17755,80577,0,98332
142927600100000,NW 311,Residential,15600,60964,0,76564
142927600200000,NW 311,Residential,16072,76795,0,92867
142927600300000,NW 311,Residential,13720,64855,0,78575
142927600400000,NW 311,Residential,19339,88413,0,107752
142927600500000,NW 311,Residential,15840,84807,0,100647
142927600600000,NW 311,Residential,16000,87269,0,103269
142927600700000,NW 311,Residential,16429,73474,0,89903
142927600800000,NW 311,Residential,16320,62123,0,78443
142927600900000,NW 311,Residential,17996,107219,0,125215
142927601000000,NW 311,Residential,17654,44203,0,61857
142927601100000,NW 311,Residential,16394,53241,0,69635
142927601200000,NW 311,Residential,20000,55582,0,75582
142927601300000,NW 311,Residential,20000,84145,0,104145
142927601400000,NW 311,Residential,20000,54186,0,74186
142927601500000,NW 311,Residential,20000,60373,0,80373
142927601600000,NW 311,Residential,16000,66121,0,82121
142927601700000,NW 311,Residential,16320,68107,0,84427
142927601800000,NW 311,Residential,16320,70138,0,86458
142927601900000,NW 311,Residential,16025,77551,0,93576
142927602000000,NW 311,Residential,15867,87529,0,103396
142927602100000,NW 311,Residential,15840,63971,0,79811
142927602200000,NW 311,Residential,16415,76987,0,93402
142927602300000,NW 311,Residential,14800,67305,0,82105
142927700100000,NW 311,Residential,16400,76690,0,93090
142927700200000,NW 311,Residential,15045,76152,0,91197
142927700300000,NW 311,Residential,13760,74885,0,88645
142927700400000,NW 311,Residential,14400,71180,0,85580
142927700500000,NW 311,Residential,15200,66926,0,82126
142927700600000,NW 311,Residential,14720,84698,0,99418
142927700700000,NW 311,Residential,15520,69581,0,85101
142927700800000,NW 311,Residential,15840,56992,0,72832
142927700900000,NW 311,Residential,20000,65511,0,85511
142927701000000,NW 311,Residential,20000,87764,0,107764
142927701100000,NW 311,Residential,20000,78349,0,98349
142927701200000,NW 311,Residential,20000,81093,0,101093
142927701300000,NW 311,Residential,20450,66018,0,86468
142927701400000,COMM NW,Commercial,68040,0,1095619,1163659
142927701500000,NW 311,Residential,15667,55174,0,70841
142927701600000,NW 311,Residential,12000,55136,0,67136
142927701700000,NW 311,Residential,20000,75820,0,95820
142927701800000,NW 311,Residential,21600,90468,0,112068
142927701900000,NW 311,Residential,18045,66604,0,84649
142927702000000,NW 311,Residential,16281,62795,0,79076
142927702100000,NW 311,Residential,16281,101054,0,117335
142927702200000,NW 311,Residential,16281,82088,0,98369
142927702300000,NW 311,Residential,16116,76662,0,92778
142927702400000,NW 311,Residential,16116,71825,0,87941
142927702500000,NW 311,Residential,14000,69877,0,83877
142927800100000,NW 320,Residential,16000,75077,0,91077
142927800200000,NW 320,Residential,16000,72169,0,88169
142927800300000,NW 320,Residential,16000,68266,0,84266
142927800400000,NW 320,Residential,16000,40917,0,56917
142927800500000,NW 320,Residential,16000,48004,0,64004
142927800600000,NW 320,Residential,16000,81463,0,97463
142927800700000,NW 320,Residential,16000,56117,0,72117
142927800800000,NW 320,Residential,16000,81121,0,97121
142927800900000,NW 320,Residential,16000,77726,0,93726
142927801000000,NW 320,Residential,16000,58567,0,74567
142927801100000,NW 320,Residential,16000,69489,0,85489
142927801200000,NW 320,Residential,14000,58170,0,72170
142927801300000,NW 320,Residential,16000,59569,0,75569
142927801400000,NW 320,Residential,13552,83060,0,96612
142927801500000,NW 320,Residential,15272,73008,0,88280
142927801600000,NW 320,Residential,10200,61756,0,71956
142927900100000,NW 320,Residential,22400,107270,0,129670
142927900200000,NW 320,Residential,16000,68410,0,84410
142927900300000,NW 320,Residential,16000,56454,0,72454
142927900400000,NW 320,Residential,16000,69262,0,85262
142927900500000,NW 320,Residential,16000,83183,0,99183
142927900600000,NW 320,Residential,16000,72554,0,88554
142927900700000,NW 320,Residential,16000,67387,0,83387
142927900800000,NW 320,Residential,16000,82952,0,98952
142927900900000,NW 320,Residential,16000,75465,0,91465
142927901000000,NW 320,Residential,16000,91161,0,107161
142927901100000,NW 320,Residential,15600,55708,0,71308
142927901200000,NW 320,Residential,14400,63175,0,77575
142927901300000,NW 320,Residential,16000,69185,0,85185
142927901400000,NW 320,Residential,11200,53076,0,64276
142927901500000,NW 320,Residential,11200,67474,0,78674
142927901600000,NW 320,Residential,16000,74382,0,90382
142927901700000,NW 320,Residential,16000,93402,0,109402
142927901800000,NW 320,Residential,16000,87265,0,103265
142927901900000,NW 320,Residential,14000,88687,0,102687
142927902000000,NW 320,Residential,16000,85246,0,101246
142927902100000,NW 320,Residential,16000,88816,0,104816
142927902200000,NW 320,Residential,16000,82698,0,98698
142927902300000,NW 320,Residential,16000,94061,0,110061
142927902400000,NW 320,Residential,16000,89287,0,105287
142927902500000,NW 320,Residential,16000,67895,0,83895
142927902600000,NW 320,Residential,16000,114862,0,130862
142927902700000,NW 320,Residential,16000,54380,0,70380
142927902800000,NW 320,Residential,16000,96327,0,112327
142927902900000,NW 320,Residential,16000,70589,0,86589
142927903000000,NW 320,Residential,16000,96878,0,112878
142928000100000,NW 320,Residential,16649,49434,0,66083
142928000200000,NW 320,Residential,18156,96117,0,114273
142928000300000,NW 320,Residential,15520,78001,0,93521
142928000400000,NW 320,Residential,16000,53764,0,69764
142928000500000,NW 320,Residential,16000,91383,0,107383
142928000600000,NW 320,Residential,16000,109905,0,125905
142928000700000,NW 320,Residential,16000,89800,0,105800
142928000800000,NW 320,Residential,16000,87485,0,103485
142928000900000,NW 320,Residential,16000,61291,0,77291
142928001000000,NW 320,Residential,16000,74987,0,90987
142928001100000,NW 320,Residential,22500,115230,0,137730
142928001200000,NW 320,Residential,13600,57752,0,71352
142928001300000,NW 320,Residential,16920,83823,0,100743
142928001400000,COMM NW,Commercial,7309,0,49467,56776
142928001500000,NW 320,Residential,18400,105335,0,123735
142928001600000,NW 320,Residential,18000,80595,0,98595
142928001700000,NW 320,Residential,18000,109855,0,127855
142928001800000,NW 320,Residential,18000,96960,0,114960
142928001900000,NW 320,Residential,18000,103270,0,121270
142928002000000,NW 320,Residential,13335,67392,0,80727
142928002100000,NW 320,Residential,13335,84509,0,97844
142928002200000,NW 320,Residential,13335,67393,0,80728
142928002300000,CONVERSIONS,Commercial,9072,0,79941,89013
142928002400000,NW 320,Residential,22027,77650,0,99677
142928002500000,NW 320,Residential,18000,83105,0,101105
142928002600000,NW 320,Residential,18000,81135,0,99135
142928002700000,NW 320,Residential,20000,128277,0,148277
142928002800000,NW 320,Residential,18000,106400,0,124400
142928100100000,NW 311,Residential,20400,82650,0,103050
142928100200000,NW 311,Residential,17600,61415,0,79015
142928100300000,NW 311,Residential,17600,139328,0,156928
142928100400000,NW 311,Residential,17600,83967,0,101567
142928100500000,NW 311,Residential,24480,138359,0,162839
142928100600000,NW 311,Residential,20400,93302,0,113702
142928200100000,NW 311,Residential,17600,91319,0,108919
142928200200000,NW 311,Residential,20400,81117,0,101517
142928200300000,NW 311,Residential,16000,73246,0,89246
142928200400000,NW 311,Residential,12000,67278,0,79278
142928200500000,NW 311,Residential,10640,60697,0,71337
142928200600000,NW 311,Residential,10640,70666,0,81306
142928200700000,NW 311,Residential,21280,90212,0,111492
142928200800000,NW 311,Residential,20400,151234,0,171634
142928200900000,NW 311,Residential,20400,110976,0,131376
142928201000000,NW 311,Residential,20400,76017,0,96417
142928201100000,CONVERSIONS,Commercial,15138,0,94742,109880
142928201200000,NW 311,Residential,16320,88841,0,105161
142928201300000,NW 311,Residential,17600,89596,0,107196
142928201400000,NW 311,Residential,17600,85107,0,102707
142928300100000,NW 320,Residential,24000,63057,0,87057
142928300200000,NW 320,Residential,16000,83233,0,99233
142928300300000,NW 320,Residential,20000,110285,0,130285
142928300400000,NW 320,Residential,20000,109699,0,129699
142928300500000,NW 320,Residential,20000,103879,0,123879
142928300600000,NW 320,Residential,9240,68762,0,78002
142928300700000,NW 320,Residential,10223,48794,0,59017
142928300800000,NW 320,Residential,11900,49712,0,61612
142928300900000,NW 320,Residential,11760,51913,0,63673
142928301000000,NW 320,Residential,6480,55225,0,61705
142928301100000,NW 320,Residential,6480,47270,0,53750
142928301200000,NW 320,Residential,15200,66838,0,82038
142928301300000,NW 320,Residential,27588,85778,0,113366
142928301400000,NW 320,Residential,20000,104806,0,124806
142928301500000,CONVERSIONS,Commercial,11340,0,65988,77328
142928301600000,NW 320,Residential,20000,106433,0,126433
142928301700000,NW 320,Residential,24800,128301,0,153101
142928301800000,CONVERSIONS,Commercial,14969,0,101640,116609
142928400100000,NW 320,Residential,24000,111000,0,135000
142928400200000,NW 320,Residential,18000,110754,0,128754
142928400300000,NW 320,Residential,18000,77842,0,95842
142928400400000,NW 320,Residential,18000,77249,0,95249
142928400500000,NW 320,Residential,18000,74900,0,92900
142928400600000,NW 320,Residential,11872,74675,0,86547
142928400700000,NW 320,Residential,17792,76514,0,94306
142928400800000,NW 320,Residential,10640,66661,0,77301
142928401200000,NW 320,Residential,13860,68568,0,82428
142928401300000,NW 320,Residential,14000,62009,0,76009
142928401400000,NW 320,Residential,18000,78973,0,96973
142928401500000,NW 320,Residential,18000,69144,0,87144
142928401600000,NW 320,Residential,18000,79048,0,97048
142928401700000,NW 320,Residential,16600,50562,0,67162
142928401800000,NW 320,Residential,10800,54880,0,65680
142928401900000,NW 320,Residential,32566,58754,0,91320
142928500100000,NW 311,Residential,20000,98415,0,118415
142928500200000,COMM SW,Commercial,180360,0,384402,564762
142928500300000,Empty,Exempt,0,0,0,0
142930100100000,E-46 RELIG PARKING,Exempt,14580,0,5183,19763
142930100200000,SW 404,Residential,15480,48381,0,63861
142930100300000,SW 404,Residential,15790,65656,0,81446
142930100400000,E-46 RELIG PARKING,Exempt,22005,0,3791,25796
142930100500000,SW 404,Residential,24750,63055,0,87805
142930100600000,SW 404,Residential,22275,52765,0,75040
142930100700000,SW 404,Residential,24008,65608,0,89616
142930101000000,SW 404,Residential,25740,57553,0,83293
142930101100000,SW 404,Residential,25965,69008,0,94973
142930101200000,SW 404,Residential,23100,57097,0,80197
142930101300000,SW 404,Residential,21000,68902,0,89902
142930101400000,SW 404,Residential,22275,57814,0,80089
142930101500000,SW 404,Residential,25097,71743,0,96840
142930200100000,SW 404,Residential,18176,101119,0,119295
142930200200000,SW 404,Residential,17820,81699,0,99519
142930200300000,SW 404,Residential,17820,111833,0,129653
142930200400000,SW 404,Residential,23364,66628,0,89992
142930200500000,SW 404,Residential,18880,103098,0,121978
142930200600000,SW 404,Residential,18880,88470,0,107350
142930200700000,SW 404,Residential,18880,94460,0,113340
142930200900000,SW 404,Residential,20400,74972,0,95372
142930201000000,SW 404,Exempt,22560,0,0,22560
142930201100000,SW 404,Residential,23250,68459,0,91709
142930201200000,SW 404,Residential,27720,56986,0,84706
142930201300000,SW 404,Residential,19800,64449,0,84249
142930201400000,SW 404,Residential,24750,64735,0,89485
142930201500000,CONVERSIONS,Commercial,15989,0,55669,71658
142930201600000,SW 404,Residential,2068,2497,0,4565
142930300100000,E-47 RELIG OTHER,Exempt,3375,0,0,3375
142930300200000,E-40 CHURCHES,Exempt,193050,0,755998,949048
142930300300000,SW 404,Residential,23100,107160,0,130260
142930300400000,SW 404,Residential,22620,71082,0,93702
142930300600000,SW 404,Residential,18800,69520,0,88320
142930300700000,SW 404,Residential,22320,93720,0,116040
142930300800000,SW 404,Residential,22491,78493,0,100984
142930300900000,SW 404,Residential,22491,88919,0,111410
142930301001000,CONDO 500,Residential,5000,44611,0,49611
142930301001001,CONDO 500,Residential,5000,42437,0,47437
142930301001002,CONDO 500,Residential,5000,44611,0,49611
142930301001003,CONDO 500,Residential,5000,42437,0,47437
142930301001004,CONDO 500,Residential,5000,44611,0,49611
142930301001005,CONDO 500,Residential,5000,42437,0,47437
142930301001006,CONDO 500,Residential,5000,42437,0,47437
142930301001007,CONDO 500,Residential,5000,42437,0,47437
142930301001008,CONDO 500,Residential,5000,42437,0,47437
142930301001009,CONDO 500,Residential,5000,42437,0,47437
142930301001010,CONDO 500,Residential,5000,42437,0,47437
142930301001011,CONDO 500,Residential,5000,42437,0,47437
142930301100000,APTS SW,Commercial,15237,0,118891,134128
142930400100000,SW 404,Residential,23760,74334,0,98094
142930400200000,SW 404,Residential,23760,76590,0,100350
142930400300000,SW 404,Residential,23760,69737,0,93497
142930400400000,SW 404,Residential,23760,94111,0,117871
142930400500000,SW 404,Residential,19800,57431,0,77231
142930400600000,SW 404,Residential,19800,77865,0,97665
142930400700000,E-43 RELIG RECREAT'N,Exempt,87739,0,0,87739
142930500100000,E-41 RELIG SCHOOLS,Exempt,272592,0,1060748,1333340
142930500200000,SW 404,Residential,26136,86387,0,112523
142930500300000,SW 404,Residential,24839,130913,0,155752
142930500400000,SW 404,Residential,20304,76241,0,96545
142930500500000,SW 404,Residential,20304,71324,0,91628
142930500600000,SW 404,Residential,24365,84373,0,108738
142930500700000,SW 404,Residential,20304,98261,0,118565
142930500800000,SW 404,Residential,26750,66348,0,93098
142930500900000,SW 404,Residential,26136,119226,0,145362
142930600100000,Empty,Exempt,0,0,0,0
142932600100000,Empty,Exempt,0,0,0,0
142932600200000,SW 405,Residential,20221,80890,0,101111
142932600300000,SW 405,Residential,20583,104387,0,124970
142932600400000,SW 405,Residential,24651,67523,0,92174
142932600500000,SW 405,Residential,23562,80600,0,104162
142932600600000,SW 405,Residential,23562,80896,0,104458
142932600700000,SW 405,Residential,23562,94437,0,117999
142932600800000,SW 405,Residential,23562,80994,0,104556
142932600900000,SW 405,Residential,23562,61441,0,85003
142932601000000,SW 405,Residential,22440,60543,0,82983
142932601100000,SW 405,Residential,22440,52981,0,75421
142932601200000,SW 405,Residential,22440,63842,0,86282
142932601300000,SW 405,Residential,22440,56539,0,78979
142932601400000,SW 405,Residential,22440,57998,0,80438
142932601500000,SW 405,Residential,25049,109969,0,135018
142932700100000,SW 405,Residential,24067,109045,0,133112
142932700200000,SW 405,Residential,19400,120994,0,140394
142932700300000,SW 405,Residential,19400,69978,0,89378
142932700400000,SW 405,Residential,19400,55279,0,74679
142932700500000,SW 405,Residential,19400,49567,0,68967
142932700600000,SW 405,Residential,23292,88680,0,111972
142932700700000,SW 405,Residential,29353,69759,0,99112
142932700800000,SW 405,Residential,28211,66397,0,94608
142932700900000,SW 405,Residential,27500,63341,0,90841
142932701000000,SW 405,Residential,26950,58093,0,85043
142932701100000,SW 405,Residential,26675,69635,0,96310
142932701200000,SW 405,Residential,26675,74065,0,100740
142932701300000,SW 405,Residential,26675,64663,0,91338
142932701400000,SW 405,Residential,26675,60575,0,87250
142932701500000,SW 405,Residential,27013,76638,0,103651
142932701600000,SW 405,Residential,25049,60368,0,85417
142932701700000,SW 405,Residential,22440,68315,0,90755
142932701800000,SW 405,Residential,22440,62057,0,84497
142932701900000,SW 405,Residential,22440,84166,0,106606
142932702000000,SW 405,Residential,22440,70128,0,92568
142932702100000,SW 405,Residential,22440,93222,0,115662
142932702200000,SW 405,Residential,23562,85418,0,108980
142932702300000,SW 405,Residential,23562,74959,0,98521
142932702400000,SW 405,Residential,23562,61155,0,84717
142932702500000,SW 405,Residential,23562,76390,0,99952
142932702600000,SW 405,Residential,23562,67102,0,90664
142932702700000,SW 405,Residential,25245,86937,0,112182
142932800100000,SW 405,Residential,32448,63081,0,95529
142932900100000,SW 405,Residential,28133,67523,0,95656
142932900200000,SW 405,Residential,27209,91299,0,118508
142932900300000,SW 405,Residential,29216,85435,0,114651
142932900400000,SW 405,Residential,26675,49443,0,76118
142932900500000,SW 405,Residential,26950,76207,0,103157
142932900600000,SW 405,Residential,26609,64072,0,90681
142933000100000,SW 405,Residential,26160,102280,0,128440
142933000200000,SW 405,Residential,28362,123427,0,151789
142933000300000,SW 405,Residential,28499,102316,0,130815
142933000400000,SW 405,Residential,25792,94670,0,120462
142933000500000,SW 405,Residential,19454,79229,0,98683
142933000600000,SW 405,Residential,27851,94563,0,122414
142933000700000,SW 405,Residential,24235,54537,0,78772
142933000800000,SW 405,Residential,23562,66984,0,90546
142933000900000,SW 405,Residential,23562,59130,0,82692
142933001000000,SW 405,Residential,32089,97220,0,129309
142933001100000,SW 405,Residential,24684,66102,0,90786
142933001200000,SW 405,Residential,20680,75153,0,95833
142933001300000,SW 405,Residential,21056,100988,0,122044
142933001400000,SW 405,Residential,23280,85673,0,108953
142933001500000,SW 405,Residential,23280,74275,0,97555
142933001600000,SW 405,Residential,21922,69357,0,91279
142933001700000,SW 405,Residential,21922,83978,0,105900
142933001800000,SW 405,Residential,23280,105571,0,128851
142933001900000,SW 405,Residential,20295,96027,0,116322
142933002000000,SW 405,Residential,25300,105674,0,130974
142933002100000,SW 405,Residential,22320,97516,0,119836
142933002200000,SW 405,Residential,23280,71158,0,94438
142933002300000,SW 405,Residential,26160,88863,0,115023
142933100100000,SW 405,Residential,20812,67092,0,87904
142933100200000,SW 405,Residential,24310,68813,0,93123
142933100300000,SW 405,Residential,28330,61391,0,89721
142933100400000,SW 405,Residential,28330,63500,0,91830
142933100500000,SW 405,Residential,28588,74337,0,102925
142933100600000,SW 405,Residential,29396,85884,0,115280
142933100700000,SW 405,Residential,29396,73627,0,103023
142933100800000,SW 405,Residential,30037,97305,0,127342
142933100900000,SW 405,Residential,29699,86762,0,116461
142933101000000,SW 405,Residential,30002,78328,0,108330
142933101100000,SW 405,Residential,30002,82090,0,112092
142933101200000,SW 405,Residential,29951,91861,0,121812
142933101300000,SW 405,Residential,24300,64359,0,88659
142933101500000,SW 405,Residential,32449,111607,0,144056
142933101600000,SW 405,Residential,22440,58792,0,81232
142933101700000,SW 405,Residential,22440,58554,0,80994
142933101800000,SW 405,Residential,24684,68483,0,93167
142933101900000,SW 405,Residential,24684,75797,0,100481
142933102000000,SW 405,Residential,16045,91935,0,107980
142933102100000,SW 405,Residential,16045,0,0,16045
142933102200000,SW 405,Residential,32089,69648,0,101737
142933102300000,SW 405,Residential,24684,70851,0,95535
142933102400000,SW 405,Residential,20812,59311,0,80123
142933200100000,SW 405,Residential,30775,70861,0,101636
142933200200000,SW 405,Residential,30553,80330,0,110883
142933200300000,SW 405,Residential,28233,83212,0,111445
142933200400000,SW 405,Residential,29108,55953,0,85061
142933300100000,SW 405,Residential,23980,86087,0,110067
142933300200000,SW 405,Residential,24128,68465,0,92593
142933300300000,SW 405,Residential,24752,81355,0,106107
142933300400000,SW 405,Residential,24752,89346,0,114098
142933300500000,SW 405,Residential,24960,79863,0,104823
142933300600000,SW 405,Residential,24960,64825,0,89785
142933300700000,SW 405,Residential,24960,70908,0,95868
142933300800000,SW 405,Residential,24150,67712,0,91862
142933300900000,SW 405,Residential,17111,65200,0,82311
142933301000000,SW 405,Residential,17111,51913,0,69024
142933301100000,SW 405,Residential,28190,57185,0,85375
142933301200000,SW 405,Residential,22440,60711,0,83151
142933301300000,SW 405,Residential,25245,0,0,25245
142933301400000,SW 405,Residential,26704,98617,0,125321
142933301500000,SW 405,Residential,26227,73787,0,100014
142933301600000,SW 405,Residential,26786,91467,0,118253
142933301700000,SW 405,Residential,26520,76311,0,102831
142933301800000,SW 405,Residential,26520,63193,0,89713
142933301900000,SW 405,Residential,26520,69497,0,96017
142933302000000,SW 405,Residential,26520,86514,0,113034
142933302100000,SW 405,Residential,26520,74204,0,100724
142933302200000,SW 405,Residential,26520,81079,0,107599
142933302300000,SW 405,Residential,25875,94567,0,120442
142933302400000,SW 405,Residential,24595,87263,0,111858
142933302500000,SW 405,Residential,23000,93680,0,116680
142933302600000,SW 405,Residential,23980,81324,0,105304
142933302700000,SW 405,Residential,21800,88085,0,109885
142933400100000,SW 405,Residential,29088,78044,0,107132
142933400200000,SW 405,Residential,28567,93608,0,122175
142933400300000,SW 405,Residential,28567,68616,0,97183
142933400400000,SW 405,Residential,28567,68943,0,97510
142933400500000,SW 405,Residential,26939,92068,0,119007
142935100100000,SW 405,Residential,26878,43122,0,70000
142935100200000,SW 405,Residential,22750,53359,0,76109
142935100300000,SW 405,Residential,24115,52629,0,76744
142935100400000,SW 405,Residential,22750,53507,0,76257
142935100500000,SW 405,Residential,24115,56904,0,81019
142935100600000,SW 405,Residential,22750,50616,0,73366
142935100700000,SW 405,Residential,24115,59010,0,83125
142935100800000,SW 405,Residential,22750,58305,0,81055
142935100900000,SW 405,Residential,24115,61231,0,85346
142935101000000,SW 405,Residential,24645,63691,0,88336
142935101100000,SW 405,Residential,25705,47120,0,72825
142935101200000,SW 405,Residential,26765,57719,0,84484
142935101300000,SW 405,Residential,24115,51029,0,75144
142935101400000,SW 405,Residential,26993,62998,0,89991
142935101500000,SW 405,Residential,25344,54070,0,79414
142935101600000,SW 405,Residential,26460,56332,0,82792
142935101700000,SW 405,Residential,25080,72112,0,97192
142935101800000,SW 405,Residential,24265,56306,0,80571
142935101900000,SW 405,Residential,23740,83359,0,107099
142935102000000,SW 405,Residential,24804,80786,0,105590
142935102100000,SW 405,Residential,24512,56199,0,80711
142935102200000,SW 405,Residential,24494,53310,0,77804
142935102300000,SW 405,Residential,23774,58444,0,82218
142935102400000,SW 405,Residential,23774,52006,0,75780
142935102500000,SW 405,Residential,23774,54392,0,78166
142935102600000,SW 405,Residential,23774,59275,0,83049
142935102700000,SW 405,Residential,23774,54514,0,78288
142935102800000,SW 405,Residential,24530,63520,0,88050
142935200100000,SW 405,Residential,26028,68671,0,94699
142935200200000,SW 405,Residential,25850,56321,0,82171
142935200300000,SW 405,Residential,23018,54030,0,77048
142935200400000,SW 405,Residential,26089,66649,0,92738
142935200500000,SW 405,Residential,25575,63284,0,88859
142935200600000,SW 405,Residential,25245,29310,0,54555
142935200700000,SW 405,Residential,26000,51817,0,77817
142935200800000,SW 405,Residential,26482,59227,0,85709
142935200900000,SW 405,Residential,26000,53491,0,79491
142935201000000,SW 405,Residential,25300,55684,0,80984
142935201100000,SW 405,Residential,25358,62595,0,87953
142935201200000,SW 405,Residential,23687,60807,0,84494
142935201300000,SW 405,Residential,24543,53813,0,78356
142935201400000,SW 405,Residential,24330,60893,0,85223
142935201500000,SW 405,Residential,29295,50596,0,79891
142935201600000,SW 405,Residential,24610,50229,0,74839
142935201700000,SW 405,Residential,23940,57131,0,81071
142935201800000,SW 405,Residential,23712,55801,0,79513
142935201900000,SW 405,Residential,26067,55280,0,81347
142935300100000,SW 405,Residential,26352,62388,0,88740
142935300200000,SW 405,Residential,24250,53935,0,78185
142935300300000,SW 405,Residential,25705,57286,0,82991
142935300400000,SW 405,Residential,24250,49516,0,73766
142935300500000,SW 405,Residential,25705,57259,0,82964
142935300600000,SW 405,Residential,24250,53624,0,77874
142935300700000,SW 405,Residential,25705,47225,0,72930
142935300800000,SW 405,Residential,24250,54315,0,78565
142935300900000,SW 405,Residential,26190,48766,0,74956
142935400100000,SW 405,Residential,24915,56624,0,81539
142935400200000,SW 405,Residential,25080,47373,0,72453
142935400300000,SW 405,Residential,23703,53264,0,76967
142935400400000,SW 405,Residential,22325,53905,0,76230
142935400500000,SW 405,Residential,23038,68514,0,91552
142935400600000,SW 405,Residential,23038,57056,0,80094
142935400700000,SW 405,Residential,25341,55803,0,81144
142935400800000,SW 405,Residential,23038,48629,0,71667
142935400900000,SW 405,Residential,23038,53968,0,77006
142935401000000,SW 405,Residential,25341,57848,0,83189
142935401100000,SW 405,Residential,23038,83565,0,106603
142935401200000,SW 405,Residential,23038,60618,0,83656
142935401300000,SW 405,Residential,22468,69835,0,92303
142935401400000,SW 405,Residential,24655,58346,0,83001
142935401500000,SW 405,Residential,23760,56712,0,80472
142935401600000,SW 405,Residential,23079,49502,0,72581
142935401700000,SW 405,Residential,21150,58640,0,79790
142935401800000,SW 405,Residential,21825,59335,0,81160
142935401900000,SW 405,Residential,23038,62850,0,85888
142935402000000,SW 405,Residential,24008,62825,0,86833
142935402100000,SW 405,Residential,21825,54937,0,76762
142935402200000,SW 405,Residential,21825,50581,0,72406
142935402300000,SW 405,Residential,24008,61730,0,85738
142935402400000,SW 405,Residential,21825,59730,0,81555
142935402500000,SW 405,Residential,21825,55933,0,77758
142935402600000,SW 405,Residential,21285,38705,0,59990
142935500100000,SW 405,Residential,26955,56133,0,83088
142935500200000,SW 405,Residential,24225,57710,0,81935
142935500300000,SW 405,Residential,23644,74302,0,97946
142935500400000,SW 405,Residential,25848,69983,0,95831
142935500500000,SW 405,Residential,24435,53271,0,77706
142935500600000,SW 405,Residential,24420,72259,0,96679
142935500700000,SW 405,Residential,24672,71959,0,96631
142935500800000,SW 405,Residential,24690,62307,0,86997
142935500900000,SW 405,Residential,25550,52808,0,78358
142935501000000,SW 405,Residential,25333,58350,0,83683
142935501100000,SW 405,Residential,24827,53831,0,78658
142935501200000,SW 405,Residential,24320,46441,0,70761
142935501300000,SW 405,Residential,23918,49958,0,73876
142935501400000,SW 405,Residential,25080,62927,0,88007
142935501500000,SW 405,Residential,22325,79284,0,101609
142935501600000,SW 405,Residential,25490,71807,0,97297
142935501700000,SW 405,Residential,23004,98783,0,121787
142935501800000,SW 405,Residential,24744,49111,0,73855
142935501900000,SW 405,Residential,23913,62492,0,86405
142935502000000,SW 405,Residential,23803,58297,0,82100
142935502100000,SW 405,Residential,24366,58490,0,82856
142935502200000,SW 405,Residential,24765,53654,0,78419
142935502300000,SW 405,Residential,25603,61363,0,86966
142935502400000,SW 405,Residential,26109,54737,0,80846
142935502500000,SW 405,Residential,23864,57035,0,80899
142935502600000,SW 405,Residential,23736,51817,0,75553
142935502700000,SW 405,Residential,25302,50849,0,76151
142935502800000,SW 405,Residential,25171,59143,0,84314
142935502900000,SW 405,Residential,28310,56468,0,84778
142935503000000,SW 405,Residential,24111,52851,0,76962
142935600100000,SW 405,Residential,24880,80297,0,105177
142935600200000,SW 405,Residential,23038,71990,0,95028
142935600300000,SW 405,Residential,23959,73215,0,97174
142935600400000,SW 405,Residential,23959,61121,0,85080
142935600500000,SW 405,Residential,23959,64921,0,88880
142935600600000,SW 405,Residential,22698,65157,0,87855
142935600700000,SW 405,Residential,22698,71278,0,93976
142935600800000,SW 405,Residential,21825,69223,0,91048
142935600900000,SW 405,Residential,23571,66109,0,89680
142935700100000,SW 405,Residential,24034,72272,0,96306
142935700200000,SW 405,Residential,23232,77027,0,100259
142935700300000,SW 405,Residential,24368,58625,0,82993
142935700400000,SW 405,Residential,23826,53808,0,77634
142935700500000,SW 405,Residential,24564,64071,0,88635
142935700600000,SW 405,Residential,24669,50641,0,75310
142935700700000,SW 405,Residential,23560,49565,0,73125
142935700800000,SW 405,Residential,22824,70706,0,93530
142935700900000,SW 405,Residential,21842,67300,0,89142
142935701000000,SW 405,Residential,21351,76704,0,98055
142935701100000,SW 405,Residential,21106,70647,0,91753
142935701200000,SW 405,Residential,21842,77948,0,99790
142935701300000,SW 405,Residential,22578,75193,0,97771
142935701400000,SW 405,Residential,23560,76141,0,99701
142935701500000,SW 405,Residential,24768,81356,0,106124
142935701600000,SW 405,Residential,20475,74183,0,94658
142935701700000,SW 405,Residential,24768,82045,0,106813
142935701800000,SW 405,Residential,24030,72682,0,96712
142935701900000,SW 405,Residential,24150,72478,0,96628
142935702000000,SW 405,Residential,23363,87371,0,110734
142935702100000,SW 405,Residential,23100,72388,0,95488
142935702200000,SW 405,Residential,19995,80779,0,100774
142935702300000,SW 405,Residential,20227,76129,0,96356
142935702400000,SW 405,Residential,21157,66147,0,87304
142935702500000,SW 405,Residential,21600,66054,0,87654
142935702600000,SW 405,Residential,22500,65473,0,87973
142935702700000,SW 405,Residential,23175,67476,0,90651
142935702800000,SW 405,Residential,23625,79085,0,102710
142935702900000,SW 405,Residential,22050,70126,0,92176
142935703000000,SW 405,Residential,25368,55952,0,81320
142935703100000,SW 405,Residential,24731,73805,0,98536
142935703200000,SW 405,Residential,24938,74795,0,99733
142935703300000,SW 405,Residential,23513,72544,0,96057
142935703400000,SW 405,Residential,25080,66105,0,91185
142935800100000,SW 405,Residential,23735,65303,0,89038
142935800200000,SW 405,Residential,21150,65591,0,86741
142935800300000,SW 405,Residential,22500,61651,0,84151
142935800400000,SW 405,Residential,22500,65778,0,88278
142935800500000,SW 405,Residential,22500,72191,0,94691
142935800600000,SW 405,Residential,22500,83096,0,105596
142935800700000,SW 405,Residential,22500,72756,0,95256
142935800800000,SW 405,Residential,22500,73638,0,96138
142935800900000,SW 405,Residential,22275,65261,0,87536
142935801000000,SW 405,Residential,22275,74159,0,96434
142935801100000,SW 405,Residential,22275,66061,0,88336
142935801200000,SW 405,Residential,22275,68048,0,90323
142935801300000,SW 405,Residential,22275,73605,0,95880
142935801400000,SW 405,Residential,23496,57160,0,80656
142935801500000,SW 405,Residential,28871,78586,0,107457
142935801600000,SW 405,Residential,20475,67002,0,87477
142935801700000,SW 405,Residential,24738,61319,0,86057
142935801800000,SW 405,Residential,24600,71443,0,96043
142935801900000,SW 405,Residential,22275,78556,0,100831
142935802000000,SW 405,Residential,22275,75662,0,97937
142935802100000,SW 405,Residential,22275,67310,0,89585
142935802200000,SW 405,Residential,22275,72891,0,95166
142935802300000,SW 405,Residential,22275,57449,0,79724
142935802400000,SW 405,Residential,22275,65808,0,88083
142935802500000,SW 405,Residential,22275,73996,0,96271
142935802600000,SW 405,Residential,22275,69395,0,91670
142935802700000,SW 405,Residential,22275,66486,0,88761
142935802800000,SW 405,Residential,22275,72242,0,94517
142935802900000,SW 405,Residential,22275,75549,0,97824
142935803000000,SW 405,Residential,21375,63950,0,85325
142935803100000,SW 405,Residential,23470,99096,0,122566
142935803200000,SW 405,Residential,21114,72804,0,93918
142935803300000,SW 405,Residential,20866,71079,0,91945
142935900100000,SW 405,Residential,24662,59746,0,84408
142935900200000,SW 405,Residential,23184,53175,0,76359
142935900300000,SW 405,Residential,21150,68704,0,89854
142935900400000,SW 405,Residential,21600,65868,0,87468
142935900500000,SW 405,Residential,21825,59200,0,81025
142935900600000,SW 405,Residential,22468,59455,0,81923
142935900700000,SW 405,Residential,21150,79149,0,100299
142936000100000,SW 405,Residential,22896,71226,0,94122
142936000200000,SW 405,Residential,23135,68390,0,91525
142936000300000,SW 405,Residential,23135,66734,0,89869
142936000400000,SW 405,Residential,22392,85869,0,108261
142937600100000,Empty,Exempt,0,0,0,0
142937600200000,Empty,Exempt,0,0,0,0
142937600202000,COMM SW,Commercial,0,0,72426,72426
142937600300000,Empty,Exempt,0,0,0,0
142937700100000,COMM SW,Commercial,144450,0,428935,573385
142937700200000,COMM SW,Commercial,122445,0,490754,613199
142937700300000,COMM SW,Commercial,18225,0,12474,30699
142937700400000,COMM SW,Commercial,80865,0,467281,548146
142937700500000,COMM SW,Commercial,14774,0,9685,24459
142937700600000,COMM SW,Commercial,51322,0,181640,232962
142937700700000,COMM SW,Commercial,34814,0,122511,157325
142937800100000,Empty,Other,0,0,0,0
142940100100000,Empty,Exempt,0,0,0,0
142940100200000,Empty,Exempt,0,0,0,0
142940200100000,SW 404,Residential,12750,50892,0,63642
142940200200000,SW 404,Residential,5000,0,0,5000
142940200300000,SW 404,Residential,5000,0,0,5000
142940200400000,SW 404,Residential,13770,26254,0,40024
142940200500000,SW 404,Residential,10200,44433,0,54633
142940200600000,SW 404,Residential,5000,0,0,5000
142940200700000,SW 404,Residential,5000,0,0,5000
142940200800000,SW 404,Residential,5000,0,0,5000
142940200900000,SW 404,Residential,13387,62265,0,75652
142940201000000,SW 404,Residential,11475,62509,0,73984
142940201100000,SW 404,Residential,11475,39272,0,50747
142940201200000,SW 404,Residential,5000,0,0,5000
142940201300000,SW 404,Residential,18360,73344,0,91704
142940201400000,SW 404,Residential,13043,63018,0,76061
142940201500000,SW 404,Residential,9440,0,0,9440
142940201600000,SW 404,Residential,6600,0,0,6600
142940201700000,SW 404,Residential,15300,64838,0,80138
142940201800000,SW 404,Residential,15300,31653,0,46953
142940201900000,SW 404,Residential,18360,44153,0,62513
142940300100000,SW 404,Residential,15606,75748,0,91354
142940300200000,SW 404,Residential,15606,56055,0,71661
142940300300000,SW 404,Residential,18727,48036,0,66763
142940300400000,COMM SW,Commercial,9720,0,8220,17940
142940300500000,SW 404,Residential,11627,0,0,11627
142940300600000,SW 404,Residential,17245,0,0,17245
142940300700000,SW 404,Residential,17245,60554,0,77799
142940300800000,SW 404,Residential,17245,61825,0,79070
142940300900000,SW 404,Residential,17245,51750,0,68995
142940301000000,CONVERSIONS,Commercial,10561,0,41055,51616
142940301100000,SW 404,Residential,16119,41621,0,57740
142940301200000,SW 404,Residential,16854,53451,0,70305
142940301300000,SW 404,Residential,17556,53447,0,71003
142940301400000,SW 404,Residential,13495,55778,0,69273
142940301500000,SW 404,Residential,17069,66084,0,83153
142940400100000,SW 404,Residential,5000,0,0,5000
142940400200000,SW 404,Residential,9812,28241,0,38053
142940400300000,SW 404,Residential,15691,52730,0,68421
142940400400000,SW 404,Residential,17231,48008,0,65239
142940400500000,SW 404,Residential,14535,37047,0,51582
142940400600000,SW 404,Residential,5000,0,0,5000
142940400700000,SW 404,Residential,13005,46863,0,59868
142940400800000,SW 404,Residential,13387,29489,0,42876
142940400900000,SW 404,Residential,11245,42737,0,53982
142940401000000,COMM SW,Commercial,38961,0,92091,131052
142940401100000,SW 404,Residential,10200,64717,0,74917
142940401200000,SW 404,Residential,5000,0,0,5000
142940401300000,SW 404,Residential,5000,0,0,5000
142940500100000,SW 404,Residential,16157,56788,0,72945
142940500200000,SW 404,Residential,9486,28503,0,37989
142940500300000,SW 404,Residential,16607,59029,0,75636
142940500400000,CONVERSIONS,Commercial,5400,0,0,5400
142940500500000,SW 404,Residential,15300,64364,0,79664
142940500600000,SW 404,Residential,5000,0,0,5000
142940500700000,SW 404,Residential,17231,27093,0,44324
142940500800000,SW 404,Residential,11023,38089,0,49112
142940500900000,E-40 CHURCHES,Exempt,12879,0,13690,26569
142940501000000,SW 404,Residential,18360,44657,0,63017
142940501100000,SW 404,Residential,15835,50131,0,65966
142940501200000,SW 404,Residential,15625,0,0,15625
142940501300000,SW 404,Residential,5000,0,0,5000
142940501400000,SW 404,Residential,13602,56093,0,69695
142940600100000,SW 404,Residential,5000,0,0,5000
142940600200000,SW 404,Residential,11513,50711,0,62224
142940600300000,SW 404,Residential,11513,37871,0,49384
142940600400000,SW 404,Residential,8300,41393,0,49693
142940600500000,SW 404,Residential,8300,46039,0,54339
142940600600000,SW 404,Residential,8032,50783,0,58815
142940600700000,SW 404,Residential,8032,56060,0,64092
142940600800000,SW 404,Residential,15300,40687,0,55987
142940600900000,SW 404,Residential,16065,57446,0,73511
142940601000000,SW 404,Residential,16065,59440,0,75505
142940601100000,SW 404,Residential,8366,28215,0,36581
142940601200000,SW 404,Residential,7461,41708,0,49169
142940601300000,SW 404,Residential,7461,41581,0,49042
142940601400000,SW 404,Residential,8366,41226,0,49592
142940601500000,SW 404,Residential,6456,48226,0,54682
142940601600000,SW 404,Residential,5000,0,0,5000
142940601700000,SW 404,Residential,5000,0,0,5000
142940601800000,SW 404,Residential,6456,51068,0,57524
142940601900000,SW 404,Residential,14152,48271,0,62423
142940602000000,SW 404,Residential,13387,31420,0,44807
142940602100000,SW 404,Residential,13770,66940,0,80710
142940602200000,SW 404,Residential,10174,34347,0,44521
142940700300000,SW 404,Residential,5000,0,0,5000
142940700400000,SW 404,Residential,9835,56187,0,66022
142940700500000,SW 404,Residential,5000,0,0,5000
142940700600000,SW 404,Residential,16524,58552,0,75076
142940700700000,SW 404,Residential,13387,68727,0,82114
142940700800000,SW 404,Residential,13387,52532,0,65919
142940700900000,SW 404,Residential,5000,0,0,5000
142940701000000,SW 404,Residential,5000,0,0,5000
142940701200000,COMM SW,Commercial,85752,0,193609,279361
142940800100000,SW 404,Residential,18934,36745,0,55679
142940800200000,SW 404,Residential,12941,39708,0,52649
142940800300000,SW 404,Residential,5000,0,0,5000
142940800400000,SW 404,Residential,10353,41125,0,51478
142940800500000,SW 404,Residential,5000,0,0,5000
142940800600000,SW 404,Residential,4455,6874,0,11329
142940800700000,SW 404,Residential,5000,0,0,5000
142940800800000,SW 404,Residential,5000,0,0,5000
142940800900000,SW 404,Residential,14726,68813,0,83539
142940801000000,SW 404,Residential,5000,0,0,5000
142940801100000,SW 404,Residential,11781,52400,0,64181
142940801200000,SW 404,Residential,17231,38851,0,56082
142940801300000,SW 404,Residential,17231,52770,0,70001
142940801400000,SW 404,Residential,16906,42265,0,59171
142940801500000,SW 404,Residential,15300,37441,0,52741
142940900100000,SW 404,Residential,17231,50418,0,67649
142940900200000,SW 404,Residential,7686,48365,0,56051
142940900300000,SW 404,Residential,17268,68978,0,86246
142940900400000,SW 404,Residential,13365,61704,0,75069
142940900500000,SW 404,Residential,13770,62016,0,75786
142940900600000,SW 404,Residential,13770,69247,0,83017
142940900700000,SW 404,Residential,18245,59913,0,78158
142940900800000,SW 404,Residential,18245,46964,0,65209
142940900900000,SW 404,Residential,9812,57808,0,67620
142940901000000,SW 404,Residential,8721,59554,0,68275
142940901100000,SW 404,Residential,11961,61973,0,73934
142940901200000,SW 404,Residential,15300,53044,0,68344
142940901300000,SW 404,Residential,17231,49201,0,66432
142940901400000,SW 404,Residential,5000,0,0,5000
142940901500000,SW 404,Residential,12431,46406,0,58837
142941000100000,SW 404,Residential,18589,74243,0,92832
142941000200000,SW 404,Residential,8788,56297,0,65085
142941000300000,SW 404,Residential,17103,43697,0,60800
142941000400000,SW 404,Residential,17371,69503,0,86874
142941000500000,SW 404,Residential,10,0,0,10
142941000600000,SW 404,Residential,15285,68350,0,83635
142941000700000,SW 404,Residential,14872,50144,0,65016
142941000800000,SW 404,Residential,16726,43530,0,60256
142941000900000,SW 404,Residential,14458,68669,0,83127
142941001000000,SW 404,Residential,14458,64875,0,79333
142941001100000,SW 404,Residential,14872,55068,0,69940
142941001200000,E-10 COUNTY,Exempt,0,0,0,0
142941001300000,SW 404,Residential,14458,63697,0,78155
142941001400000,SW 404,Residential,14458,54393,0,68851
142941001500000,SW 404,Residential,12393,54438,0,66831
142941100100000,SW 404,Residential,5000,0,0,5000
142941100200000,SW 404,Residential,16065,0,0,16065
142941100300000,SW 404,Residential,10472,54239,0,64711
142941100400000,SW 404,Residential,5000,0,0,5000
142941100500000,SW 404,Residential,5000,0,0,5000
142941100600000,SW 404,Residential,10472,57917,0,68389
142941100700000,SW 404,Residential,5000,0,0,5000
142941100800000,SW 404,Residential,10880,59070,0,69950
142941100900000,SW 404,Residential,5000,0,0,5000
142941101000000,SW 404,Residential,5000,0,0,5000
142941200100000,SW 404,Residential,7952,0,0,7952
142941200200000,SW 404,Residential,5000,0,0,5000
142941200300000,SW 404,Residential,11136,37230,0,48366
142941200400000,SW 404,Residential,11461,49612,0,61073
142941200500000,SW 404,Residential,11461,55748,0,67209
142941200600000,SW 404,Residential,11461,47953,0,59414
142941200700000,SW 404,Residential,15300,49330,0,64630
142941200800000,SW 404,Residential,4290,17332,0,21622
142941200900000,SW 404,Residential,12464,37585,0,50049
142941201000000,SW 404,Residential,14858,24798,0,39656
142941300100000,SW 404,Residential,18245,67132,0,85377
142941300200000,COMM SW,Commercial,8165,0,25607,33772
142941300300000,SW 404,Residential,16929,69708,0,86637
142941300400000,SW 404,Residential,16200,61375,0,77575
142941300500000,SW 404,Residential,15390,62672,0,78062
142941300600000,SW 404,Residential,18954,50765,0,69719
142941300700000,SW 404,Residential,16200,55655,0,71855
142942600100000,SW 404,Residential,5966,0,0,5966
142942600200000,COMM SW,Commercial,9331,0,32236,41567
142942600300000,SW 404,Residential,12919,47086,0,60005
142942600400000,SW 404,Residential,16200,54187,0,70387
142942600500000,SW 404,Residential,17314,34930,0,52244
142942600600000,SW 404,Residential,16200,61618,0,77818
142942600700000,SW 404,Residential,16200,52060,0,68260
142942600800000,APTS SW,Commercial,5897,0,37322,43219
142942600900000,SW 404,Residential,16200,48874,0,65074
142942601000000,SW 404,Residential,16200,41363,0,57563
142942601100000,SW 404,Residential,16200,62196,0,78396
142942601200000,SW 404,Residential,10800,59830,0,70630
142942601300000,SW 404,Residential,10800,47804,0,58604
142942601400000,SW 404,Residential,16200,61842,0,78042
142942601500000,SW 404,Residential,16200,67440,0,83640
142942601600000,SW 404,Residential,16200,56771,0,72971
142942601700000,SW 404,Residential,16200,55809,0,72009
142942601800000,SW 404,Residential,18000,64176,0,82176
142942601900000,SW 404,Residential,16402,45233,0,61635
142942700200000,Empty,Other,0,0,0,0
142942700300000,COMM SW,Commercial,36515,0,0,36515
142942700302000,COMM SW,Commercial,0,0,59023,59023
142942700400000,COMM SW,Commercial,91800,0,65358,157158
142942700500000,Empty,Other,0,0,0,0
142942800100000,COMM SW,Commercial,120150,0,132899,253049
142942800200000,SW 404,Residential,21168,93255,0,114423
142942800300000,SW 404,Residential,16800,68715,0,85515
142942800400000,SW 404,Residential,11200,70875,0,82075
142942800500000,SW 404,Residential,20750,81461,0,102211
142942800600000,SW 404,Residential,14000,76135,0,90135
142942800700000,SW 404,Residential,19505,82305,0,101810
142942800800000,SW 404,Residential,26156,87539,0,113695
142942800900000,SW 404,Residential,26156,67643,0,93799
142942801000000,SW 404,Residential,26156,48778,0,74934
142942801100000,SW 404,Residential,26156,67577,0,93733
142942801200000,SW 404,Residential,26156,39859,0,66015
142942801300000,SW 404,Residential,26156,59171,0,85327
142942801400000,SW 404,Residential,26156,78738,0,104894
142942801500000,SW 404,Residential,26156,78509,0,104665
142942801600000,SW 404,Residential,22080,25334,0,47414
142942801700000,SW 404,Residential,12730,65802,0,78532
142942801800000,SW 404,Residential,13410,66965,0,80375
142942801900000,SW 404,Residential,13754,0,0,13754
142942802000000,SW 404,Residential,21340,15026,0,36366
142942802100000,SW 404,Residential,22000,23481,0,45481
142942802200000,SW 404,Residential,20600,0,0,20600
142942900100000,SW 404,Residential,21996,68242,0,90238
142942900200000,SW 404,Residential,21996,61054,0,83050
142942900300000,SW 404,Residential,21816,69394,0,91210
142942900400000,SW 404,Residential,21141,93436,0,114577
142942900500000,SW 404,Residential,17250,90479,0,107729
142942900600000,SW 404,Residential,24750,68717,0,93467
142942900700000,SW 404,Residential,24750,52245,0,76995
142942900800000,SW 404,Residential,24750,55507,0,80257
142942900900000,SW 404,Residential,24750,73467,0,98217
142942901000000,SW 404,Residential,24750,62059,0,86809
142942901100000,SW 404,Residential,24750,78413,0,103163
142942901200000,SW 404,Residential,24750,63070,0,87820
142942901300000,SW 404,Residential,24750,72288,0,97038
142942901400000,SW 404,Residential,23018,103480,0,126498
142942901500000,SW 404,Residential,30476,74507,0,104983
142942901600000,SW 404,Residential,25397,49954,0,75351
142942901700000,SW 404,Residential,24500,69875,0,94375
142942901800000,SW 404,Residential,24500,54567,0,79067
142942901900000,SW 404,Residential,24500,64640,0,89140
142942902000000,SW 404,Residential,24500,68196,0,92696
142942902100000,SW 404,Residential,28028,96289,0,124317
142942902200000,SW 404,Residential,24500,66061,0,90561
142943000100000,E-40 CHURCHES,Exempt,103275,0,376026,479301
142943000200000,SW 404,Residential,24750,58226,0,82976
142943000300000,SW 404,Residential,24750,73859,0,98609
142943000400000,SW 404,Residential,24750,78541,0,103291
142943000500000,SW 404,Residential,23513,71495,0,95008
142943000600000,SW 404,Residential,24750,71064,0,95814
142943000700000,SW 404,Residential,24750,64088,0,88838
142943000800000,SW 404,Residential,23018,69982,0,93000
142943100100000,SW 404,Residential,20898,50281,0,71179
142943100200000,SW 404,Residential,17010,57267,0,74277
142943100300000,SW 404,Residential,17010,46648,0,63658
142943100400000,SW 404,Residential,17010,46036,0,63046
142943100500000,SW 404,Residential,17010,80071,0,97081
142943100600000,SW 404,Residential,17010,79544,0,96554
142943100700000,SW 404,Residential,12757,39192,0,51949
142943100800000,SW 404,Residential,12757,60396,0,73153
142943100900000,SW 404,Residential,12757,42386,0,55143
142943101000000,SW 404,Residential,12757,53764,0,66521
142943101100000,SW 404,Residential,17010,48324,0,65334
142943200100000,SW 404,Residential,15048,26642,0,41690
142943200200000,COMM SW,Commercial,22032,0,0,22032
142943200300000,Empty,Other,0,0,0,0
142943200400000,SW 404,Residential,18700,54755,0,73455
142943200500000,SW 404,Residential,16800,41589,0,58389
142943200600000,SW 404,Residential,16800,55888,0,72688
142943200700000,SW 404,Residential,16800,59928,0,76728
142943200800000,SW 404,Residential,15120,46067,0,61187
142943200900000,SW 404,Residential,15120,68979,0,84099
142943201000000,SW 404,Residential,15228,46741,0,61969
142943201100000,SW 404,Residential,13320,0,0,13320
142943201200000,SW 404,Residential,16632,79387,0,96019
142943300100000,COMM SW,Commercial,24349,0,66946,91295
142943300200000,COMM SW,Commercial,12860,0,50623,63483
142943300300000,COMM SW,Commercial,13248,0,24838,38086
142943300400000,COMM SW,Commercial,22956,0,94468,117424
142943300500000,COMM SW,Commercial,44712,0,79145,123857
142943300600000,COMM SW,Commercial,51840,0,151806,203646
142943300700000,SW 404,Residential,12840,33710,0,46550
142943300800000,SW 404,Residential,12960,37059,0,50019
142945100100000,SW 404,Residential,18450,49348,0,67798
142945100200000,SW 404,Residential,19350,68295,0,87645
142945100300000,SW 404,Residential,18810,58090,0,76900
142945200100000,Empty,Exempt,0,0,0,0
142945200200000,COMM SW,Commercial,13219,0,0,13219
142945300100000,INDUSTRIAL,Industrial,432100,0,2446077,2878177
142945300102000,COMM SW,Commercial,0,0,14284,14284
142945400100000,SW 404,Residential,18360,52824,0,71184
142945400200000,COMM SW,Commercial,52877,0,106795,159672
142945400300000,COMM SW,Commercial,101250,0,133572,234822
142945400400000,COMM SW,Commercial,205200,0,268869,474069
142945500100000,SW 404,Residential,16000,39506,0,55506
142945500200000,SW 404,Residential,16000,43958,0,59958
142945500300000,SW 404,Residential,16000,39382,0,55382
142945500400000,CONVERSIONS,Commercial,9072,0,38731,47803
142945500500000,SW 404,Residential,16000,47075,0,63075
142945500600000,SW 404,Residential,16000,55031,0,71031
142945500700000,SW 404,Residential,16000,59948,0,75948
142945500800000,SW 404,Residential,16000,52306,0,68306
142945500900000,COMM SW,Commercial,18144,0,103230,121374
142945501000000,COMM SW,Commercial,18144,0,0,18144
142945501002000,COMM SW,Commercial,0,0,85806,85806
142945501100000,COMM SW,Commercial,44226,0,0,44226
142945501202000,COMM SW,Commercial,0,0,94791,94791
142945600100000,COMM SW,Commercial,18144,0,83862,102006
142945600200000,INDUSTRIAL,Industrial,11565,0,0,11565
142945600202000,INDUSTRIAL,Industrial,0,0,20177,20177
142945600300000,COMM SW,Commercial,86805,0,309190,395995
142945600400000,SW 404,Residential,12000,64594,0,76594
142945600500000,SW 404,Residential,16000,89178,0,105178
142945600600000,SW 404,Residential,16000,44948,0,60948
142945600700000,SW 404,Residential,16000,48099,0,64099
142945600800000,SW 404,Residential,16000,81028,0,97028
142945600900000,SW 404,Residential,12000,64422,0,76422
142945601000000,SW 404,Residential,16000,84146,0,100146
142945601100000,SW 404,Residential,16000,67827,0,83827
142945601200000,SW 404,Residential,16000,75669,0,91669
142945601300000,SW 404,Residential,16000,67284,0,83284
142945700100000,Empty,Other,0,0,0,0
142945800100000,INDUSTRIAL,Industrial,25800,0,1092330,1118130
142945800200000,Empty,Other,0,0,0,0
142945900100000,Empty,Other,0,0,0,0
142945900200000,COMM SW,Commercial,54432,0,0,54432
142945900300000,Empty,Other,0,0,0,0
142945900400000,COMM SW,Commercial,59805,0,0,59805
142946000100000,Empty,Other,0,0,0,0
142946000200000,Empty,Other,0,0,0,0
142946000300000,Empty,Other,0,0,0,0
142946000400000,Empty,Other,0,0,0,0
142946000500000,COMM SW,Commercial,72576,0,0,72576
142946000600000,COMM SW,Commercial,36288,0,0,36288
142946000700000,Empty,Other,0,0,0,0
142946000800000,COMM SW,Commercial,18014,0,0,18014
142946100100000,COMM SW,Commercial,29565,0,235018,264583
142946100200000,SW 404,Residential,8621,37026,0,45647
142946100300000,COMM SW,Commercial,25532,0,52339,77871
142946100400000,COMM SW,Commercial,19686,0,58363,78049
142946100500000,SW 404,Residential,19123,61315,0,80438
142946100600000,SW 404,Residential,16896,35827,0,52723
142946100700000,SW 404,Residential,16896,68082,0,84978
142946200100000,SW 404,Residential,23040,89235,0,112275
142946200200000,SW 404,Residential,15360,70983,0,86343
142946200300000,COMM SW,Commercial,137700,0,0,137700
142946200400000,Empty,Other,0,0,0,0
142947600100000,SW 404,Residential,9945,29491,0,39436
142947600200000,SW 404,Residential,5000,0,0,5000
142947600300000,SW 404,Residential,11628,52174,0,63802
142947600400000,SW 404,Residential,9163,45111,0,54274
142947600500000,SW 404,Residential,9163,54462,0,63625
142947600600000,SW 404,Residential,9163,58568,0,67731
142947600700000,SW 404,Residential,9163,52184,0,61347
142947700200000,SW 404,Residential,16200,44538,0,60738
142947700300000,SW 404,Residential,13883,48784,0,62667
142947700400000,SW 404,Residential,17129,69161,0,86290
142947700500000,SW 404,Residential,12096,42851,0,54947
142947700600000,SW 404,Residential,5000,0,0,5000
142947700700000,SW 404,Residential,13600,71777,0,85377
142947700800000,SW 404,Residential,13260,44457,0,57717
142947800100000,SW 404,Residential,16200,70227,0,86427
142947800200000,SW 404,Residential,18561,34570,0,53131
142947800300000,SW 404,Residential,11735,55714,0,67449
142947800400000,SW 404,Residential,10966,61001,0,71967
142947800500000,SW 404,Residential,10389,59528,0,69917
142947800600000,SW 404,Residential,15670,40116,0,55786
142947800700000,SW 404,Residential,15006,37235,0,52241
142947900100000,SW 404,Residential,5000,0,0,5000
142947900200000,SW 404,Residential,17660,52340,0,70000
142947900300000,SW 404,Residential,18610,40756,0,59366
142948000400000,COMM SW,Commercial,27522,0,0,27522
142948000500000,Empty,Other,0,0,0,0
142948000600000,Empty,Other,0,0,0,0
142948000602000,COMM SW,Commercial,0,0,8081,8081
142948100100000,COMM SW,Commercial,35453,0,43162,78615
142948100200000,COMM SW,Commercial,11858,0,37886,49744
142948100300000,SW 404,Residential,15920,49145,0,65065
142948100400000,SW 404,Residential,15390,32847,0,48237
142948100500000,COMM SW,Commercial,10303,0,36800,47103
142948100600000,COMM SW,Commercial,18540,0,0,18540
142948100800000,Empty,Other,0,0,0,0
142948200100000,SW 404,Residential,14400,76952,0,91352
142948200200000,SW 404,Residential,14400,81402,0,95802
142948200300000,SW 404,Residential,14400,60692,0,75092
142948200400000,SW 404,Residential,14400,67060,0,81460
142948200500000,SW 404,Residential,14400,59230,0,73630
142948200600000,SW 404,Residential,14400,57466,0,71866
142948200700000,SW 404,Residential,14400,64593,0,78993
142948201100000,COMM SW,Commercial,18371,0,0,18371
142948201200000,COMM SW,Commercial,18144,0,0,18144
142948201300000,SW 404,Residential,14400,47188,0,61588
142948201400000,SW 404,Residential,14400,49576,0,63976
142948201500000,SW 404,Residential,14400,45229,0,59629
142948201600000,SW 404,Residential,14400,67763,0,82163
142948201700000,Empty,Other,0,0,0,0
142948201800000,Empty,Other,0,0,0,0
142948201900000,COMM SW,Commercial,30861,0,0,30861
142948201902000,COMM SW,Commercial,0,0,31420,31420
142948202000000,COMM SW,Commercial,8383,0,0,8383
142948300100000,SW 404,Residential,9576,60608,0,70184
142948300200000,SW 404,Residential,10773,38509,0,49282
142948300300000,SW 404,Residential,10773,51624,0,62397
142948300400000,SW 404,Residential,10944,37134,0,48078
142948300500000,SW 404,Residential,16320,83391,0,99711
142948300600000,SW 404,Residential,16320,68429,0,84749
142948300700000,SW 404,Residential,16320,69300,0,85620
142948300800000,SW 404,Residential,14280,68701,0,82981
142948300900000,SW 404,Residential,14280,72068,0,86348
142948301000000,SW 404,Residential,14280,70535,0,84815
142948301100000,SW 404,Residential,12495,62093,0,74588
142948301200000,Empty,Exempt,0,0,0,0
142948301300000,COMM SW,Commercial,19440,0,0,19440
142948301400000,COMM SW,Commercial,18842,0,0,18842
142948400200000,COMM SW,Commercial,185895,0,282101,467996
142948500200000,INDUSTRIAL,Industrial,259203,0,790352,1049555
142948500300000,COMM SW,Commercial,274536,0,1009328,1283864
142948500500000,COMM SW,Commercial,93015,0,177801,270816
142948500600000,COMM SW,Commercial,184680,0,0,184680
142948500602000,COMM SW,Commercial,0,0,104164,104164
142948500602001,COMM SW,Commercial,0,0,83350,83350
142948500700000,INDUSTRIAL,Industrial,202880,0,413548,616428
142948500800000,COMM SW,Commercial,32140,0,9168,41308
142948500900000,COMM SW,Commercial,20347,0,77799,98146
142948501000000,COMM SW,Commercial,33221,0,95089,128310
142948501100000,COMM SW,Commercial,226800,0,362294,589094
142948501200000,INDUSTRIAL,Industrial,2400,0,0,2400
142948501300000,Empty,Other,0,0,0,0
142948501400000,INDUSTRIAL,Industrial,16800,0,12257,29057
142948600100000,INDUSTRIAL,Industrial,92625,0,0,92625
142948600200000,Empty,Other,0,0,0,0
142948600300000,COMM SW,Commercial,60480,0,111623,172103
142948600400000,Empty,Other,0,0,0,0
142948600500000,Empty,Other,0,0,0,0
142948700400000,COMM SW,Commercial,75816,0,136887,212703
142948800100000,COMM SW,Commercial,57645,0,4908,62553
143010100100000,NW 324,Residential,26208,106973,0,133181
143010100200000,NW 324,Residential,51100,169393,0,220493
143010100300000,NW 324,Residential,18988,82471,0,101459
143010100400000,NW 324,Residential,18988,59899,0,78887
143010100500000,NW 324,Residential,18899,66237,0,85136
143010100600000,NW 324,Residential,20400,74242,0,94642
143010100700000,NW 324,Residential,20400,88085,0,108485
143010100800000,NW 324,Residential,20400,87015,0,107415
143010100900000,NW 324,Residential,20400,72985,0,93385
143010101000000,NW 324,Residential,20400,80192,0,100592
143010101100000,NW 324,Residential,20400,58002,0,78402
143010101200000,NW 324,Residential,20400,89950,0,110350
143010101300000,NW 324,Residential,26520,136491,0,163011
143010101400000,NW 324,Residential,20400,59539,0,79939
143010101500000,NW 324,Residential,20400,91870,0,112270
143010101600000,NW 324,Residential,20400,68519,0,88919
143010101700000,NW 324,Residential,22950,86178,0,109128
143010101800000,NW 324,Residential,22950,80857,0,103807
143010101900000,NW 324,Residential,20400,66232,0,86632
143010102000000,NW 324,Residential,20400,84800,0,105200
143010102100000,NW 324,Residential,20400,64114,0,84514
143010102200000,NW 324,Residential,20400,102194,0,122594
143010102300000,NW 324,Residential,19676,95445,0,115121
143010102400000,NW 324,Residential,19908,77558,0,97466
143010102500000,NW 324,Residential,27421,77454,0,104875
143010102600000,NW 324,Residential,24840,94491,0,119331
143010102700000,NW 324,Residential,26662,106470,0,133132
143010102800000,NW 324,Residential,29280,105777,0,135057
143010102900000,NW 324,Residential,29280,30531,0,59811
143010103000000,NW 324,Residential,32452,83120,0,115572
143010103100000,NW 324,Residential,24400,107559,0,131959
143010103200000,NW 324,Residential,31378,96615,0,127993
143010103300000,NW 324,Residential,29280,118083,0,147363
143010103400000,NW 324,Residential,24400,95669,0,120069
143010103500000,NW 324,Residential,24400,92060,0,116460
143010103600000,NW 324,Residential,29280,96806,0,126086
143010103700000,NW 324,Residential,24400,81715,0,106115
143010103800000,NW 324,Residential,26840,103938,0,130778
143010103900000,NW 324,Residential,27664,87306,0,114970
143010104000000,NW 324,Residential,24960,80087,0,105047
143010104100000,NW 324,Residential,28035,90208,0,118243
143010104200000,NW 324,Residential,27706,111802,0,139508
143010200100000,NW 324,Residential,18899,78146,0,97045
143010200200000,NW 324,Residential,24684,97736,0,122420
143010200300000,E-40 CHURCHES,Exempt,379674,0,3089454,3469128
143010200400000,NW 324,Residential,50250,110200,0,160450
143010200500000,NW 324,Residential,24240,94225,0,118465
143010200600000,NW 324,Residential,24240,86698,0,110938
143010200700000,NW 324,Residential,21412,83008,0,104420
143010200800000,NW 324,Residential,21412,99570,0,120982
143010200900000,NW 324,Residential,21412,85428,0,106840
143010201000000,NW 324,Residential,30097,141603,0,171700
143010201100000,NW 324,Residential,28080,86920,0,115000
143010201200000,NW 324,Residential,24480,56745,0,81225
143010201300000,NW 324,Residential,24480,86677,0,111157
143010201400000,NW 324,Residential,24480,61617,0,86097
143010201500000,NW 324,Residential,24480,83568,0,108048
143010201600000,NW 324,Residential,24480,59200,0,83680
143010201700000,NW 324,Residential,26936,72335,0,99271
143010201800000,NW 324,Residential,26524,92043,0,118567
143010201900000,NW 324,Residential,31856,54925,0,86781
143010202000000,NW 324,Residential,51700,114105,0,165805
143010202100000,NW 324,Residential,30163,80646,0,110809
143010202200000,NW 324,Residential,24964,71960,0,96924
143010202300000,NW 324,Exempt,59050,0,90761,149811
143010202400000,NW 324,Residential,20116,74431,0,94547
143010202500000,NW 324,Residential,19364,83550,0,102914
143010202600000,NW 324,Residential,18760,85556,0,104316
143010202700000,NW 324,Residential,20400,75452,0,95852
143010202800000,NW 324,Residential,20400,84311,0,104711
143010202900000,NW 324,Residential,20400,77113,0,97513
143010203000000,NW 324,Residential,22950,92980,0,115930
143010203100000,NW 324,Residential,22950,106734,0,129684
143010203200000,NW 324,Residential,20400,116113,0,136513
143010203300000,NW 324,Residential,20400,81361,0,101761
143010203400000,NW 324,Residential,20400,108372,0,128772
143010203500000,NW 324,Residential,20400,80730,0,101130
143010203600000,NW 324,Residential,20400,73701,0,94101
143010203700000,NW 324,Residential,20400,69246,0,89646
143010203800000,NW 324,Residential,20400,84963,0,105363
143010203900000,NW 324,Residential,20400,84353,0,104753
143010204000000,NW 324,Residential,22950,97805,0,120755
143010204100000,NW 324,Residential,22950,81920,0,104870
143010204200000,NW 324,Residential,20400,67697,0,88097
143010204300000,NW 324,Residential,20400,82536,0,102936
143010300100000,NW 324,Residential,46008,34611,0,80619
143010300200000,NW 324,Residential,22896,89435,0,112331
143010300300000,NW 324,Residential,27132,106559,0,133691
143010300400000,NW 324,Residential,27360,88236,0,115596
143010300500000,NW 324,Residential,27300,81562,0,108862
143010300600000,NW 324,Residential,21412,82603,0,104015
143010300700000,NW 324,Residential,21412,96177,0,117589
143010300800000,NW 324,Residential,24480,88278,0,112758
143010300900000,NW 324,Residential,24480,67707,0,92187
143010301000000,NW 324,Residential,24480,43543,0,68023
143010301100000,NW 324,Residential,24480,68670,0,93150
143010301200000,NW 324,Residential,24480,65871,0,90351
143010301300000,NW 324,Residential,24480,57298,0,81778
143010301400000,NW 324,Residential,31856,89178,0,121034
143010301500000,NW 324,Residential,27598,67576,0,95174
143010301600000,NW 324,Residential,24864,34330,0,59194
143010400100000,COMM NW,Commercial,78797,0,167594,246391
143012600100000,NW 324,Residential,52200,103330,0,155530
143012600200000,NW 324,Residential,31104,136981,0,168085
143012600300000,NW 324,Residential,24320,99989,0,124309
143012600400000,NW 324,Residential,28900,134677,0,163577
143012600500000,NW 324,Residential,28900,96209,0,125109
143012600600000,NW 324,Residential,24661,86932,0,111593
143012600700000,NW 324,Residential,24000,90372,0,114372
143012600800000,NW 324,Residential,24000,56132,0,80132
143012600900000,NW 324,Residential,24000,90611,0,114611
143012601000000,NW 324,Residential,24000,95898,0,119898
143012601100000,NW 324,Residential,24000,92435,0,116435
143012601200000,NW 324,Residential,24000,92480,0,116480
143012601300000,NW 324,Residential,26197,111135,0,137332
143012601400000,NW 324,Residential,28004,100511,0,128515
143012601500000,NW 324,Residential,24480,72861,0,97341
143012700100000,NW 324,Residential,23100,99318,0,122418
143012700200000,NW 324,Residential,23485,113479,0,136964
143012700300000,NW 324,Residential,30530,114374,0,144904
143012700400000,NW 324,Residential,33445,96389,0,129834
143012700500000,NW 324,Residential,33840,93429,0,127269
143012700600000,NW 324,Residential,33840,75501,0,109341
143012700700000,NW 324,Residential,33840,74111,0,107951
143012700800000,NW 324,Residential,33840,85767,0,119607
143012700900000,NW 324,Residential,33840,86536,0,120376
143012701000000,NW 324,Residential,33840,91936,0,125776
143012701100000,NW 324,Residential,32670,92860,0,125530
143012701200000,NW 324,Residential,31680,75623,0,107303
143012701300000,NW 324,Residential,38190,84303,0,122493
143012701400000,NW 324,Residential,37226,92616,0,129842
143012701500000,NW 324,Residential,32336,81511,0,113847
143012701600000,NW 324,Residential,34071,94941,0,129012
143012701700000,NW 324,Residential,33840,72624,0,106464
143012701800000,NW 324,Residential,33840,74129,0,107969
143012701900000,NW 324,Residential,33840,92920,0,126760
143012702000000,NW 324,Residential,33840,97749,0,131589
143012702100000,NW 324,Residential,34235,78821,0,113056
143012702200000,NW 324,Residential,33700,115050,0,148750
143012702300000,NW 324,Residential,32944,113920,0,146864
143012702400000,NW 324,Residential,27900,91171,0,119071
143012702500000,NW 324,Residential,27900,94799,0,122699
143012702600000,NW 324,Residential,27900,81527,0,109427
143012702700000,NW 324,Residential,27900,122818,0,150718
143012702800000,NW 324,Residential,27900,75118,0,103018
143012702900000,NW 324,Residential,27900,73207,0,101107
143012703000000,NW 324,Residential,28164,91456,0,119620
143012703100000,NW 324,Residential,20400,101390,0,121790
143012703200000,NW 324,Residential,27759,103153,0,130912
143012703300000,NW 324,Residential,25685,88669,0,114354
143012703400000,NW 324,Residential,24480,95133,0,119613
143012703500000,NW 324,Residential,24480,88108,0,112588
143012703600000,NW 324,Residential,24480,93525,0,118005
143012703700000,NW 324,Residential,24480,73827,0,98307
143012703800000,NW 324,Residential,24480,86760,0,111240
143012703900000,NW 324,Residential,24480,98889,0,123369
143012704000000,NW 324,Residential,24863,85133,0,109996
143012704100000,NW 324,Residential,25704,104488,0,130192
143012704200000,NW 324,Residential,26112,102475,0,128587
143012704300000,NW 324,Residential,25952,108209,0,134161
143012704400000,NW 324,Residential,26320,108895,0,135215
143012704500000,NW 324,Residential,22974,95272,0,118246
143012704600000,NW 324,Residential,23100,126675,0,149775
143012800100000,NW 324,Residential,34235,85131,0,119366
143012800200000,NW 324,Residential,35137,68974,0,104111
143012800300000,NW 324,Residential,33840,111949,0,145789
143012800400000,NW 324,Residential,33840,76256,0,110096
143012800500000,NW 324,Residential,33840,77274,0,111114
143012800600000,NW 324,Residential,33840,68865,0,102705
143012800700000,NW 324,Residential,33840,72744,0,106584
143012800800000,NW 324,Residential,33840,71326,0,105166
143012800900000,NW 324,Residential,33840,77415,0,111255
143012801000000,NW 324,Residential,33840,71065,0,104905
143012801100000,NW 324,Residential,33840,67736,0,101576
143012801200000,NW 324,Residential,33840,72405,0,106245
143012801300000,NW 324,Residential,33840,84832,0,118672
143012801400000,NW 324,Residential,33727,59401,0,93128
143012801500000,NW 324,Residential,33502,84464,0,117966
143012801600000,NW 324,Residential,33840,106805,0,140645
143012801700000,NW 324,Residential,33840,80843,0,114683
143012801800000,NW 324,Residential,33840,96575,0,130415
143012801900000,NW 324,Residential,33840,73332,0,107172
143012802000000,NW 324,Residential,33840,85607,0,119447
143012802100000,NW 324,Residential,33840,89791,0,123631
143012802200000,NW 324,Residential,33840,74225,0,108065
143012802300000,NW 324,Residential,33840,89573,0,123413
143012802400000,NW 324,Residential,33840,83263,0,117103
143012802500000,NW 324,Residential,33840,74920,0,108760
143012802600000,NW 324,Residential,33840,84921,0,118761
143012900100000,NW 324,Residential,36067,85750,0,121817
143012900200000,NW 324,Residential,35532,95095,0,130627
143012900300000,NW 324,Residential,34776,101708,0,136484
143012900400000,NW 324,Residential,34216,116113,0,150329
143012900500000,NW 324,Residential,33840,87253,0,121093
143012900600000,NW 324,Residential,33840,84300,0,118140
143012900700000,NW 324,Residential,33840,82416,0,116256
143012900800000,NW 324,Residential,33840,76804,0,110644
143012900900000,NW 324,Residential,33840,74615,0,108455
143012901000000,NW 324,Residential,32712,74990,0,107702
143012901100000,NW 324,Residential,29027,74773,0,103800
143012901200000,NW 324,Residential,33703,86168,0,119871
143012901300000,NW 324,Residential,33480,76967,0,110447
143012901400000,NW 324,Residential,33480,73040,0,106520
143012901500000,NW 324,Residential,33480,82210,0,115690
143012901600000,NW 324,Residential,33480,88977,0,122457
143012901700000,NW 324,Residential,33480,85273,0,118753
143012901800000,NW 324,Residential,33480,82447,0,115927
143012901900000,NW 324,Residential,32736,86891,0,119627
143013000100000,NW 324,Residential,36698,76307,0,113005
143013000200000,NW 324,Residential,33871,75186,0,109057
143013000300000,Empty,Exempt,0,0,0,0
143013000400000,NW 324,Residential,36119,70760,0,106879
143013000500000,NW 324,Residential,36542,76250,0,112792
143013000600000,NW 324,Residential,41940,84060,0,126000
143013000700000,NW 324,Residential,40658,75998,0,116656
143013000800000,NW 324,Residential,34596,83216,0,117812
143013000900000,NW 324,Residential,35154,82882,0,118036
143013001000000,NW 324,Residential,35154,82335,0,117489
143013001100000,NW 324,Residential,35154,72786,0,107940
143013001200000,NW 324,Residential,35154,72627,0,107781
143013001300000,NW 324,Residential,35154,72257,0,107411
143013001400000,NW 324,Residential,35154,82827,0,117981
143013001500000,NW 324,Residential,34596,84925,0,119521
143013001600000,NW 324,Residential,33840,78040,0,111880
143013001700000,NW 324,Residential,34560,82894,0,117454
143013001800000,NW 324,Residential,36360,86968,0,123328
143013001900000,NW 324,Residential,37800,110512,0,148312
143013002000000,NW 324,Residential,38520,76135,0,114655
143013002100000,NW 324,Residential,30510,112300,0,142810
143013002200000,NW 324,Residential,32527,0,0,32527
143013100100000,NW 324,Residential,29878,70411,0,100289
143013100200000,NW 324,Residential,29575,73889,0,103464
143013100300000,NW 324,Residential,29575,82112,0,111687
143013100400000,NW 324,Residential,29575,92268,0,121843
143013100500000,NW 324,Residential,30618,91352,0,121970
143013100600000,E-70 CHARITY OTHER,Exempt,62370,0,533071,595441
143013100700000,NW 324,Residential,41873,74944,0,116817
143013100800000,NW 324,Residential,35712,69134,0,104846
143013100900000,NW 324,Residential,34968,73496,0,108464
143013101000000,NW 324,Residential,41850,126953,0,168803
143013101100000,COMM NW,Commercial,44928,0,154401,199329
143013101200000,COMM NW,Commercial,146362,0,413343,559705
143013101300000,COMM NW,Commercial,146880,0,1297236,1444116
143013101400000,APTS NW,Commercial,24250,0,414810,439060
143013101500000,NW 324,Residential,31447,92650,0,124097
143015100100000,NW 324,Residential,26327,59811,0,86138
143015100200000,NW 324,Residential,26790,97914,0,124704
143015100300000,NW 324,Residential,24720,90853,0,115573
143015100400000,NW 324,Residential,24844,61432,0,86276
143015100500000,NW 324,Residential,21836,64523,0,86359
143015100600000,NW 324,Residential,24720,88788,0,113508
143015100700000,NW 324,Residential,24720,80319,0,105039
143015100800000,NW 324,Residential,24720,89185,0,113905
143015100900000,NW 324,Residential,24720,57048,0,81768
143015101000000,NW 324,Residential,24720,71042,0,95762
143015200100000,NW 324,Residential,28828,73268,0,102096
143015200200000,NW 324,Residential,28329,67967,0,96296
143015200300000,NW 324,Residential,28846,82119,0,110965
143015200400000,NW 324,Residential,29159,95627,0,124786
143015200500000,NW 324,Residential,24960,105040,0,130000
143015200600000,NW 324,Residential,24960,86111,0,111071
143015200700000,NW 324,Residential,25200,80939,0,106139
143015200800000,NW 324,Residential,25200,94457,0,119657
143015200900000,NW 324,Residential,25200,65337,0,90537
143015201000000,NW 324,Residential,25200,70848,0,96048
143015201100000,NW 324,Residential,23744,71658,0,95402
143015201200000,NW 324,Residential,23044,73559,0,96603
143015201300000,NW 324,Residential,37080,134981,0,172061
143015201500000,NW 324,Residential,24720,60502,0,85222
143015201600000,NW 324,Residential,22248,97793,0,120041
143015201700000,NW 324,Residential,30338,61941,0,92279
143015201800000,NW 324,Residential,27810,125483,0,153293
143015300100000,NW 324,Residential,35704,105860,0,141564
143015300200000,NW 324,Residential,30337,72737,0,103074
143015300300000,NW 324,Residential,31185,90919,0,122104
143015300400000,NW 324,Residential,31185,89577,0,120762
143015300500000,NW 324,Residential,30690,90731,0,121421
143015300600000,NW 324,Residential,28215,71928,0,100143
143015300700000,NW 324,Residential,29700,76641,0,106341
143015300800000,NW 324,Residential,29700,66638,0,96338
143015300900000,NW 324,Residential,29700,74609,0,104309
143015301000000,NW 324,Residential,29700,84724,0,114424
143015301100000,NW 324,Residential,27416,83788,0,111204
143015301200000,NW 324,Residential,23046,100069,0,123115
143015301300000,NW 324,Residential,23296,79092,0,102388
143015301400000,NW 324,Residential,24960,79113,0,104073
143015301500000,NW 324,Residential,24960,82208,0,107168
143015301600000,NW 324,Residential,25200,66360,0,91560
143015301700000,NW 324,Residential,25200,101305,0,126505
143015301800000,NW 324,Residential,25200,91521,0,116721
143015301900000,NW 324,Residential,25200,81917,0,107117
143015400100000,NW 324,Residential,31560,70842,0,102402
143015400200000,NW 324,Residential,30810,103648,0,134458
143015400300000,NW 324,Residential,31185,84075,0,115260
143015400400000,NW 324,Residential,31522,94151,0,125673
143015400500000,NW 324,Residential,30810,101982,0,132792
143015400600000,NW 324,Residential,29700,78545,0,108245
143015400700000,NW 324,Residential,29700,85028,0,114728
143015400800000,NW 324,Residential,27720,81105,0,108825
143015400900000,NW 324,Residential,29700,83379,0,113079
143015401000000,NW 324,Residential,30443,86171,0,116614
143015401100000,NW 324,Residential,27798,93433,0,121231
143015401200000,NW 324,Residential,27791,103838,0,131629
143015401300000,NW 324,Residential,29700,82684,0,112384
143015401400000,NW 324,Residential,29700,86923,0,116623
143015401500000,NW 324,Residential,27720,73776,0,101496
143015401600000,NW 324,Residential,29700,83979,0,113679
143015401700000,NW 324,Residential,31185,84031,0,115216
143015401800000,NW 324,Residential,30075,82242,0,112317
143015401900000,NW 324,Residential,32561,84547,0,117108
143015402000000,NW 324,Residential,32917,85346,0,118263
143015500100000,NW 324,Residential,29774,81114,0,110888
143015500200000,NW 324,Residential,29400,74037,0,103437
143015500300000,NW 324,Residential,31188,86903,0,118091
143015500400000,NW 324,Residential,29400,76483,0,105883
143015500500000,NW 324,Residential,29400,70512,0,99912
143015500600000,NW 324,Residential,31190,78862,0,110052
143015500700000,NW 324,Residential,29400,77894,0,107294
143015500800000,NW 324,Residential,27440,73284,0,100724
143015500900000,NW 324,Residential,29400,91638,0,121038
143015501000000,NW 324,Residential,27440,75337,0,102777
143015501100000,NW 324,Residential,26937,86866,0,113803
143015501200000,NW 324,Residential,119450,236354,0,355804
143015501300000,Empty,Exempt,0,0,0,0
143017600100000,COMM NW,Commercial,515160,0,3084840,3600000
143017600200000,NW 324,Residential,24400,83866,0,108266
143017600300000,NW 324,Residential,24400,79709,0,104109
143017600400000,NW 324,Residential,33818,96003,0,129821
143017600500000,NW 324,Residential,33818,79611,0,113429
143017600600000,NW 324,Residential,32940,93138,0,126078
143017600700000,NW 324,Residential,29280,102963,0,132243
143017600800000,NW 324,Residential,31720,94920,0,126640
143017600900000,NW 324,Residential,32448,85929,0,118377
143017601000000,NW 324,Residential,21840,93964,0,115804
143017601100000,NW 324,Residential,19400,40885,0,60285
143017601200000,NW 324,Residential,19400,89955,0,109355
143017601300000,NW 324,Residential,22000,49360,0,71360
143017601400000,NW 324,Residential,24400,63612,0,88012
143017601500000,NW 324,Residential,19968,71937,0,91905
143017601600000,NW 324,Residential,28832,91511,0,120343
143017601700000,NW 324,Residential,21840,92765,0,114605
143017601800000,NW 324,Residential,21840,104191,0,126031
143017601900000,NW 324,Residential,21840,89125,0,110965
143017602000000,NW 324,Residential,30355,87887,0,118242
143017602100000,NW 324,Residential,24400,80422,0,104822
143017602200000,NW 324,Residential,24400,93452,0,117852
143017602300000,NW 324,Residential,36600,99853,0,136453
143017602400000,NW 324,Residential,24400,35236,0,59636
143017602500000,NW 324,Residential,24400,65255,0,89655
143017602600000,NW 324,Residential,24400,68214,0,92614
143017602700000,NW 324,Residential,24400,89757,0,114157
143017602800000,NW 324,Residential,33818,102643,0,136461
143017602900000,NW 324,Residential,33818,83956,0,117774
143017603000000,NW 324,Residential,36600,48052,0,84652
143017603100000,NW 324,Residential,36600,87769,0,124369
143017603200000,NW 324,Residential,24400,74775,0,99175
143017700100000,NW 324,Residential,24797,63265,0,88062
143017700200000,NW 324,Residential,21400,60482,0,81882
143017700300000,NW 324,Residential,22657,83485,0,106142
143017700400000,NW 324,Residential,27720,84926,0,112646
143017700500000,NW 324,Residential,26208,80493,0,106701
143017700600000,NW 324,Residential,29232,60664,0,89896
143017700700000,NW 324,Residential,29367,69464,0,98831
143017700800000,NW 324,Residential,24349,73260,0,97609
143017700900000,NW 324,Residential,23256,82373,0,105629
143017701000000,NW 324,Residential,24720,51096,0,75816
143017701100000,NW 324,Residential,24720,75070,0,99790
143017701200000,NW 324,Residential,24720,98977,0,123697
143017701300000,NW 324,Residential,24720,101410,0,126130
143017701400000,NW 324,Residential,24720,87280,0,112000
143017701500000,NW 324,Residential,24720,45720,0,70440
143017701600000,NW 324,Residential,24173,48230,0,72403
143017701700000,NW 324,Residential,27357,93135,0,120492
143017701800000,NW 324,Residential,27357,81673,0,109030
143017701900000,NW 324,Residential,25936,65881,0,91817
143017702000000,NW 324,Residential,26513,43209,0,69722
143017702100000,NW 324,Residential,33211,42425,0,75636
143017702200000,NW 324,Residential,23458,56436,0,79894
143017702300000,NW 324,Residential,25440,74945,0,100385
143017702400000,NW 324,Residential,25440,102870,0,128310
143017702500000,NW 324,Residential,22560,100691,0,123251
143017702600000,NW 324,Residential,11360,34270,0,45630
143017800100000,NW 324,Residential,24720,81503,0,106223
143017800200000,NW 324,Residential,24854,77723,0,102577
143017800300000,NW 324,Residential,23520,63422,0,86942
143017800400000,NW 324,Residential,23520,75364,0,98884
143017800500000,NW 324,Residential,23520,74607,0,98127
143017800600000,NW 324,Residential,23520,73218,0,96738
143017800700000,NW 324,Residential,23520,72590,0,96110
143017800800000,NW 324,Residential,23520,79444,0,102964
143017800900000,NW 324,Residential,23520,85279,0,108799
143017801000000,NW 324,Residential,23334,54657,0,77991
143017900100000,NW 324,Residential,28080,92904,0,120984
143017900200000,NW 324,Residential,27336,102368,0,129704
143017900300000,NW 324,Residential,26532,96745,0,123277
143017900400000,NW 324,Residential,26532,83129,0,109661
143017900500000,NW 324,Residential,26136,71873,0,98009
143017900600000,NW 324,Residential,29964,108035,0,137999
143017900700000,NW 324,Residential,26400,111209,0,137609
143017900800000,NW 324,Residential,26800,82555,0,109355
143017900900000,NW 324,Residential,26800,65708,0,92508
143017901000000,NW 324,Residential,26800,94562,0,121362
143017901100000,NW 324,Residential,24240,113513,0,137753
143017901200000,NW 324,Residential,24240,87566,0,111806
143017901300000,NW 324,Residential,26260,101973,0,128233
143017901400000,NW 324,Residential,28159,112710,0,140869
143017901500000,E-40 CHURCHES,Exempt,278424,0,450612,729036
143017901600000,NW 324,Residential,24570,58180,0,82750
143017901700000,NW 324,Residential,18096,81357,0,99453
143017901800000,NW 324,Residential,18600,54753,0,73353
143017901900000,NW 324,Residential,23200,80412,0,103612
143017902000000,NW 324,Residential,36600,64515,0,101115
143017902100000,NW 324,Residential,21200,32380,0,53580
143017902200000,NW 324,Residential,21200,107212,0,128412
143017902300000,NW 324,Residential,25440,89989,0,115429
143017902400000,NW 324,Residential,25440,93560,0,119000
143017902500000,NW 324,Residential,29062,86470,0,115532
143020100100000,NW 324,Residential,24786,94680,0,119466
143020100200000,NW 324,Residential,25220,92786,0,118006
143020100300000,NW 324,Residential,26000,86581,0,112581
143020100400000,NW 324,Residential,24480,87095,0,111575
143020100500000,NW 324,Residential,24960,86571,0,111531
143020100600000,NW 324,Residential,29172,63048,0,92220
143020100700000,NW 324,Residential,29172,106905,0,136077
143020100800000,NW 324,Residential,25251,74758,0,100009
143020100900000,NW 324,Residential,25792,74382,0,100174
143020101000000,NW 324,Residential,25792,72194,0,97986
143020101100000,NW 324,Residential,26582,81066,0,107648
143020101200000,NW 324,Residential,32812,74356,0,107168
143020101300000,NW 324,Residential,32240,78942,0,111182
143020101400000,NW 324,Residential,32240,80343,0,112583
143020101500000,NW 324,Residential,33020,82419,0,115439
143020101600000,NW 324,Residential,36465,97368,0,133833
143020101700000,NW 324,Residential,36115,99257,0,135372
143020101800000,NW 324,Residential,30096,88472,0,118568
143020101900000,NW 324,Residential,29832,88076,0,117908
143020102000000,NW 324,Residential,30597,76655,0,107252
143020102100000,NW 324,Residential,37333,112751,0,150084
143020102200000,NW 324,Residential,33967,89610,0,123577
143020102300000,NW 324,Residential,34330,84620,0,118950
143020102400000,NW 324,Residential,30805,80747,0,111552
143020102500000,NW 324,Residential,30805,79522,0,110327
143020102600000,NW 324,Residential,30805,77510,0,108315
143020102700000,NW 324,Residential,30805,89558,0,120363
143020102800000,NW 324,Residential,30805,83454,0,114259
143020102900000,NW 324,Residential,30805,93683,0,124488
143020103000000,NW 324,Residential,30805,94878,0,125683
143020103100000,NW 324,Residential,30805,86996,0,117801
143020103200000,NW 324,Residential,30805,87996,0,118801
143020103300000,NW 324,Residential,30805,83379,0,114184
143020103400000,NW 324,Residential,31209,77785,0,108994
143020103500000,NW 324,Residential,30300,81305,0,111605
143020103600000,NW 324,Residential,39390,82810,0,122200
143020200100000,NW 324,Residential,32314,128723,0,161037
143020200200000,NW 324,Residential,29140,68342,0,97482
143020200300000,NW 324,Residential,29140,82803,0,111943
143020200400000,NW 324,Residential,29140,105672,0,134812
143020200500000,NW 324,Residential,29140,79310,0,108450
143020200600000,NW 324,Residential,29140,84434,0,113574
143020200700000,NW 324,Residential,29140,113724,0,142864
143020200800000,NW 324,Residential,29140,91132,0,120272
143020200900000,NW 324,Residential,29140,108578,0,137718
143020201000000,NW 324,Residential,29140,97333,0,126473
143020201100000,NW 324,Residential,29140,92509,0,121649
143020201200000,NW 324,Residential,29140,70612,0,99752
143020201300000,NW 324,Residential,31394,88083,0,119477
143020201400000,APTS NW,Commercial,37110,0,124860,161970
143020201500000,NW 324,Residential,28440,94416,0,122856
143020201600000,NW 324,Residential,33600,91924,0,125524
143020201700000,NW 324,Residential,32000,102973,0,134973
143020201800000,NW 324,Residential,31360,85900,0,117260
143020201900000,NW 324,Residential,31040,107136,0,138176
143020202000000,NW 324,Residential,31040,81957,0,112997
143020202100000,NW 324,Residential,31040,96494,0,127534
143020202200000,NW 324,Residential,31040,111905,0,142945
143020202300000,NW 324,Residential,31040,107493,0,138533
143020202400000,NW 324,Residential,31040,93915,0,124955
143020202500000,NW 324,Residential,31059,86663,0,117722
143020300100000,Empty,Exempt,0,0,0,0
143020300200000,NW 324,Residential,11600,0,0,11600
143020300300000,NW 324,Residential,28576,114143,0,142719
143020300400000,NW 324,Residential,28576,94357,0,122933
143020300500000,NW 324,Residential,28200,97604,0,125804
143020300600000,NW 324,Residential,28200,92053,0,120253
143020300700000,NW 324,Residential,28200,79757,0,107957
143020300800000,NW 324,Residential,28200,88608,0,116808
143020300900000,NW 324,Residential,28200,89516,0,117716
143020301000000,NW 324,Residential,30609,114029,0,144638
143020301100000,NW 324,Residential,31130,81250,0,112380
143020301200000,NW 324,Residential,28200,84707,0,112907
143020301300000,NW 324,Residential,28200,90830,0,119030
143020301400000,NW 324,Residential,28200,85798,0,113998
143020301500000,NW 324,Residential,28200,78217,0,106417
143020301600000,NW 324,Residential,28200,93738,0,121938
143020301700000,NW 324,Residential,28576,83280,0,111856
143020301800000,NW 324,Residential,28576,90818,0,119394
143020400100000,NW 324,Residential,32623,84225,0,116848
143020400200000,Empty,Exempt,0,0,0,0
143020400300000,Empty,Exempt,0,0,0,0
143020400400000,NW 324,Residential,32173,98091,0,130264
143020400500000,NW 324,Residential,31040,92139,0,123179
143020400600000,NW 324,Residential,31040,91443,0,122483
143020400700000,NW 324,Residential,31040,105290,0,136330
143020400800000,NW 324,Residential,31040,99671,0,130711
143020400900000,NW 324,Residential,31040,104500,0,135540
143020401000000,NW 324,Residential,31040,83356,0,114396
143020401100000,NW 324,Residential,31040,106234,0,137274
143020401200000,NW 324,Residential,31040,98292,0,129332
143020401300000,NW 324,Residential,29760,115933,0,145693
143020401400000,APTS NW,Commercial,59400,0,975583,1034983
143020401500000,NW 324,Residential,27012,68999,0,96011
143020401600000,NW 324,Residential,31504,56342,0,87846
143020401700000,NW 324,Residential,23280,76966,0,100246
143020401800000,NW 324,Residential,26190,84246,0,110436
143020401900000,NW 324,Residential,31310,78579,0,109889
143020402000000,NW 324,Residential,31108,84175,0,115283
143020402100000,NW 324,Residential,30300,92917,0,123217
143020402200000,NW 324,Residential,30300,89585,0,119885
143020402300000,NW 324,Residential,30300,84600,0,114900
143020402400000,NW 324,Residential,30300,93908,0,124208
143020402500000,NW 324,Residential,30300,96451,0,126751
143020402600000,NW 324,Residential,30300,90683,0,120983
143020402700000,NW 324,Residential,30805,70651,0,101456
143020402800000,NW 324,Residential,30805,105378,0,136183
143020402900000,NW 324,Residential,30805,88672,0,119477
143020403000000,NW 324,Residential,30805,123006,0,153811
143020500100000,NW 324,Residential,29385,85011,0,114396
143020500200000,NW 324,Residential,27830,105786,0,133616
143020500300000,NW 324,Residential,28210,94012,0,122222
143020500400000,NW 324,Residential,22568,88531,0,111099
143020500500000,NW 324,Residential,22568,75744,0,98312
143020500600000,NW 324,Residential,22725,80670,0,103395
143022600100000,NW 324,Residential,28272,79513,0,107785
143022600200000,NW 324,Residential,28272,107806,0,136078
143022600300000,NW 324,Residential,28272,108726,0,136998
143022600400000,NW 324,Residential,27900,90203,0,118103
143022600500000,NW 324,Residential,27900,75884,0,103784
143022600600000,NW 324,Residential,27900,89094,0,116994
143022600700000,NW 324,Residential,27900,94676,0,122576
143022600800000,NW 324,Residential,27900,93112,0,121012
143022600900000,NW 324,Residential,27900,91571,0,119471
143022601000000,NW 324,Residential,27300,84029,0,111329
143022601100000,NW 324,Residential,27546,95995,0,123541
143022601200000,NW 324,Residential,11232,0,0,11232
143022601300000,NW 324,Residential,31824,82950,0,114774
143022601400000,NW 324,Residential,22926,80905,0,103831
143022601500000,NW 324,Residential,28210,109067,0,137277
143022601600000,NW 324,Residential,29394,73874,0,103268
143022601700000,NW 324,Residential,28381,76793,0,105174
143022601800000,NW 324,Residential,27900,89415,0,117315
143022601900000,NW 324,Residential,27900,85755,0,113655
143022602000000,NW 324,Residential,27900,90767,0,118667
143022602100000,NW 324,Residential,27900,80444,0,108344
143022602200000,NW 324,Residential,27900,94055,0,121955
143022602300000,NW 324,Residential,27900,83820,0,111720
143022602400000,NW 324,Residential,28272,87407,0,115679
143022700100000,Empty,Other,0,0,0,0
143022700200000,NW 324,Residential,33140,83989,0,117129
143022700300000,NW 324,Residential,33330,82689,0,116019
143022700400000,NW 324,Residential,34340,103790,0,138130
143022700500000,NW 324,Residential,32320,91246,0,123566
143022700600000,NW 324,Residential,35476,87468,0,122944
143022700700000,NW 324,Residential,35350,99908,0,135258
143022700800000,NW 324,Residential,36360,94170,0,130530
143022700900000,NW 324,Residential,42906,96572,0,139478
143022701000000,NW 324,Residential,28798,92935,0,121733
143022701100000,NW 324,Residential,28500,112042,0,140542
143022701200000,NW 324,Residential,28500,89055,0,117555
143022701300000,NW 324,Residential,28500,96377,0,124877
143022701400000,NW 324,Residential,28500,76913,0,105413
143022701500000,NW 324,Residential,28500,102217,0,130717
143022701600000,NW 324,Residential,28500,89781,0,118281
143022701700000,NW 324,Residential,28500,88083,0,116583
143022701800000,NW 324,Residential,28500,90300,0,118800
143022701900000,NW 324,Residential,28500,92204,0,120704
143022702000000,NW 324,Residential,28500,84275,0,112775
143022702100000,NW 324,Residential,28500,113893,0,142393
143022702200000,NW 324,Residential,28500,84092,0,112592
143022800100000,COMM NW,Commercial,99948,0,3283,103231
143022800200000,COMM NW,Commercial,120960,0,194697,315657
143022800300000,NW 324,Residential,17,0,0,17
143022800400000,COMM NW,Commercial,621864,0,2307207,2929071
143022800500000,COMM NW,Commercial,374112,0,1031681,1405793
143022800600000,COMM NW,Commercial,145800,0,174617,320417
143022800900000,COMM NW,Commercial,57022,0,156629,213651
143022801000000,COMM NW,Commercial,103615,0,121385,225000
143022801100000,COMM NW,Commercial,111586,0,136199,247785
143022801200000,COMM NW,Commercial,84135,0,130415,214550
143022801300000,COMM NW,Commercial,79389,0,78446,157835
143022801400000,NW 324,Residential,27720,51430,0,79150
143022801500000,NW 324,Residential,27906,85039,0,112945
143022801600000,NW 324,Residential,35350,89941,0,125291
143022801700000,NW 324,Residential,36360,97306,0,133666
143022801800000,NW 324,Residential,35350,80417,0,115767
143022801900000,NW 324,Residential,32825,79061,0,111886
143022802000000,NW 324,Residential,32320,96249,0,128569
143022802100000,NW 324,Residential,32320,81333,0,113653
143022802200000,NW 324,Residential,33835,98103,0,131938
143022802300000,NW 324,Residential,32571,140815,0,173386
143022802400000,COMM NW,Commercial,6435,0,0,6435
143022802500000,COMM NW,Commercial,15529,0,0,15529
143022802600000,COMM NW,Commercial,35105,0,0,35105
143022802700000,COMM NW,Commercial,35105,0,0,35105
143022802800000,COMM NW,Commercial,38935,0,0,38935
143022802900000,COMM NW,Commercial,38423,0,0,38423
143022803000000,COMM NW,Commercial,33113,0,0,33113
143022900700000,COMM NW,Commercial,778,0,0,778
143022900800000,COMM NW,Commercial,17604,0,1153,18757
143025100100000,COMM NW,Commercial,123379,0,156065,279444
143025100200000,COMM NW,Commercial,96665,0,155784,252449
143025100301000,CONDO 500,Residential,5000,15196,0,20196
143025100301001,CONDO 500,Residential,5000,14007,0,19007
143025100301002,CONDO 500,Residential,5000,15196,0,20196
143025100301003,CONDO 500,Residential,5000,14007,0,19007
143025100301004,CONDO 500,Residential,5000,13224,0,18224
143025100301005,CONDO 500,Residential,5000,12035,0,17035
143025100401000,CONDO 500,Residential,5000,51228,0,56228
143025100401001,CONDO 500,Residential,5000,45987,0,50987
143025100401002,CONDO 500,Residential,5000,51228,0,56228
143025100401003,CONDO 500,Residential,5000,45987,0,50987
143025100401004,CONDO 500,Residential,5000,49256,0,54256
143025100401005,CONDO 500,Residential,5000,44015,0,49015
143025100500000,APTS NW,Commercial,12134,0,125593,137727
143025100600000,APTS NW,Commercial,13268,0,125593,138861
143025100700000,APTS NW,Commercial,13414,0,125336,138750
143025100800000,NW 333,Residential,28587,96345,0,124932
143025100900000,NW 333,Residential,36012,132276,0,168288
143025101000000,NW 333,Residential,44779,159420,0,204199
143025101100000,NW 333,Residential,33046,126153,0,159199
143025101200000,NW 333,Residential,33228,101717,0,134945
143025101300000,NW 333,Residential,35100,108167,0,143267
143025101400000,NW 333,Residential,35100,95517,0,130617
143025101500000,NW 333,Residential,35100,118642,0,153742
143025101600000,NW 333,Residential,35100,105482,0,140582
143025101700000,NW 333,Residential,35802,137642,0,173444
143025101800000,NW 333,Residential,32760,108812,0,141572
143025101900000,NW 333,Residential,31200,100124,0,131324
143025102000000,NW 333,Residential,31853,106321,0,138174
143025102100000,NW 333,Residential,31200,134603,0,165803
143025102200000,NW 333,Residential,31800,183761,0,215561
143025102300000,NW 333,Residential,31800,175062,0,206862
143025102400000,NW 333,Residential,30952,170713,0,201665
143025102500000,NW 333,Residential,61200,459938,0,521138
143025102600000,NW 324,Residential,57900,0,0,57900
143025200100000,APTS NW,Commercial,14580,0,122289,136869
143025200200000,APTS NW,Commercial,14580,0,120569,135149
143025200300000,NW 333,Ag Land,3413,0,8470,11883
143025200400000,NW 333,Residential,31393,130718,0,162111
143025200500000,NW 333,Residential,37183,134168,0,171351
143025200600000,NW 333,Residential,36032,102665,0,138697
143025200700000,NW 333,Residential,30528,113847,0,144375
143025200800000,NW 333,Residential,30528,87816,0,118344
143025200900000,NW 333,Residential,30528,80501,0,111029
143025201000000,NW 333,Residential,30528,96651,0,127179
143025201100000,NW 333,Residential,30528,84767,0,115295
143025201200000,NW 333,Residential,30782,110464,0,141246
143025201300000,NW 333,Residential,29962,93546,0,123508
143025201400000,NW 333,Residential,29680,92249,0,121929
143025201500000,NW 333,Residential,29680,88317,0,117997
143025201600000,NW 333,Residential,30210,120495,0,150705
143025201700000,NW 333,Residential,30210,106598,0,136808
143025201800000,NW 333,Residential,30210,110118,0,140328
143025201900000,NW 333,Residential,29680,106437,0,136117
143025202000000,NW 333,Residential,29991,121338,0,151329
143025202100000,NW 333,Residential,29640,113375,0,143015
143025202200000,NW 333,Residential,29120,104074,0,133194
143025202300000,NW 333,Residential,29952,104646,0,134598
143025202400000,NW 333,Residential,27040,113411,0,140451
143025202500000,NW 333,Residential,29640,120860,0,150500
143025202600000,NW 333,Residential,29528,104776,0,134304
143025202700000,NW 333,Residential,29120,115101,0,144221
143025202800000,APTS NW,Commercial,14515,0,129731,144246
143025300200000,COMM NW,Commercial,326268,0,627672,953940
143025300300000,COMM NW,Commercial,198990,0,255475,454465
143025300400000,NW 333,Residential,29037,69716,0,98753
143025300500000,NW 333,Residential,29120,76569,0,105689
143025300600000,NW 333,Residential,29120,83822,0,112942
143025300700000,NW 333,Residential,29120,93387,0,122507
143025300800000,NW 333,Residential,29065,75090,0,104155
143025300900000,NW 333,Residential,30727,87378,0,118105
143025301000000,NW 333,Residential,29120,82482,0,111602
143025301100000,NW 333,Residential,29120,77875,0,106995
143025301200000,NW 333,Residential,29120,70341,0,99461
143025301300000,NW 333,Residential,29120,86890,0,116010
143025301400000,NW 333,Residential,30257,90109,0,120366
143025400100000,NW 333,Residential,29646,122445,0,152091
143025400200000,NW 333,Residential,30097,107222,0,137319
143025400300000,NW 333,Residential,29680,100832,0,130512
143025400400000,NW 333,Residential,30210,102754,0,132964
143025400500000,NW 333,Residential,29680,85048,0,114728
143025400600000,NW 333,Residential,30210,122710,0,152920
143025400700000,NW 333,Residential,29680,111611,0,141291
143025400800000,NW 333,Residential,30210,100323,0,130533
143025400900000,NW 333,Residential,29680,89003,0,118683
143025401000000,NW 333,Residential,28408,111270,0,139678
143025401100000,NW 333,Residential,31418,120464,0,151882
143025401200000,NW 333,Residential,30210,91310,0,121520
143025401300000,NW 333,Residential,29680,88349,0,118029
143025401400000,NW 333,Residential,30438,105779,0,136217
143025401500000,NW 333,Residential,31811,114190,0,146001
143025401600000,NW 333,Residential,29960,99372,0,129332
143025401700000,NW 333,Residential,30210,134254,0,164464
143025401800000,NW 333,Residential,29680,111740,0,141420
143025401900000,NW 333,Residential,30210,97798,0,128008
143025402000000,NW 333,Residential,29680,148334,0,178014
143025402100000,NW 333,Residential,30210,160754,0,190964
143025402200000,NW 333,Residential,29680,118834,0,148514
143025402300000,NW 333,Residential,30210,100744,0,130954
143025402400000,NW 333,Residential,29680,121483,0,151163
143025402500000,NW 333,Residential,30210,131398,0,161608
143025402600000,NW 333,Residential,29680,119937,0,149617
143025500100000,NW 333,Residential,29120,81122,0,110242
143025500200000,NW 333,Residential,29120,111204,0,140324
143025500300000,NW 333,Residential,29120,113733,0,142853
143025500400000,NW 333,Residential,29120,77808,0,106928
143025500500000,NW 333,Residential,28160,67523,0,95683
143025500600000,NW 333,Residential,28160,101136,0,129296
143025500700000,NW 333,Residential,28087,86326,0,114413
143025500800000,NW 333,Residential,29231,111372,0,140603
143025500900000,NW 333,Residential,28160,71099,0,99259
143025501000000,NW 333,Residential,28160,106883,0,135043
143025600100000,NW 333,Residential,33300,180308,0,213608
143025600200000,NW 333,Residential,33300,182863,0,216163
143025600300000,NW 333,Residential,30932,103699,0,134631
143025600400000,NW 333,Residential,28812,138932,0,167744
143025600500000,NW 333,Residential,28000,122425,0,150425
143027600100000,NW 324,Residential,33758,80694,0,114452
143027600200000,NW 324,Residential,24240,82603,0,106843
143027600300000,NW 324,Residential,24240,54216,0,78456
143027600400000,NW 324,Residential,24240,79610,0,103850
143027600500000,NW 324,Residential,24240,69721,0,93961
143027600600000,NW 324,Residential,24240,83242,0,107482
143027600700000,NW 324,Residential,28280,77278,0,105558
143027600800000,NW 324,Residential,28280,140268,0,168548
143027600900000,NW 324,Residential,29088,85122,0,114210
143027601000000,NW 324,Residential,28280,106490,0,134770
143027601100000,NW 324,Residential,28280,83070,0,111350
143027601200000,NW 324,Residential,28280,83260,0,111540
143027601300000,NW 324,Residential,28280,83185,0,111465
143027601400000,NW 324,Residential,30300,127835,0,158135
143027700100000,NW 324,Residential,25728,60798,0,86526
143027700200000,NW 324,Residential,24696,74813,0,99509
143027700300000,NW 324,Residential,18397,35339,0,53736
143027700400000,NW 324,Residential,18393,92799,0,111192
143027700500000,NW 324,Residential,18393,61595,0,79988
143027700600000,NW 324,Residential,24240,66889,0,91129
143027700700000,NW 324,Residential,24240,50442,0,74682
143027700800000,NW 324,Residential,24240,30194,0,54434
143027700900000,APTS NW,Commercial,36733,0,113267,150000
143027701000000,NW 324,Residential,30906,81101,0,112007
143027701100000,NW 324,Residential,31129,80981,0,112110
143027701200000,NW 324,Residential,40226,113177,0,153403
143027701300000,NW 324,Residential,30300,150017,0,180317
143027701400000,NW 324,Residential,30300,82001,0,112301
143027701500000,NW 324,Residential,29088,77647,0,106735
143027701600000,NW 324,Residential,29088,89859,0,118947
143027701700000,NW 324,Residential,24240,67263,0,91503
143027701800000,NW 324,Residential,24240,82414,0,106654
143027701900000,NW 324,Residential,20200,74054,0,94254
143027702000000,NW 324,Residential,28280,106021,0,134301
143027702100000,NW 324,Residential,24240,56684,0,80924
143027702200000,NW 324,Residential,24240,91984,0,116224
143027702300000,NW 324,Residential,24240,68866,0,93106
143027702400000,NW 324,Residential,24240,70504,0,94744
143027702500000,NW 324,Residential,24240,90160,0,114400
143027702600000,NW 324,Residential,34000,0,0,34000
143027800100000,NW 324,Residential,18397,108601,0,126998
143027800200000,NW 324,Residential,18393,60945,0,79338
143027800300000,NW 324,Residential,18393,63842,0,82235
143027800400000,COMM NW,Commercial,125280,0,106007,231287
143027800402000,COMM NW,Commercial,0,0,46411,46411
143027800500000,COMM NW,Commercial,111110,0,113767,224877
143027800600000,COMM NW,Commercial,109555,0,168303,277858
143027800700000,COMM NW,Commercial,352080,0,178614,530694
143027800800000,NW 333,Residential,30952,158859,0,189811
143027800900000,NW 333,Residential,31800,164570,0,196370
143027801000000,NW 333,Residential,31800,180659,0,212459
143027801100000,NW 324,Residential,57500,73983,0,131483
143027801200000,NW 324,Residential,5000,0,0,5000
143027801300000,NW 324,Residential,31162,82610,0,113772
143027801400000,NW 324,Residential,23054,74901,0,97955
143027801500000,NW 324,Residential,28473,81337,0,109810
143027801600000,NW 324,Residential,28168,81691,0,109859
143027801700000,NW 324,Residential,930,0,0,930
143027801800000,APTS NW,Commercial,43060,0,272954,316014
143027801900000,NW 324,Residential,9520,0,0,9520
143027802000000,NW 324,Residential,24240,28491,0,52731
143027802100000,NW 324,Residential,24240,72591,0,96831
143027802200000,NW 324,Residential,24240,29734,0,53974
143027802400000,NW 324,Residential,28324,0,0,28324
143027802500000,NW 324,Residential,28324,0,0,28324
143027802600000,NW 324,Residential,28324,0,0,28324
143027802700000,NW 324,Residential,28324,0,0,28324
143027900100000,NW 324,Residential,36741,99733,0,136474
143027900200000,NW 324,Residential,36630,102801,0,139431
143027900300000,NW 324,Residential,36630,94084,0,130714
143027900400000,NW 324,Residential,36741,103412,0,140153
143027900500000,NW 324,Residential,23320,136470,0,159790
143028000100000,NW 333,Residential,33824,195630,0,229454
143028000200000,NW 333,Residential,33600,179535,0,213135
143028000300000,NW 324,Residential,28080,0,0,28080
143028000400000,NW 324,Residential,26320,0,0,26320
143028000500000,NW 324,Residential,26320,0,0,26320
143028000600000,Empty,Exempt,0,0,0,0
143028100100000,NW 324,Residential,20,0,0,20
143030100100000,E-40 CHURCHES,Exempt,396576,0,726062,1122638
143030100200000,NW 333,Residential,25913,118929,0,144842
143030100300000,NW 333,Residential,25860,136745,0,162605
143030100400000,NW 333,Residential,26014,122899,0,148913
143030100500000,NW 333,Residential,26220,112892,0,139112
143030100600000,NW 333,Residential,26220,126962,0,153182
143030100700000,NW 333,Residential,26220,133477,0,159697
143030100800000,NW 333,Residential,33579,145149,0,178728
143030100900000,NW 333,Residential,28280,96642,0,124922
143030101000000,Empty,Exempt,0,0,0,0
143030101100000,NW 333,Residential,32123,128007,0,160130
143030101200000,NW 333,Residential,29220,150437,0,179657
143030101300000,NW 333,Residential,27537,95200,0,122737
143030101400000,NW 333,Residential,24240,94509,0,118749
143030101500000,NW 333,Residential,27472,110316,0,137788
143030200100000,NW 333,Residential,25993,113733,0,139726
143030200200000,NW 333,Residential,25280,93374,0,118654
143030200300000,NW 333,Residential,24800,83913,0,108713
143030200400000,NW 333,Residential,26684,93990,0,120674
143030200500000,NW 333,Residential,28896,94228,0,123124
143030200600000,NW 333,Residential,39179,108290,0,147469
143030300100000,NW 333,Residential,28955,141795,0,170750
143030300200000,NW 333,Residential,30562,118193,0,148755
143030300300000,NW 333,Residential,33320,142791,0,176111
143030300400000,NW 333,Residential,32944,130611,0,163555
143030300500000,NW 333,Residential,28920,147270,0,176190
143030300600000,NW 333,Residential,29058,127185,0,156243
143030300700000,NW 333,Residential,26574,91155,0,117729
143030300800000,NW 333,Residential,26574,95790,0,122364
143030300900000,NW 333,Residential,26574,89750,0,116324
143030301000000,NW 333,Residential,26574,92183,0,118757
143030301100000,NW 333,Residential,26574,85503,0,112077
143030301200000,NW 333,Residential,26574,85290,0,111864
143030301300000,NW 333,Residential,27724,92387,0,120111
143030301400000,NW 333,Residential,27520,95789,0,123309
143030301500000,NW 333,Residential,56300,156197,0,212497
143030301600000,NW 333,Residential,39942,105922,0,145864
143030301700000,NW 333,Residential,32096,157432,0,189528
143030301800000,NW 333,Residential,31459,76866,0,108325
143030301900000,NW 333,Residential,28000,120960,0,148960
143030302000000,NW 333,Residential,26477,110124,0,136601
143030302100000,NW 333,Residential,29539,144761,0,174300
143030302200000,NW 333,Residential,26577,124048,0,150625
143030400100000,SW 406,Residential,56650,61242,0,117892
143030400200000,SW 406,Residential,47981,155482,0,203463
143030400300000,SW 406,Residential,39360,101772,0,141132
143030400400000,SW 406,Residential,36102,142050,0,178152
143030400500000,SW 406,Residential,35953,139320,0,175273
143030400600000,SW 406,Residential,31624,100346,0,131970
143030400700000,SW 406,Residential,48300,83611,0,131911
143030400800000,SW 406,Residential,30240,84399,0,114639
143030400900000,SW 406,Residential,36400,105545,0,141945
143030401000000,SW 427,Residential,51200,186568,0,237768
143030401100000,SW 427,Residential,57350,173203,0,230553
143030401200000,SW 427,Residential,32516,123528,0,156044
143030401300000,SW 427,Residential,32804,120826,0,153630
143030401400000,SW 427,Residential,32021,118258,0,150279
143030401500000,SW 427,Residential,31520,112961,0,144481
143030401600000,SW 427,Residential,31979,83965,0,115944
143030500200000,E-40 CHURCHES,Exempt,192186,0,1008586,1200772
143030500300000,SW 406,Residential,34272,99100,0,133372
143030500400000,SW 406,Residential,59200,338018,0,397218
143030500500000,SW 406,Residential,28350,47932,0,76282
143030500600000,SW 406,Residential,32148,70551,0,102699
143030500700000,SW 406,Residential,43392,96315,0,139707
143030500800000,SW 406,Residential,29120,90497,0,119617
143032600100000,NW 333,Residential,29169,129912,0,159081
143032600200000,NW 333,Residential,27744,113970,0,141714
143032600300000,NW 333,Residential,27744,118768,0,146512
143032600400000,NW 333,Residential,27744,108906,0,136650
143032700100000,NW 333,Residential,24720,96984,0,121704
143032700200000,NW 333,Residential,26154,90288,0,116442
143032700300000,NW 333,Residential,25956,93909,0,119865
143032700400000,NW 333,Residential,28170,127458,0,155628
143032800100000,NW 333,Residential,31623,106161,0,137784
143032800200000,NW 333,Residential,29120,92586,0,121706
143032800300000,NW 333,Residential,29357,103344,0,132701
143032900100000,NW 333,Residential,28883,114299,0,143182
143032900200000,NW 333,Residential,29120,120776,0,149896
143032900300000,NW 333,Residential,29120,91755,0,120875
143032900400000,NW 333,Residential,29357,92750,0,122107
143033000100000,NW 333,Residential,29376,106694,0,136070
143033000200000,NW 333,Residential,26112,101190,0,127302
143033000300000,NW 333,Residential,26357,108372,0,134729
143033000400000,NW 333,Residential,27744,111105,0,138849
143033000500000,NW 333,Residential,26177,90622,0,116799
143033000600000,NW 333,Residential,27744,110322,0,138066
143033000700000,NW 333,Residential,27744,92608,0,120352
143033000800000,NW 333,Residential,29552,125410,0,154962
143033000900000,NW 333,Residential,29955,87215,0,117170
143033001000000,NW 333,Residential,29952,93364,0,123316
143033001100000,NW 333,Residential,29952,92678,0,122630
143033001200000,NW 333,Residential,29120,108056,0,137176
143033001300000,NW 333,Residential,29952,83854,0,113806
143033001400000,NW 333,Residential,29952,82372,0,112324
143033001500000,NW 333,Residential,29952,83221,0,113173
143033001600000,NW 333,Residential,29952,86418,0,116370
143033001700000,NW 333,Residential,29952,87756,0,117708
143033001800000,NW 333,Residential,29711,87419,0,117130
143033001900000,NW 333,Residential,25772,86839,0,112611
143033002000000,NW 333,Residential,25544,74079,0,99623
143033002100000,NW 333,Residential,25544,108515,0,134059
143033002200000,NW 333,Residential,25544,86146,0,111690
143033002300000,NW 333,Residential,25544,89296,0,114840
143033002400000,NW 333,Residential,25544,91734,0,117278
143033002500000,NE 115,Residential,22046,94192,0,116238
143033002600000,NW 333,Residential,28815,117553,0,146368
143033002700000,NW 333,Residential,28620,121367,0,149987
143033002800000,NW 333,Residential,26005,120316,0,146321
143033002900000,NW 333,Residential,25368,70026,0,95394
143033003000000,NW 333,Residential,29842,115025,0,144867
143033003100000,NW 333,Residential,28016,91665,0,119681
143033003200000,NW 333,Residential,28016,83746,0,111762
143033003300000,NW 333,Residential,26434,91668,0,118102
143033003400000,NW 333,Residential,28016,97261,0,125277
143033003500000,NW 333,Residential,28016,84665,0,112681
143033003600000,NW 333,Residential,28016,111326,0,139342
143033003700000,NW 333,Residential,28016,108812,0,136828
143033100100000,NW 333,Residential,28016,85623,0,113639
143033100200000,NW 333,Residential,28016,95636,0,123652
143033100300000,NW 333,Residential,28016,104814,0,132830
143033100400000,NW 333,Residential,28016,135966,0,163982
143033100500000,NW 333,Residential,26434,91147,0,117581
143033100600000,NW 333,Residential,28016,92548,0,120564
143033100700000,NW 333,Residential,28016,111560,0,139576
143033100800000,NW 333,Residential,29842,95592,0,125434
143033100900000,NW 333,Residential,29422,107602,0,137024
143033101000000,NW 333,Residential,29845,95207,0,125052
143033101100000,NW 333,Residential,29661,114445,0,144106
143033101200000,NW 333,Residential,24720,93969,0,118689
143033101300000,NW 333,Residential,25137,81900,0,107037
143033101400000,NW 333,Residential,25544,78761,0,104305
143033101500000,NW 333,Residential,25544,105437,0,130981
143033101600000,NW 333,Residential,25544,104622,0,130166
143033101700000,NW 333,Residential,25544,81803,0,107347
143033101800000,NW 333,Residential,25544,84857,0,110401
143033101900000,NE 115,Residential,22612,110424,0,133036
143033102000000,NW 333,Residential,25772,81250,0,107022
143033102100000,NW 333,Residential,25544,90674,0,116218
143033102200000,NW 333,Residential,25544,89893,0,115437
143033102300000,NW 333,Residential,25544,100028,0,125572
143033102400000,NW 333,Residential,25544,88557,0,114101
143033102500000,NW 333,Residential,24720,96894,0,121614
143033102600000,NW 333,Residential,28612,115331,0,143943
143033102700000,NW 333,Residential,28824,100388,0,129212
143033102800000,NW 333,Residential,26780,111381,0,138161
143033102900000,NW 333,Residential,25928,83231,0,109159
143033103000000,NW 333,Residential,28560,106981,0,135541
143033103100000,NW 333,Residential,29664,115427,0,145091
143033103200000,NW 333,Residential,29664,125503,0,155167
143033103300000,NW 333,Residential,29862,114743,0,144605
143033103400000,NW 333,Residential,29746,119965,0,149711
143033103500000,NW 333,Residential,30996,142542,0,173538
143033103600000,NW 333,Residential,28922,125065,0,153987
143033103700000,NW 333,Residential,25800,124998,0,150798
143033103800000,NW 333,Residential,27276,90132,0,117408
143033103900000,NW 333,Residential,28500,109458,0,137958
143033104000000,NW 333,Residential,28500,107587,0,136087
143033104100000,NW 333,Residential,31007,101286,0,132293
143033200100000,NW 333,Residential,31188,102083,0,133271
143033200200000,NW 333,Residential,29862,97188,0,127050
143033200300000,NW 333,Residential,29664,93102,0,122766
143033200400000,NW 333,Residential,29664,111192,0,140856
143033200500000,NW 333,Residential,30400,136142,0,166542
143033200600000,NW 333,Residential,32565,117242,0,149807
143033200700000,NW 333,Residential,28520,116996,0,145516
143033200800000,NW 333,Residential,28494,115063,0,143557
143033200900000,NW 333,Residential,31128,98805,0,129933
143033201000000,NW 333,Residential,28840,110385,0,139225
143033201100000,NW 333,Residential,28840,99857,0,128697
143033201200000,NW 333,Residential,34718,127557,0,162275
143033201300000,NW 333,Residential,30138,106497,0,136635
143033201400000,NW 333,Residential,24682,96882,0,121564
143033201500000,NW 333,Residential,25180,86576,0,111756
143033201600000,NW 333,Residential,28491,82532,0,111023
143033201700000,NW 333,Residential,25440,92311,0,117751
143033201800000,NW 333,Residential,25228,74126,0,99354
143033201900000,NW 333,Residential,23256,48132,0,71388
143033202000000,NW 333,Residential,26984,89022,0,116006
143033202100000,NW 333,Residential,21420,0,0,21420
143033202200000,NW 333,Residential,16957,74640,0,91597
143033202400000,NW 333,Residential,28373,83674,0,112047
143033202500000,NW 333,Residential,27720,102573,0,130293
143033202600000,NW 333,Residential,28169,92692,0,120861
143033202700000,NW 333,Residential,34658,57142,0,91800
143033202800000,NW 333,Residential,33966,116754,0,150720
143033202900000,NW 333,Residential,34200,84950,0,119150
143033203000000,NW 333,Residential,30348,125810,0,156158
143033203100000,NW 333,Residential,28800,103410,0,132210
143033203200000,NW 333,Residential,40180,43087,0,83267
143033203300000,NW 333,Residential,41210,79986,0,121196
143033300100000,SW 406,Residential,32742,84867,0,117609
143033300200000,SW 406,Residential,30548,97727,0,128275
143033300300000,SW 406,Residential,40250,168002,0,208252
143033300400000,SW 406,Residential,40250,147344,0,187594
143033300500000,SW 406,Residential,40250,112382,0,152632
143033300600000,SW 406,Residential,40077,135240,0,175317
143033400100000,SW 406,Residential,29376,92732,0,122108
143033400200000,SW 406,Residential,27968,89294,0,117262
143033400300000,SW 406,Residential,36890,125337,0,162227
143033400400000,SW 406,Residential,36720,117250,0,153970
143033400500000,SW 406,Residential,35700,112998,0,148698
143033400600000,E-40 CHURCHES,Exempt,224640,0,631452,856092
143033400700000,SW 406,Residential,45050,89061,0,134111
143033400800000,SW 406,Residential,37834,123226,0,161060
143033400900000,SW 406,Residential,37584,99756,0,137340
143033401000000,SW 406,Residential,4296,0,0,4296
143033500100000,SW 406,Residential,32647,100384,0,133031
143035100100000,SW 406,Residential,39100,115506,0,154606
143035100200000,SW 406,Residential,37950,106593,0,144543
143035100300000,SW 406,Residential,36417,94783,0,131200
143035100400000,SW 406,Residential,34560,120775,0,155335
143035100500000,SW 406,Residential,30400,90573,0,120973
143035200100000,SW 406,Residential,31040,114127,0,145167
143035200200000,SW 406,Residential,31040,88900,0,119940
143035200300000,SW 406,Residential,27895,75310,0,103205
143035200400000,SW 406,Residential,28320,92254,0,120574
143035200500000,SW 406,Residential,29500,70872,0,100372
143035200600000,SW 406,Residential,30862,87676,0,118538
143035200700000,SW 406,Residential,32012,89320,0,121332
143035200800000,SW 406,Residential,32098,92830,0,124928
143035300100000,SW 406,Residential,30315,81904,0,112219
143035300200000,SW 406,Residential,42476,144725,0,187201
143035300300000,SW 406,Residential,33048,110384,0,143432
143035300400000,SW 406,Residential,25864,90762,0,116626
143035300500000,SW 406,Residential,30090,104947,0,135037
143035300600000,SW 406,Residential,30090,79004,0,109094
143035300700000,COMM SW,Commercial,102390,0,118479,220869
143035300800000,COMM SW,Commercial,35694,0,594826,630520
143035300900000,SW 406,Residential,33948,69902,0,103850
143035301000000,SW 406,Residential,33948,54947,0,88895
143035301100000,SW 406,Residential,31901,92039,0,123940
143035301200000,SW 406,Residential,30315,93857,0,124172
143035301300000,SW 406,Residential,30315,82033,0,112348
143035301400000,SW 406,Residential,30315,86427,0,116742
143035301500000,SW 406,Residential,30315,86900,0,117215
143035301600000,SW 406,Residential,30315,86472,0,116787
143035301700000,SW 406,Residential,30315,86935,0,117250
143035301800000,SW 406,Residential,30315,94722,0,125037
143035301900000,SW 406,Residential,30315,81702,0,112017
143035400100000,SW 406,Residential,31040,96170,0,127210
143035400200000,SW 406,Residential,31040,86604,0,117644
143035400300000,SW 406,Exempt,56450,0,167681,224131
143035400400000,SW 406,Residential,30862,82882,0,113744
143035400500000,SW 406,Residential,30090,91225,0,121315
143035400600000,SW 406,Residential,28910,81736,0,110646
143035400700000,SW 406,Residential,27895,88889,0,116784
143035400800000,SW 406,Residential,33370,101034,0,134404
143035400900000,SW 406,Residential,30315,104909,0,135224
143035401000000,SW 406,Residential,30315,67900,0,98215
143035401100000,SW 406,Residential,30315,102722,0,133037
143035401200000,SW 406,Residential,30315,99173,0,129488
143035401300000,SW 406,Residential,31767,88212,0,119979
143035401400000,SW 406,Residential,43077,112366,0,155443
143035401500000,SW 406,Residential,40147,101217,0,141364
143035401600000,SW 406,Residential,25660,77497,0,103157
143035401700000,SW 406,Residential,25500,106707,0,132207
143035401800000,SW 406,Residential,32640,91663,0,124303
143035401900000,SW 406,Residential,32640,87974,0,120614
143035402000000,SW 406,Residential,32640,91440,0,124080
143035402100000,SW 406,Residential,32640,91361,0,124001
143035500100000,SW 406,Residential,31680,74618,0,106298
143035500200000,SW 406,Residential,31680,92473,0,124153
143035500300000,SW 406,Residential,36720,96911,0,133631
143035500400000,SW 406,Residential,36802,88111,0,124913
143035600100000,E-70 CHARITY OTHER,Exempt,96660,0,404707,501367
143035600200000,SW 406,Residential,38400,129687,0,168087
143035600300000,CONVERSIONS,Commercial,28350,0,61720,90070
143035600400000,SW 406,Residential,37066,121218,0,158284
143035600500000,SW 406,Residential,42914,104239,0,147153
143035600600000,SW 406,Residential,38080,107879,0,145959
143035600700000,SW 406,Residential,34272,89567,0,123839
143035600800000,SW 406,Residential,34711,0,0,34711
143035600900000,COMM SW,Commercial,126360,0,312403,438763
143035601000000,COMM SW,Commercial,241650,0,247788,489438
143035601100000,COMM SW,Commercial,278100,0,317394,595494
143035601200000,E-05 STATE,Exempt,0,0,0,0
143035601300000,COMM SW,Commercial,183605,0,269814,453419
143035601400000,COMM SW,Commercial,96846,0,72829,169675
143035601500000,COMM SW,Commercial,373680,0,858722,1232402
143035601600000,COMM SW,Commercial,179820,0,434190,614010
143035601602000,COMM SW,Commercial,0,0,29159,29159
143035601700000,COMM SW,Commercial,244080,0,155920,400000
143035601800000,COMM SW,Commercial,35046,0,0,35046
143035601900000,COMM SW,Commercial,534600,0,415400,950000
143037600100000,SW 427,Residential,32445,92982,0,125427
143037600200000,SW 427,Residential,32130,90409,0,122539
143037600300000,SW 427,Residential,31815,99526,0,131341
143037600400000,SW 427,Residential,32094,109380,0,141474
143037600500000,SW 427,Residential,31285,110550,0,141835
143037600600000,SW 427,Residential,31678,91345,0,123023
143037600700000,SW 427,Residential,31806,93976,0,125782
143037600800000,SW 427,Residential,31445,95770,0,127215
143037600900000,SW 427,Residential,30555,109887,0,140442
143037601000000,SW 427,Residential,30555,87618,0,118173
143037601100000,SW 427,Residential,31472,96327,0,127799
143037700100000,Empty,Exempt,0,0,0,0
143037700200000,SW 406,Residential,37800,94566,0,132366
143037700300000,SW 406,Residential,40320,132091,0,172411
143037700400000,SW 406,Residential,29925,0,0,29925
143037700500000,SW 406,Residential,29925,76656,0,106581
143037700600000,SW 406,Residential,31008,66914,0,97922
143037700700000,SW 406,Residential,31008,89299,0,120307
143037700800000,SW 406,Residential,33102,128942,0,162044
143037700900000,SW 406,Residential,28080,86079,0,114159
143037701000000,SW 406,Residential,32538,138836,0,171374
143037701100000,SW 406,Residential,32640,145788,0,178428
143037701300000,SW 406,Residential,39718,85751,0,125469
143037701400000,SW 427,Residential,31536,96814,0,128350
143037701500000,SW 427,Residential,31536,121624,0,153160
143037701600000,SW 427,Residential,32951,95179,0,128130
143037701700000,SW 427,Residential,33179,90570,0,123749
143037701800000,SW 427,Residential,32915,101576,0,134491
143037701900000,SW 427,Residential,33517,106091,0,139608
143037702000000,SW 427,Residential,32100,94546,0,126646
143037702100000,SW 427,Residential,35007,95045,0,130052
143037702200000,SW 427,Residential,31344,94118,0,125462
143037702300000,SW 427,Residential,31497,89655,0,121152
143037800100000,SW 406,Residential,31080,127820,0,158900
143037800200000,SW 406,Residential,55750,249330,0,305080
143037800300000,SW 406,Residential,32099,89399,0,121498
143037900100000,SW 406,Residential,32412,118795,0,151207
143037900200000,SW 406,Residential,33061,92276,0,125337
143037900300000,SW 406,Residential,32679,77591,0,110270
143037900400000,SW 406,Residential,28080,69600,0,97680
143037900500000,SW 406,Residential,36504,54098,0,90602
143037900600000,SW 406,Residential,33696,64369,0,98065
143037900700000,SW 406,Residential,33696,129995,0,163691
143037900800000,SW 406,Residential,32844,110752,0,143596
143037900900000,SW 406,Residential,32640,81975,0,114615
143037901000000,SW 406,Residential,32412,81641,0,114053
143038000100000,COMM SW,Commercial,118800,0,76140,194940
143038000200000,SW 406,Residential,32534,44681,0,77215
143038000300000,SW 406,Residential,33264,73875,0,107139
143038000500000,SW 406,Residential,41250,90548,0,131798
143038000600000,SW 406,Residential,35531,47264,0,82795
143038000700000,SW 406,Residential,34500,122896,0,157396
143038000800000,SW 406,Residential,43500,71860,0,115360
143038000802000,COMM SW,Commercial,0,0,19534,19534
143038000900000,APTS SW,Commercial,109080,0,1231985,1341065
143038001000000,COMM SW,Commercial,97200,0,0,97200
143038001100000,COMM SW,Commercial,172500,0,0,172500
143038001200000,COMM SW,Commercial,126387,0,243144,369531
143038001300000,COMM SW,Commercial,57265,0,80908,138173
143038001400000,COMM SW,Commercial,102114,0,248789,350903
143038001500000,COMM SW,Commercial,354931,0,25069,380000
143038100100000,COMM SW,Commercial,123323,0,241898,365221
143038100200000,COMM SW,Commercial,270000,0,576772,846772
143040100100000,SW 405,Residential,20580,79877,0,100457
143040100200000,SW 405,Residential,19861,70179,0,90040
143040100300000,SW 405,Residential,19861,64109,0,83970
143040100400000,SW 405,Residential,19861,57110,0,76971
143040100500000,SW 405,Residential,19861,85524,0,105385
143040100600000,SW 405,Residential,19861,69028,0,88889
143040100700000,SW 405,Residential,19861,57945,0,77806
143040100800000,SW 405,Residential,19861,62163,0,82024
143040100900000,SW 405,Residential,19861,72361,0,92222
143040101000000,SW 405,Residential,19861,56990,0,76851
143040101100000,SW 405,Residential,19861,63278,0,83139
143040101200000,SW 405,Residential,19861,61187,0,81048
143040101300000,SW 405,Residential,19861,68842,0,88703
143040101400000,SW 405,Residential,19861,70632,0,90493
143040101500000,SW 405,Residential,19861,96275,0,116136
143040101600000,SW 405,Residential,19861,56303,0,76164
143040101700000,SW 405,Residential,19600,62599,0,82199
143040101800000,SW 405,Residential,19600,76274,0,95874
143040101900000,SW 405,Residential,19600,66412,0,86012
143040102000000,SW 405,Residential,24234,58523,0,82757
143040102100000,SW 405,Residential,28924,91627,0,120551
143040102200000,SW 405,Residential,27564,60774,0,88338
143040102300000,SW 405,Residential,27564,70088,0,97652
143040102400000,SW 405,Residential,27564,61813,0,89377
143040102500000,SW 405,Residential,27564,69307,0,96871
143040102600000,SW 405,Residential,27564,65748,0,93312
143040102700000,SW 405,Residential,27564,56115,0,83679
143040102800000,SW 405,Residential,27564,81031,0,108595
143040102900000,SW 405,Residential,27564,71890,0,99454
143040103000000,SW 405,Residential,27564,71868,0,99432
143040103100000,SW 405,Residential,27564,58646,0,86210
143040103200000,SW 405,Residential,27564,92134,0,119698
143040103300000,SW 405,Residential,27564,67534,0,95098
143040103400000,SW 405,Residential,27564,50477,0,78041
143040103500000,SW 405,Residential,27564,69280,0,96844
143040200100000,SW 405,Residential,22230,70213,0,92443
143040200200000,SW 405,Residential,28767,74920,0,103687
143040200300000,SW 405,Residential,25690,61823,0,87513
143040200400000,SW 405,Residential,24558,53230,0,77788
143040200500000,SW 405,Residential,24700,72033,0,96733
143040200600000,SW 405,Residential,25441,72755,0,98196
143040200700000,SW 405,Residential,24453,78132,0,102585
143040200800000,SW 405,Residential,26034,104068,0,130102
143040200900000,SW 405,Residential,32752,49828,0,82580
143040201000000,SW 405,Residential,36180,112880,0,149060
143040201100000,SW 405,Residential,39075,106555,0,145630
143040201200000,SW 405,Residential,28850,102321,0,131171
143040201300000,SW 405,Residential,31089,103653,0,134742
143040201400000,SW 405,Residential,31350,78791,0,110141
143040201500000,SW 405,Residential,29355,87597,0,116952
143040201600000,SW 405,Residential,29575,82838,0,112413
143040201700000,SW 405,Residential,28652,68400,0,97052
143040201800000,SW 405,Residential,25577,90249,0,115826
143040201900000,SW 405,Residential,25393,80347,0,105740
143040202000000,SW 405,Residential,27239,75133,0,102372
143040202100000,SW 405,Residential,22624,53712,0,76336
143040202200000,SW 405,Residential,23028,67642,0,90670
143040202300000,SW 405,Residential,22440,52645,0,75085
143040202400000,SW 405,Residential,22440,98138,0,120578
143040202500000,SW 405,Residential,23484,74586,0,98070
143040202600000,SW 405,Residential,22180,85988,0,108168
143040202700000,SW 405,Residential,22394,75928,0,98322
143040202800000,SW 405,Residential,22394,66835,0,89229
143040202900000,SW 405,Residential,21780,78992,0,100772
143040203000000,SW 405,Residential,23187,59678,0,82865
143040203100000,SW 405,Residential,21466,82024,0,103490
143040300100000,SW 405,Residential,28283,61339,0,89622
143040300200000,SW 405,Residential,28512,71416,0,99928
143040300300000,SW 405,Residential,28952,74095,0,103047
143040300400000,SW 405,Residential,28522,72029,0,100551
143040300500000,SW 405,Residential,29040,57166,0,86206
143040300600000,SW 405,Residential,28635,61999,0,90634
143040300700000,SW 405,Residential,27621,69255,0,96876
143040300800000,SW 405,Residential,28943,70331,0,99274
143040300900000,SW 405,Residential,28779,62710,0,91489
143040301000000,SW 405,Residential,27954,70202,0,98156
143040301100000,SW 405,Residential,28081,76035,0,104116
143040301200000,SW 405,Residential,28276,69701,0,97977
143040301300000,SW 405,Residential,27500,67671,0,95171
143040301400000,SW 405,Residential,29172,82667,0,111839
143040400100000,SW 405,Residential,30553,73468,0,104021
143040400200000,SW 405,Residential,30553,63517,0,94070
143040400300000,SW 405,Residential,30553,67399,0,97952
143040400400000,SW 405,Residential,30553,102375,0,132928
143040400500000,SW 405,Residential,30553,65752,0,96305
143040400600000,SW 405,Residential,30553,67949,0,98502
143040400700000,SW 405,Residential,30553,65658,0,96211
143040400800000,SW 405,Residential,30553,61564,0,92117
143040400900000,SW 405,Residential,31492,82898,0,114390
143040401000000,SW 405,Residential,30793,95778,0,126571
143040401100000,SW 405,Residential,30163,83212,0,113375
143040401200000,SW 405,Residential,30383,54700,0,85083
143040401300000,SW 405,Residential,31350,104009,0,135359
143040401400000,SW 405,Residential,30814,76950,0,107764
143040401500000,SW 405,Residential,31762,73473,0,105235
143040401600000,SW 405,Residential,29770,99380,0,129150
143040401700000,SW 405,Residential,28435,64699,0,93134
143040401800000,SW 405,Residential,29113,70470,0,99583
143040401900000,SW 405,Residential,30553,110005,0,140558
143040402000000,SW 405,Residential,30553,80565,0,111118
143040402100000,SW 405,Residential,30553,110701,0,141254
143040402200000,SW 405,Residential,30553,72969,0,103522
143040402300000,SW 405,Residential,30553,99137,0,129690
143040402400000,SW 405,Residential,30553,71520,0,102073
143040402500000,SW 405,Residential,30553,88780,0,119333
143040402600000,SW 405,Residential,30553,85427,0,115980
143040402700000,SW 405,Residential,30553,90698,0,121251
143040402800000,SW 405,Residential,28875,82044,0,110919
143040500100000,SW 405,Residential,32961,84214,0,117175
143040500200000,SW 405,Residential,29046,58938,0,87984
143040500300000,SW 405,Residential,21077,50746,0,71823
143040500400000,SW 405,Residential,23520,54719,0,78239
143040500500000,SW 405,Residential,21168,63824,0,84992
143040500600000,SW 405,Residential,23520,65089,0,88609
143040500700000,SW 405,Residential,23520,68288,0,91808
143040500800000,SW 405,Residential,23128,78089,0,101217
143040500900000,SW 405,Residential,23128,80023,0,103151
143040501000000,SW 405,Residential,23128,72354,0,95482
143040501100000,SW 405,Residential,29903,59439,0,89342
143040501200000,SW 405,Residential,29903,66612,0,96515
143040501300000,SW 405,Residential,29903,68787,0,98690
143040501400000,SW 405,Residential,29903,69755,0,99658
143040501500000,SW 405,Residential,29903,71520,0,101423
143040501600000,SW 405,Residential,30409,60873,0,91282
143040501700000,SW 405,Residential,29343,77431,0,106774
143040501800000,SW 405,Residential,29343,92795,0,122138
143040501900000,SW 405,Residential,29343,65814,0,95157
143040502000000,SW 405,Residential,29343,80257,0,109600
143040502100000,SW 405,Residential,29343,77614,0,106957
143040502200000,SW 405,Residential,29343,73054,0,102397
143040600100000,Empty,Exempt,0,0,0,0
143040700100000,SW 405,Residential,28916,66212,0,95128
143040700200000,SW 405,Residential,29343,75776,0,105119
143040700300000,SW 405,Residential,29343,89759,0,119102
143040700400000,SW 405,Residential,29343,80279,0,109622
143040700500000,SW 405,Residential,29343,74417,0,103760
143040700600000,SW 405,Residential,29343,106482,0,135825
143040700700000,SW 405,Residential,29343,72993,0,102336
143040700800000,SW 405,Residential,29343,94302,0,123645
143040700900000,SW 405,Residential,29343,96309,0,125652
143040701000000,SW 405,Residential,26675,65950,0,92625
143040701100000,SW 405,Residential,28809,67282,0,96091
143040701200000,SW 405,Residential,29343,97372,0,126715
143040701300000,SW 405,Residential,28809,82262,0,111071
143040701400000,SW 405,Residential,29700,114850,0,144550
143040701500000,SW 405,Residential,28809,104479,0,133288
143040701600000,SW 405,Residential,28569,65599,0,94168
143040701700000,SW 405,Residential,32017,76702,0,108719
143040701800000,SW 405,Residential,30080,68011,0,98091
143040701900000,SW 405,Residential,30600,87224,0,117824
143040702000000,SW 405,Residential,33700,63665,0,97365
143042600100000,SW 405,Residential,26724,86045,0,112769
143042600200000,SW 405,Residential,28500,69761,0,98261
143042600300000,SW 405,Residential,29331,70522,0,99853
143042600400000,SW 405,Residential,29331,97313,0,126644
143042600500000,SW 405,Residential,29331,76647,0,105978
143042600600000,SW 405,Residential,29331,67374,0,96705
143042600700000,SW 405,Residential,29331,93721,0,123052
143042600800000,SW 405,Exempt,29331,0,89404,118735
143042600900000,SW 405,Residential,28737,58931,0,87668
143042601000000,SW 405,Residential,28737,71971,0,100708
143042601100000,SW 405,Residential,29700,74750,0,104450
143042601200000,SW 405,Residential,29700,65897,0,95597
143042601300000,SW 405,Residential,29700,63810,0,93510
143042601400000,SW 405,Residential,30800,89200,0,120000
143042601500000,SW 405,Residential,29700,85402,0,115102
143042601600000,SW 405,Residential,29700,90923,0,120623
143042601700000,SW 405,Residential,26724,77885,0,104609
143042601800000,SW 405,Residential,26724,111488,0,138212
143042601900000,SW 405,Residential,26724,75323,0,102047
143042602000000,SW 405,Residential,26724,83251,0,109975
143042700100000,SW 405,Residential,30377,107341,0,137718
143042700200000,SW 405,Residential,25688,57209,0,82897
143042700300000,SW 405,Residential,25992,68798,0,94790
143042700400000,SW 405,Residential,27360,75857,0,103217
143042700500000,SW 405,Residential,27360,112925,0,140285
143042700600000,SW 405,Residential,32832,95908,0,128740
143042700700000,SW 405,Residential,27360,83908,0,111268
143042700800000,SW 405,Residential,27360,33990,0,61350
143042700900000,SW 405,Residential,27360,62842,0,90202
143042701000000,SW 405,Residential,27250,19344,0,46594
143042701100000,SW 405,Residential,28451,84225,0,112676
143042701200000,SW 405,Residential,25587,49391,0,74978
143042701300000,SW 405,Residential,25793,56925,0,82718
143042701400000,SW 405,Residential,24250,51299,0,75549
143042701500000,SW 405,Residential,27600,50920,0,78520
143042701600000,SW 405,Residential,30000,61964,0,91964
143042701700000,SW 405,Residential,26633,69879,0,96512
143042701800000,SW 405,Residential,25783,53258,0,79041
143042701900000,SW 405,Residential,27300,52805,0,80105
143042702000000,SW 405,Residential,27300,54178,0,81478
143042702100000,SW 405,Residential,27300,63171,0,90471
143042702200000,SW 405,Residential,27300,51407,0,78707
143042702300000,SW 405,Residential,27922,56597,0,84519
143042702400000,SW 405,Residential,28160,44963,0,73123
143042800100000,NW 333,Residential,45700,65576,0,111276
143042800200000,NW 333,Residential,43680,134947,0,178627
143042900100000,SW 405,Residential,27645,77592,0,105237
143042900200000,SW 405,Residential,26675,54391,0,81066
143042900300000,SW 405,Residential,26675,53468,0,80143
143042900400000,SW 405,Residential,26675,56668,0,83343
143042900500000,SW 405,Residential,26675,64991,0,91666
143042900600000,SW 405,Residential,26675,57081,0,83756
143042900700000,SW 405,Residential,26675,53720,0,80395
143042900800000,SW 405,Residential,28809,67227,0,96036
143042900900000,SW 405,Residential,28382,56974,0,85356
143042901000000,SW 405,Residential,29022,52661,0,81683
143042901100000,SW 405,Residential,29022,38496,0,67518
143042901200000,SW 405,Residential,27742,60232,0,87974
143042901300000,SW 405,Residential,27742,68283,0,96025
143042901400000,SW 405,Residential,27742,54641,0,82383
143042901500000,SW 405,Residential,27742,49135,0,76877
143042901600000,SW 405,Residential,27742,52080,0,79822
143042901700000,SW 405,Residential,27742,50500,0,78242
143042901800000,SW 405,Residential,27742,76456,0,104198
143042901900000,SW 405,Residential,27742,54931,0,82673
143042902000000,SW 405,Residential,27645,56273,0,83918
143042902100000,SW 405,Residential,27645,67059,0,94704
143042902200000,SW 405,Residential,27645,45307,0,72952
143043000100000,SW 405,Residential,29904,55942,0,85846
143043000200000,SW 405,Residential,29716,60679,0,90395
143043000300000,SW 405,Residential,30544,63774,0,94318
143043000400000,SW 405,Residential,29464,47213,0,76677
143043000500000,SW 405,Residential,30257,56317,0,86574
143043000600000,SW 405,Residential,29304,65748,0,95052
143043000700000,SW 405,Residential,30015,58737,0,88752
143043000800000,SW 405,Residential,27260,53887,0,81147
143043000900000,SW 405,Residential,30600,63269,0,93869
143043001000000,SW 405,Residential,29820,56071,0,85891
143043100100000,SW 405,Residential,30318,75738,0,106056
143043100200000,SW 405,Residential,32082,101353,0,133435
143043100300000,SW 405,Residential,29240,54136,0,83376
143043100400000,SW 405,Residential,27982,63009,0,90991
143043100500000,SW 405,Residential,30148,57346,0,87494
143043100600000,SW 405,Residential,29450,52331,0,81781
143043100700000,SW 405,Residential,29453,62161,0,91614
143043100800000,SW 405,Residential,29550,50149,0,79699
143043100900000,SW 405,Residential,29237,74507,0,103744
143043101000000,SW 405,Residential,25867,46891,0,72758
143043101100000,SW 405,Residential,30300,85015,0,115315
143043101200000,SW 405,Residential,32051,84757,0,116808
143043101300000,SW 405,Residential,25060,96255,0,121315
143043101400000,SW 405,Residential,24966,153333,0,178299
143043101500000,SW 405,Residential,24000,68048,0,92048
143043101600000,SW 405,Residential,24000,89785,0,113785
143043101700000,SW 405,Residential,24000,81544,0,105544
143043101800000,SW 405,Residential,24000,66790,0,90790
143043101900000,SW 405,Residential,24000,96755,0,120755
143043102000000,SW 405,Residential,24750,100479,0,125229
143043102100000,SW 405,Residential,25899,71609,0,97508
143043200100000,SW 405,Residential,27900,54657,0,82557
143043200200000,SW 405,Residential,29240,53533,0,82773
143043200300000,SW 405,Residential,29927,54309,0,84236
143043200400000,SW 405,Residential,31850,72742,0,104592
143043200500000,SW 405,Residential,32648,60656,0,93304
143043200600000,SW 405,Residential,28737,50263,0,79000
143043300100000,SW 405,Residential,26050,71238,0,97288
143043300200000,SW 405,Residential,25750,58982,0,84732
143043300300000,SW 405,Residential,25750,55737,0,81487
143043300400000,SW 405,Residential,25750,53160,0,78910
143043300500000,SW 405,Residential,25750,65483,0,91233
143043300600000,SW 405,Residential,25750,48435,0,74185
143043300700000,SW 405,Residential,25750,57118,0,82868
143043300800000,SW 405,Residential,25750,52975,0,78725
143043300900000,SW 405,Residential,25750,52752,0,78502
143043301000000,SW 405,Residential,25750,62441,0,88191
143043301100000,SW 405,Residential,25750,64461,0,90211
143043301200000,SW 405,Residential,25750,66276,0,92026
143043301300000,SW 405,Residential,25862,56025,0,81887
143043301400000,SW 405,Residential,26258,57001,0,83259
143043301500000,SW 405,Residential,25000,55018,0,80018
143043301600000,SW 405,Residential,25000,46826,0,71826
143043301700000,SW 405,Residential,25000,50874,0,75874
143043301800000,SW 405,Residential,25000,53488,0,78488
143043301900000,SW 405,Residential,25000,53411,0,78411
143043302000000,SW 405,Residential,25000,68814,0,93814
143043302100000,SW 405,Residential,25000,45244,0,70244
143043302200000,SW 405,Residential,25000,50760,0,75760
143043302300000,SW 405,Residential,25000,54159,0,79159
143043302400000,SW 405,Residential,25000,65288,0,90288
143043302500000,SW 405,Residential,25000,55393,0,80393
143043302600000,SW 405,Residential,24717,58800,0,83517
143043400100000,SW 405,Residential,23128,64860,0,87988
143043400200000,SW 405,Residential,23128,65671,0,88799
143043400300000,SW 405,Residential,20900,64913,0,85813
143043400400000,SW 405,Residential,20900,70550,0,91450
143043400500000,SW 405,Residential,26173,72723,0,98896
143043400600000,SW 405,Residential,31237,80820,0,112057
143043500100000,SW 405,Residential,24509,51676,0,76185
143043500200000,SW 405,Residential,24250,55692,0,79942
143043500300000,SW 405,Residential,24250,57959,0,82209
143043500400000,SW 405,Residential,24250,65570,0,89820
143043500500000,SW 405,Residential,24250,64468,0,88718
143043500600000,SW 405,Residential,24250,57155,0,81405
143043500700000,SW 405,Residential,24250,63533,0,87783
143043500800000,SW 405,Residential,24250,55077,0,79327
143043500900000,SW 405,Residential,24250,59184,0,83434
143043501000000,SW 405,Residential,24250,57971,0,82221
143043501100000,SW 405,Residential,24250,56745,0,80995
143043501200000,SW 405,Residential,24250,55911,0,80161
143043501300000,SW 405,Residential,25805,66340,0,92145
143043501400000,SW 427,Residential,31911,82525,0,114436
143043501500000,SW 427,Residential,31951,109667,0,141618
143043501600000,SW 427,Residential,38178,158722,0,196900
143043501700000,SW 427,Residential,32470,109561,0,142031
143043501800000,SW 405,Residential,30300,58334,0,88634
143043501900000,SW 405,Residential,30300,80571,0,110871
143043502000000,SW 405,Residential,30300,85011,0,115311
143043502100000,SW 405,Residential,30300,72143,0,102443
143043502200000,SW 405,Residential,30300,88926,0,119226
143045100100000,SW 405,Residential,30000,54289,0,84289
143045200100000,SW 405,Residential,32980,93756,0,126736
143045200200000,SW 405,Residential,32246,88352,0,120598
143045200300000,SW 405,Residential,23520,56860,0,80380
143045200400000,SW 405,Residential,23520,81337,0,104857
143045200500000,SW 405,Residential,23520,90573,0,114093
143045200600000,SW 405,Residential,23520,79819,0,103339
143045200700000,SW 405,Residential,23520,87577,0,111097
143045200800000,SW 405,Residential,26251,101602,0,127853
143045200900000,SW 406,Residential,41184,262958,0,304142
143045201000000,SW 406,Residential,57150,115966,0,173116
143045201100000,COMM SW,Commercial,45924,0,33416,79340
143045201200000,COMM SW,Commercial,88244,0,48201,136445
143045201300000,COMM SW,Commercial,631260,0,0,631260
143045201400000,COMM SW,Commercial,177444,0,476242,653686
143045201500000,SW 405,Residential,32414,82637,0,115051
143045201600000,SW 405,Residential,31565,54857,0,86422
143045201700000,SW 405,Residential,31110,123751,0,154861
143045201800000,SW 405,Residential,31860,86052,0,117912
143045201900000,SW 405,Residential,29970,71293,0,101263
143045202000000,SW 405,Residential,30900,77572,0,108472
143045202100000,SW 405,Residential,30600,68408,0,99008
143045202200000,SW 405,Residential,30600,88329,0,118929
143045202300000,SW 405,Residential,30600,71905,0,102505
143045202400000,SW 405,Residential,30600,72621,0,103221
143045202500000,Empty,Exempt,0,0,0,0
143045202600000,Empty,Exempt,0,0,0,0
143045202700000,SW 405,Residential,32560,73579,0,106139
143045202800000,SW 405,Residential,31724,80495,0,112219
143045202900000,SW 405,Residential,32010,74534,0,106544
143045203000000,SW 405,Residential,30960,99638,0,130598
143045203100000,SW 405,Residential,30742,77501,0,108243
143045203200000,SW 405,Residential,30393,79797,0,110190
143045203300000,SW 405,Residential,29100,74566,0,103666
143045203400000,SW 405,Residential,29100,66307,0,95407
143045203500000,SW 405,Residential,29100,82736,0,111836
143045203600000,SW 405,Residential,29100,76832,0,105932
143045203700000,SW 405,Residential,29100,67449,0,96549
143045203800000,SW 405,Residential,29100,65163,0,94263
143045203900000,SW 405,Residential,26190,80264,0,106454
143045300100000,SW 406,Residential,26617,71559,0,98176
143045300200000,SW 406,Residential,31438,84135,0,115573
143045300300000,SW 406,Residential,31500,82036,0,113536
143045300400000,SW 406,Residential,31500,123096,0,154596
143045300500000,SW 406,Residential,31500,87017,0,118517
143045300600000,SW 406,Residential,34440,529,0,34969
143045300700000,SW 427,Residential,31302,90414,0,121716
143045300800000,SW 427,Residential,31302,86887,0,118189
143045300900000,SW 427,Residential,29243,95034,0,124277
143045301000000,SW 427,Residential,32689,109966,0,142655
143045301100000,SW 406,Residential,47359,99131,0,146490
143045301200000,SW 427,Residential,31500,89126,0,120626
143045301300000,SW 427,Residential,30555,104878,0,135433
143045301500000,SW 406,Residential,29270,85835,0,115105
143045301600000,SW 406,Residential,31559,122819,0,154378
143045301700000,SW 406,Residential,35644,101245,0,136889
143045301800000,SW 406,Residential,30923,114576,0,145499
143045400100000,SW 427,Residential,32737,86560,0,119297
143045400200000,SW 427,Residential,32607,87783,0,120390
143045400300000,SW 427,Residential,31690,101917,0,133607
143045500100000,SW 405,Residential,30084,67999,0,98083
143045500200000,SW 405,Residential,30167,54565,0,84732
143045500300000,SW 405,Residential,30167,63591,0,93758
143045500400000,SW 405,Residential,30167,72247,0,102414
143045500500000,SW 405,Residential,30833,80343,0,111176
143045500600000,SW 405,Residential,30000,85337,0,115337
143045500700000,SW 405,Residential,30000,88500,0,118500
143045600800000,SW 405,Residential,33197,106859,0,140056
143045600900000,SW 405,Residential,29981,89745,0,119726
143045601000000,SW 405,Residential,30542,84277,0,114819
143045601100000,SW 405,Residential,32785,101579,0,134364
143045601200000,SW 405,Residential,30600,98162,0,128762
143045601300000,SW 405,Residential,30300,93589,0,123889
143045601400000,SW 405,Residential,30300,94350,0,124650
143045601500000,SW 405,Residential,30300,72627,0,102927
143045601600000,SW 405,Residential,30300,81465,0,111765
143045601700000,SW 405,Residential,30300,72791,0,103091
143045601800000,SW 405,Residential,30300,92990,0,123290
143045601900000,SW 405,Residential,30300,82777,0,113077
143045602000000,SW 405,Residential,29963,84277,0,114240
143045602100000,SW 405,Residential,29700,81771,0,111471
143045602200000,SW 405,Residential,29700,86916,0,116616
143045602300000,SW 405,Residential,29700,98657,0,128357
143045602400000,SW 405,Residential,29700,87137,0,116837
143045602500000,SW 405,Residential,29700,85787,0,115487
143045602600000,SW 405,Residential,30995,82005,0,113000
143045602700000,SW 405,Residential,30590,109251,0,139841
143045700100000,Empty,Exempt,0,0,0,0
143047600100000,Empty,Exempt,0,0,0,0
143047600200000,CONVERSIONS,Commercial,9310,0,89115,98425
143047600300000,SW 405,Residential,31500,73373,0,104873
143047600400000,SW 405,Residential,30000,95996,0,125996
143047600500000,SW 405,Residential,30000,82043,0,112043
143047600600000,SW 405,Residential,30000,75384,0,105384
143047600700000,SW 405,Residential,30000,97601,0,127601
143047600800000,SW 405,Residential,30400,87894,0,118294
143047600900000,SW 405,Residential,30400,94589,0,124989
143047601000000,SW 405,Residential,30400,90624,0,121024
143047601100000,SW 405,Residential,30400,72942,0,103342
143047601200000,SW 405,Residential,30400,68673,0,99073
143047601300000,SW 405,Residential,30115,66655,0,96770
143047700100000,SW 405,Residential,32432,55718,0,88150
143047700200000,SW 405,Residential,30600,66507,0,97107
143047700300000,SW 405,Residential,30240,79435,0,109675
143047700400000,SW 405,Residential,29700,80178,0,109878
143047700500000,SW 405,Residential,29700,67775,0,97475
143047700600000,SW 405,Residential,29700,82283,0,111983
143047700700000,SW 405,Residential,30805,115203,0,146008
143047700800000,SW 405,Residential,32109,88903,0,121012
143047700900000,SW 405,Residential,31500,88414,0,119914
143047800100000,SW 405,Residential,30922,79031,0,109953
143047800200000,SW 405,Residential,30394,74149,0,104543
143047800300000,SW 405,Residential,29150,70272,0,99422
143047800400000,SW 405,Residential,31192,105492,0,136684
143047800500000,SW 405,Residential,30805,72195,0,103000
143047800600000,SW 405,Residential,29700,72495,0,102195
143047800700000,SW 405,Residential,31020,84557,0,115577
143047800800000,SW 405,Residential,31067,68735,0,99802
143110100100000,COMM SW,Commercial,120150,0,203593,323743
143110100200000,Empty,Other,0,0,0,0
143110100300000,COMM SW,Commercial,160650,0,81159,241809
143110100400000,COMM SW,Commercial,216000,0,298820,514820
143110100500000,COMM SW,Commercial,291384,0,134550,425934
143110200100000,COMM SW,Commercial,90936,0,27828,118764
143110200200000,COMM SW,Commercial,232200,0,278004,510204
143110300100000,COMM SW,Commercial,160650,0,114350,275000
143110300200000,COMM SW,Commercial,84240,0,304286,388526
143110300300000,COMM SW,Commercial,48600,0,137357,185957
143110300400000,COMM SW,Commercial,48600,0,67020,115620
143110300402000,COMM SW,Commercial,0,0,10581,10581
143110300500000,COMM SW,Commercial,130140,0,294436,424576
143110300600000,COMM SW,Commercial,71280,0,113854,185134
143110300700000,COMM SW,Commercial,24840,0,0,24840
143110300800000,COMM SW,Commercial,139050,0,430614,569664
143110300900000,COMM SW,Commercial,108270,0,122738,231008
143110301000000,COMM SW,Commercial,31943,0,191736,223679
143110301100000,COMM SW,Commercial,130140,0,224256,354396
143110301600000,SW 420,Residential,555250,0,0,555250
143110301700000,COMM SW,Commercial,186300,0,71945,258245
143112600100000,COMM SW,Commercial,167400,0,409376,576776
143112600200000,COMM SW,Commercial,86805,0,85568,172373
143112600300000,COMM SW,Commercial,89100,0,89968,179068
143112600400000,COMM SW,Commercial,79966,0,146193,226159
143112600700000,COMM SW,Commercial,283435,0,356565,640000
143112600800000,COMM SW,Commercial,276274,0,0,276274
143112700100000,COMM SW,Commercial,81810,0,176037,257847
143112700200000,COMM SW,Commercial,121905,0,150634,272539
143112700300000,COMM SW,Commercial,162675,0,394782,557457
143112700400000,SW 420,Residential,40976,0,0,40976
143112700500000,SW 420,Residential,41200,0,0,41200
143112700600000,SW 420,Residential,41600,0,0,41600
143112700700000,SW 420,Residential,40109,0,0,40109
143112700800000,SW 420,Residential,39576,0,0,39576
143112700900000,SW 420,Residential,33950,0,0,33950
143112800100000,COMM SW,Commercial,139455,0,219831,359286
143112800200000,COMM SW,Commercial,209250,0,282363,491613
143112800300000,COMM SW,Commercial,247050,0,209921,456971
143112800400000,COMM SW,Commercial,259200,0,193072,452272
143112800402000,COMM SW,Commercial,0,0,23610,23610
143112800500000,SW 420,Commercial,127526,0,110069,237595
143112800600000,SW 420,Residential,43824,0,0,43824
143112800700000,SW 420,Residential,39200,0,0,39200
143112800800000,SW 420,Residential,39200,0,0,39200
143112800900000,SW 420,Residential,42927,0,0,42927
143112801000000,SW 420,Residential,48510,0,0,48510
143112801100000,SW 420,Residential,48062,0,0,48062
143112801200000,SW 420,Residential,49400,0,0,49400
143112801300000,SW 420,Residential,43360,0,0,43360
143112801400000,SW 420,Residential,36734,0,0,36734
143112801500000,SW 420,Residential,36734,0,0,36734
143112801600000,SW 420,Residential,36734,0,0,36734
143112801700000,SW 420,Residential,93500,0,0,93500
143112900100000,SW 420,Residential,37461,0,0,37461
143112900200000,SW 420,Residential,37875,0,0,37875
143112900300000,SW 420,Residential,46460,0,0,46460
143112900400000,SW 420,Residential,45920,0,0,45920
143112900500000,SW 420,Residential,45220,0,0,45220
143112900600000,SW 420,Residential,44289,0,0,44289
143115100400000,SW 420,Residential,25440,103816,0,129256
143115100500000,SW 420,Residential,25440,74158,0,99598
143115100600000,SW 420,Residential,25440,113992,0,139432
143115100700000,SW 420,Residential,25440,103464,0,128904
143115100800000,SW 431,Residential,24422,122398,0,146820
143115100900000,SW 420,Residential,25440,82948,0,108388
143115101000000,SW 420,Residential,25160,53230,0,78390
143115101100000,SW 420,Residential,22950,92024,0,114974
143115101200000,SW 431,Residential,18725,53342,0,72067
143115101300000,SW 420,Residential,31238,83729,0,114967
143115101400000,SW 420,Residential,31238,80617,0,111855
143115101500000,SW 420,Residential,31238,150856,0,182094
143115101600000,SW 420,Residential,42350,19425,0,61775
143115101800000,SW 420,Residential,48332,261593,0,309925
143115101900000,SW 420,Residential,49678,189150,0,238828
143115102000000,SW 420,Residential,42101,0,0,42101
143115102200000,SW 420,Residential,65401,302353,0,367754
143115102300000,SW 420,Residential,46186,182979,0,229165
143115102400000,SW 420,Residential,45000,202525,0,247525
143115102500000,SW 420,Residential,45000,246471,0,291471
143115102600000,SW 420,Residential,36000,185187,0,221187
143115102700000,SW 420,Residential,32000,214138,0,246138
143115102800000,SW 420,Residential,31300,171095,0,202395
143115200100000,SW 420,Residential,117250,0,0,117250
143115200200000,SW 420,Residential,31000,125515,0,156515
143115200300000,SW 420,Residential,30110,132513,0,162623
143115200400000,SW 420,Residential,30600,115794,0,146394
143115200500000,SW 420,Residential,30600,134385,0,164985
143115200600000,SW 420,Residential,30600,96789,0,127389
143115200700000,SW 420,Residential,30600,90508,0,121108
143115200800000,SW 420,Residential,30600,100706,0,131306
143115200900000,SW 420,Residential,30600,106207,0,136807
143115201000000,SW 420,Residential,30600,158320,0,188920
143115201100000,SW 420,Residential,32640,118382,0,151022
143115201200000,SW 420,Residential,43369,172735,0,216104
143115201300000,SW 420,Residential,40800,0,0,40800
143115201400000,SW 420,Residential,40800,181851,0,222651
143115201500000,SW 420,Residential,45818,195270,0,241088
143115201600000,SW 420,Residential,47502,253518,0,301020
143115201700000,SW 420,Residential,45450,258531,0,303981
143115201800000,SW 420,Residential,45450,202899,0,248349
143115201900000,SW 420,Residential,45584,217931,0,263515
143115202000000,SW 420,Residential,30300,149207,0,179507
143115202100000,SW 420,Residential,30300,141937,0,172237
143115202200000,SW 420,Residential,30300,156679,0,186979
143115202300000,SW 420,Residential,30300,141455,0,171755
143115202400000,SW 420,Residential,30300,171540,0,201840
143115202500000,SW 420,Residential,30300,140989,0,171289
143115202600000,SW 420,Residential,30300,153327,0,183627
143115202700000,SW 420,Residential,30300,135375,0,165675
143115202800000,SW 420,Residential,32825,162955,0,195780
143115202900000,Empty,Exempt,0,0,0,0
143115203000000,SW 420,Residential,32825,174732,0,207557
143115203100000,SW 420,Residential,32825,171156,0,203981
143115203200000,SW 420,Residential,32825,186573,0,219398
143115203300000,SW 420,Residential,32148,143262,0,175410
143115203400000,SW 420,Residential,30300,173247,0,203547
143115203500000,SW 420,Residential,30300,139607,0,169907
143115203600000,SW 420,Residential,30300,122116,0,152416
143115203700000,SW 420,Residential,30300,0,0,30300
143115203800000,SW 420,Residential,35628,0,0,35628
143115203900000,SW 420,Residential,35628,176682,0,212310
143115204000000,SW 420,Residential,32825,141469,0,174294
143115204100000,SW 420,Residential,32825,139577,0,172402
143115204200000,SW 420,Residential,32825,135245,0,168070
143115204300000,SW 420,Residential,32825,170152,0,202977
143115204400000,SW 420,Residential,12500,0,0,12500
143115204500000,SW 420,Residential,44299,0,0,44299
143115300900000,SW 420,Residential,45734,231331,0,277065
143115400100000,SW 420,Residential,45004,222622,0,267626
143115400200000,SW 420,Residential,42005,208547,0,250552
143115400300000,SW 420,Residential,45004,185599,0,230603
143115500100000,SW 420,Residential,1250,0,0,1250
143115500200000,SW 420,Residential,30048,0,0,30048
143115500300000,SW 420,Residential,32194,160162,0,192356
143115500400000,SW 420,Residential,31013,124217,0,155230
143115500500000,SW 420,Residential,31013,152571,0,183584
143115500600000,SW 420,Residential,30048,133409,0,163457
143115500700000,SW 420,Residential,30048,174789,0,204837
143115500800000,SW 420,Residential,30048,161100,0,191148
143115500900000,SW 420,Residential,30048,154475,0,184523
143115501000000,SW 420,Residential,30048,138795,0,168843
143115501100000,SW 420,Residential,29588,150267,0,179855
143115600100000,SW 420,Residential,36304,170935,0,207239
143115600200000,SW 420,Residential,36304,177360,0,213664
143115600300000,SW 420,Residential,35779,0,0,35779
143115700100000,SW 420,Residential,35350,134387,0,169737
143115800100000,SW 420,Residential,38134,125992,0,164126
143115800200000,SW 420,Residential,35365,133274,0,168639
143115800300000,SW 420,Residential,37617,122242,0,159859
143117600200000,SW 420,Residential,25740,82283,0,108023
143117600300000,SW 420,Residential,25740,59180,0,84920
143117600400000,SW 420,Residential,23760,68742,0,92502
143117600500000,SW 420,Residential,31680,57850,0,89530
143117600600000,SW 420,Residential,25740,99804,0,125544
143117600700000,SW 420,Residential,27720,59597,0,87317
143117600800000,SW 420,Residential,25740,98561,0,124301
143117600900000,SW 420,Residential,20244,45013,0,65257
143117601000000,SW 420,Residential,29498,75368,0,104866
143117601100000,SW 420,Residential,18025,29052,0,47077
143117601300000,SW 420,Residential,32111,0,0,32111
143117601400000,SW 420,Residential,32320,201782,0,234102
143117601500000,SW 420,Residential,32320,171888,0,204208
143117601600000,SW 420,Residential,32640,175625,0,208265
143117601700000,SW 420,Residential,38520,165427,0,203947
143117601800000,SW 420,Residential,31212,149217,0,180429
143117601900000,SW 420,Residential,29478,185908,0,215386
143117602000000,SW 420,Residential,29867,244169,0,274036
143117602100000,SW 420,Residential,38078,153232,0,191310
143117602300000,SW 420,Residential,1140,0,0,1140
143117602400000,SW 420,Residential,36203,211633,0,247836
143117602500000,SW 420,Residential,28701,176043,0,204744
143117602600000,SW 420,Residential,28620,158554,0,187174
143117602700000,SW 420,Residential,29440,173837,0,203277
143117602800000,SW 420,Residential,29440,154845,0,184285
143117602900000,SW 420,Residential,30400,191899,0,222299
143117603000000,SW 420,Residential,32000,153088,0,185088
143117603100000,SW 420,Residential,32320,177558,0,209878
143117603200000,SW 420,Residential,32320,199549,0,231869
143117603300000,SW 420,Residential,32331,176147,0,208478
143117603400000,SW 420,Residential,30478,117558,0,148036
143117603500000,SW 420,Residential,30906,143014,0,173920
143117603600000,SW 420,Residential,30300,80494,0,110794
143117603700000,SW 420,Residential,30300,102473,0,132773
143117603800000,SW 420,Residential,30300,102971,0,133271
143117603900000,SW 420,Residential,30704,137462,0,168166
143117604000000,SW 420,Residential,31088,101392,0,132480
143117604100000,SW 420,Residential,31108,125739,0,156847
143117604200000,SW 420,Residential,31815,157319,0,189134
143117604300000,SW 420,Residential,32623,176100,0,208723
143117604400000,SW 420,Residential,30219,148884,0,179103
143117604500000,SW 420,Residential,31270,186136,0,217406
143117604600000,SW 420,Residential,31557,150506,0,182063
143117604800000,SW 420,Residential,30300,0,0,30300
143117604900000,Empty,Exempt,0,0,0,0
143117605000000,Empty,Exempt,0,0,0,0
143117605100000,SW 420,Residential,25480,0,0,25480
143117605200000,SW 420,Residential,25480,124293,0,149773
143117605300000,SW 420,Residential,25480,144688,0,170168
143117605400000,SW 420,Residential,25480,186245,0,211725
143117605600000,SW 420,Residential,58016,209719,0,267735
143117605700000,SW 420,Exempt,0,0,0,0
143117605800000,SW 420,Exempt,0,0,0,0
143117605900000,SW 420,Residential,62400,65434,0,127834
143117606000000,SW 420,Residential,6250,0,0,6250
143117700100000,SW 420,Residential,34340,211085,0,245425
143117700300000,SW 420,Residential,68150,124932,0,193082
143117700500000,SW 420,Residential,33769,225091,0,258860
143117700600000,SW 420,Residential,30300,134518,0,164818
143117700700000,SW 420,Residential,27270,105076,0,132346
143117700800000,SW 420,Residential,30300,112697,0,142997
143117700900000,SW 420,Residential,30300,0,0,30300
143117701000000,SW 420,Residential,30300,122820,0,153120
143117701100000,SW 420,Residential,30381,172207,0,202588
143117701200000,SW 420,Residential,30300,108870,0,139170
143117701300000,SW 420,Residential,36360,171551,0,207911
143117701400000,SW 420,Residential,540,0,0,540
143117701500000,SW 420,Residential,32623,210669,0,243292
143117701600000,SW 420,Residential,32280,191282,0,223562
143117701700000,SW 420,Residential,46027,253512,0,299539
143117701800000,SW 420,Residential,40668,222622,0,263290
143117701900000,SW 420,Residential,80350,0,0,80350
143117800100000,SW 420,Residential,44827,147682,0,192509
143117800200000,SW 420,Residential,40400,190118,0,230518
143117800300000,SW 420,Residential,40400,200649,0,241049
143117800400000,SW 420,Residential,40400,200448,0,240848
143117800500000,SW 420,Residential,40400,206172,0,246572
143117800600000,SW 420,Residential,40400,213396,0,253796
143117900100000,SW 420,Residential,45904,174718,0,220622
143117900200000,SW 420,Residential,42845,207431,0,250276
143117900300000,SW 420,Residential,45454,174378,0,219832
143120100200000,Empty,Exempt,0,0,0,0
143120200100000,COMM SW,Commercial,307584,0,208102,515686
143120200300000,COMM SW,Commercial,127130,0,193015,320145
143120200600000,COMM SW,Commercial,926100,0,2006467,2932567
143120200700000,COMM SW,Commercial,133920,0,198022,331942
143120200800000,COMM SW,Commercial,487080,0,641532,1128612
143120200900000,COMM SW,Commercial,114480,0,4432,118912
143122600200000,COMM SW,Commercial,280800,0,533934,814734
143122600300000,COMM SW,Commercial,689310,0,2048003,2737313
143122600400000,COMM SW,Commercial,427680,0,354279,781959
143122700100000,COMM SW,Commercial,297432,0,248856,546288
143122700200000,COMM SW,Commercial,141912,0,1119,143031
143122700300000,COMM SW,Commercial,130464,0,204853,335317
143122700400000,COMM SW,Commercial,48730,0,83687,132417
143122700500000,COMM SW,Commercial,528120,0,860282,1388402
143122700600000,COMM SW,Commercial,274234,0,150766,425000
143122700700000,COMM SW,Commercial,366336,0,1493740,1860076
143122700702000,COMM SW,Commercial,0,0,23391,23391
143122700800000,COMM SW,Commercial,113832,0,41286,155118
143122700900000,COMM SW,Commercial,99187,0,19829,119016
143122701000000,COMM SW,Commercial,40241,0,0,40241
143122701002000,COMM SW,Commercial,0,0,149472,149472
143122701100000,COMM SW,Commercial,103788,0,8685,112473
143122701102000,COMM SW,Commercial,0,0,125370,125370
143122701200000,COMM SW,Commercial,137592,0,304268,441860
143122701300000,COMM SW,Commercial,292032,0,417689,709721
143122701400000,COMM SW,Commercial,259308,0,0,259308
143125100100000,COMM SW,Commercial,22,0,0,22
143125100300000,COMM SW,Commercial,827704,0,827561,1655265
143125100700000,APTS SW,Commercial,39552,0,407251,446803
143125100800000,APTS SW,Commercial,40043,0,407117,447160
143125100900000,APTS SW,Commercial,29546,0,267237,296783
143125101000000,COMM SW,Commercial,2552,0,0,2552
143125101100000,COMM SW,Commercial,583200,0,2068929,2652129
143125101200000,COMM SW,Commercial,35788,0,0,35788
143125101300000,COMM SW,Commercial,259200,0,0,259200
143125101400000,COMM SW,Commercial,270000,0,574980,844980
143125101500000,COMM SW,Commercial,155520,0,296480,452000
143125101600000,COMM SW,Commercial,72961,0,0,72961
143125101700000,COMM SW,Commercial,174960,0,526537,701497
143125101702000,COMM SW,Commercial,0,0,38127,38127
143125101800000,COMM SW,Commercial,263520,0,1062471,1325991
143125102000000,COMM SW,Commercial,142560,0,0,142560
143125102002000,COMM SW,Commercial,0,0,53979,53979
143125102100000,COMM SW,Commercial,228960,0,689489,918449
143125200100000,COMM SW,Commercial,361152,0,409966,771118
143125300100000,SW 420,Residential,27571,108458,0,136029
143125300200000,SW 420,Residential,27440,99777,0,127217
143125300300000,SW 420,Residential,28075,91118,0,119193
143125300400000,SW 420,Residential,28413,100990,0,129403
143125300500000,APTS SW,Commercial,13497,0,119111,132608
143125300600000,APTS SW,Commercial,32226,0,306055,338281
143125301000000,CONDO 500,Residential,144000,0,0,144000
143125301001000,CONDO 500,Residential,6000,71205,0,77205
143125301001001,CONDO 500,Residential,6000,71205,0,77205
143125301001002,CONDO 500,Residential,6000,70934,0,76934
143125301001003,CONDO 500,Residential,6000,70934,0,76934
143125301001004,CONDO 500,Residential,6000,72233,0,78233
143125301001005,CONDO 500,Residential,6000,72233,0,78233
143125301001006,CONDO 500,Residential,6000,72233,0,78233
143125301001007,CONDO 500,Residential,6000,72233,0,78233
143125301001008,CONDO 500,Residential,6000,72233,0,78233
143125301001009,CONDO 500,Residential,6000,72233,0,78233
143125301001010,CONDO 500,Residential,6000,72233,0,78233
143125301001011,CONDO 500,Residential,6000,72233,0,78233
143125301001012,CONDO 500,Residential,6000,71205,0,77205
143125301001013,CONDO 500,Residential,6000,71205,0,77205
143125301001014,CONDO 500,Residential,6000,70934,0,76934
143125301001015,CONDO 500,Residential,6000,70934,0,76934
143125301001016,CONDO 500,Residential,6000,72233,0,78233
143125301001017,CONDO 500,Residential,6000,72233,0,78233
143125301001018,CONDO 500,Residential,6000,72233,0,78233
143125301001019,CONDO 500,Residential,6000,72233,0,78233
143125301001020,CONDO 500,Residential,6000,72233,0,78233
143125301001021,CONDO 500,Residential,6000,72233,0,78233
143125301001022,CONDO 500,Residential,6000,72233,0,78233
143125301001023,CONDO 500,Residential,6000,72233,0,78233
143125301001024,CONDO 500,Residential,6000,71205,0,77205
143125301001025,CONDO 500,Residential,6000,71205,0,77205
143125301001026,CONDO 500,Residential,6000,70934,0,76934
143125301001027,CONDO 500,Residential,6000,70934,0,76934
143125301001028,CONDO 500,Residential,6000,72233,0,78233
143125301001029,CONDO 500,Residential,6000,72233,0,78233
143125301001030,CONDO 500,Residential,6000,72233,0,78233
143125301001031,CONDO 500,Residential,6000,72233,0,78233
143125301001032,CONDO 500,Residential,6000,72233,0,78233
143125301001033,CONDO 500,Residential,6000,72233,0,78233
143125301001034,CONDO 500,Residential,6000,72233,0,78233
143125301001035,CONDO 500,Residential,6000,72233,0,78233
143125301001036,CONDO 500,Residential,6000,71251,0,77251
143125301001037,CONDO 500,Residential,6000,71251,0,77251
143125301001038,CONDO 500,Residential,6000,70980,0,76980
143125301001039,CONDO 500,Residential,6000,70980,0,76980
143125301001040,CONDO 500,Residential,6000,72279,0,78279
143125301001041,CONDO 500,Residential,6000,72279,0,78279
143125301001042,CONDO 500,Residential,6000,72279,0,78279
143125301001043,CONDO 500,Residential,6000,72279,0,78279
143125301001044,CONDO 500,Residential,6000,72279,0,78279
143125301001045,CONDO 500,Residential,6000,72279,0,78279
143125301001046,CONDO 500,Residential,6000,72279,0,78279
143125301001047,CONDO 500,Residential,6000,72279,0,78279
143125301001048,CONDO 500,Residential,6000,71251,0,77251
143125301001049,CONDO 500,Residential,6000,71251,0,77251
143125301001050,CONDO 500,Residential,6000,70980,0,76980
143125301001051,CONDO 500,Residential,6000,70980,0,76980
143125301001052,CONDO 500,Residential,6000,72279,0,78279
143125301001053,CONDO 500,Residential,6000,72279,0,78279
143125301001054,CONDO 500,Residential,6000,72279,0,78279
143125301001055,CONDO 500,Residential,6000,72279,0,78279
143125301001056,CONDO 500,Residential,6000,72279,0,78279
143125301001057,CONDO 500,Residential,6000,72279,0,78279
143125301001058,CONDO 500,Residential,6000,72279,0,78279
143125301001059,CONDO 500,Residential,6000,72279,0,78279
143125301001060,CONDO 500,Residential,6000,71251,0,77251
143125301001061,CONDO 500,Residential,6000,71251,0,77251
143125301001062,CONDO 500,Residential,6000,70980,0,76980
143125301001063,CONDO 500,Residential,6000,70980,0,76980
143125301001064,CONDO 500,Residential,6000,72279,0,78279
143125301001065,CONDO 500,Residential,6000,72279,0,78279
143125301001066,CONDO 500,Residential,6000,72279,0,78279
143125301001067,CONDO 500,Residential,6000,72279,0,78279
143125301001068,CONDO 500,Residential,6000,72279,0,78279
143125301001069,CONDO 500,Residential,6000,72279,0,78279
143125301001070,CONDO 500,Residential,6000,72279,0,78279
143125301001071,CONDO 500,Residential,6000,72279,0,78279
143125301001072,CONDO 500,Residential,6000,71298,0,77298
143125301001073,CONDO 500,Residential,6000,71298,0,77298
143125301001074,CONDO 500,Residential,6000,71298,0,77298
143125301001075,CONDO 500,Residential,6000,71298,0,77298
143125301001076,CONDO 500,Residential,6000,72326,0,78326
143125301001077,CONDO 500,Residential,6000,72326,0,78326
143125301001078,CONDO 500,Residential,6000,72326,0,78326
143125301001079,CONDO 500,Residential,6000,72326,0,78326
143125301001080,CONDO 500,Residential,6000,72326,0,78326
143125301001081,CONDO 500,Residential,6000,72326,0,78326
143125301001082,CONDO 500,Residential,6000,72326,0,78326
143125301001083,CONDO 500,Residential,6000,72326,0,78326
143125301001084,CONDO 500,Residential,6000,72025,0,78025
143125301001085,CONDO 500,Residential,6000,72025,0,78025
143125301001086,CONDO 500,Residential,6000,72025,0,78025
143125301001087,CONDO 500,Residential,6000,72025,0,78025
143125301001088,CONDO 500,Residential,6000,73064,0,79064
143125301001089,CONDO 500,Residential,6000,73064,0,79064
143125301001090,CONDO 500,Residential,6000,73064,0,79064
143125301001091,CONDO 500,Residential,6000,73064,0,79064
143125301001092,CONDO 500,Residential,6000,73064,0,79064
143125301001093,CONDO 500,Residential,6000,73064,0,79064
143125301001094,CONDO 500,Residential,6000,73064,0,79064
143125301001095,CONDO 500,Residential,6000,73064,0,79064
143125301001096,CONDO 500,Residential,6000,119239,0,125239
143125301001097,CONDO 500,Residential,6000,119239,0,125239
143125301001098,CONDO 500,Residential,6000,119239,0,125239
143125301001099,CONDO 500,Residential,6000,119239,0,125239
143125301001100,CONDO 500,Residential,6000,113131,0,119131
143125301001101,CONDO 500,Residential,6000,113131,0,119131
143125301001102,CONDO 500,Residential,6000,113131,0,119131
143125301001103,CONDO 500,Residential,6000,113131,0,119131
143127600100000,SW 420,Residential,30066,84993,0,115059
143127600200000,SW 420,Residential,30224,93991,0,124215
143127600300000,SW 420,Residential,30224,90168,0,120392
143127600400000,SW 420,Residential,29315,114459,0,143774
143127600500000,SW 420,Residential,29315,97715,0,127030
143127600600000,SW 420,Residential,29315,96611,0,125926
143127600700000,SW 420,Residential,29315,81182,0,110497
143127600800000,SW 420,Residential,29315,92833,0,122148
143127600900000,SW 420,Residential,31111,65081,0,96192
143127601000000,SW 420,Residential,32802,100881,0,133683
143127601100000,COMM SW,Commercial,248119,0,0,248119
143127601200000,COMM SW,Commercial,261360,0,0,261360
143127601300000,COMM SW,Commercial,36180,0,0,36180
143127601400000,E-40 CHURCHES,Exempt,35381,0,88025,123406
143127601500000,SW 420,Residential,33328,64743,0,98071
143127601600000,SW 420,Residential,24000,80141,0,104141
143127601700000,SW 420,Residential,27000,118633,0,145633
143127601800000,SW 420,Residential,30567,117481,0,148048
143127601900000,SW 420,Residential,30682,103185,0,133867
143127602000000,SW 420,Residential,32148,95738,0,127886
143127602100000,SW 420,Residential,29335,81783,0,111118
143127602200000,SW 420,Residential,30139,82852,0,112991
143127602300000,SW 420,Residential,29855,104715,0,134570
143127602400000,SW 420,Residential,32415,94762,0,127177
143127602500000,SW 420,Residential,26649,101252,0,127901
143127602600000,SW 420,Residential,27284,85625,0,112909
143127602700000,SW 420,Residential,27461,82587,0,110048
143127602800000,SW 420,Residential,29479,83673,0,113152
143127602900000,SW 420,Residential,32385,101074,0,133459
143127700100000,SW 420,Residential,29258,81156,0,110414
143127700200000,SW 420,Residential,29610,103299,0,132909
143127700300000,SW 420,Residential,29610,89489,0,119099
143127700400000,SW 420,Residential,29610,91789,0,121399
143127700500000,SW 420,Residential,27284,81618,0,108902
143127700600000,SW 420,Residential,27284,89588,0,116872
143127700700000,SW 420,Residential,27284,99294,0,126578
143127700800000,SW 420,Residential,27284,98371,0,125655
143127700900000,SW 420,Residential,29306,93539,0,122845
143127701000000,SW 420,Residential,27943,82714,0,110657
143127701100000,SW 420,Residential,27284,85936,0,113220
143127701200000,SW 420,Residential,25380,91455,0,116835
143127701300000,SW 420,Residential,29938,93517,0,123455
143127701400000,SW 420,Residential,29610,92365,0,121975
143127701500000,SW 420,Residential,29610,113407,0,143017
143127701600000,SW 420,Residential,29610,82487,0,112097
143127701700000,SW 420,Residential,29610,93479,0,123089
143127701800000,SW 420,Residential,29963,84822,0,114785
143127800100000,SW 420,Residential,30631,93088,0,123719
143127800200000,SW 420,Residential,30912,80568,0,111480
143127800300000,SW 420,Residential,30912,94283,0,125195
143127800400000,SW 420,Residential,30912,74214,0,105126
143127800500000,SW 420,Residential,30912,89606,0,120518
143127800600000,SW 420,Residential,31248,80951,0,112199
143127800700000,SW 420,Residential,29760,88094,0,117854
143127800800000,SW 420,Residential,25568,87564,0,113132
143127800900000,SW 420,Residential,28200,82790,0,110990
143127801000000,SW 420,Residential,28200,112853,0,141053
143127900100000,SW 420,Residential,26938,88378,0,115316
143127900200000,SW 420,Residential,31212,101471,0,132683
143127900300000,SW 420,Residential,30375,90953,0,121328
143127900400000,SW 420,Residential,30678,87830,0,118508
143127900500000,SW 420,Residential,30729,106991,0,137720
143127900600000,SW 420,Residential,30527,90102,0,120629
143127900700000,SW 420,Residential,30400,77254,0,107654
143127900800000,SW 420,Residential,31059,95159,0,126218
143127900900000,SW 420,Residential,31137,113522,0,144659
143127901000000,SW 420,Residential,29184,82072,0,111256
143127901100000,SW 420,Residential,28453,77170,0,105623
143127901200000,SW 420,Residential,30380,75448,0,105828
143127901300000,SW 420,Residential,31040,96003,0,127043
143127901400000,SW 420,Residential,30780,80822,0,111602
143127901500000,SW 420,Residential,26880,84637,0,111517
143128000100000,SW 420,Residential,30888,83087,0,113975
143128000200000,SW 420,Residential,26741,89981,0,116722
143128000300000,SW 420,Residential,27664,99333,0,126997
143128000400000,SW 420,Residential,25480,108930,0,134410
143128000500000,SW 420,Residential,29563,93358,0,122921
143128000600000,SW 420,Residential,28200,87927,0,116127
143128000700000,SW 420,Residential,28200,88067,0,116267
143128000800000,SW 420,Residential,28200,96050,0,124250
143128000900000,SW 420,Residential,30080,85031,0,115111
143128001000000,SW 420,Residential,30080,99086,0,129166
143128001100000,SW 420,Residential,30080,75798,0,105878
143128001200000,SW 420,Residential,30080,87652,0,117732
143128001300000,SW 420,Residential,27232,99024,0,126256
143128001400000,SW 420,Residential,30053,92346,0,122399
143128001500000,SW 420,Residential,30464,103042,0,133506
143128001600000,SW 420,Residential,25480,83567,0,109047
143128001700000,SW 420,Residential,25480,114407,0,139887
143128001800000,SW 420,Residential,25480,86019,0,111499
143128001900000,SW 420,Residential,30950,108774,0,139724
143128100100000,SW 420,Residential,29120,106305,0,135425
143128100200000,SW 420,Residential,31305,80367,0,111672
143128100300000,SW 420,Residential,29328,97336,0,126664
143128100400000,SW 420,Residential,29328,113680,0,143008
143128100500000,SW 420,Residential,29328,103573,0,132901
143128100600000,SW 420,Residential,30264,116699,0,146963
143128100700000,SW 420,Residential,31824,84178,0,116002
143128100800000,SW 420,Residential,31728,122230,0,153958
143128100900000,SW 420,Residential,27200,112972,0,140172
143128101000000,SW 420,Residential,28160,118656,0,146816
143128101100000,SW 420,Residential,31741,120935,0,152676
143128101200000,SW 420,Residential,29958,104723,0,134681
143130100100000,SW 420,Residential,26257,119462,0,145719
143130100200000,SW 420,Residential,26257,89726,0,115983
143130100300000,SW 420,Residential,25145,115560,0,140705
143130100400000,SW 420,Residential,27939,77137,0,105076
143130100500000,SW 420,Residential,25725,100734,0,126459
143130100600000,SW 420,Residential,25725,148490,0,174215
143130100700000,SW 420,Residential,38745,113444,0,152189
143130100800000,SW 420,Residential,53900,84180,0,138080
143130100900000,SW 420,Residential,2350,0,0,2350
143130101000000,SW 420,Residential,54400,234473,0,288873
143130101100000,SW 420,Residential,46800,124528,0,171328
143130101200000,SW 420,Residential,29400,123944,0,153344
143130200100000,SW 420,Residential,26144,56630,0,82774
143130200200000,SW 420,Residential,43575,72978,0,116553
143130200300000,SW 420,Residential,39040,125786,0,164826
143130200400000,SW 420,Residential,39040,97055,0,136095
143130200500000,SW 420,Residential,31040,78080,0,109120
143130200600000,SW 420,Residential,33330,42495,0,75825
143130200700000,SW 420,Residential,33296,93060,0,126356
143130200800000,SW 420,Residential,24396,60464,0,84860
143130200900000,SW 420,Residential,25308,59528,0,84836
143130201000000,SW 420,Residential,32206,30460,0,62666
143130201100000,SW 420,Residential,48314,61979,0,110293
143130201200000,SW 420,Residential,60950,94316,0,155266
143130201300000,Empty,Exempt,0,0,0,0
143130201400000,SW 420,Residential,78050,135574,0,213624
143130201500000,SW 420,Residential,37884,102811,0,140695
143130201600000,SW 420,Residential,30958,100603,0,131561
143130201700000,SW 420,Residential,30958,150857,0,181815
143130201800000,SW 420,Residential,32288,136293,0,168581
143130201900000,SW 420,Residential,21671,131689,0,153360
143130202000000,SW 420,Exempt,21672,133226,0,154898
143130300100000,SW 420,Residential,23203,70121,0,93324
143130300200000,SW 420,Residential,39406,64507,0,103913
143130300300000,SW 420,Residential,35136,29866,0,65002
143130300400000,SW 420,Residential,31040,151105,0,182145
143130300500000,SW 420,Residential,29100,173157,0,202257
143130300600000,SW 420,Residential,29100,124353,0,153453
143130300700000,SW 420,Residential,29232,146024,0,175256
143130300800000,SW 420,Residential,21941,65598,0,87539
143130300900000,SW 420,Residential,23760,90934,0,114694
143130301000000,SW 420,Residential,22176,81209,0,103385
143130301100000,SW 420,Residential,23760,81127,0,104887
143130400100000,SW 420,Residential,32076,132314,0,164390
143130400200000,SW 420,Residential,32436,179155,0,211591
143130400300000,SW 420,Residential,33183,149608,0,182791
143130400400000,SW 420,Residential,31040,108341,0,139381
143130400500000,SW 420,Residential,31040,110882,0,141922
143130400600000,SW 420,Residential,32766,122881,0,155647
143130400700000,SW 420,Residential,31564,135392,0,166956
143130500100000,SW 420,Residential,32332,107147,0,139479
143130500200000,SW 420,Residential,29100,120972,0,150072
143130500300000,SW 420,Residential,28409,83413,0,111822
143130500400000,SW 420,Residential,30814,97849,0,128663
143130500500000,SW 420,Residential,30000,103474,0,133474
143130500600000,SW 420,Residential,30000,110562,0,140562
143130500700000,SW 420,Residential,30000,105747,0,135747
143130500800000,SW 420,Residential,30414,101630,0,132044
143132600100000,SW 420,Residential,36234,89178,0,125412
143132600200000,SW 420,Residential,36234,113438,0,149672
143132600300000,SW 420,Residential,31258,93624,0,124882
143132600400000,SW 420,Residential,24960,114678,0,139638
143132600500000,SW 420,Residential,31916,137298,0,169214
143132600600000,SW 420,Residential,32724,109254,0,141978
143132600700000,SW 420,Residential,32724,123563,0,156287
143132600800000,SW 420,Residential,54,0,0,54
143132600900000,SW 420,Residential,30400,138802,0,169202
143132601000000,SW 420,Residential,30720,126142,0,156862
143132700100000,SW 420,Residential,25680,0,0,25680
143132700200000,SW 420,Residential,32164,87186,0,119350
143132700300000,SW 420,Exempt,38987,0,167623,206610
143132700400000,SW 420,Residential,25463,143684,0,169147
143132700500000,SW 420,Residential,28000,148039,0,176039
143132700600000,SW 420,Residential,28560,147338,0,175898
143132700700000,SW 420,Residential,28560,177682,0,206242
143132700800000,SW 420,Residential,27720,147029,0,174749
143132700900000,SW 420,Residential,31075,152874,0,183949
143132701000000,SW 420,Residential,31944,146179,0,178123
143132701100000,SW 420,Residential,27720,156376,0,184096
143132701200000,SW 420,Residential,28987,145522,0,174509
143132701300000,SW 420,Residential,28546,158476,0,187022
143132701400000,SW 420,Residential,28560,0,0,28560
143132701500000,SW 420,Residential,31680,94329,0,126009
143132701600000,SW 420,Residential,31696,86003,0,117699
143132701700000,SW 420,Residential,31878,82412,0,114290
143132702700000,COMM SW,Commercial,1495584,0,4129582,5625166
143132702800000,COMM SW,Commercial,384426,0,582008,966434
143132702900000,COMM SW,Commercial,396900,0,678608,1075508
143132703000000,SW 420,Residential,32130,174495,0,206625
143132703100000,SW 420,Residential,31827,222591,0,254418
143132703200000,SW 420,Residential,28560,207099,0,235659
143132703300000,SW 420,Residential,30345,192122,0,222467
143132703400000,SW 420,Residential,28560,152282,0,180842
143132703500000,SW 420,Residential,30345,217934,0,248279
143132703600000,SW 420,Residential,36995,256187,0,293182
143132703700000,SW 420,Residential,28526,165281,0,193807
143132703800000,SW 420,Residential,29100,131886,0,160986
143132703900000,SW 420,Residential,31736,109135,0,140871
143132704000000,SW 420,Residential,31512,139910,0,171422
143132704100000,SW 420,Residential,32320,124517,0,156837
143132704200000,SW 420,Residential,32320,130949,0,163269
143132704300000,SW 420,Residential,30300,119263,0,149563
143132704400000,SW 420,Residential,26220,161627,0,187847
143132704500000,COMM SW,Commercial,1057207,0,2690604,3747811
143132800100000,SW 420,Residential,33833,171690,0,205523
143132800200000,SW 420,Residential,32400,157623,0,190023
143132800300000,SW 420,Residential,34247,195668,0,229915
143132800400000,SW 420,Residential,28948,0,0,28948
143132800500000,SW 420,Residential,28215,113126,0,141341
143132800600000,SW 420,Residential,29876,105313,0,135189
143132800700000,SW 420,Residential,29100,115791,0,144891
143132800800000,SW 420,Residential,29100,115903,0,145003
143132900100000,SW 420,Residential,29100,111527,0,140627
143132900200000,SW 420,Residential,26866,108961,0,135827
143132900300000,SW 420,Residential,29750,121044,0,150794
143132900400000,SW 420,Residential,27573,109604,0,137177
143133000100000,SW 420,Residential,31331,140757,0,172088
143133000200000,SW 420,Residential,31040,114716,0,145756
143133000300000,SW 420,Residential,31331,127792,0,159123
143133000400000,SW 420,Residential,27720,179735,0,207455
143133000500000,SW 420,Residential,29453,164402,0,193855
143133000600000,SW 420,Residential,29453,168540,0,197993
143133000700000,SW 420,Residential,29453,130780,0,160233
143133000800000,SW 420,Residential,29453,160885,0,190338
143133000900000,SW 420,Residential,31680,106027,0,137707
143133001000000,SW 420,Residential,29700,108128,0,137828
143133001100000,SW 420,Residential,30397,112888,0,143285
143133100600000,SW 420,Residential,31815,111740,0,143555
143135100100000,SW 420,Residential,30935,134817,0,165752
143135100200000,SW 420,Residential,28794,133778,0,162572
143135200100000,SW 420,Residential,29457,171663,0,201120
143135200200000,SW 420,Residential,26876,156053,0,182929
143135200300000,SW 420,Residential,26525,161845,0,188370
143135200400000,SW 420,Residential,26799,174179,0,200978
143135200500000,SW 420,Residential,28673,173053,0,201726
143135200600000,SW 420,Residential,29453,157262,0,186715
143135200700000,SW 420,Residential,29875,161804,0,191679
143135200800000,SW 420,Residential,30754,182491,0,213245
143135200900000,SW 420,Residential,29642,180636,0,210278
143135201000000,SW 420,Residential,29453,204879,0,234332
143135201100000,SW 420,Residential,29649,207660,0,237309
143135201200000,SW 420,Residential,29626,149990,0,179616
143135201300000,SW 420,Residential,29453,174843,0,204296
143135201400000,SW 420,Residential,27720,180693,0,208413
143135201500000,SW 420,Residential,30500,161976,0,192476
143135201600000,SW 420,Residential,29522,173286,0,202808
143135201700000,SW 420,Residential,27720,186733,0,214453
143135201800000,SW 420,Residential,29453,138703,0,168156
143135201900000,SW 420,Residential,29017,182987,0,212004
143135202000000,SW 420,Residential,31300,200300,0,231600
143135300100000,SW 420,Residential,30884,178809,0,209693
143135300200000,COMM SW,Commercial,548100,0,794444,1342544
143135300400000,SW 420,Residential,36446,312771,0,349217
143135300500000,SW 420,Residential,34808,212895,0,247703
143135300600000,SW 420,Residential,32008,233824,0,265832
143135300700000,SW 420,Residential,30044,210199,0,240243
143135300800000,SW 420,Residential,33516,204062,0,237578
143135300900000,SW 420,Residential,34335,248395,0,282730
143135301000000,SW 420,Residential,32175,227809,0,259984
143135301100000,SW 420,Residential,33973,220678,0,254651
143135301200000,COMM SW,Commercial,743904,0,956130,1700034
143135301300000,COMM SW,Commercial,22,0,3813,3835
143135301400000,COMM SW,Commercial,532224,0,930045,1462269
143135301500000,COMM SW,Commercial,476280,0,642750,1119030
143135301600000,COMM SW,Commercial,387828,0,469247,857075
143135301700000,COMM SW,Commercial,373464,0,1577831,1951295
143135301800000,COMM SW,Commercial,612360,0,1270096,1882456
143135302100000,COMM SW,Commercial,737856,0,2413896,3151752
143135302200000,COMM SW,Commercial,4447,0,0,4447
143135302300000,COMM SW,Commercial,374447,0,306417,680864
143135302400000,COMM SW,Commercial,504792,0,1200142,1704934
143135302600000,SW 420,Residential,29440,169154,0,198594
143135302700000,SW 420,Residential,33649,185173,0,218822
143135302800000,SW 420,Residential,28520,164464,0,192984
143135302900000,SW 420,Residential,33723,161400,0,195123
143135303000000,SW 420,Residential,31060,161725,0,192785
143135303100000,SW 420,Residential,24955,147536,0,172491
143135303200000,SW 420,Residential,24190,161555,0,185745
143135303300000,SW 420,Residential,35650,138970,0,174620
143137600100000,Empty,Exempt,0,0,0,0
143137700100000,SW 420,Residential,62450,82666,0,145116
143137700200000,SW 420,Residential,29787,144372,0,174159
143137700300000,SW 420,Residential,30000,137327,0,167327
143137700400000,SW 420,Residential,30000,0,0,30000
143137700500000,SW 420,Residential,32000,138623,0,170623
143137700600000,SW 420,Residential,37445,196071,0,233516
143137700700000,SW 420,Residential,26190,135757,0,161947
143137700800000,SW 420,Residential,26609,124785,0,151394
143137700900000,SW 420,Residential,25181,135205,0,160386
143137701000000,SW 420,Residential,24978,134435,0,159413
143137701200000,Empty,Exempt,0,0,0,0
143137701300000,SW 420,Residential,30768,142811,0,173579
143137701400000,SW 420,Residential,24066,120311,0,144377
143137701500000,SW 420,Residential,24255,121733,0,145988
143137701600000,SW 420,Residential,24255,122471,0,146726
143137701700000,SW 420,Residential,24255,102235,0,126490
143137701800000,SW 420,Residential,24444,101015,0,125459
143137701900000,SW 420,Residential,24255,85744,0,109999
143137702000000,Empty,Exempt,0,0,0,0
143137702100000,Empty,Exempt,0,0,0,0
143137800100000,SW 420,Residential,32128,96792,0,128920
143137800200000,SW 420,Residential,29925,169797,0,199722
143137800300000,SW 420,Residential,28262,160852,0,189114
143137800400000,SW 420,Residential,29090,156716,0,185806
143137800500000,SW 420,Residential,29631,180096,0,209727
143137800600000,SW 420,Residential,29925,196229,0,226154
143137800700000,SW 420,Residential,29925,165533,0,195458
143137800800000,SW 420,Residential,33285,147356,0,180641
143137800900000,SW 420,Residential,29067,115019,0,144086
143137801000000,SW 420,Residential,30000,147820,0,177820
143137801100000,SW 420,Residential,30000,142470,0,172470
143137801200000,SW 420,Residential,30000,134880,0,164880
143137801300000,SW 420,Residential,32000,120792,0,152792
143137801400000,SW 420,Residential,33536,121704,0,155240
143137801500000,SW 420,Residential,65,0,0,65
143137801600000,SW 420,Residential,30000,110714,0,140714
143137801700000,SW 420,Residential,30000,116594,0,146594
143137801800000,SW 420,Residential,30000,87350,0,117350
143137900400000,SW 420,Residential,33614,161202,0,194816
143137900500000,SW 420,Residential,33649,205924,0,239573
143137900600000,SW 420,Residential,28520,166815,0,195335
143137900700000,SW 420,Residential,33649,145292,0,178941
143137900800000,SW 420,Residential,32660,137979,0,170639
143137900900000,SW 420,Residential,33120,212625,0,245745
143137901000000,SW 420,Residential,33649,165600,0,199249
143137901100000,SW 420,Residential,33649,179057,0,212706
143137901200000,SW 420,Residential,32660,167967,0,200627
143137901300000,SW 420,Residential,33649,179131,0,212780
143137901400000,SW 420,Residential,35420,185761,0,221181
143137901500000,SW 420,Residential,33649,146510,0,180159
143137901600000,SW 420,Residential,34500,163366,0,197866
143137901700000,SW 420,Residential,26163,162768,0,188931
143137901800000,SW 420,Residential,27773,151335,0,179108
143137901900000,SW 420,Residential,24593,168509,0,193102
143137902000000,SW 420,Residential,24955,145510,0,170465
143137902100000,SW 420,Residential,28980,161601,0,190581
143137902200000,SW 420,Residential,28980,165025,0,194005
143137902300000,SW 420,Residential,26163,183100,0,209263
143137902400000,SW 420,Residential,27773,174080,0,201853
143137902500000,SW 420,Residential,24955,197778,0,222733
143137902600000,SW 420,Residential,26163,0,0,26163
143137902700000,SW 420,Residential,26968,179495,0,206463
143137902800000,SW 420,Residential,27773,184976,0,212749
143137902900000,SW 420,Residential,23788,168574,0,192362
143137903000000,SW 420,Residential,27562,190387,0,217949
143140100100000,SW 419,Residential,19775,75352,0,95127
143140100200000,SW 419,Residential,31442,31839,0,63281
143140100300000,SW 419,Residential,20650,120850,0,141500
143140100400000,SW 419,Residential,20650,48553,0,69203
143140100500000,SW 419,Residential,20650,109719,0,130369
143140100600000,SW 419,Residential,20650,53724,0,74374
143140100700000,SW 419,Residential,30975,95728,0,126703
143140100800000,SW 419,Residential,30975,64570,0,95545
143140100900000,SW 419,Residential,30975,63530,0,94505
143140101000000,SW 419,Residential,30665,87093,0,117758
143140101100000,SW 419,Residential,30665,48463,0,79128
143140101200000,SW 419,Residential,27258,84108,0,111366
143140101300000,SW 419,Residential,25606,46051,0,71657
143140101400000,SW 419,Residential,28910,89164,0,118074
143140101500000,SW 419,Residential,27258,47765,0,75023
143140101600000,SW 419,Residential,27258,101995,0,129253
143140101700000,SW 419,Residential,38161,43406,0,81567
143140101800000,SW 419,Residential,68350,130298,0,198648
143140101900000,SW 419,Ag Land,20506,0,0,20506
143140102000000,SW 419,Ag Dwelling,3740,168562,2646,174948
143140102100000,SW 419,Residential,46300,102472,0,148772
143140102200000,SW 419,Residential,40000,83548,0,123548
143140102300000,SW 419,Residential,2453,0,0,2453
143142600100000,SW 420,Residential,25725,116748,0,142473
143142600200000,SW 420,Residential,22848,100181,0,123029
143142600300000,SW 420,Residential,20097,105783,0,125880
143142600400000,SW 420,Residential,23909,88388,0,112297
143142600500000,SW 420,Residential,25988,101052,0,127040
143142600600000,SW 420,Residential,25988,90216,0,116204
143142600700000,SW 420,Residential,25988,88236,0,114224
143142600800000,SW 420,Residential,25988,90213,0,116201
143142600900000,SW 420,Residential,25988,103889,0,129877
143142601000000,SW 420,Residential,25988,99642,0,125630
143142601100000,SW 420,Residential,25988,88505,0,114493
143142601200000,SW 420,Residential,25988,98305,0,124293
143142601300000,SW 420,Residential,25988,88950,0,114938
143142601400000,SW 420,Residential,25988,104190,0,130178
143142601500000,SW 420,Residential,25988,104504,0,130492
143142700100000,SW 420,Residential,20936,124133,0,145069
143142700200000,COMM SW,Commercial,83268,0,86332,169600
143142700300000,SW 420,Ag Dwelling,7230,42891,13662,63783
143142700400000,SW 420,Residential,25973,95460,0,121433
143142700500000,SW 420,Residential,24240,100284,0,124524
143142700600000,SW 420,Residential,24240,78746,0,102986
143142700700000,SW 420,Residential,24240,85866,0,110106
143142700800000,SW 420,Residential,24240,91675,0,115915
143142700900000,SW 420,Residential,24240,93168,0,117408
143142701000000,SW 420,Residential,24240,106667,0,130907
143142701100000,SW 420,Residential,24240,90033,0,114273
143142701200000,SW 420,Residential,24240,108207,0,132447
143142701300000,SW 420,Residential,24240,103532,0,127772
143142701400000,SW 420,Residential,25856,135500,0,161356
143142701500000,SW 420,Residential,25856,102528,0,128384
143142701600000,SW 420,Residential,25856,110138,0,135994
143142701700000,SW 420,Residential,25856,85867,0,111723
143142701800000,SW 420,Residential,25856,104565,0,130421
143142701900000,SW 420,Residential,25856,93714,0,119570
143142702000000,SW 420,Residential,25856,104201,0,130057
143142702100000,SW 420,Residential,25856,94936,0,120792
143142702200000,SW 420,Residential,25856,132346,0,158202
143142702300000,SW 420,Residential,26188,121532,0,147720
143142702400000,SW 420,Residential,26513,95681,0,122194
143142702500000,SW 420,Residential,26513,84864,0,111377
143142702600000,SW 420,Residential,26513,99880,0,126393
143142702700000,SW 420,Residential,26513,110937,0,137450
143142702800000,SW 420,Residential,26250,114965,0,141215
143142702900000,SW 420,Residential,26250,114773,0,141023
143142703000000,SW 420,Residential,26250,110438,0,136688
143142703100000,SW 420,Residential,26117,103222,0,129339
143142703200000,SW 420,Residential,26117,13130,0,39247
143142703300000,SW 420,Residential,24500,0,0,24500
143142703400000,SW 420,Residential,24500,114547,0,139047
143142703500000,SW 420,Residential,25988,128389,0,154377
143142703600000,SW 420,Residential,23324,122453,0,145777
143142703700000,SW 420,Residential,20370,113574,0,133944
143142800100000,SW 420,Residential,22566,94538,0,117104
143142800200000,SW 420,Residential,20930,73004,0,93934
143142800300000,SW 420,Residential,25073,137028,0,162101
143142800400000,SW 420,Residential,23562,228,0,23790
143142800500000,SW 420,Residential,26260,112769,0,139029
143142800600000,SW 420,Residential,26513,122362,0,148875
143142800700000,SW 420,Residential,26159,117420,0,143579
143142800800000,SW 420,Residential,26159,101067,0,127226
143142800900000,SW 420,Residential,26513,125288,0,151801
143142801000000,SW 420,Residential,26513,145041,0,171554
143142801100000,SW 420,Residential,26513,130054,0,156567
143142801200000,SW 420,Residential,53850,0,0,53850
143142801300000,SW 420,Residential,26969,111301,0,138270
143142801400000,SW 420,Residential,24644,119128,0,143772
143142801500000,SW 420,Residential,24644,103156,0,127800
143142801600000,SW 420,Residential,24644,94982,0,119626
143142801700000,SW 419,Residential,23668,97078,0,120746
143142801800000,SW 420,Residential,26442,107809,0,134251
143142801900000,SW 420,Residential,28280,105247,0,133527
143142802000000,SW 420,Residential,27270,107489,0,134759
143142802100000,SW 420,Residential,25856,104041,0,129897
143142802200000,SW 420,Residential,26906,111841,0,138747
143142802300000,SW 420,Residential,24240,76947,0,101187
143142802400000,SW 420,Residential,24240,81061,0,105301
143142802500000,SW 420,Residential,24240,85874,0,110114
143142802600000,SW 420,Residential,24240,85407,0,109647
143142802700000,SW 420,Residential,24240,98167,0,122407
143142802800000,SW 420,Residential,24240,133296,0,157536
143142802900000,SW 420,Residential,24240,95166,0,119406
143142803000000,SW 420,Residential,24240,79899,0,104139
143142900100000,SW 420,Residential,25169,106833,0,132002
143142900200000,SW 420,Residential,23495,107889,0,131384
143142900300000,SW 420,Residential,25353,114067,0,139420
143142900400000,SW 420,Residential,25099,104679,0,129778
143142900500000,SW 420,Residential,25099,117407,0,142506
143142900600000,SW 420,Residential,25099,120672,0,145771
143142900700000,SW 420,Residential,26159,136902,0,163061
143143000100000,SW 420,Residential,19054,0,0,19054
143145100100000,SW 420,Ag Land,38064,0,0,38064
143145100200000,SW 418,Ag Dwelling,12536,71019,0,83555
143145100300000,SW 418,Residential,32500,30805,0,63305
143147600100000,SW 418,Ag Dwelling,24702,6701,2542,33945
143147600200000,SW 418,Ag Dwelling,977,97492,0,98469
143147600300000,SW 418,Ag Dwelling,20387,77237,1129,98753
143147600400000,SW 418,Ag Dwelling,14172,110290,8127,132589
143210100100000,COMM SW,Commercial,15120,0,43629,58749
143210100200000,COMM SW,Commercial,26460,0,3496,29956
143210100300000,SW 404,Residential,17314,41983,0,59297
143210100400000,SW 404,Residential,16200,58515,0,74715
143210100500000,SW 404,Residential,16200,36032,0,52232
143210100600000,SW 404,Residential,16200,55541,0,71741
143210100700000,SW 404,Residential,16200,74036,0,90236
143210100800000,SW 404,Residential,16200,52258,0,68458
143210100900000,SW 404,Residential,16200,48386,0,64586
143210101000000,SW 404,Residential,16200,53448,0,69648
143210101100000,SW 404,Residential,16200,46402,0,62602
143210101200000,SW 404,Residential,16200,61470,0,77670
143210101300000,SW 404,Residential,16200,62400,0,78600
143210101400000,SW 404,Residential,16200,50770,0,66970
143210101500000,SW 404,Residential,16200,56939,0,73139
143210101600000,SW 404,Residential,16200,69819,0,86019
143210200500000,SW 404,Residential,16200,71174,0,87374
143210200600000,APTS SW,Commercial,19051,0,230949,250000
143210200700000,APTS SW,Residential,46267,748008,0,794275
143210300100000,SW 404,Residential,17100,55705,0,72805
143210300200000,SW 404,Residential,18000,47426,0,65426
143210300300000,SW 404,Residential,17100,75010,0,92110
143210300400000,SW 404,Residential,17100,55376,0,72476
143210400100000,COMM SW,Commercial,448470,0,1079672,1528142
143210400600000,SW 404,Residential,21600,65566,0,87166
143210400700000,SW 404,Residential,21600,68327,0,89927
143210400800000,SW 404,Residential,18000,53857,0,71857
143210400900000,SW 404,Residential,18000,47314,0,65314
143210401000000,SW 404,Residential,18000,58934,0,76934
143210401100000,SW 404,Residential,18810,55309,0,74119
143210401200000,SW 404,Residential,22968,89106,0,112074
143210401300000,SW 404,Residential,21114,39471,0,60585
143210401400000,SW 404,Residential,21362,70739,0,92101
143210401500000,SW 404,Residential,18000,35139,0,53139
143210401600000,APTS SW,Commercial,27216,0,381290,408506
143210401700000,SW 404,Residential,18000,67288,0,85288
143210401800000,CONVERSIONS,Commercial,9072,0,72068,81140
143210500100000,SW 404,Residential,19045,73284,0,92329
143210500200000,SW 404,Residential,18938,65716,0,84654
143210500300000,SW 404,Residential,20250,85705,0,105955
143210500400000,SW 404,Residential,20250,75879,0,96129
143210500500000,SW 404,Residential,18938,66867,0,85805
143210500600000,SW 404,Residential,17870,57257,0,75127
143210500700000,SW 404,Residential,17316,67624,0,84940
143210500800000,SW 404,Residential,17316,62725,0,80041
143210500900000,SW 404,Residential,23136,99878,0,123014
143210501000000,SW 404,Residential,20250,56179,0,76429
143210501100000,SW 404,Residential,20250,70557,0,90807
143210501200000,SW 404,Residential,18938,79659,0,98597
143210501300000,SW 404,Residential,18034,75931,0,93965
143210501400000,SW 404,Residential,17550,73591,0,91141
143210501500000,SW 404,Residential,17316,62593,0,79909
143210600100000,SW 404,Residential,8901,0,0,8901
143210600200000,SW 404,Residential,21600,75638,0,97238
143210600300000,SW 404,Residential,18000,58653,0,76653
143210600400000,SW 404,Residential,17802,47639,0,65441
143210600500000,SW 404,Residential,21362,65168,0,86530
143210600600000,SW 404,Residential,17595,150940,0,168535
143210600700000,SW 404,Residential,8901,8816,0,17717
143210700300000,COMM SW,Commercial,16848,0,3711,20559
143210700400000,SW 404,Residential,18000,62985,0,80985
143210700500000,SW 404,Residential,18000,52593,0,70593
143210700600000,SW 404,Residential,18000,65200,0,83200
143210700700000,SW 404,Residential,18000,48576,0,66576
143210700800000,SW 404,Residential,18000,47140,0,65140
143210700900000,SW 404,Residential,18000,42993,0,60993
143210701000000,SW 404,Residential,18000,0,0,18000
143210701100000,SW 404,Residential,18000,63371,0,81371
143210701200000,SW 404,Residential,13680,77485,0,91165
143210701300000,SW 404,Residential,12150,86743,0,98893
143210701400000,SW 404,Residential,24000,81852,0,105852
143210701500000,SW 404,Residential,22500,68555,0,91055
143210701600000,SW 404,Residential,24750,103554,0,128304
143210701700000,SW 404,Residential,20000,72455,0,92455
143210701800000,SW 404,Residential,20000,53417,0,73417
143210701900000,SW 404,Residential,20000,52860,0,72860
143210702000000,SW 404,Residential,20000,59631,0,79631
143210702100000,SW 404,Residential,20000,54689,0,74689
143210702200000,SW 404,Residential,20000,44448,0,64448
143210702300000,SW 404,Residential,24000,53268,0,77268
143210702400000,SW 404,Residential,23550,46448,0,69998
143210702500000,COMM SW,Commercial,9720,0,84691,94411
143210702600000,COMM SW,Commercial,31050,0,102965,134015
143210702700000,COMM SW,Commercial,95971,0,59060,155031
143210800100000,SW 404,Residential,18810,84855,0,103665
143210800200000,SW 404,Residential,18000,59083,0,77083
143210800300000,SW 404,Residential,21600,73780,0,95380
143210800500000,SW 404,Residential,18000,43670,0,61670
143210800600000,SW 404,Residential,18000,40164,0,58164
143210800700000,SW 404,Residential,18000,0,0,18000
143210800800000,SW 404,Residential,18000,87231,0,105231
143210800900000,SW 404,Residential,9720,41314,0,51034
143210801000000,SW 404,Residential,9180,39526,0,48706
143210801100000,COMM SW,Commercial,5557,0,113916,119473
143210801200000,COMM SW,Commercial,9072,0,3864,12936
143210801300000,SW 404,Residential,20000,48219,0,68219
143210801400000,SW 404,Residential,20000,43500,0,63500
143210801500000,SW 404,Residential,20000,89628,0,109628
143210801600000,SW 404,Residential,20000,34354,0,54354
143210801700000,SW 404,Residential,20000,80242,0,100242
143210801800000,SW 404,Residential,20900,52838,0,73738
143210900100000,Empty,Exempt,0,0,0,0
143211000100000,COMM SW,Commercial,90720,0,120500,211220
143211000200000,SW 404,Residential,20000,36589,0,56589
143211000300000,SW 404,Residential,20000,47946,0,67946
143211000400000,SW 404,Residential,20000,47597,0,67597
143211000500000,SW 404,Residential,24000,40892,0,64892
143211000600000,SW 404,Residential,24000,71413,0,95413
143211000700000,SW 404,Residential,20000,67007,0,87007
143211000800000,SW 404,Residential,20000,69936,0,89936
143211000900000,SW 404,Residential,24000,86852,0,110852
143211001000000,SW 404,Residential,24000,74500,0,98500
143211001100000,SW 404,Residential,20000,83150,0,103150
143211001200000,SW 404,Residential,20000,56237,0,76237
143211001300000,SW 404,Residential,20000,73862,0,93862
143211001400000,SW 404,Residential,20000,67860,0,87860
143211001500000,SW 404,Residential,20000,52950,0,72950
143211001600000,SW 404,Residential,20000,93944,0,113944
143211001700000,SW 404,Residential,20000,97780,0,117780
143211001800000,SW 404,Residential,20000,34574,0,54574
143211001900000,SW 404,Residential,20000,55378,0,75378
143211002000000,SW 404,Residential,20000,60175,0,80175
143211002100000,SW 404,Residential,20000,67503,0,87503
143211002200000,SW 404,Residential,20000,63127,0,83127
143211002300000,COMM SW,Commercial,90720,0,58865,149585
143211100100000,E-46 RELIG PARKING,Exempt,21546,0,5774,27320
143211100200000,SW 404,Exempt,24000,0,128140,152140
143211100300000,E-40 CHURCHES,Exempt,20844,0,307265,328109
143211100400000,SW 404,Residential,16720,66227,0,82947
143211100500000,SW 404,Residential,22360,78048,0,100408
143211100600000,SW 404,Residential,20000,74303,0,94303
143211100700000,SW 404,Residential,24000,124597,0,148597
143211100800000,SW 404,Residential,24000,118627,0,142627
143211100900000,SW 404,Residential,20000,92065,0,112065
143211101000000,SW 404,Residential,20900,78697,0,99597
143211200100000,SW 404,Residential,21280,65085,0,86365
143211200200000,SW 404,Residential,24000,60605,0,84605
143211200300000,SW 404,Residential,24000,76312,0,100312
143211200400000,SW 404,Residential,20000,76146,0,96146
143211200500000,SW 404,Residential,21840,73857,0,95697
143211200600000,SW 404,Residential,18240,64710,0,82950
143211200700000,SW 404,Residential,21280,65218,0,86498
143212600100000,SW 404,Residential,18000,53004,0,71004
143212600200000,SW 404,Residential,18000,84373,0,102373
143212600300000,SW 404,Residential,18000,54734,0,72734
143212600400000,SW 404,Residential,18000,50900,0,68900
143212600500000,SW 404,Residential,18000,62173,0,80173
143212600600000,SW 404,Residential,27000,35911,0,62911
143212600700000,SW 404,Residential,23400,104018,0,127418
143212700100000,SW 404,Residential,19890,75112,0,95002
143212700200000,SW 404,Residential,12600,42990,0,55590
143212700300000,SW 404,Residential,18000,45175,0,63175
143212700400000,SW 404,Residential,18000,63338,0,81338
143212700500000,SW 404,Residential,18000,52861,0,70861
143212700600000,SW 404,Residential,18000,23673,0,41673
143212700700000,SW 404,Residential,18000,27566,0,45566
143212700800000,SW 404,Residential,18000,37502,0,55502
143212700900000,COMM SW,Commercial,18144,0,0,18144
143212701000000,COMM SW,Commercial,18144,0,0,18144
143212701100000,SW 404,Residential,18000,92761,0,110761
143212701200000,SW 404,Residential,18000,90715,0,108715
143212701300000,SW 404,Residential,18000,75171,0,93171
143212800200000,COMM SW,Commercial,43186,0,22455,65641
143212800300000,Empty,Other,0,0,0,0
143212900100000,SW 404,Residential,21600,70089,0,91689
143212900200000,SW 404,Residential,18000,50035,0,68035
143212900300000,SW 404,Residential,18000,46304,0,64304
143212900400000,SW 404,Residential,18000,53243,0,71243
143212900500000,SW 404,Residential,18000,38908,0,56908
143212900600000,SW 404,Residential,18000,100157,0,118157
143212900700000,SW 404,Residential,18000,36635,0,54635
143212900800000,SW 404,Residential,18000,58231,0,76231
143212900900000,SW 404,Residential,18000,43723,0,61723
143212901000000,SW 404,Residential,18000,44620,0,62620
143212901100000,SW 404,Residential,18000,43370,0,61370
143212901200000,SW 404,Residential,18000,23855,0,41855
143212901300000,SW 404,Residential,18000,42748,0,60748
143212901400000,SW 404,Residential,18000,48194,0,66194
143212901500000,SW 404,Residential,18000,82002,0,100002
143212901600000,SW 404,Residential,10800,0,0,10800
143212901700000,SW 404,Residential,10800,83043,0,93843
143212901800000,SW 404,Residential,18000,58520,0,76520
143213000100000,SW 404,Residential,18000,60625,0,78625
143213000200000,SW 404,Residential,18000,89641,0,107641
143213000300000,SW 404,Residential,10800,61399,0,72199
143213000400000,SW 404,Residential,10800,0,0,10800
143213000500000,SW 404,Residential,18000,73428,0,91428
143213000600000,SW 404,Residential,21600,28400,0,50000
143213000700000,SW 404,Residential,21600,41872,0,63472
143213000800000,SW 404,Residential,18000,166,0,18166
143213000900000,SW 404,Residential,18000,35015,0,53015
143213001000000,SW 404,Residential,18000,18293,0,36293
143213001100000,SW 404,Residential,18000,25622,0,43622
143213001200000,SW 404,Residential,18000,46605,0,64605
143213001300000,SW 404,Residential,18000,61157,0,79157
143213001400000,SW 404,Residential,18000,54950,0,72950
143213001500000,COMM SW,Commercial,18144,0,0,18144
143213001600000,SW 404,Residential,21600,100628,0,122228
143213001700000,SW 404,Residential,18000,63311,0,81311
143213001800000,SW 404,Residential,21600,39949,0,61549
143213001900000,SW 404,Residential,21600,45321,0,66921
143213002000000,SW 404,Residential,18000,27991,0,45991
143213002100000,SW 404,Residential,18000,35319,0,53319
143213002200000,SW 404,Residential,21262,56381,0,77643
143213100100000,COMM SW,Commercial,9765,0,0,9765
143213100200000,COMM SW,Commercial,191700,0,217107,408807
143213200100000,SW 404,Residential,18000,41686,0,59686
143213200200000,SW 404,Residential,18000,0,0,18000
143213200300000,SW 404,Residential,18000,60479,0,78479
143213200400000,SW 404,Residential,18000,59882,0,77882
143213200500000,SW 404,Residential,18000,71566,0,89566
143213200600000,SW 404,Residential,18000,0,0,18000
143213200700000,SW 404,Residential,18000,51979,0,69979
143213200800000,SW 404,Residential,18000,62660,0,80660
143213200900000,SW 404,Residential,20000,79467,0,99467
143213201000000,SW 404,Residential,20000,69534,0,89534
143213201100000,SW 404,Residential,20000,83614,0,103614
143213201200000,SW 404,Residential,20000,69196,0,89196
143213201300000,SW 404,Residential,20000,44739,0,64739
143213201400000,Empty,Exempt,0,0,0,0
143213201500000,Empty,Exempt,0,0,0,0
143213300100000,SW 404,Residential,18000,67711,0,85711
143213300200000,SW 404,Residential,18000,42812,0,60812
143213300300000,SW 404,Residential,18000,46206,0,64206
143213300400000,SW 404,Residential,18000,37950,0,55950
143213300500000,SW 404,Residential,18000,63286,0,81286
143213300600000,SW 404,Residential,18000,63423,0,81423
143213300700000,SW 404,Residential,18000,82309,0,100309
143213300800000,SW 404,Residential,18000,41789,0,59789
143213300900000,COMM SW,Commercial,84240,0,192838,277078
143213301000000,SW 404,Residential,20000,4871,0,24871
143213301100000,SW 404,Residential,20000,88421,0,108421
143213301200000,SW 404,Residential,20000,84590,0,104590
143213301300000,SW 404,Residential,20000,51646,0,71646
143213301400000,SW 404,Residential,20000,49101,0,69101
143213301500000,SW 404,Residential,20000,76312,0,96312
143213301600000,SW 404,Residential,20000,41508,0,61508
143213301700000,SW 404,Residential,20000,36049,0,56049
143213301800000,SW 404,Residential,20000,51779,0,71779
143213301900000,SW 404,Residential,24000,70611,0,94611
143213302000000,SW 404,Residential,20000,50460,0,70460
143213302100000,SW 404,Residential,20000,46795,0,66795
143213400100000,SW 404,Residential,20000,39073,0,59073
143213400200000,SW 404,Residential,30000,83868,0,113868
143213400300000,SW 404,Residential,20000,49717,0,69717
143213400400000,SW 404,Residential,22950,47533,0,70483
143213400500000,SW 404,Residential,22950,80363,0,103313
143213400600000,SW 404,Residential,20000,20072,0,40072
143213400700000,SW 404,Residential,20000,27901,0,47901
143213400800000,SW 404,Residential,23200,75841,0,99041
143213400900000,SW 404,Residential,24800,81420,0,106220
143213500100000,SW 404,Residential,20000,45789,0,65789
143213500200000,SW 404,Residential,20250,96785,0,117035
143213500300000,SW 404,Residential,17500,49526,0,67026
143213500400000,SW 404,Residential,24000,78305,0,102305
143213500500000,SW 404,Residential,24000,123054,0,147054
143213500600000,SW 404,Residential,20000,59755,0,79755
143213500700000,SW 404,Residential,20000,61022,0,81022
143213500800000,SW 404,Residential,20000,75607,0,95607
143213500900000,SW 404,Residential,17600,47726,0,65326
143213501000000,SW 404,Residential,14000,63779,0,77779
143213501100000,SW 404,Residential,18200,55585,0,73785
143213501200000,SW 404,Residential,20000,53445,0,73445
143213501300000,SW 404,Residential,20000,45663,0,65663
143213501400000,SW 404,Residential,20000,55162,0,75162
143213501500000,SW 404,Residential,20000,47824,0,67824
143213501600000,SW 404,Residential,20000,67217,0,87217
143213501700000,SW 404,Residential,20000,96162,0,116162
143213501800000,SW 404,Residential,20000,69254,0,89254
143213600100000,SW 404,Residential,24000,68998,0,92998
143213600200000,SW 404,Residential,20000,89925,0,109925
143213600300000,SW 404,Residential,20000,71461,0,91461
143213600400000,SW 404,Residential,20000,53819,0,73819
143213600500000,SW 404,Residential,20000,55842,0,75842
143213600600000,SW 404,Residential,20250,75583,0,95833
143213600700000,SW 404,Residential,22500,94592,0,117092
143213600800000,SW 404,Residential,20000,52918,0,72918
143213600900000,SW 404,Residential,20000,56056,0,76056
143213601000000,SW 404,Residential,20000,62630,0,82630
143213601100000,SW 404,Residential,20000,58148,0,78148
143213601200000,SW 404,Residential,20000,71363,0,91363
143213601300000,SW 404,Residential,20000,57642,0,77642
143213601400000,SW 404,Residential,20000,64797,0,84797
143213601500000,SW 404,Residential,20000,94544,0,114544
143213601600000,SW 404,Residential,20000,19732,0,39732
143213601700000,SW 404,Residential,20000,52006,0,72006
143213601800000,SW 404,Residential,20000,47234,0,67234
143213601900000,SW 404,Residential,20000,54411,0,74411
143213602000000,SW 404,Residential,20000,47324,0,67324
143213602100000,SW 404,Residential,20000,44663,0,64663
143213602200000,SW 404,Residential,24000,44744,0,68744
143213602300000,SW 404,Residential,20000,89302,0,109302
143213700100000,SW 404,Residential,20000,59440,0,79440
143213700200000,SW 404,Residential,20000,38135,0,58135
143213700300000,SW 404,Residential,20000,81424,0,101424
143213700400000,SW 404,Residential,20000,45886,0,65886
143213700500000,SW 404,Residential,20000,87417,0,107417
143213700600000,SW 404,Residential,22950,48816,0,71766
143213700700000,SW 404,Residential,22950,67017,0,89967
143213700800000,SW 404,Residential,20000,92000,0,112000
143213700900000,SW 404,Residential,20000,42530,0,62530
143213701000000,SW 404,Residential,20000,52142,0,72142
143213701100000,SW 404,Residential,20000,57088,0,77088
143213701200000,SW 404,Residential,20000,47347,0,67347
143215100100000,SW 404,Residential,24000,64166,0,88166
143215100200000,SW 404,Residential,24000,83030,0,107030
143215100300000,SW 404,Residential,20000,20398,0,40398
143215100400000,SW 404,Residential,20000,16517,0,36517
143215100500000,SW 404,Residential,20000,57030,0,77030
143215100600000,SW 404,Residential,20000,59066,0,79066
143215100700000,SW 404,Residential,20000,48920,0,68920
143215100800000,SW 404,Residential,20000,59657,0,79657
143215100900000,SW 404,Residential,20000,55125,0,75125
143215101000000,SW 404,Residential,20000,63928,0,83928
143215101100000,SW 404,Residential,20000,55235,0,75235
143215101200000,SW 404,Residential,20000,52181,0,72181
143215101300000,SW 404,Residential,20000,55232,0,75232
143215101400000,SW 404,Residential,20000,49228,0,69228
143215101500000,SW 404,Residential,20000,60504,0,80504
143215101600000,SW 404,Residential,24000,73442,0,97442
143215101700000,SW 404,Residential,24000,49479,0,73479
143215200100000,SW 404,Residential,20000,32662,0,52662
143215200200000,SW 404,Residential,20000,52616,0,72616
143215200300000,SW 404,Residential,20000,65418,0,85418
143215200400000,SW 404,Residential,20000,61136,0,81136
143215200500000,SW 404,Residential,20000,42435,0,62435
143215200600000,SW 404,Residential,24000,71077,0,95077
143215200700000,SW 404,Residential,20000,46385,0,66385
143215200800000,SW 404,Residential,20000,87191,0,107191
143215200900000,SW 404,Residential,20000,49254,0,69254
143215201000000,SW 404,Residential,20000,40795,0,60795
143215201100000,SW 404,Residential,20000,58877,0,78877
143215201200000,SW 404,Residential,20000,38000,0,58000
143215201300000,SW 404,Residential,20000,79515,0,99515
143215201400000,SW 404,Residential,20000,67630,0,87630
143215201500000,SW 404,Residential,20000,71470,0,91470
143215201600000,SW 404,Residential,20000,103198,0,123198
143215201700000,SW 404,Residential,20000,120256,0,140256
143215201800000,SW 404,Residential,24000,68093,0,92093
143215201900000,SW 404,Residential,20000,76744,0,96744
143215202000000,SW 404,Residential,20000,40881,0,60881
143215202100000,SW 404,Residential,20000,29403,0,49403
143215202200000,SW 404,Residential,20000,66207,0,86207
143215202300000,SW 404,Residential,24000,16830,0,40830
143215300100000,SW 404,Residential,20000,69939,0,89939
143215300200000,SW 404,Residential,20000,53644,0,73644
143215300300000,SW 404,Residential,20000,42575,0,62575
143215300400000,SW 404,Residential,20000,46675,0,66675
143215300500000,SW 404,Residential,20000,43791,0,63791
143215300600000,SW 404,Residential,22950,77723,0,100673
143215300700000,SW 404,Residential,18560,52571,0,71131
143215300800000,SW 404,Residential,20000,40599,0,60599
143215300900000,SW 404,Residential,20000,51481,0,71481
143215301000000,SW 404,Residential,20000,46753,0,66753
143215301100000,SW 404,Residential,20000,63685,0,83685
143215400100000,SW 404,Residential,24000,55309,0,79309
143215400200000,SW 404,Residential,20000,49633,0,69633
143215400300000,SW 404,Residential,24000,54670,0,78670
143215400400000,SW 404,Residential,24000,66255,0,90255
143215400500000,SW 404,Residential,20000,53332,0,73332
143215400600000,SW 404,Residential,24000,116323,0,140323
143215400700000,SW 404,Residential,24000,100684,0,124684
143215400800000,SW 404,Residential,20000,43703,0,63703
143215400900000,SW 404,Residential,20000,106404,0,126404
143215401000000,SW 404,Residential,20000,42104,0,62104
143215401100000,SW 404,Residential,24000,88759,0,112759
143215401200000,SW 404,Residential,20000,86760,0,106760
143215401300000,SW 404,Residential,20000,68159,0,88159
143215401400000,SW 404,Residential,24000,67001,0,91001
143215500100000,SW 404,Residential,20000,77286,0,97286
143215500200000,SW 404,Residential,24000,0,0,24000
143215500300000,SW 404,Residential,24000,86496,0,110496
143215500400000,SW 404,Residential,20000,48554,0,68554
143215500500000,SW 404,Residential,20000,86742,0,106742
143215500600000,SW 404,Residential,20000,39859,0,59859
143215500700000,SW 404,Residential,20000,46536,0,66536
143215500800000,SW 404,Residential,20000,48078,0,68078
143215500900000,SW 404,Residential,20000,51383,0,71383
143215501000000,SW 404,Residential,24000,58193,0,82193
143215501100000,SW 404,Residential,30000,82667,0,112667
143215501200000,SW 404,Residential,12000,0,0,12000
143215501300000,SW 404,Residential,12000,51419,0,63419
143215501400000,SW 404,Residential,24000,49085,0,73085
143215501500000,SW 404,Residential,20000,68768,0,88768
143215501600000,SW 404,Residential,24000,44932,0,68932
143215501700000,SW 404,Residential,20000,73462,0,93462
143215501800000,SW 404,Residential,20000,57165,0,77165
143215501900000,SW 404,Residential,20000,71194,0,91194
143215600100000,SW 404,Residential,20000,38437,0,58437
143215600200000,SW 404,Residential,20000,34626,0,54626
143215600300000,SW 404,Residential,24000,31811,0,55811
143215600400000,SW 404,Residential,20000,19963,0,39963
143215600500000,SW 404,Residential,22312,81499,0,103811
143215600600000,SW 404,Residential,23085,105228,0,128313
143215600700000,SW 404,Residential,24000,19860,0,43860
143215600800000,SW 404,Residential,20000,44803,0,64803
143215600900000,SW 404,Residential,20000,50039,0,70039
143215601000000,SW 404,Residential,20000,50671,0,70671
143215700100000,SW 404,Residential,24000,51131,0,75131
143215700200000,SW 404,Residential,20000,84426,0,104426
143215700300000,SW 404,Residential,20000,54662,0,74662
143215700400000,SW 404,Residential,20000,53570,0,73570
143215700500000,SW 404,Residential,20000,33061,0,53061
143215700600000,SW 404,Residential,20000,42285,0,62285
143215700700000,SW 404,Residential,19950,63694,0,83644
143215700800000,SW 404,Residential,19950,68850,0,88800
143215700900000,SW 404,Residential,18000,45584,0,63584
143215701000000,SW 404,Residential,27000,58811,0,85811
143215701100000,SW 404,Residential,18000,55592,0,73592
143215701200000,SW 404,Residential,18000,103932,0,121932
143215701300000,SW 404,Residential,18000,62566,0,80566
143215701400000,SW 404,Residential,18000,89199,0,107199
143215701500000,SW 404,Residential,18000,82717,0,100717
143215800100000,SW 404,Residential,20000,59687,0,79687
143215800200000,SW 404,Residential,24000,50826,0,74826
143215800300000,SW 404,Residential,22750,77257,0,100007
143215800400000,SW 404,Residential,22750,119021,0,141771
143215800500000,SW 404,Residential,20000,86941,0,106941
143215800600000,SW 404,Residential,20000,82711,0,102711
143215800700000,SW 404,Residential,20000,90737,0,110737
143215800800000,SW 404,Residential,20000,34881,0,54881
143215800900000,SW 404,Residential,20000,44880,0,64880
143215801000000,SW 404,Residential,20000,43870,0,63870
143215801100000,SW 404,Residential,20000,60761,0,80761
143215801200000,SW 404,Residential,18000,55933,0,73933
143215801300000,SW 404,Residential,18000,47713,0,65713
143215801400000,SW 404,Residential,21600,55998,0,77598
143215801600000,SW 404,Residential,21600,94502,0,116102
143215801700000,SW 404,Residential,18000,68497,0,86497
143215801800000,SW 404,Residential,18000,36578,0,54578
143215801900000,SW 404,Residential,18000,64409,0,82409
143215802000000,SW 404,Residential,18000,4139,0,22139
143215802100000,SW 404,Residential,18000,58814,0,76814
143215802200000,SW 404,Residential,18000,71191,0,89191
143215802300000,SW 404,Residential,18000,34994,0,52994
143215900100000,SW 404,Residential,24000,74416,0,98416
143215900200000,SW 404,Residential,20000,47327,0,67327
143215900300000,SW 404,Residential,24000,48769,0,72769
143215900400000,SW 404,Residential,22950,87634,0,110584
143215900500000,SW 404,Residential,20169,81488,0,101657
143215900600000,SW 404,Residential,18000,54557,0,72557
143215900700000,SW 404,Residential,21600,94943,0,116543
143215900800000,SW 404,Residential,21600,105559,0,127159
143216000100000,SW 404,Residential,18816,4400,0,23216
143216000200000,SW 404,Residential,21168,54971,0,76139
143216000300000,SW 404,Residential,17640,52944,0,70584
143216000400000,SW 404,Residential,17640,29044,0,46684
143216000500000,SW 404,Residential,21168,62308,0,83476
143216000600000,SW 404,Residential,17640,105548,0,123188
143216000700000,SW 404,Residential,21168,47044,0,68212
143216100100000,SW 404,Residential,17640,43866,0,61506
143216100200000,SW 404,Residential,17640,78215,0,95855
143216100300000,SW 404,Residential,21168,87784,0,108952
143216100500000,SW 404,Residential,21168,101976,0,123144
143216100600000,SW 404,Residential,18816,61187,0,80003
143216100700000,SW 404,Residential,15680,71186,0,86866
143216100800000,SW 404,Residential,17640,30897,0,48537
143216100900000,SW 404,Residential,17640,41058,0,58698
143216101000000,SW 404,Residential,18816,67531,0,86347
143216200100000,SW 404,Residential,21222,41627,0,62849
143216200200000,SW 404,Residential,15680,51902,0,67582
143216200300000,SW 404,Residential,17640,69616,0,87256
143216200400000,SW 404,Residential,18816,72146,0,90962
143216200500000,SW 404,Residential,17346,113654,0,131000
143217600100000,COMM SW,Commercial,90720,0,176316,267036
143217600200000,SW 404,Residential,20000,59561,0,79561
143217600300000,SW 404,Residential,20000,83300,0,103300
143217600400000,SW 404,Residential,20000,57778,0,77778
143217600500000,SW 404,Residential,20000,61787,0,81787
143217600600000,SW 404,Residential,20000,95705,0,115705
143217600700000,SW 404,Residential,24000,91764,0,115764
143217600800000,SW 404,Residential,20000,93314,0,113314
143217600900000,SW 404,Residential,20000,49113,0,69113
143217601000000,SW 404,Residential,20000,61177,0,81177
143217601100000,SW 404,Residential,15200,76335,0,91535
143217601200000,SW 404,Residential,13500,44244,0,57744
143217601300000,SW 404,Residential,16600,62356,0,78956
143217601400000,SW 404,Residential,19000,48513,0,67513
143217601500000,SW 404,Residential,16600,54814,0,71414
143217601600000,SW 404,Residential,20000,54717,0,74717
143217601700000,SW 404,Residential,20000,111101,0,131101
143217601800000,SW 404,Residential,20000,45838,0,65838
143217601900000,SW 404,Residential,20000,64384,0,84384
143217602000000,SW 404,Residential,20000,16995,0,36995
143217602100000,SW 404,Residential,24000,62638,0,86638
143217602200000,SW 404,Residential,20000,66937,0,86937
143217602300000,SW 404,Residential,20000,40681,0,60681
143217602400000,SW 404,Residential,20000,60234,0,80234
143217602500000,COMM SW,Commercial,90720,0,94787,185507
143217700100000,SW 404,Residential,20900,71511,0,92411
143217700200000,SW 404,Residential,20000,53818,0,73818
143217700300000,SW 404,Residential,20000,52281,0,72281
143217700400000,SW 404,Residential,20000,58438,0,78438
143217700500000,SW 404,Residential,20000,71570,0,91570
143217700600000,SW 404,Residential,20000,50419,0,70419
143217700700000,SW 404,Residential,20000,63347,0,83347
143217700800000,SW 404,Residential,20900,96549,0,117449
143217700900000,SW 404,Residential,20737,70661,0,91398
143217701000000,SW 404,Residential,20737,90383,0,111120
143217701100000,SW 404,Residential,20000,29733,0,49733
143217701200000,SW 404,Residential,20000,66477,0,86477
143217701300000,SW 404,Residential,20000,52093,0,72093
143217701400000,SW 404,Residential,24000,106529,0,130529
143217701500000,SW 404,Residential,20900,73994,0,94894
143217800100000,SW 404,Residential,24750,70886,0,95636
143217800200000,SW 404,Residential,20000,73703,0,93703
143217800300000,SW 404,Residential,20000,75625,0,95625
143217800400000,SW 404,Residential,20000,84198,0,104198
143217800500000,SW 404,Residential,20000,74158,0,94158
143217800600000,SW 404,Residential,22500,49468,0,71968
143217900100000,COMM SW,Commercial,120960,0,204629,325589
143217900200000,COMM SW,Commercial,30240,0,2280,32520
143217900300000,SW 404,Residential,30000,71456,0,101456
143217900400000,SW 404,Residential,24000,67267,0,91267
143217900500000,SW 404,Residential,20000,84922,0,104922
143217900600000,SW 404,Residential,20000,83543,0,103543
143217900700000,SW 404,Residential,20000,84063,0,104063
143217900800000,SW 404,Residential,20000,93562,0,113562
143217900900000,SW 404,Residential,20000,86411,0,106411
143217901000000,SW 404,Residential,24000,70095,0,94095
143217901100000,SW 404,Residential,20000,68214,0,88214
143217901200000,SW 404,Residential,20000,77179,0,97179
143217901300000,SW 404,Residential,20000,71183,0,91183
143217901400000,SW 404,Residential,20000,72212,0,92212
143217901500000,SW 404,Residential,20000,52860,0,72860
143217901600000,SW 404,Residential,20000,50224,0,70224
143217901700000,SW 404,Residential,20000,56306,0,76306
143217901800000,SW 404,Residential,20000,51827,0,71827
143217901900000,SW 404,Residential,20000,75642,0,95642
143217902000000,SW 404,Residential,20000,34618,0,54618
143217902100000,SW 404,Residential,20000,67864,0,87864
143217902200000,SW 404,Residential,40000,67871,0,107871
143217902300000,COMM SW,Commercial,60480,0,61257,121737
143218000100000,SW 404,Residential,16060,69327,0,85387
143218000200000,SW 404,Residential,20000,61488,0,81488
143218000300000,SW 404,Residential,20000,47346,0,67346
143218000400000,SW 404,Residential,20000,84289,0,104289
143218000500000,SW 404,Residential,20000,63630,0,83630
143218000600000,SW 404,Residential,20000,52699,0,72699
143218000700000,SW 404,Residential,20000,111075,0,131075
143218000800000,SW 404,Residential,20900,114035,0,134935
143218000900000,SW 404,Residential,20900,57800,0,78700
143218001000000,SW 404,Residential,20000,56216,0,76216
143218001100000,SW 404,Residential,20000,51467,0,71467
143218001200000,SW 404,Residential,20000,69435,0,89435
143218001300000,SW 404,Residential,24000,68563,0,92563
143218001400000,SW 404,Residential,25200,90380,0,115580
143218001500000,SW 404,Residential,15600,39586,0,55186
143218100100000,SW 404,Residential,22500,79323,0,101823
143218100300000,SW 404,Residential,20000,87437,0,107437
143218100400000,SW 404,Residential,24750,54235,0,78985
143218100500000,SW 404,Residential,20000,84080,0,104080
143218100600000,SW 404,Residential,20000,87340,0,107340
143218100700000,SW 404,Residential,24000,100003,0,124003
143218200100000,COMM SW,Commercial,30240,0,139052,169292
143218200200000,SW 404,Residential,20000,41030,0,61030
143218200300000,SW 404,Residential,20000,53340,0,73340
143218200400000,SW 404,Residential,20000,54521,0,74521
143218200500000,SW 404,Residential,20000,30761,0,50761
143218200600000,SW 404,Residential,20000,48407,0,68407
143218200700000,SW 404,Residential,20000,66451,0,86451
143218200800000,SW 404,Residential,20000,42612,0,62612
143218200900000,SW 404,Residential,20000,47754,0,67754
143218201000000,SW 404,Residential,20000,74771,0,94771
143218201100000,SW 404,Residential,20000,50044,0,70044
143218201200000,SW 404,Residential,20000,31586,0,51586
143218201300000,SW 404,Residential,20000,55418,0,75418
143218201400000,SW 404,Residential,20000,62933,0,82933
143218201500000,SW 404,Residential,20000,38292,0,58292
143218201600000,SW 404,Residential,19152,39915,0,59067
143218201700000,SW 404,Residential,20482,73496,0,93978
143218201800000,SW 404,Residential,20000,73858,0,93858
143218201900000,SW 404,Residential,20000,55971,0,75971
143218202000000,SW 404,Residential,20000,41320,0,61320
143218202100000,SW 404,Residential,20000,76745,0,96745
143218202200000,SW 404,Residential,20000,75417,0,95417
143218202300000,SW 404,Residential,20000,65720,0,85720
143218202400000,SW 404,Residential,20000,61528,0,81528
143218202500000,SW 404,Residential,20000,53814,0,73814
143218202600000,SW 404,Residential,20000,49986,0,69986
143218202700000,SW 404,Residential,20000,40654,0,60654
143218202800000,SW 404,Residential,20000,104105,0,124105
143218202900000,COMM SW,Commercial,60480,0,62070,122550
143218300100000,SW 404,Residential,20900,42956,0,63856
143218300200000,SW 404,Residential,20000,74526,0,94526
143218300300000,SW 404,Residential,20000,46272,0,66272
143218300400000,SW 404,Residential,20000,49046,0,69046
143218300500000,SW 404,Residential,20000,40785,0,60785
143218300600000,SW 404,Residential,20000,63543,0,83543
143218300700000,SW 404,Residential,20000,48411,0,68411
143218300800000,SW 404,Residential,15400,71769,0,87169
143218300900000,SW 404,Residential,16800,55237,0,72037
143218301000000,SW 404,Residential,24000,66360,0,90360
143218301100000,SW 404,Residential,24000,72556,0,96556
143218301200000,SW 404,Residential,20000,83405,0,103405
143218301300000,SW 404,Residential,24000,68626,0,92626
143218301400000,SW 404,Residential,20000,62362,0,82362
143218301500000,SW 404,Residential,20900,56122,0,77022
143218400100000,SW 404,Residential,22500,45152,0,67652
143218400200000,SW 404,Residential,20000,52793,0,72793
143218400300000,SW 404,Residential,18000,49464,0,67464
143218400400000,SW 404,Residential,22500,58380,0,80880
143218400500000,SW 404,Residential,20000,45730,0,65730
143218400600000,SW 404,Residential,20000,57933,0,77933
143218400700000,SW 404,Residential,24000,82601,0,106601
143218400800000,SW 404,Residential,20000,58723,0,78723
143218500100000,Empty,Other,0,0,0,0
143218500200000,Empty,Exempt,0,0,0,0
143218500300000,SW 404,Residential,15680,53988,0,69668
143218500400000,SW 404,Residential,18346,45478,0,63824
143218500500000,SW 404,Residential,16934,95639,0,112573
143218500600000,SW 404,Residential,19600,82400,0,102000
143218500700000,SW 404,Residential,15680,54275,0,69955
143218500800000,SW 404,Residential,19600,29678,0,49278
143218500900000,SW 404,Residential,15680,48855,0,64535
143218501000000,SW 404,Residential,15680,68523,0,84203
143218501100000,SW 404,Residential,15520,52156,0,67676
143218501200000,SW 404,Residential,15520,51221,0,66741
143218501300000,SW 404,Residential,19456,72604,0,92060
143218501400000,SW 404,Residential,15565,111958,0,127523
143218600100000,COMM SW,Commercial,67418,0,307893,375311
143218600200000,SW 404,Residential,15520,89267,0,104787
143218600300000,SW 404,Residential,15520,23713,0,39233
143218600400000,SW 404,Residential,19555,67688,0,87243
143218700100000,SW 404,Residential,24960,58787,0,83747
143218700200000,SW 404,Residential,20218,93947,0,114165
143220100100000,SW 404,Residential,23475,55095,0,78570
143220200100000,COMM SW,Commercial,972,0,0,972
143220200200000,COMM SW,Commercial,38940,0,0,38940
143220300100000,COMM SW,Commercial,30375,0,0,30375
143220300200000,COMM SW,Commercial,168750,0,252303,421053
143220300300000,COMM SW,Commercial,339012,0,748810,1087822
143220300400000,E-05 STATE,Exempt,0,0,0,0
143220400100000,SW 404,Residential,20000,50662,0,70662
143220400200000,SW 404,Residential,20000,49463,0,69463
143220400300000,SW 404,Residential,24000,62626,0,86626
143220400400000,SW 404,Residential,20000,58894,0,78894
143220400500000,SW 404,Residential,20000,32858,0,52858
143220400600000,SW 404,Residential,20000,72469,0,92469
143220400700000,SW 404,Residential,20000,53396,0,73396
143220400800000,SW 404,Residential,16000,73639,0,89639
143220400900000,SW 404,Residential,12000,0,0,12000
143220401000000,SW 404,Residential,20000,44239,0,64239
143220401100000,SW 404,Residential,20000,51290,0,71290
143220401200000,SW 404,Residential,20000,80118,0,100118
143220401300000,SW 404,Residential,20000,88908,0,108908
143220401400000,SW 404,Residential,20000,57678,0,77678
143220401500000,SW 404,Residential,20000,79437,0,99437
143220401600000,SW 404,Residential,20000,60243,0,80243
143220401700000,SW 404,Residential,20000,41365,0,61365
143220401800000,SW 404,Residential,20000,56677,0,76677
143220401900000,SW 404,Residential,20000,64193,0,84193
143220402000000,SW 404,Residential,24000,55749,0,79749
143220402100000,SW 404,Residential,24000,43010,0,67010
143220500100000,E-05 STATE,Exempt,0,0,0,0
143220500200000,SW 404,Residential,31583,81317,0,112900
143220500202000,COMM SW,Commercial,0,0,22520,22520
143220500300000,SW 404,Residential,23086,46367,0,69453
143220500400000,SW 404,Residential,23968,59021,0,82989
143220500500000,SW 404,Residential,20000,82426,0,102426
143220500600000,SW 404,Residential,22500,73316,0,95816
143220500700000,SW 404,Residential,27500,97245,0,124745
143220500800000,SW 404,Residential,24000,42876,0,66876
143220500900000,SW 404,Residential,20000,65354,0,85354
143220501000000,SW 404,Residential,16150,46600,0,62750
143220501100000,SW 404,Residential,16625,43990,0,60615
143220501200000,SW 404,Residential,16150,46905,0,63055
143220600100000,SW 404,Residential,24000,56034,0,80034
143220600200000,SW 404,Residential,20000,47663,0,67663
143220600300000,SW 404,Residential,24000,44618,0,68618
143220600400000,SW 404,Residential,24000,87568,0,111568
143220600500000,SW 404,Residential,20000,55117,0,75117
143220600600000,SW 404,Residential,24000,38826,0,62826
143220600700000,SW 404,Residential,20000,84304,0,104304
143220600800000,SW 404,Residential,20000,44695,0,64695
143220600900000,SW 404,Residential,24000,88255,0,112255
143220601000000,SW 404,Residential,20000,58439,0,78439
143220601100000,SW 404,Residential,20000,102457,0,122457
143220601200000,SW 404,Residential,24000,57853,0,81853
143220601300000,SW 404,Residential,20000,65052,0,85052
143220601400000,SW 404,Residential,20000,75319,0,95319
143220601500000,SW 404,Residential,20000,113850,0,133850
143220601600000,SW 404,Residential,20000,61207,0,81207
143220601700000,SW 404,Residential,20000,49673,0,69673
143220601800000,SW 404,Residential,20000,95703,0,115703
143220700100000,SW 404,Residential,20000,65341,0,85341
143220700200000,SW 404,Residential,20000,55836,0,75836
143220700300000,SW 404,Residential,20000,42452,0,62452
143220700400000,SW 404,Residential,24000,93538,0,117538
143220700500000,SW 404,Residential,20000,89042,0,109042
143220700600000,SW 404,Residential,20000,56548,0,76548
143220700700000,SW 404,Residential,24000,10750,0,34750
143220700800000,SW 404,Residential,20000,50316,0,70316
143220700900000,SW 404,Residential,24000,54766,0,78766
143220701000000,SW 404,Residential,20000,62042,0,82042
143220701100000,SW 404,Residential,26125,92450,0,118575
143220701200000,SW 404,Residential,29216,85295,0,114511
143220701300000,SW 404,Residential,20000,0,0,20000
143220701400000,SW 404,Residential,30000,93154,0,123154
143220701500000,SW 404,Residential,24000,51162,0,75162
143220701600000,SW 404,Residential,24000,61600,0,85600
143220701700000,SW 404,Residential,20000,68118,0,88118
143220701800000,SW 404,Residential,20000,57951,0,77951
143220701900000,SW 404,Residential,23375,65187,0,88562
143220702000000,SW 404,Residential,24375,66310,0,90685
143220702100000,SW 404,Residential,20000,65432,0,85432
143220702200000,SW 404,Residential,24000,60346,0,84346
143222600100000,SW 405,Residential,20700,72320,0,93020
143222600200000,SW 405,Residential,20925,76308,0,97233
143222600300000,SW 405,Residential,21150,42318,0,63468
143222600400000,SW 405,Residential,21600,74890,0,96490
143222600500000,SW 405,Residential,21825,58420,0,80245
143222600600000,SW 405,Residential,21825,81729,0,103554
143222600700000,SW 405,Residential,21600,58017,0,79617
143222600800000,SW 405,Residential,21600,46441,0,68041
143222600900000,SW 405,Residential,21375,52538,0,73913
143222601000000,SW 405,Residential,21150,48873,0,70023
143222601100000,SW 405,Residential,20925,55885,0,76810
143222601200000,SW 405,Residential,20700,51676,0,72376
143222601300000,SW 405,Residential,20475,57739,0,78214
143222601400000,SW 405,Residential,20250,64890,0,85140
143222601500000,SW 405,Residential,23247,55168,0,78415
143222601600000,SW 405,Residential,22842,54204,0,77046
143222601700000,SW 405,Residential,25440,78989,0,104429
143222601800000,SW 405,Residential,24422,59136,0,83558
143222601900000,SW 405,Residential,22050,55382,0,77432
143222602000000,SW 405,Residential,23052,55587,0,78639
143222602100000,COMM SW,Commercial,58320,0,174105,232425
143222602200000,COMM SW,Commercial,82620,0,215206,297826
143222602300000,COMM SW,Commercial,43740,0,16451,60191
143222602400000,COMM SW,Commercial,162000,0,186277,348277
143222602500000,COMM SW,Commercial,101148,0,76450,177598
143222602502000,COMM SW,Commercial,0,0,55432,55432
143222602600000,COMM SW,Commercial,44955,0,3899,48854
143222602700000,E-05 STATE,Exempt,0,0,0,0
143222700100000,SW 405,Residential,21825,82089,0,103914
143222700200000,SW 405,Residential,22465,66256,0,88721
143222700300000,COMM SW,Commercial,29808,0,0,29808
143222700400000,COMM SW,Commercial,94095,0,22029,116124
143222800100000,COMM SW,Commercial,189810,0,494414,684224
143222800200000,COMM SW,Commercial,66927,0,0,66927
143222800300000,APTS SW,Commercial,173137,0,117749,290886
143222800400000,SW 405,Ag Land,6976,0,0,6976
143222800500000,SW 405,Ag Dwelling,10282,27086,847,38215
143225100100000,COMM SW,Commercial,253314,0,39160,292474
143225100102001,COMM SW,Commercial,0,0,14697,14697
143225200100000,SW 405,Residential,61550,11235,0,72785
143225200201000,CONDO 500,Residential,5000,42260,0,47260
143225200201001,CONDO 500,Residential,5000,42260,0,47260
143225200201002,CONDO 500,Residential,5000,42260,0,47260
143225200201003,CONDO 500,Residential,5000,42260,0,47260
143225200201004,CONDO 500,Residential,5000,41974,0,46974
143225200201005,CONDO 500,Residential,5000,41974,0,46974
143225200201006,CONDO 500,Residential,5000,41974,0,46974
143225200201007,CONDO 500,Residential,5000,41974,0,46974
143225200300000,SW 405,Residential,34104,80499,0,114603
143225200400000,SW 405,Residential,21753,71478,0,93231
143225200500000,SW 405,Residential,19775,59571,0,79346
143225200600000,SW 405,Residential,21560,70847,0,92407
143225200700000,SW 405,Residential,25136,60817,0,85953
143225300201000,CONDO 501,Residential,6000,96657,0,102657
143225300201001,CONDO 501,Residential,6000,96657,0,102657
143225300201002,CONDO 501,Residential,6000,96657,0,102657
143225300201003,CONDO 501,Residential,6000,96657,0,102657
143225300201004,CONDO 501,Residential,6000,83385,0,89385
143225300201005,CONDO 501,Residential,6000,83385,0,89385
143225300201006,CONDO 501,Residential,6000,83385,0,89385
143225300201007,CONDO 501,Residential,6000,83385,0,89385
143225300201008,CONDO 501,Residential,6000,86787,0,92787
143225300201009,CONDO 501,Residential,6000,96657,0,102657
143225300201010,CONDO 501,Residential,6000,86787,0,92787
143225300201011,CONDO 501,Residential,6000,96657,0,102657
143225300201012,CONDO 501,Residential,6000,75010,0,81010
143225300201013,CONDO 501,Residential,6000,83385,0,89385
143225300201014,CONDO 501,Residential,6000,75010,0,81010
143225300201015,CONDO 501,Residential,6000,83385,0,89385
143225300201016,CONDO 501,Residential,6000,96657,0,102657
143225300201017,CONDO 501,Residential,6000,86787,0,92787
143225300201018,CONDO 501,Residential,6000,96657,0,102657
143225300201019,CONDO 501,Residential,6000,86787,0,92787
143225300201020,CONDO 501,Residential,6000,83385,0,89385
143225300201021,CONDO 501,Residential,6000,75010,0,81010
143225300201022,CONDO 501,Residential,6000,83385,0,89385
143225300201023,CONDO 501,Residential,6000,75010,0,81010
143225300201024,CONDO 501,Residential,6000,5812,0,11812
143225300201025,CONDO 501,Residential,6000,5812,0,11812
143225300201026,CONDO 501,Residential,6000,5812,0,11812
143225300201027,CONDO 501,Residential,6000,5812,0,11812
143225300201028,CONDO 501,Residential,6000,5812,0,11812
143225300201029,CONDO 501,Residential,6000,5812,0,11812
143225300201030,CONDO 501,Residential,6000,5812,0,11812
143225300201031,CONDO 501,Residential,6000,5812,0,11812
143225300201032,CONDO 501,Residential,6000,86787,0,92787
143225300201033,CONDO 501,Residential,6000,96657,0,102657
143225300201034,CONDO 501,Residential,6000,86787,0,92787
143225300201035,CONDO 501,Residential,6000,96657,0,102657
143225300201036,CONDO 501,Residential,6000,75010,0,81010
143225300201037,CONDO 501,Residential,6000,83508,0,89508
143225300201038,CONDO 501,Residential,6000,75010,0,81010
143225300201039,CONDO 501,Residential,6000,83508,0,89508
143225300201040,CONDO 501,Residential,6000,96657,0,102657
143225300201041,CONDO 501,Residential,6000,86787,0,92787
143225300201042,CONDO 501,Residential,6000,96657,0,102657
143225300201043,CONDO 501,Residential,6000,86787,0,92787
143225300201044,CONDO 501,Residential,6000,83508,0,89508
143225300201045,CONDO 501,Residential,6000,75010,0,81010
143225300201046,CONDO 501,Residential,6000,83508,0,89508
143225300201047,CONDO 501,Residential,6000,75010,0,81010
143225300300000,SW 405,Residential,49199,131209,0,180408
143225300400000,SW 405,Residential,32179,0,0,32179
143225300500000,SW 405,Residential,35670,119933,0,155603
143225300600000,SW 405,Residential,24548,96228,0,120776
143225300700000,SW 405,Residential,23660,97188,0,120848
143225300800000,SW 405,Residential,23660,90339,0,113999
143225300900000,SW 405,Residential,24139,57268,0,81407
143225301000000,SW 405,Residential,19600,64724,0,84324
143225301100000,SW 405,Residential,19600,0,0,19600
143225301200000,SW 405,Residential,19600,131554,0,151154
143225301300000,SW 405,Residential,46084,105844,0,151928
143225301400000,SW 405,Residential,26953,49595,0,76548
143225301500000,APTS SW,Commercial,55620,0,536501,592121
143225301600000,COMM SW,Commercial,37800,0,82985,120785
143225301700000,SW 405,Residential,42313,49687,0,92000
143225301800000,SW 405,Residential,40363,64585,0,104948
143227600100000,SW 404,Residential,20000,0,0,20000
143227600200000,SW 404,Residential,20000,43892,0,63892
143227600300000,SW 404,Residential,24000,103215,0,127215
143227600400000,SW 404,Residential,12000,237,0,12237
143227600500000,SW 404,Residential,12000,63240,0,75240
143227600600000,SW 404,Residential,20000,46831,0,66831
143227600700000,SW 404,Residential,20000,63297,0,83297
143227600800000,SW 404,Residential,24000,69265,0,93265
143227600900000,SW 404,Residential,21660,61300,0,82960
143227601000000,SW 404,Residential,15200,61953,0,77153
143227601100000,SW 404,Residential,15200,56552,0,71752
143227601200000,SW 404,Residential,20000,59688,0,79688
143227601300000,SW 404,Residential,24000,62015,0,86015
143227601400000,SW 404,Residential,24000,81500,0,105500
143227601500000,SW 404,Residential,24000,53533,0,77533
143227601600000,SW 404,Residential,20000,75750,0,95750
143227601700000,SW 404,Residential,20000,53403,0,73403
143227601800000,SW 404,Residential,20000,49775,0,69775
143227601900000,Empty,Exempt,0,0,0,0
143227602000000,SW 404,Residential,2500,0,0,2500
143227700100000,SW 404,Residential,24000,56846,0,80846
143227700200000,SW 404,Residential,20000,69757,0,89757
143227700300000,SW 404,Residential,24000,72959,0,96959
143227700400000,SW 404,Residential,20000,68954,0,88954
143227700500000,SW 404,Residential,20000,91667,0,111667
143227700600000,SW 404,Residential,20000,55588,0,75588
143227700700000,SW 404,Residential,20000,46137,0,66137
143227700800000,SW 404,Residential,24000,55828,0,79828
143227700900000,SW 404,Residential,25000,50730,0,75730
143227701000000,SW 404,Residential,25000,62775,0,87775
143227701100000,SW 404,Residential,25000,69215,0,94215
143227701200000,SW 404,Residential,24650,46453,0,71103
143227701300000,SW 404,Residential,24000,84766,0,108766
143227701400000,SW 404,Residential,24000,84762,0,108762
143227701500000,SW 404,Residential,24000,80117,0,104117
143227701600000,SW 404,Residential,20000,85324,0,105324
143227701700000,SW 404,Residential,24000,91540,0,115540
143227701800000,SW 404,Residential,20000,16440,0,36440
143227701900000,SW 404,Residential,10000,0,0,10000
143227702000000,SW 404,Residential,20000,101179,0,121179
143227702100000,SW 404,Residential,22500,73640,0,96140
143227702200000,SW 404,Residential,21375,105587,0,126962
143227800100000,SW 404,Residential,20000,42118,0,62118
143227800200000,SW 404,Residential,24000,36730,0,60730
143227800300000,Empty,Exempt,0,0,0,0
143227800400000,SW 404,Residential,24000,75787,0,99787
143227800500000,SW 404,Residential,24000,38589,0,62589
143227800600000,SW 404,Residential,24000,55000,0,79000
143227800700000,SW 404,Residential,12000,0,0,12000
143227800800000,SW 404,Residential,12000,83031,0,95031
143227800900000,SW 404,Residential,24000,84175,0,108175
143227801000000,SW 404,Residential,20000,81737,0,101737
143227801100000,SW 404,Residential,24000,97979,0,121979
143227801200000,Empty,Exempt,0,0,0,0
143227801300000,SW 404,Residential,20000,41296,0,61296
143227801400000,SW 404,Residential,24000,62575,0,86575
143227801500000,SW 404,Residential,24000,469,0,24469
143227801600000,SW 404,Residential,20000,87252,0,107252
143227900100000,SW 404,Residential,20000,71413,0,91413
143227900200000,SW 404,Residential,20000,80132,0,100132
143227900300000,SW 404,Residential,20000,30435,0,50435
143227900400000,SW 404,Residential,20000,38306,0,58306
143227900500000,SW 404,Residential,20000,31748,0,51748
143227900600000,SW 404,Residential,20000,60399,0,80399
143227900700000,SW 404,Residential,20000,39000,0,59000
143227900800000,SW 404,Residential,20000,94080,0,114080
143227900900000,SW 404,Residential,20000,77200,0,97200
143227901000000,SW 404,Residential,20000,97546,0,117546
143227901100000,SW 404,Residential,28000,129096,0,157096
143227901200000,SW 404,Residential,20000,67865,0,87865
143227901300000,SW 404,Residential,20000,85548,0,105548
143227901400000,SW 404,Residential,20000,71710,0,91710
143227901500000,SW 404,Residential,20000,82296,0,102296
143227901600000,SW 404,Residential,20000,13086,0,33086
143227901700000,SW 404,Residential,23192,48882,0,72074
143227901800000,SW 404,Residential,22806,59664,0,82470
143227901900000,SW 404,Residential,24000,64104,0,88104
143227902000000,SW 404,Residential,27500,121860,0,149360
143227902100000,SW 404,Residential,20000,62543,0,82543
143227902200000,SW 404,Residential,20000,67444,0,87444
143227902300000,SW 404,Residential,20000,69913,0,89913
143227902400000,SW 404,Residential,20000,79616,0,99616
143227902500000,SW 404,Residential,20000,34441,0,54441
143227902600000,SW 404,Residential,24000,41662,0,65662
143227902700000,SW 404,Residential,20000,72086,0,92086
143227902800000,SW 404,Residential,26000,62110,0,88110
143227902900000,SW 404,Residential,20000,74460,0,94460
143227903000000,SW 404,Residential,20000,67642,0,87642
143227903100000,SW 404,Residential,20000,48736,0,68736
143228000100000,Empty,Exempt,0,0,0,0
143228000200000,SW 404,Residential,20000,59581,0,79581
143228000300000,SW 404,Residential,30000,33730,0,63730
143228000400000,SW 404,Residential,20000,76587,0,96587
143228000500000,SW 404,Residential,18000,72650,0,90650
143228000600000,SW 404,Residential,18000,54241,0,72241
143228000700000,SW 404,Residential,18000,71351,0,89351
143228000800000,SW 404,Residential,18000,28045,0,46045
143228000900000,SW 404,Residential,18000,61352,0,79352
143228001000000,SW 404,Residential,18000,0,0,18000
143228100100000,SW 404,Residential,20000,76828,0,96828
143228100200000,SW 404,Residential,20000,91764,0,111764
143228100300000,SW 404,Residential,20000,75336,0,95336
143228100400000,SW 404,Residential,26000,76503,0,102503
143228100500000,SW 404,Residential,20000,91932,0,111932
143228100600000,SW 404,Residential,20000,95643,0,115643
143228100700000,SW 404,Residential,20000,37799,0,57799
143228100800000,SW 404,Residential,20000,41186,0,61186
143228100900000,SW 404,Residential,20000,22518,0,42518
143228101000000,SW 404,Residential,20000,99291,0,119291
143228101100000,SW 404,Residential,20000,64830,0,84830
143228101200000,SW 404,Residential,20000,25000,0,45000
143228101300000,SW 404,Residential,24000,91663,0,115663
143228101400000,SW 404,Residential,24000,95114,0,119114
143228101700000,SW 404,Residential,21121,38033,0,59154
143228101800000,SW 404,Residential,23400,72322,0,95722
143228101900000,SW 404,Residential,18000,69960,0,87960
143228102000000,SW 404,Residential,18000,56090,0,74090
143228102100000,SW 404,Residential,18000,78111,0,96111
143228102200000,SW 404,Residential,18000,68361,0,86361
143228102300000,SW 404,Residential,18000,54542,0,72542
143228102400000,SW 404,Residential,18000,25653,0,43653
143228102500000,SW 404,Residential,18000,59060,0,77060
143228102600000,SW 404,Residential,18000,72879,0,90879
143228102700000,SW 404,Residential,23400,60476,0,83876
143228102800000,SW 404,Residential,18000,40617,0,58617
143228102900000,SW 404,Residential,18000,47004,0,65004
143228103000000,SW 404,Residential,18000,57659,0,75659
143228103100000,SW 404,Residential,23400,30653,0,54053
143228103200000,SW 404,Residential,26449,83919,0,110368
143228200100000,Empty,Exempt,0,0,0,0
143228200200000,SW 404,Residential,15680,56087,0,71767
143228200300000,SW 404,Residential,15680,36692,0,52372
143228200400000,SW 404,Residential,15680,72186,0,87866
143228200500000,SW 404,Residential,17640,60412,0,78052
143228200600000,SW 404,Residential,15680,75713,0,91393
143228200700000,SW 404,Residential,15680,55960,0,71640
143228200800000,SW 404,Residential,17640,32151,0,49791
143228200900000,SW 404,Residential,15680,49579,0,65259
143228201000000,SW 404,Residential,17640,0,0,17640
143228201100000,E-40 CHURCHES,Exempt,32141,0,121386,153527
143228300100000,SW 404,Residential,17640,89419,0,107059
143228300200000,SW 404,Residential,17640,74243,0,91883
143228300300000,SW 404,Residential,17640,82656,0,100296
143228300400000,SW 404,Residential,12060,37192,0,49252
143228300500000,SW 404,Residential,10720,34421,0,45141
143228300600000,SW 404,Residential,12060,38243,0,50303
143228300700000,SW 404,Residential,10720,35306,0,46026
143228300900000,SW 404,Residential,20384,98326,0,118710
143228301000000,SW 404,Residential,19800,45097,0,64897
143228301100000,SW 404,Residential,12060,34167,0,46227
143228301200000,SW 404,Residential,12060,32358,0,44418
143228301300000,SW 404,Residential,10720,39471,0,50191
143228301400000,SW 404,Residential,23520,71788,0,95308
143228301500000,SW 404,Residential,19296,41575,0,60871
143228301600000,SW 404,Residential,20502,36241,0,56743
143228301700000,SW 404,Residential,21168,77309,0,98477
143228301800000,SW 404,Residential,17339,44522,0,61861
143230100100000,Empty,Other,0,0,0,0
143230100300000,COMM SW,Commercial,2291,0,0,2291
143230100400000,COMM SW,Commercial,458649,0,0,458649
143232600100000,COMM SW,Commercial,139946,0,240878,380824
143232600200000,SW 418,Residential,36920,0,0,36920
143232600300000,SW 418,Residential,38588,65893,0,104481
143232600400000,SW 418,Residential,30700,36144,0,66844
143232700100000,Empty,Other,0,0,0,0
143232800100000,SW 418,Residential,25736,30080,0,55816
143232800200000,SW 418,Residential,26775,31580,0,58355
143232800300000,SW 418,Residential,17850,66432,0,84282
143232800400000,SW 418,Residential,17850,87537,0,105387
143232800500000,SW 418,Residential,17850,76509,0,94359
143232800600000,SW 418,Residential,20400,75084,0,95484
143232800700000,SW 418,Residential,30345,93841,0,124186
143232800800000,SW 418,Residential,17850,88010,0,105860
143232800900000,SW 418,Residential,12320,53404,0,65724
143232801000000,SW 418,Residential,19342,60539,0,79881
143232801100000,SW 418,Residential,29704,68707,0,98411
143232801200000,SW 418,Residential,225,0,0,225
143232801300000,SW 418,Residential,24500,67380,0,91880
143232801400000,SW 418,Residential,21309,47925,0,69234
143232801500000,SW 418,Residential,16000,86038,0,102038
143232801600000,COMM SW,Commercial,325728,0,706402,1032130
143232801700000,SW 418,Residential,35450,951,0,36401
143232801800000,SW 418,Residential,16000,39355,0,55355
143235100100000,SW 418,Ag Land,27584,0,0,27584
143235100300000,COMM SW,Other,0,0,0,0
143235200100000,SW 418,Ag Dwelling,12183,109927,0,122110
143235200200000,Empty,Other,0,0,0,0
143237600200000,COMM SW,Commercial,299106,0,726858,1025964
143237600500000,INDUSTRIAL,Industrial,149000,0,0,149000
143237600600000,COMM SW,Commercial,59400,0,0,59400
143237600700000,COMM SW,Commercial,41918,0,0,41918
143237600800000,COMM SW,Commercial,234319,0,0,234319
143240100100000,INDUSTRIAL,Industrial,533065,0,3466935,4000000
143242600100000,INDUSTRIAL,Industrial,418600,0,1907033,2325633
143242600200000,Empty,Other,0,0,0,0
143242600300000,INDUSTRIAL,Industrial,59000,0,0,59000
143242600400000,INDUSTRIAL,Industrial,150000,0,0,150000
143242600500000,Empty,Other,0,0,0,0
143242600600000,COMM SW,Commercial,47520,0,48575,96095
143242600700000,COMM SW,Commercial,109728,0,137959,247687
143242600900000,COMM SW,Commercial,108972,0,432261,541233
143245100100000,COMM SW,Commercial,365013,0,1574312,1939325
143245100200000,COMM SW,Commercial,172800,0,146720,319520
143245100300000,COMM SW,Commercial,50855,0,111905,162760
143245100400000,COMM SW,Commercial,31018,0,165,31183
143245100500000,COMM SW,Commercial,44634,0,47577,92211
143245200100000,COMM SW,Commercial,80179,0,387663,467842
143245200200000,COMM SW,Commercial,71798,0,462167,533965
143245200300000,COMM SW,Commercial,107568,0,352258,459826
143245200400000,COMM SW,Commercial,71280,0,233878,305158
143245200500000,COMM SW,Commercial,30996,0,1689,32685
143245200600000,COMM SW,Commercial,101174,0,271837,373011
143245200700000,COMM SW,Commercial,81821,0,68179,150000
143245300100000,COMM SW,Commercial,338526,0,1389193,1727719
143245300200000,COMM SW,Commercial,181008,0,447678,628686
143245400100000,COMM SW,Commercial,200448,0,197203,397651
143245400200000,COMM SW,Commercial,69444,0,269377,338821
143245400300000,COMM SW,Commercial,29700,0,6776,36476
143245400400000,COMM SW,Commercial,54000,0,125087,179087
143245400500000,COMM SW,Commercial,45576,0,107255,152831
143245400600000,COMM SW,Commercial,262980,0,237433,500413
143245400700000,COMM SW,Commercial,122688,0,280268,402956
143247600100000,COMM SW,Commercial,660906,0,2477006,3137912
143247600200000,COMM SW,Commercial,102546,0,0,102546
143247600300000,COMM SW,Commercial,221832,0,1018270,1240102
143247700100000,COMM SW,Commercial,124740,0,35549,160289
143247700102000,COMM SW,Commercial,0,0,57829,57829
143247700200000,COMM SW,Commercial,140940,0,395212,536152
143247700300000,COMM SW,Commercial,19440,0,0,19440
143247700400000,COMM SW,Commercial,292885,0,735504,1028389
143247700500000,COMM SW,Commercial,80352,0,281478,361830
143247700600000,COMM SW,Commercial,80006,0,66206,146212
143247700700000,COMM SW,Commercial,191376,0,15416,206792
143247800100000,COMM SW,Commercial,88992,0,300506,389498
143247800200000,COMM SW,Commercial,87696,0,30296,117992
143247800300000,COMM SW,Commercial,40565,0,0,40565
143247800400000,COMM SW,Commercial,23846,0,62530,86376
143247800500000,COMM SW,Commercial,42656,0,8960,51616
143247800600000,COMM SW,Commercial,43416,0,0,43416
143247800700000,COMM SW,Commercial,19440,0,2754,22194
143247800800000,COMM SW,Commercial,245700,0,854300,1100000
143310100100000,SW 402,Residential,11000,0,0,11000
143310100200000,SW 402,Residential,6000,0,0,6000
143310100300000,SW 402,Residential,6000,0,0,6000
143310100400000,SW 402,Residential,5000,0,0,5000
143310100500000,SW 402,Residential,11000,0,0,11000
143310100600000,COMM SW,Commercial,60480,0,0,60480
143310100700000,SW 402,Residential,10000,0,0,10000
143310200100000,SW 402,Residential,5400,0,0,5400
143310200200000,SW 402,Residential,5400,0,0,5400
143310200300000,SW 402,Residential,7600,0,0,7600
143310200400000,SW 402,Residential,7600,0,0,7600
143310200500000,SW 402,Residential,13200,0,0,13200
143310200600000,SW 402,Residential,5000,0,0,5000
143310300100000,SW 412,Residential,7000,0,0,7000
143310300200000,SW 412,Residential,12000,0,0,12000
143310300300000,SW 412,Residential,12000,0,0,12000
143310300400000,SW 412,Residential,12000,0,0,12000
143310300500000,SW 412,Residential,12000,0,0,12000
143310300600000,SW 412,Residential,7000,0,0,7000
143310300700000,SW 412,Residential,6000,0,0,6000
143310300800000,SW 412,Residential,6000,0,0,6000
143310300900000,SW 412,Residential,7000,0,0,7000
143310301000000,SW 412,Residential,24750,39478,0,64228
143310301100000,SW 412,Residential,15750,70723,0,86473
143310301200000,SW 412,Residential,15750,63219,0,78969
143310301300000,SW 412,Residential,18000,99621,0,117621
143310301400000,SW 412,Residential,24750,60444,0,85194
143310301500000,SW 412,Residential,24750,59858,0,84608
143310301600000,SW 412,Residential,24750,61422,0,86172
143310301700000,SW 412,Residential,24750,60453,0,85203
143310301800000,SW 412,Residential,24750,91934,0,116684
143310400100000,SW 402,Residential,5000,0,0,5000
143310400200000,SW 402,Residential,11857,25656,0,37513
143310400300000,SW 402,Residential,21165,53831,0,74996
143310400400000,SW 402,Residential,25500,65192,0,90692
143310400500000,SW 402,Residential,24769,43268,0,68037
143310400600000,SW 402,Residential,10965,48513,0,59478
143310400700000,SW 402,Residential,9945,48713,0,58658
143310500100000,COMM SW,Commercial,46267,0,4758,51025
143310500200000,SW 412,Residential,22140,50197,0,72337
143310500300000,COMM SW,Commercial,20023,0,64405,84428
143310600100000,SW 412,Residential,5000,0,0,5000
143310600200000,SW 412,Residential,12507,67319,0,79826
143310600300000,SW 412,Residential,12000,52310,0,64310
143310600400000,SW 412,Residential,12000,67392,0,79392
143310600500000,SW 412,Residential,12000,72050,0,84050
143310600600000,SW 412,Residential,12000,67001,0,79001
143310600700000,SW 412,Residential,6000,0,0,6000
143310600800000,SW 412,Residential,12000,70357,0,82357
143310600900000,SW 412,Residential,12000,60885,0,72885
143310601000000,SW 412,Residential,19897,74060,0,93957
143310601100000,SW 412,Residential,16925,55691,0,72616
143310601200000,SW 412,Residential,17000,68331,0,85331
143310601300000,SW 412,Residential,17000,58472,0,75472
143310601400000,SW 412,Residential,17000,51385,0,68385
143310601500000,SW 412,Residential,17000,61125,0,78125
143310601600000,SW 412,Residential,17000,61963,0,78963
143310601700000,SW 412,Residential,10000,0,0,10000
143310601800000,SW 412,Residential,10000,0,0,10000
143310601900000,SW 412,Residential,10000,0,0,10000
143310602000000,SW 412,Residential,10000,0,0,10000
143310602100000,SW 412,Residential,7634,0,0,7634
143310700100000,E-70 CHARITY OTHER,Exempt,325728,0,531032,856760
143310700200000,COMM SW,Commercial,5533,0,38710,44243
143310700300000,SW 412,Residential,17334,28096,0,45430
143310700400000,SW 412,Residential,14994,32065,0,47059
143310700500000,SW 412,Residential,18396,43661,0,62057
143310700600000,SW 412,Residential,9500,0,0,9500
143310700700000,SW 412,Residential,20825,32499,0,53324
143310700800000,SW 412,Residential,20825,53126,0,73951
143310700900000,SW 412,Residential,20825,45196,0,66021
143310701000000,SW 412,Residential,20825,69080,0,89905
143310701100000,SW 412,Residential,20825,53451,0,74276
143310800100000,SW 412,Residential,23324,48559,0,71883
143310800200000,SW 412,Residential,23324,60769,0,84093
143310800300000,SW 412,Residential,20825,53166,0,73991
143310800400000,SW 412,Residential,16660,69270,0,85930
143310800500000,SW 412,Residential,22695,38979,0,61674
143310800600000,SW 412,Residential,21250,49612,0,70862
143310800700000,SW 412,Residential,21250,64604,0,85854
143310800800000,SW 412,Residential,21250,69691,0,90941
143310800900000,SW 412,Residential,21250,61625,0,82875
143310801000000,SW 412,Residential,21250,50582,0,71832
143310801100000,SW 412,Residential,21250,69021,0,90271
143310801200000,SW 412,Residential,20825,69526,0,90351
143310801300000,SW 412,Residential,20825,61758,0,82583
143310801400000,SW 412,Residential,20825,66128,0,86953
143310801500000,SW 412,Residential,9500,0,0,9500
143310801600000,SW 412,Residential,20825,67228,0,88053
143310801700000,SW 412,Residential,17909,46664,0,64573
143310801800000,SW 412,Residential,15410,0,0,15410
143310801900000,SW 412,Residential,5000,0,0,5000
143310900100000,SW 412,Residential,5000,0,0,5000
143310900200000,SW 412,Residential,16788,75793,0,92581
143310900300000,SW 412,Residential,17000,77305,0,94305
143310900400000,SW 412,Residential,10000,0,0,10000
143310900500000,SW 412,Residential,17000,84162,0,101162
143310900600000,SW 412,Residential,17000,59813,0,76813
143310900700000,SW 412,Residential,24990,58575,0,83565
143310900800000,SW 412,Residential,15616,0,0,15616
143310900900000,SW 412,Residential,17510,47676,0,65186
143310901000000,SW 412,Residential,17510,65117,0,82627
143310901100000,SW 412,Residential,17510,42123,0,59633
143310901200000,SW 412,Residential,17510,51778,0,69288
143310901300000,SW 412,Residential,17510,67773,0,85283
143310901400000,SW 412,Residential,17510,72748,0,90258
143310901500000,SW 412,Residential,26486,58696,0,85182
143310901600000,SW 412,Residential,23256,69479,0,92735
143310901700000,SW 412,Residential,14008,48845,0,62853
143310901800000,SW 412,Residential,14008,23908,0,37916
143310901900000,SW 412,Residential,14008,70937,0,84945
143310902000000,SW 412,Residential,14008,60839,0,74847
143310902100000,SW 412,Residential,14008,61274,0,75282
143310902200000,SW 412,Residential,14008,69965,0,83973
143310902300000,SW 412,Residential,5000,0,0,5000
143310902400000,SW 412,Residential,14008,42984,0,56992
143311000100000,Empty,Exempt,0,0,0,0
143311000200000,SW 412,Residential,22907,37807,0,60714
143311000300000,SW 412,Residential,16950,0,0,16950
143311000400000,SW 412,Residential,22907,49559,0,72466
143311000500000,SW 412,Residential,22907,50749,0,73656
143311000600000,SW 412,Residential,22907,67659,0,90566
143311000700000,SW 412,Residential,22907,77129,0,100036
143311000800000,SW 412,Residential,22907,54649,0,77556
143311000900000,SW 412,Residential,22907,52608,0,75515
143311001000000,SW 412,Residential,22074,40862,0,62936
143311100100000,SW 412,Residential,22907,55161,0,78068
143311100200000,SW 412,Residential,21250,74876,0,96126
143311100300000,SW 412,Residential,21250,63045,0,84295
143311100400000,SW 412,Residential,21250,60447,0,81697
143311100500000,SW 412,Residential,21250,49791,0,71041
143311100600000,SW 412,Residential,21250,88268,0,109518
143311100700000,SW 412,Residential,21250,62245,0,83495
143311100800000,SW 412,Residential,21250,59231,0,80481
143311100900000,SW 412,Residential,21250,73595,0,94845
143311101000000,SW 412,Residential,10000,0,0,10000
143311101100000,SW 412,Residential,18077,70941,0,89018
143311101200000,SW 412,Residential,22074,49979,0,72053
143311101300000,SW 412,Residential,22907,79562,0,102469
143311101400000,SW 412,Residential,22907,67291,0,90198
143311101500000,SW 412,Residential,22907,59129,0,82036
143311101600000,SW 412,Residential,22907,81732,0,104639
143311101700000,SW 412,Residential,22907,61317,0,84224
143311101800000,SW 412,Residential,22907,43236,0,66143
143311101900000,SW 412,Residential,22907,68159,0,91066
143312600100000,COMM SW,Commercial,27216,0,237384,264600
143312700100000,Empty,Exempt,0,0,0,0
143312700200000,Empty,Exempt,0,0,0,0
143312700300000,SW 402,Residential,3604,22607,0,26211
143312700400000,SW 402,Residential,15836,71873,0,87709
143312700500000,SW 402,Residential,19080,43142,0,62222
143312700600000,SW 402,Residential,18192,77118,0,95310
143312700700000,SW 402,Residential,15432,59586,0,75018
143312800100000,SW 402,Residential,12600,60953,0,73553
143312800200000,SW 402,Residential,13020,26497,0,39517
143312800300000,SW 402,Residential,15675,37317,0,52992
143312800400000,SW 402,Residential,16245,28945,0,45190
143312800500000,SW 402,Residential,14175,38281,0,52456
143312800600000,SW 402,Residential,9450,36698,0,46148
143312800700000,SW 402,Residential,8466,26295,0,34761
143312800800000,SW 402,Residential,5000,0,0,5000
143312800900000,SW 402,Residential,17679,0,0,17679
143312801000000,SW 402,Residential,6972,22713,0,29685
143312801100000,SW 402,Residential,18000,42922,0,60922
143312801200000,SW 402,Residential,18000,70014,0,88014
143312801300000,SW 402,Residential,14000,0,0,14000
143312801400000,SW 402,Residential,18000,24857,0,42857
143312900100000,SW 402,Residential,18000,42428,0,60428
143312900200000,SW 402,Residential,18000,38141,0,56141
143312900300000,E-40 CHURCHES,Exempt,13608,0,37906,51514
143312900500000,SW 402,Residential,5000,0,0,5000
143312900600000,SW 402,Residential,5000,0,0,5000
143312900700000,SW 402,Residential,5000,0,0,5000
143312900800000,SW 402,Residential,14000,0,0,14000
143312900900000,COMM SW,Commercial,28544,0,57548,86092
143312901000000,COMM SW,Commercial,60480,0,0,60480
143312901100000,SW 402,Residential,18000,23932,0,41932
143312901200000,SW 402,Residential,5000,0,0,5000
143312901300000,SW 402,Residential,9000,29899,0,38899
143312901400000,SW 402,Residential,18000,36616,0,54616
143313000100000,SW 402,Residential,6000,0,0,6000
143313000200000,SW 402,Residential,12060,49625,0,61685
143313000300000,Empty,Other,0,0,0,0
143313000400000,SW 402,Residential,19521,0,0,19521
143313100100000,COMM SW,Commercial,36288,0,3499,39787
143313100200000,COMM SW,Commercial,36288,0,6548,42836
143313100300000,SW 412,Residential,20400,61262,0,81662
143313100400000,SW 412,Residential,20400,99577,0,119977
143313100500000,SW 412,Residential,20400,50828,0,71228
143313100600000,SW 412,Residential,21250,55596,0,76846
143313100700000,SW 412,Residential,21250,42438,0,63688
143313100800000,SW 412,Residential,21250,55465,0,76715
143313100900000,SW 412,Residential,21250,60183,0,81433
143313101000000,SW 412,Residential,21250,41273,0,62523
143313101100000,SW 412,Residential,21250,75769,0,97019
143313200100000,APTS SW,Commercial,8529,0,75543,84072
143313200200000,APTS SW,Commercial,8529,0,56173,64702
143313200300000,SW 412,Residential,5000,0,0,5000
143313200400000,COMM SW,Commercial,13608,0,12799,26407
143313200500000,SW 412,Residential,13500,45108,0,58608
143313200600000,SW 412,Residential,14400,32253,0,46653
143313200700000,SW 412,Residential,10230,27652,0,37882
143313200800000,SW 412,Residential,5000,0,0,5000
143313200900000,SW 412,Residential,7752,21769,0,29521
143313201000000,SW 412,Residential,9990,39773,0,49763
143313201100000,SW 412,Residential,11610,32827,0,44437
143313201400000,SW 412,Residential,15000,61806,0,76806
143313201500000,SW 412,Residential,15000,58582,0,73582
143313201600000,SW 412,Residential,19125,64773,0,83898
143313201700000,SW 412,Residential,28000,115295,0,143295
143313300100000,SW 412,Residential,18000,34534,0,52534
143313300200000,SW 412,Residential,18000,45755,0,63755
143313300300000,SW 412,Residential,18000,68189,0,86189
143313300400000,SW 412,Residential,18000,57867,0,75867
143313300500000,SW 412,Residential,18000,60830,0,78830
143313300600000,COMM SW,Commercial,16632,0,62216,78848
143313300700000,COMM SW,Commercial,39312,0,11102,50414
143313300800000,COMM SW,Commercial,54432,0,11433,65865
143313300900000,COMM SW,Commercial,81475,0,195344,276819
143313301000000,SW 412,Residential,10000,0,0,10000
143313301100000,SW 412,Residential,18000,0,0,18000
143313301200000,SW 412,Residential,15000,61838,0,76838
143313301300000,SW 412,Residential,15000,27659,0,42659
143313301400000,SW 412,Residential,15000,46715,0,61715
143313400100000,SW 412,Residential,20642,63561,0,84203
143313400200000,SW 412,Residential,17437,47488,0,64925
143313400300000,SW 412,Residential,20292,59626,0,79918
143313400400000,SW 412,Residential,15000,47151,0,62151
143313400500000,SW 412,Residential,15000,40263,0,55263
143313400600000,SW 412,Residential,18750,42417,0,61167
143313400700000,SW 412,Residential,18750,49370,0,68120
143313400800000,SW 412,Residential,18750,35796,0,54546
143313400900000,SW 412,Residential,15000,0,0,15000
143313500100000,SW 412,Residential,5000,0,0,5000
143313500200000,SW 412,Residential,20182,64666,0,84848
143313600100000,SW 412,Residential,15733,49088,0,64821
143313600200000,SW 412,Residential,5000,0,0,5000
143313600300000,SW 412,Residential,10440,49994,0,60434
143313600400000,SW 412,Residential,19612,52448,0,72060
143313700100000,SW 412,Residential,15525,45555,0,61080
143313700200000,SW 412,Residential,5000,0,0,5000
143313700300000,SW 412,Residential,8137,46570,0,54707
143313700400000,SW 412,Residential,10125,40005,0,50130
143313700500000,SW 412,Residential,15562,37917,0,53479
143313700600000,SW 412,Residential,15000,0,0,15000
143313700700000,SW 412,Residential,5000,0,0,5000
143313700800000,SW 412,Residential,18750,34051,0,52801
143313700900000,SW 412,Residential,18750,69923,0,88673
143313701000000,SW 412,Residential,18750,39731,0,58481
143313701100000,SW 412,Residential,18750,45577,0,64327
143313701200000,SW 412,Residential,17374,44513,0,61887
143313701300000,SW 412,Residential,17377,50822,0,68199
143313701400000,SW 412,Residential,17374,57726,0,75100
143313701500000,SW 412,Residential,10883,0,0,10883
143313701600000,SW 412,Residential,18750,57734,0,76484
143313701700000,SW 412,Residential,18750,44112,0,62862
143313701800000,SW 412,Residential,15000,0,0,15000
143313701900000,SW 412,Residential,10000,0,0,10000
143313702000000,SW 412,Residential,18750,53764,0,72514
143313702100000,SW 412,Residential,18750,58669,0,77419
143313702200000,SW 412,Residential,18750,30045,0,48795
143313702300000,SW 412,Residential,15000,44418,0,59418
143313800100000,SW 412,Residential,12000,52343,0,64343
143313800200000,SW 412,Residential,12000,57866,0,69866
143313900100000,SW 412,Residential,15000,36358,0,51358
143313900200000,SW 412,Residential,15000,59799,0,74799
143313900300000,SW 412,Residential,15000,51873,0,66873
143313900400000,SW 412,Residential,15000,68894,0,83894
143313900500000,SW 412,Residential,18750,51814,0,70564
143313900600000,SW 412,Residential,18750,53612,0,72362
143313900700000,SW 412,Residential,22500,63516,0,86016
143314000100000,SW 412,Residential,22338,59042,0,81380
143314000200000,SW 412,Residential,9700,0,0,9700
143314000300000,SW 412,Residential,17000,22607,0,39607
143314000400000,SW 412,Residential,17000,44193,0,61193
143314000500000,SW 412,Residential,17000,58819,0,75819
143314000600000,SW 412,Residential,10200,61403,0,71603
143314000700000,SW 412,Residential,10200,473,0,10673
143314000800000,SW 412,Residential,17000,43835,0,60835
143314000900000,SW 412,Residential,17000,58790,0,75790
143314001000000,SW 412,Residential,17000,55300,0,72300
143314001100000,SW 412,Residential,17000,67782,0,84782
143314001200000,SW 412,Residential,17000,67046,0,84046
143314001300000,SW 412,Residential,17000,17153,0,34153
143314001400000,SW 412,Residential,17000,56014,0,73014
143314001500000,SW 412,Residential,10000,0,0,10000
143314001600000,SW 412,Residential,17000,61949,0,78949
143314100100000,SW 412,Residential,20250,63943,0,84193
143314100200000,SW 412,Residential,18000,72837,0,90837
143314100300000,SW 412,Residential,18000,54313,0,72313
143314100400000,SW 412,Residential,18000,58775,0,76775
143314100500000,SW 412,Residential,36000,33276,0,69276
143314100600000,SW 412,Residential,18000,82073,0,100073
143314100700000,SW 412,Residential,18000,66323,0,84323
143314100800000,COMM SW,Commercial,9072,0,33321,42393
143314100900000,SW 412,Residential,18000,93021,0,111021
143314101000000,SW 412,Residential,18000,63745,0,81745
143314101100000,SW 412,Residential,18000,62413,0,80413
143314101200000,SW 412,Residential,18000,40383,0,58383
143314101300000,SW 412,Residential,5000,0,0,5000
143314101400000,SW 412,Residential,18000,78905,0,96905
143314101500000,SW 412,Residential,15750,68035,0,83785
143315100100000,SW 412,Residential,19448,57399,0,76847
143315100200000,SW 412,Residential,18700,56643,0,75343
143315100300000,SW 412,Residential,29172,75811,0,104983
143315100400000,SW 412,Residential,29172,49764,0,78936
143315100500000,SW 412,Residential,29452,77029,0,106481
143315100600000,SW 412,Residential,29452,73524,0,102976
143315100700000,SW 412,Residential,28330,65267,0,93597
143315100800000,SW 412,Residential,28330,62679,0,91009
143315100900000,SW 412,Residential,24255,75492,0,99747
143315101000000,SW 412,Residential,24255,68935,0,93190
143315101100000,SW 412,Residential,33075,91835,0,124910
143315101200000,SW 412,Residential,24473,57970,0,82443
143315101300000,SW 412,Residential,24473,57899,0,82372
143315101400000,SW 412,Residential,24710,54634,0,79344
143315101500000,SW 412,Residential,24710,75278,0,99988
143315101600000,SW 412,Residential,24030,80599,0,104629
143315101700000,SW 412,Residential,24030,79044,0,103074
143315101800000,SW 412,Residential,16700,0,0,16700
143315101900000,SW 412,Residential,15130,52341,0,67471
143315200100000,SW 412,Residential,22050,68449,0,90499
143315200200000,SW 412,Residential,21609,72509,0,94118
143315200300000,SW 412,Residential,30591,54545,0,85136
143315200400000,SW 412,Residential,30591,75918,0,106509
143315200500000,SW 412,Residential,32611,87348,0,119959
143315200600000,SW 412,Residential,32611,86019,0,118630
143315200700000,SW 412,Residential,40747,83190,0,123937
143315200800000,SW 412,Residential,27270,77024,0,104294
143315200900000,SW 412,Residential,24543,93684,0,118227
143315201000000,SW 412,Residential,22725,72419,0,95144
143315201100000,SW 412,Residential,22725,62591,0,85316
143315201200000,SW 412,Residential,25250,94989,0,120239
143315201300000,SW 412,Residential,36234,71141,0,107375
143315201400000,SW 412,Residential,36234,73144,0,109378
143315201500000,SW 412,Residential,36234,41384,0,77618
143315201600000,SW 412,Residential,34452,86314,0,120766
143315201700000,SW 412,Residential,34675,72884,0,107559
143315201800000,SW 412,Residential,19080,55050,0,74130
143315201900000,SW 412,Residential,27720,70138,0,97858
143315202000000,SW 412,Residential,36000,106421,0,142421
143315202100000,SW 412,Residential,33482,69649,0,103131
143315202200000,SW 412,Residential,29250,83510,0,112760
143315202300000,SW 412,Residential,29250,81844,0,111094
143315202400000,SW 412,Residential,29000,64367,0,93367
143315202500000,SW 412,Residential,38312,65395,0,103707
143315202600000,SW 412,Residential,25000,59187,0,84187
143315202700000,SW 412,Residential,25000,36214,0,61214
143315202800000,SW 412,Residential,25000,59988,0,84988
143315202900000,SW 412,Residential,250,0,0,250
143315203000000,SW 412,Residential,7492,0,0,7492
143315203100000,SW 412,Residential,13234,0,0,13234
143315203300000,SW 412,Residential,26400,98538,0,124938
143315203400000,SW 412,Residential,23760,75020,0,98780
143315203500000,SW 412,Residential,23760,65298,0,89058
143315300100000,SW 412,Residential,25000,64500,0,89500
143315300200000,SW 412,Residential,22816,72559,0,95375
143315300300000,SW 412,Residential,24056,95587,0,119643
143315300400000,SW 412,Residential,23446,75073,0,98519
143315300500000,SW 412,Residential,25000,72005,0,97005
143315300600000,SW 412,Residential,25000,59349,0,84349
143315300700000,SW 412,Residential,25000,97866,0,122866
143315300800000,SW 412,Residential,25000,91168,0,116168
143315300900000,SW 412,Residential,26067,71414,0,97481
143315301000000,SW 412,Residential,30759,73737,0,104496
143315301100000,SW 412,Residential,30070,98096,0,128166
143315301200000,SW 412,Residential,31000,87949,0,118949
143315301300000,SW 412,Residential,26700,72529,0,99229
143315301400000,SW 412,Residential,35600,91055,0,126655
143315301500000,SW 412,Residential,25000,97789,0,122789
143315301600000,SW 412,Residential,25000,70834,0,95834
143315400100000,SW 412,Residential,17437,22156,0,39593
143315400200000,SW 412,Residential,23250,70609,0,93859
143315400300000,SW 412,Residential,21855,79784,0,101639
143315400400000,SW 412,Residential,23250,76825,0,100075
143315400500000,SW 412,Residential,24645,75909,0,100554
143315400600000,SW 412,Residential,24645,68349,0,92994
143315400700000,SW 412,Residential,23250,82497,0,105747
143315400800000,SW 412,Residential,21855,78773,0,100628
143315400900000,SW 412,Residential,23250,84020,0,107270
143315401000000,SW 412,Residential,23018,101485,0,124503
143315401100000,SW 412,Residential,23715,70963,0,94678
143315401200000,SW 412,Residential,23250,69063,0,92313
143315401300000,SW 412,Residential,23250,69487,0,92737
143315401400000,SW 412,Residential,23250,69921,0,93171
143315401500000,SW 412,Residential,23250,87874,0,111124
143315401600000,SW 412,Residential,23250,96605,0,119855
143315401700000,SW 412,Residential,23250,62420,0,85670
143315401800000,SW 412,Residential,23250,57462,0,80712
143315401900000,SW 412,Residential,23250,67196,0,90446
143315402000000,SW 412,Residential,22940,79080,0,102020
143315500100000,E-40 CHURCHES,Exempt,307260,0,3486840,3794100
143315500200000,SW 412,Residential,33000,106859,0,139859
143315500300000,SW 412,Residential,25000,65602,0,90602
143315500400000,SW 412,Residential,25000,50828,0,75828
143315500500000,SW 412,Residential,25000,76416,0,101416
143315500600000,SW 412,Residential,25000,85109,0,110109
143315500700000,SW 412,Residential,25000,91717,0,116717
143315500800000,SW 412,Residential,25467,71528,0,96995
143315500900000,SW 412,Residential,35104,60670,0,95774
143315501000000,SW 412,Residential,19344,117602,0,136946
143315501100000,SW 412,Residential,19369,88843,0,108212
143315501200000,SW 412,Residential,19535,93204,0,112739
143315501300000,SW 412,Residential,19535,90174,0,109709
143315501400000,SW 412,Residential,19535,81868,0,101403
143315501500000,SW 412,Residential,19535,55513,0,75048
143315501600000,SW 412,Residential,27720,62797,0,90517
143315501700000,SW 412,Residential,35200,73548,0,108748
143315501800000,SW 412,Residential,22000,55825,0,77825
143315501900000,SW 412,Residential,37400,93489,0,130889
143315502000000,SW 412,Residential,40617,119008,0,159625
143315502100000,E-40 CHURCHES,Exempt,279,0,0,279
143315600100000,SW 412,Residential,25500,110945,0,136445
143315600200000,SW 412,Residential,25500,67522,0,93022
143315600300000,SW 412,Residential,25500,70141,0,95641
143315600400000,SW 412,Residential,25500,83788,0,109288
143315600500000,SW 412,Residential,25500,74154,0,99654
143315600600000,SW 412,Residential,25500,83622,0,109122
143315600700000,SW 412,Residential,33660,96373,0,130033
143315600800000,SW 412,Residential,37485,107324,0,144809
143315600900000,SW 412,Residential,22050,43406,0,65456
143315601000000,SW 412,Residential,19600,70413,0,90013
143315601100000,SW 412,Residential,20825,79825,0,100650
143315601200000,SW 412,Residential,36382,73077,0,109459
143315601300000,SW 412,Residential,26928,75199,0,102127
143315601400000,SW 412,Residential,28560,20384,0,48944
143315601500000,SW 412,Residential,24480,57353,0,81833
143315601600000,SW 412,Residential,28560,83919,0,112479
143315601700000,SW 412,Residential,22440,73680,0,96120
143315601800000,SW 412,Residential,18360,75509,0,93869
143316500500000,SW 402,Residential,9390,38352,0,47742
143316500600000,Empty,Exempt,0,0,0,0
143317600100000,SW 412,Residential,18289,48767,0,67056
143317600200000,SW 412,Residential,21991,38944,0,60935
143317600300000,SW 412,Residential,25490,58607,0,84097
143317600400000,SW 412,Residential,25490,58110,0,83600
143317600500000,SW 412,Residential,25490,62012,0,87502
143317600600000,SW 412,Residential,26010,60059,0,86069
143317600700000,SW 412,Residential,26010,51480,0,77490
143317600800000,SW 412,Residential,27246,77834,0,105080
143317600900000,SW 412,Residential,25269,64067,0,89336
143317601000000,SW 412,Residential,24070,64768,0,88838
143317601100000,SW 412,Residential,25253,73428,0,98681
143317601200000,SW 412,Residential,24072,56891,0,80963
143317601300000,SW 412,Residential,26042,62835,0,88877
143317601400000,SW 412,Residential,26042,78918,0,104960
143317601500000,SW 412,Residential,24480,72655,0,97135
143317601600000,SW 412,Residential,28216,80416,0,108632
143317601700000,SW 412,Residential,29311,59551,0,88862
143317601800000,SW 412,Residential,29032,81080,0,110112
143317601900000,SW 412,Residential,29032,86881,0,115913
143317602000000,SW 412,Residential,29032,89076,0,118108
143317602100000,SW 412,Residential,29032,75873,0,104905
143317602200000,SW 412,Residential,27349,77827,0,105176
143317602300000,SW 412,Residential,25946,87317,0,113263
143317602400000,SW 412,Residential,25119,92455,0,117574
143317602500000,SW 412,Residential,29032,62753,0,91785
143317602600000,SW 412,Residential,29032,74874,0,103906
143317602700000,SW 412,Residential,29032,64316,0,93348
143317602800000,SW 412,Residential,29032,59907,0,88939
143317602900000,SW 412,Residential,29032,68084,0,97116
143317603000000,SW 412,Residential,34155,101463,0,135618
143317603100000,SW 412,Residential,34650,118897,0,153547
143317603200000,SW 412,Residential,29931,81484,0,111415
143317603300000,SW 413,Residential,36382,117105,0,153487
143317603400000,SW 413,Residential,34155,113248,0,147403
143317603500000,SW 413,Residential,36956,80693,0,117649
143317603600000,SW 413,Residential,29100,80415,0,109515
143317603700000,APTS SW,Commercial,16425,0,101929,118354
143317603800000,APTS SW,Commercial,18468,0,174480,192948
143317604000000,APTS SW,Commercial,18079,0,118816,136895
143317604100000,APTS SW,Commercial,18808,0,124601,143409
143317604200000,APTS SW,Residential,39188,260812,0,300000
143317604300000,APTS SW,Commercial,38999,0,302243,341242
143317604401000,CONDO 500,Residential,5000,39432,0,44432
143317604401001,CONDO 500,Residential,5000,35869,0,40869
143317604401002,CONDO 500,Residential,5000,35869,0,40869
143317604401003,CONDO 500,Residential,5000,39430,0,44430
143317604401004,CONDO 500,Residential,5000,35869,0,40869
143317604401005,CONDO 500,Residential,5000,35869,0,40869
143317604501000,CONDO 500,Residential,5000,39476,0,44476
143317604501001,CONDO 500,Residential,5000,35295,0,40295
143317604501002,CONDO 500,Residential,5000,35295,0,40295
143317604501003,CONDO 500,Residential,5000,40005,0,45005
143317604501004,CONDO 500,Residential,5000,37142,0,42142
143317604501005,CONDO 500,Residential,5000,35693,0,40693
143317700100000,SW 412,Residential,24990,43445,0,68435
143317700200000,SW 412,Residential,16660,76874,0,93534
143317700300000,SW 412,Residential,17640,43368,0,61008
143317700400000,SW 412,Residential,17640,54372,0,72012
143317700500000,SW 412,Residential,9600,0,0,9600
143317700600000,SW 412,Residential,17640,73493,0,91133
143317700700000,SW 412,Residential,26460,43531,0,69991
143317700800000,SW 412,Residential,26460,61803,0,88263
143317700900000,SW 412,Residential,17640,47302,0,64942
143317701000000,SW 412,Residential,17640,60761,0,78401
143317701100000,SW 412,Residential,17640,44077,0,61717
143317701200000,SW 412,Residential,19600,63904,0,83504
143317701300000,SW 412,Residential,19600,71226,0,90826
143317701400000,SW 412,Residential,35214,46884,0,82098
143317701500000,SW 412,Residential,35543,66673,0,102216
143317701600000,SW 412,Residential,19600,67605,0,87205
143317701700000,SW 412,Residential,19600,53281,0,72881
143317701800000,SW 412,Residential,17640,61147,0,78787
143317701900000,SW 412,Residential,17640,81082,0,98722
143317702000000,SW 412,Residential,17640,56485,0,74125
143317702100000,SW 412,Residential,17640,46403,0,64043
143317702200000,SW 412,Residential,17640,58876,0,76516
143317702300000,SW 412,Residential,17640,52381,0,70021
143317702400000,SW 412,Residential,17640,29091,0,46731
143317702500000,SW 412,Residential,17640,66472,0,84112
143317702600000,SW 412,Residential,26460,61759,0,88219
143317800200000,SW 413,Residential,32465,93769,0,126234
143317800300000,SW 413,Residential,35145,94114,0,129259
143317800400000,SW 413,Residential,32175,72921,0,105096
143317800500000,SW 413,Residential,35269,83562,0,118831
143317800600000,SW 413,Residential,32175,76154,0,108329
143317800700000,SW 413,Residential,32175,81167,0,113342
143317800800000,SW 413,Residential,35030,86631,0,121661
143317800900000,SW 413,Residential,37167,81541,0,118708
143317801000000,SW 413,Residential,24696,68836,0,93532
143317801100000,COMM SW,Commercial,948888,0,4103499,5052387
143317900100000,SW 413,Residential,36538,84769,0,121307
143317900200000,SW 413,Residential,33330,88557,0,121887
143317900300000,SW 413,Residential,33330,89760,0,123090
143317900400000,SW 413,Residential,32825,77458,0,110283
143317900500000,SW 413,Residential,35350,122975,0,158325
143317900600000,SW 413,Residential,35981,119436,0,155417
143317900700000,SW 413,Residential,28785,65653,0,94438
143317900800000,SW 413,Residential,28854,83330,0,112184
143317900900000,SW 413,Residential,30805,64290,0,95095
143317901000000,SW 413,Residential,29644,61669,0,91313
143317901100000,SW 413,Residential,27160,88335,0,115495
143317901200000,SW 413,Residential,25750,96471,0,122221
143317901300000,SW 413,Residential,29174,78782,0,107956
143317901400000,SW 413,Residential,30596,111515,0,142111
143317901500000,SW 413,Residential,36720,68998,0,105718
143317901600000,SW 413,Residential,32130,77023,0,109153
143317901700000,SW 413,Residential,34680,93891,0,128571
143317901800000,SW 413,Residential,30600,75616,0,106216
143317904500000,APTS SW,Commercial,5706,0,242913,248619
143317904600000,APTS SW,Commercial,32448,0,371659,404107
143317904700000,APTS SW,Commercial,15614,0,160139,175753
143317904800000,APTS SW,Commercial,8529,0,85582,94111
143318000100000,SW 412,Residential,41040,91699,0,132739
143318000200000,SW 412,Residential,24533,115792,0,140325
143318000300000,SW 412,Residential,22500,75341,0,97841
143318000400000,SW 412,Residential,22500,113041,0,135541
143318000500000,SW 412,Residential,22500,71190,0,93690
143318000600000,SW 412,Residential,25000,51808,0,76808
143318000700000,SW 412,Residential,25000,66970,0,91970
143318000800000,SW 412,Residential,25000,92369,0,117369
143318000900000,SW 412,Residential,25000,79803,0,104803
143318001000000,SW 412,Residential,25000,67352,0,92352
143318001100000,SW 412,Residential,24000,67252,0,91252
143318001200000,SW 412,Residential,25783,128389,0,154172
143318001300000,SW 412,Residential,30000,96591,0,126591
143318001400000,SW 412,Residential,30000,91820,0,121820
143318001500000,SW 412,Residential,26917,100194,0,127111
143318001600000,SW 412,Residential,25000,55189,0,80189
143318001700000,SW 412,Residential,25000,66725,0,91725
143318001800000,SW 412,Residential,25000,102055,0,127055
143318001900000,SW 412,Residential,25000,83234,0,108234
143318002000000,SW 412,Residential,25000,79936,0,104936
143318002100000,SW 412,Residential,38000,114153,0,152153
143320100100000,SW 402,Residential,10400,0,0,10400
143320100200000,SW 402,Residential,15000,46683,0,61683
143320100300000,SW 402,Residential,15000,19196,0,34196
143320100400000,SW 402,Residential,15000,52911,0,67911
143320100500000,SW 402,Residential,15000,55326,0,70326
143320100600000,SW 402,Residential,10400,0,0,10400
143320100700000,SW 402,Residential,15300,33494,0,48794
143320100800000,SW 402,Residential,15300,58156,0,73456
143320200100000,SW 402,Residential,18000,61365,0,79365
143320200200000,SW 402,Residential,11466,61282,0,72748
143320200300000,SW 402,Residential,10811,53310,0,64121
143320200400000,SW 402,Residential,11138,52275,0,63413
143320200500000,SW 402,Residential,11970,46288,0,58258
143320200600000,SW 402,Residential,11970,53367,0,65337
143320200700000,SW 402,Residential,22810,59089,0,81899
143320200800000,SW 402,Residential,18000,35116,0,53116
143320200900000,SW 402,Residential,18000,64179,0,82179
143320201000000,SW 402,Residential,18000,77549,0,95549
143320300100000,SW 402,Residential,14316,63760,0,78076
143320300200000,SW 402,Residential,14316,87541,0,101857
143320300300000,SW 402,Residential,14316,36723,0,51039
143320300400000,COMM SW,Commercial,11745,0,25041,36786
143320400100000,COMM SW,Commercial,16200,0,20725,36925
143320400200000,SW 402,Residential,18000,40760,0,58760
143320400300000,SW 402,Residential,18000,45581,0,63581
143320400400000,SW 402,Residential,18000,54059,0,72059
143320400500000,SW 402,Residential,18000,55738,0,73738
143320400600000,SW 402,Residential,18000,52026,0,70026
143320400700000,SW 402,Residential,18000,29991,0,47991
143320400800000,COMM SW,Commercial,40500,0,146609,187109
143320400900000,COMM SW,Commercial,40500,0,18639,59139
143320401000000,SW 402,Residential,5400,0,0,5400
143320401100000,SW 402,Residential,10400,0,0,10400
143320500100000,SW 402,Residential,18000,57928,0,75928
143320500200000,SW 402,Residential,16380,27037,0,43417
143320500300000,SW 402,Residential,16380,50315,0,66695
143320500400000,SW 402,Residential,16380,59443,0,75823
143320500500000,SW 402,Residential,16380,65015,0,81395
143320500600000,SW 402,Residential,19656,64842,0,84498
143320500700000,SW 402,Residential,13104,38640,0,51744
143320500800000,SW 402,Residential,18000,87692,0,105692
143320500900000,SW 402,Residential,10000,0,0,10000
143320501000000,SW 402,Residential,18000,51755,0,69755
143320501100000,SW 402,Residential,18000,39345,0,57345
143320501200000,SW 402,Residential,18000,24612,0,42612
143320600100000,SW 402,Residential,11025,35983,0,47008
143320600200000,SW 402,Residential,13140,54379,0,67519
143320600300000,SW 402,Residential,5907,0,0,5907
143320600400000,SW 402,Residential,12960,45063,0,58023
143320600500000,SW 402,Residential,11340,43817,0,55157
143320600600000,SW 402,Residential,5000,0,0,5000
143320600700000,SW 402,Residential,14316,55681,0,69997
143320600800000,SW 402,Residential,14316,45946,0,60262
143320700100000,COMM SW,Commercial,29700,0,127006,156706
143320700200000,COMM SW,Commercial,21600,0,7193,28793
143320700300000,SW 402,Residential,18360,0,0,18360
143320700400000,SW 402,Residential,18000,43168,0,61168
143320700500000,SW 402,Residential,18000,29125,0,47125
143320700600000,SW 402,Residential,18000,53053,0,71053
143320700700000,SW 402,Residential,18000,85958,0,103958
143320700800000,SW 402,Residential,14580,38135,0,52715
143320700900000,SW 402,Residential,18675,67832,0,86507
143320701000000,SW 402,Residential,22950,75274,0,98224
143320701100000,SW 402,Residential,22950,37242,0,60192
143320701200000,SW 402,Residential,22950,42632,0,65582
143320800100000,SW 402,Residential,10000,0,0,10000
143320800200000,SW 402,Residential,21060,39156,0,60216
143320800300000,SW 402,Residential,21060,48286,0,69346
143320800400000,SW 402,Residential,21060,28820,0,49880
143320800500000,CONVERSIONS,Commercial,5400,0,0,5400
143320800600000,SW 402,Residential,21060,40020,0,61080
143320800700000,SW 402,Residential,21060,51938,0,72998
143320800800000,SW 402,Residential,18000,68397,0,86397
143320800900000,SW 402,Residential,18000,62465,0,80465
143320801000000,SW 402,Residential,18000,53735,0,71735
143320801100000,SW 402,Residential,18000,72979,0,90979
143320801200000,SW 402,Residential,10000,0,0,10000
143320900100000,SW 402,Residential,13167,58584,0,71751
143320900200000,SW 402,Residential,14256,56093,0,70349
143320900300000,SW 402,Residential,13167,67055,0,80222
143320900400000,SW 402,Residential,14316,54983,0,69299
143320900500000,SW 402,Residential,14316,40981,0,55297
143320900600000,APTS SW,Commercial,14742,0,134563,149305
143321000100000,SW 402,Residential,22950,80793,0,103743
143321000200000,SW 402,Residential,27000,50708,0,77708
143321000300000,SW 402,Residential,27000,65540,0,92540
143321000400000,SW 402,Residential,14400,58420,0,72820
143321000500000,SW 402,Residential,14400,0,0,14400
143321000600000,SW 402,Residential,22500,79888,0,102388
143321000700000,SW 402,Residential,22500,57067,0,79567
143321000800000,SW 402,Residential,17500,63006,0,80506
143321000900000,SW 402,Residential,17010,54385,0,71395
143321001000000,SW 402,Residential,22950,37190,0,60140
143321001100000,SW 402,Residential,22950,44492,0,67442
143321001200000,SW 402,Residential,22950,62844,0,85794
143321001300000,SW 402,Residential,22950,59162,0,82112
143321001400000,SW 402,Residential,22950,57338,0,80288
143321001500000,SW 402,Residential,22950,81687,0,104637
143321100100000,SW 402,Residential,22500,101949,0,124449
143321100200000,SW 402,Residential,14256,34926,0,49182
143321100300000,SW 402,Residential,14256,24332,0,38588
143321100400000,SW 402,Residential,14256,34852,0,49108
143321100500000,SW 402,Residential,14256,31643,0,45899
143321100600000,SW 402,Residential,21060,92146,0,113206
143321100700000,SW 402,Residential,23400,66699,0,90099
143321100800000,SW 402,Residential,23400,26888,0,50288
143321100900000,SW 402,Residential,23400,33281,0,56681
143321101000000,SW 402,Residential,23400,69418,0,92818
143321101100000,SW 402,Residential,25000,70562,0,95562
143321101200000,SW 402,Residential,25000,48542,0,73542
143321101300000,SW 402,Residential,22500,66705,0,89205
143321101400000,SW 402,Residential,22500,59246,0,81746
143321101500000,SW 402,Residential,22500,65347,0,87847
143321101600000,SW 402,Residential,22500,55670,0,78170
143321200100000,SW 402,Residential,14316,44058,0,58374
143321200200000,SW 402,Residential,15907,62816,0,78723
143321200300000,SW 402,Residential,17675,56062,0,73737
143321200400000,SW 402,Residential,15907,80631,0,96538
143322600100000,SW 403,Residential,16524,34381,0,50905
143322600200000,SW 403,Residential,12118,45355,0,57473
143322600300000,SW 403,Residential,15991,82003,0,97994
143322600400000,SW 403,Residential,16524,56496,0,73020
143322600500000,SW 403,Residential,16524,63627,0,80151
143322600600000,SW 403,Residential,15228,57331,0,72559
143322600700000,SW 403,Residential,16937,39044,0,55981
143322600800000,SW 403,Residential,16524,62138,0,78662
143322700100000,SW 403,Residential,14544,58817,0,73361
143322700200000,SW 403,Residential,12726,60103,0,72829
143322700300000,SW 403,Residential,12726,50345,0,63071
143322700400000,SW 403,Residential,12726,53582,0,66308
143322700500000,SW 403,Residential,12726,66671,0,79397
143322700600000,SW 403,Residential,12726,49075,0,61801
143322700700000,SW 403,Residential,14544,44798,0,59342
143322700800000,SW 403,Residential,14544,57440,0,71984
143322700900000,SW 403,Residential,14544,42847,0,57391
143322701000000,SW 403,Residential,14544,54799,0,69343
143322800100000,Empty,Exempt,0,0,0,0
143322800200000,Empty,Exempt,0,0,0,0
143322900100000,SW 403,Residential,20196,79168,0,99364
143322900200000,SW 403,Residential,17005,35070,0,52075
143322900300000,SW 403,Residential,16243,41529,0,57772
143322900400000,SW 403,Residential,16524,58097,0,74621
143322900500000,SW 403,Residential,16524,82238,0,98762
143322900600000,SW 403,Residential,16524,67758,0,84282
143322900700000,SW 403,Residential,16524,62269,0,78793
143322900800000,SW 403,Residential,16524,61804,0,78328
143322900900000,SW 403,Residential,16524,55783,0,72307
143322901000000,SW 403,Residential,16524,12091,0,28615
143322901100000,SW 403,Residential,16524,47904,0,64428
143323000100000,SW 403,Residential,18762,46913,0,65675
143323000200000,SW 403,Residential,15120,35604,0,50724
143323000300000,SW 403,Residential,15120,68509,0,83629
143323000400000,SW 403,Residential,15120,51037,0,66157
143323000500000,SW 403,Residential,15120,37834,0,52954
143323000600000,SW 403,Residential,15120,57759,0,72879
143323000700000,SW 403,Residential,15120,55593,0,70713
143323000800000,SW 403,Residential,18144,43952,0,62096
143323000900000,SW 403,Residential,13104,41260,0,54364
143323001000000,SW 403,Residential,14890,48356,0,63246
143323001100000,SW 403,Residential,14890,38436,0,53326
143323001200000,SW 403,Residential,12726,44454,0,57180
143323001300000,SW 403,Residential,15271,54053,0,69324
143323001400000,SW 403,Residential,15635,74744,0,90379
143323100100000,SW 403,Residential,16708,96295,0,113003
143323100200000,E-05 STATE,Exempt,0,0,0,0
143323100300000,SW 403,Residential,16243,82842,0,99085
143323100400000,COMM SW,Commercial,110160,0,359589,469749
143323100500000,COMM SW,Commercial,76410,0,10788,87198
143323100600000,SW 403,Residential,14429,55123,0,69552
143323100700000,SW 403,Residential,14688,54373,0,69061
143323100800000,SW 403,Residential,14038,59070,0,73108
143323100900000,SW 403,Residential,14038,41943,0,55981
143323101000000,SW 403,Residential,14688,58016,0,72704
143323101100000,SW 403,Residential,14830,47458,0,62288
143323200100000,SW 403,Residential,16524,59947,0,76471
143323200200000,SW 403,Residential,14458,53553,0,68011
143323200300000,SW 403,Residential,14458,63832,0,78290
143323200400000,SW 403,Residential,14458,47576,0,62034
143323200500000,SW 403,Residential,14458,45299,0,59757
143323200600000,SW 403,Residential,12852,55912,0,68764
143323200700000,SW 403,Residential,15422,61099,0,76521
143323200800000,SW 403,Residential,16524,53794,0,70318
143323200900000,SW 403,Residential,16524,40299,0,56823
143323201000000,SW 403,Residential,16524,63033,0,79557
143323201100000,SW 403,Residential,16524,49948,0,66472
143323201200000,SW 403,Residential,16524,46607,0,63131
143323300100000,SW 403,Residential,16065,42812,0,58877
143323300200000,SW 403,Residential,16065,31106,0,47171
143323300300000,SW 403,Residential,17850,59200,0,77050
143323300400000,SW 403,Residential,16065,45971,0,62036
143323300500000,SW 403,Residential,730,0,0,730
143323300600000,SW 403,Residential,16065,43415,0,59480
143323300700000,SW 403,Residential,16065,57838,0,73903
143323300800000,SW 403,Residential,18241,69505,0,87746
143323300900000,SW 403,Residential,13601,56281,0,69882
143323301000000,SW 403,Residential,12726,81469,0,94195
143323301100000,SW 403,Residential,13681,62038,0,75719
143323301200000,SW 403,Residential,16417,79994,0,96411
143323301300000,SW 403,Residential,15876,53725,0,69601
143323301400000,SW 403,Residential,2240,0,0,2240
143323301500000,SW 403,Residential,2240,0,0,2240
143323301600000,SW 403,Residential,15120,43029,0,58149
143323301700000,SW 403,Residential,15120,44307,0,59427
143323301800000,SW 403,Residential,15120,45466,0,60586
143323301900000,SW 403,Residential,15120,40066,0,55186
143323302000000,SW 403,Residential,14323,42489,0,56812
143323302100000,SW 403,Residential,14112,45763,0,59875
143323302200000,SW 403,Residential,18816,59348,0,78164
143323302300000,SW 403,Residential,18816,60156,0,78972
143323302400000,SW 403,Residential,17791,55737,0,73528
143323302500000,SW 403,Residential,15680,69450,0,85130
143323302600000,SW 403,Residential,21698,145680,0,167378
143323302700000,SW 403,Residential,18326,56234,0,74560
143323302800000,SW 403,Residential,15680,0,0,15680
143323303100000,COMM SW,Commercial,64670,0,102424,167094
143325100100000,Empty,Exempt,0,0,0,0
143325100200000,COMM SW,Commercial,430920,0,349761,780681
143325100300000,COMM SW,Commercial,304560,0,488312,792872
143325100400000,SW 403,Residential,31434,56113,0,87547
143325100500000,SW 403,Residential,21624,92391,0,114015
143325100600000,SW 403,Residential,20900,73871,0,94771
143325100700000,SW 403,Residential,20900,40781,0,61681
143325100800000,SW 403,Residential,20952,67431,0,88383
143325100900000,SW 403,Residential,20952,85437,0,106389
143325101000000,SW 403,Residential,22844,65251,0,88095
143325101100000,SW 403,Residential,21430,41800,0,63230
143325101200000,SW 403,Residential,20832,49787,0,70619
143325101300000,SW 403,Residential,20832,64582,0,85414
143325101400000,SW 403,Residential,20832,67212,0,88044
143325101500000,SW 403,Residential,20832,98875,0,119707
143325200100000,SW 403,Residential,16400,69281,0,85681
143325200200000,SW 403,Residential,17520,67184,0,84704
143325200300000,SW 403,Residential,19680,39509,0,59189
143325200400000,SW 403,Residential,19680,58206,0,77886
143325200500000,SW 403,Residential,20252,68630,0,88882
143325200600000,SW 403,Residential,20241,56800,0,77041
143325200700000,SW 403,Residential,19680,55876,0,75556
143325200800000,SW 403,Residential,19680,63294,0,82974
143325200900000,SW 403,Residential,21600,74520,0,96120
143325201000000,SW 403,Residential,16400,68424,0,84824
143327600100000,SW 412,Residential,23409,70677,0,94086
143327600200000,SW 412,Residential,12600,30302,0,42902
143327600300000,SW 412,Residential,21165,61118,0,82283
143327600400000,SW 412,Residential,20000,62687,0,82687
143327600500000,SW 412,Residential,20000,79963,0,99963
143327600600000,SW 412,Residential,20000,53899,0,73899
143327600700000,SW 412,Residential,20000,63143,0,83143
143327600800000,SW 412,Residential,20000,79628,0,99628
143327600900000,SW 412,Residential,25500,73401,0,98901
143327601000000,SW 412,Residential,26010,106726,0,132736
143327601100000,SW 412,Residential,20400,74054,0,94454
143327601200000,SW 412,Residential,20400,102153,0,122553
143327601300000,SW 412,Residential,18360,62838,0,81198
143327601400000,SW 412,Residential,18360,38529,0,56889
143327601500000,SW 412,Residential,18360,84885,0,103245
143327700100000,SW 412,Residential,25500,83062,0,108562
143327700200000,SW 412,Residential,21000,67303,0,88303
143327700300000,SW 412,Residential,19665,80301,0,99966
143327700400000,SW 412,Residential,18009,59107,0,77116
143327700500000,SW 412,Residential,18720,72123,0,90843
143327700600000,SW 412,Residential,18720,82120,0,100840
143327700700000,SW 412,Residential,18720,72660,0,91380
143327700800000,SW 412,Residential,18720,84184,0,102904
143327700900000,SW 412,Residential,23868,39340,0,63208
143327701000000,SW 412,Residential,25500,97454,0,122954
143327701100000,SW 412,Residential,20000,76278,0,96278
143327701200000,SW 412,Residential,20000,58861,0,78861
143327701300000,SW 412,Residential,20000,84920,0,104920
143327701400000,SW 412,Residential,20000,82809,0,102809
143327701500000,SW 412,Residential,20000,73204,0,93204
143327800100000,SW 412,Residential,30600,53181,0,83781
143327800200000,SW 412,Residential,33392,53115,0,86507
143327800300000,SW 412,Residential,31350,115524,0,146874
143327800400000,SW 412,Residential,30000,28714,0,58714
143327800500000,SW 412,Residential,30000,101824,0,131824
143327800600000,SW 412,Residential,30000,79008,0,109008
143327800700000,SW 412,Residential,20400,98492,0,118892
143327800800000,SW 412,Residential,20400,68752,0,89152
143327800900000,SW 412,Residential,20400,28272,0,48672
143327801000000,SW 412,Residential,30600,12057,0,42657
143327801100000,SW 412,Residential,30600,65841,0,96441
143327900100000,SW 412,Residential,27300,60527,0,87827
143327900200000,SW 412,Residential,9207,19691,0,28898
143327900300000,SW 412,Residential,28080,32481,0,60561
143327900400000,SW 412,Residential,28080,79693,0,107773
143327900500000,SW 412,Residential,28080,28721,0,56801
143327900600000,SW 412,Residential,18720,56613,0,75333
143327900700000,SW 412,Residential,18720,57984,0,76704
143327900800000,SW 412,Residential,18720,44083,0,62803
143327900900000,SW 412,Residential,30000,90203,0,120203
143327901000000,SW 412,Residential,36000,51669,0,87669
143327901100000,SW 412,Residential,15000,44074,0,59074
143327901200000,SW 412,Residential,15000,59047,0,74047
143327901300000,SW 412,Residential,15000,51838,0,66838
143328000100000,SW 412,Residential,20790,68842,0,89632
143328000200000,SW 412,Residential,20790,98104,0,118894
143328000300000,SW 412,Residential,21829,99520,0,121349
143328000400000,SW 412,Residential,20790,90441,0,111231
143328000500000,SW 412,Residential,20790,66990,0,87780
143328000600000,SW 412,Residential,22523,46118,0,68641
143328000700000,SW 412,Residential,19058,65317,0,84375
143328000800000,SW 412,Residential,20790,43692,0,64482
143328000900000,SW 412,Residential,23562,147375,0,170937
143328100100000,SW 412,Residential,33150,87602,0,120752
143328100200000,SW 412,Residential,20000,48998,0,68998
143328100300000,SW 412,Residential,32000,86938,0,118938
143328100400000,SW 412,Residential,36000,59018,0,95018
143328100500000,SW 412,Residential,23750,81772,0,105522
143328100600000,SW 412,Residential,26400,88924,0,115324
143328100700000,SW 412,Residential,26400,90610,0,117010
143328100800000,SW 412,Residential,16320,0,0,16320
143328100900000,SW 412,Residential,16320,92094,0,108414
143328101000000,SW 412,Residential,27000,106391,0,133391
143328200100000,SW 412,Residential,27000,119215,0,146215
143328200200000,SW 412,Residential,25272,73313,0,98585
143328200300000,SW 412,Residential,25272,67835,0,93107
143328200400000,SW 412,Residential,25272,81228,0,106500
143328200500000,SW 412,Residential,30400,43066,0,73466
143328200600000,SW 412,Residential,30400,76696,0,107096
143328200700000,SW 412,Residential,27000,118986,0,145986
143328200800000,SW 412,Residential,27000,60986,0,87986
143328200900000,SW 412,Residential,27000,89703,0,116703
143328201000000,SW 412,Residential,27000,59615,0,86615
143328300100000,SW 412,Residential,17850,75664,0,93514
143328300200000,SW 412,Residential,26600,95154,0,121754
143328300300000,SW 412,Residential,22800,76838,0,99638
143328300400000,SW 412,Residential,22800,67692,0,90492
143328300500000,SW 412,Residential,19000,89325,0,108325
143328300600000,SW 412,Residential,19000,66013,0,85013
143328300700000,SW 412,Residential,19000,90863,0,109863
143328300800000,SW 412,Residential,19000,69634,0,88634
143328300900000,SW 412,Residential,27360,83130,0,110490
143328301000000,SW 412,Residential,26180,86526,0,112706
143328301100000,SW 412,Residential,21906,69483,0,91389
143328301200000,SW 412,Residential,21888,111729,0,133617
143328301300000,SW 412,Residential,15200,72653,0,87853
143328301400000,SW 412,Residential,15200,79197,0,94397
143328301500000,SW 412,Residential,16720,90235,0,106955
143328301600000,SW 412,Residential,16720,87824,0,104544
143328301700000,SW 412,Residential,16720,77290,0,94010
143328301800000,SW 412,Residential,16720,75481,0,92201
143328301900000,SW 412,Residential,18240,86546,0,104786
143328302000000,SW 412,Residential,19040,64815,0,83855
143328302100000,SW 412,Residential,19360,53616,0,72976
143328302200000,SW 412,Residential,14784,0,0,14784
143328302300000,SW 412,Residential,20400,76439,0,96839
143328400100000,SW 412,Residential,21418,77497,0,98915
143328400200000,SW 412,Residential,23644,129450,0,153094
143330100100000,SW 416,Residential,57290,121610,0,178900
143330100200000,SW 416,Residential,25680,98437,0,124117
143330100300000,SW 416,Residential,31744,60972,0,92716
143330100400000,SW 416,Residential,3120,36583,0,39703
143330100500000,SW 416,Residential,17120,80635,0,97755
143330100600000,SW 416,Residential,21400,61505,0,82905
143330100700000,SW 416,Residential,21400,91641,0,113041
143330100800000,SW 416,Residential,25680,70235,0,95915
143330100900000,SW 416,Residential,29960,93155,0,123115
143330101000000,SW 416,Residential,29680,56555,0,86235
143330101100000,SW 416,Residential,33920,62925,0,96845
143330101200000,SW 416,Residential,21200,84158,0,105358
143330101300000,SW 416,Residential,30210,38906,0,69116
143330101400000,SW 416,Residential,30210,70092,0,100302
143330101500000,SW 416,Residential,21200,71426,0,92626
143330101600000,SW 416,Residential,21200,81762,0,102962
143330101700000,SW 416,Residential,21200,105432,0,126632
143330101800000,SW 416,Residential,21200,83035,0,104235
143330101900000,SW 416,Residential,17520,67813,0,85333
143330102000000,SW 416,Residential,29792,72943,0,102735
143330102100000,SW 416,Residential,30520,88138,0,118658
143330102200000,SW 416,Residential,30520,96695,0,127215
143330200100000,SW 417,Residential,37411,69102,0,106513
143330200200000,SW 417,Residential,33600,78793,0,112393
143330200300000,SW 417,Residential,35784,115858,0,151642
143330300100000,SW 416,Residential,22565,127327,0,149892
143330300200000,SW 416,Residential,25440,97440,0,122880
143330300300000,SW 416,Residential,21200,69610,0,90810
143330300400000,SW 416,Residential,21200,91653,0,112853
143330300500000,SW 416,Residential,21200,75364,0,96564
143330300600000,SW 416,Residential,21200,79217,0,100417
143330300700000,SW 416,Residential,31800,85147,0,116947
143330300800000,SW 416,Residential,21200,70742,0,91942
143330300900000,SW 416,Residential,17600,71291,0,88891
143330301000000,SW 416,Residential,29920,73268,0,103188
143330301100000,SW 416,Residential,26075,97581,0,123656
143330301200000,SW 416,Residential,23280,75962,0,99242
143330301300000,SW 416,Residential,23280,82646,0,105926
143330301400000,SW 416,Residential,23280,104133,0,127413
143330301500000,SW 416,Residential,23280,62148,0,85428
143330301600000,SW 416,Residential,23280,81218,0,104498
143330301700000,SW 416,Residential,23280,88782,0,112062
143330301800000,SW 416,Residential,23280,69453,0,92733
143330301900000,SW 416,Residential,23280,85773,0,109053
143330302000000,SW 416,Residential,23280,104736,0,128016
143330302100000,SW 416,Residential,24240,72798,0,97038
143330302200000,SW 416,Residential,30199,83845,0,114044
143330302300000,SW 416,Residential,27160,79613,0,106773
143330302400000,SW 416,Residential,20952,53719,0,74671
143330400100000,SW 417,Residential,36400,84884,0,121284
143330400200000,SW 417,Residential,32428,107661,0,140089
143330400300000,SW 417,Residential,31200,62364,0,93564
143330500100000,SW 416,Residential,27160,83164,0,110324
143330500200000,SW 416,Residential,30031,77291,0,107322
143330500300000,SW 416,Residential,23280,47089,0,70369
143330500400000,SW 416,Residential,31040,101142,0,132182
143330500500000,SW 416,Residential,27547,101943,0,129490
143330500600000,SW 416,Residential,26000,86111,0,112111
143330500700000,SW 416,Residential,28000,96054,0,124054
143330500800000,SW 416,Residential,24000,72620,0,96620
143330500900000,SW 416,Residential,28000,107533,0,135533
143330501000000,SW 416,Residential,33810,85411,0,119221
143330501100000,SW 416,Residential,30051,81614,0,111665
143330501200000,SW 416,Residential,36855,121027,0,157882
143330600100000,SW 416,Residential,29488,84355,0,113843
143330600200000,SW 416,Residential,23280,83095,0,106375
143330600300000,SW 416,Residential,23280,99313,0,122593
143330600400000,SW 416,Residential,23280,79314,0,102594
143330600500000,SW 416,Residential,23280,79958,0,103238
143330600600000,SW 416,Residential,23180,374,0,23554
143330600700000,SW 416,Residential,22848,90828,0,113676
143330600800000,SW 416,Residential,22848,110939,0,133787
143330600900000,SW 416,Residential,22848,103996,0,126844
143330601000000,SW 416,Residential,26887,114858,0,141745
143330601100000,SW 416,Residential,35451,289733,0,325184
143330601200000,SW 416,Residential,24240,6123,0,30363
143330601300000,SW 416,Residential,28280,74808,0,103088
143330601400000,SW 416,Residential,27541,83014,0,110555
143330700100000,SW 417,Residential,31200,89578,0,120778
143330700200000,SW 417,Residential,32501,153563,0,186064
143330700300000,SW 417,Residential,33051,99927,0,132978
143330700400000,SW 417,Residential,29769,92637,0,122406
143330700500000,SW 417,Residential,27495,76170,0,103665
143332600100000,SW 417,Residential,34076,71001,0,105077
143332600200000,SW 417,Residential,32882,73022,0,105904
143332600300000,SW 417,Residential,30736,84095,0,114831
143332600400000,SW 417,Residential,29380,105644,0,135024
143332600500000,SW 417,Residential,28200,57664,0,85864
143332600600000,SW 417,Residential,34642,50692,0,85334
143332600700000,SW 417,Residential,28500,46580,0,75080
143332600800000,SW 417,Residential,32700,53621,0,86321
143332600900000,SW 417,Residential,34580,51894,0,86474
143332601000000,SW 417,Residential,32589,48360,0,80949
143332601100000,SW 417,Residential,30600,60821,0,91421
143332700100000,SW 417,Residential,30600,65321,0,95921
143332700200000,SW 417,Residential,30600,59425,0,90025
143332700300000,SW 417,Residential,30600,67131,0,97731
143332700400000,SW 417,Residential,30600,84783,0,115383
143332700500000,SW 417,Residential,30600,68197,0,98797
143332800100000,SW 417,Residential,31200,88818,0,120018
143332800200000,SW 417,Residential,33197,54995,0,88192
143332800300000,Empty,Exempt,0,0,0,0
143332800400000,SW 417,Residential,34800,88942,0,123742
143332800500000,COMM SW,Commercial,136307,0,45280,181587
143332800600000,SW 417,Residential,28967,48732,0,77699
143332800700000,SW 417,Residential,29760,65987,0,95747
143332800800000,SW 417,Residential,31185,46763,0,77948
143332800900000,SW 417,Residential,28215,49912,0,78127
143332801000000,SW 417,Residential,28215,73588,0,101803
143332801100000,SW 417,Residential,28215,94295,0,122510
143332801200000,SW 417,Residential,28215,48434,0,76649
143332801300000,SW 417,Residential,29490,54789,0,84279
143332801400000,SW 417,Residential,29640,51604,0,81244
143332801500000,SW 417,Residential,31200,45977,0,77177
143332900100000,SW 417,Residential,32657,79513,0,112170
143332900200000,SW 417,Residential,29100,69168,0,98268
143332900300000,SW 417,Residential,29100,61574,0,90674
143332900400000,SW 417,Residential,29100,56940,0,86040
143332900500000,SW 417,Residential,31769,71107,0,102876
143333000100000,SW 417,Residential,31977,61277,0,93254
143333000200000,SW 417,Residential,32141,51322,0,83463
143333000300000,SW 417,Residential,31984,62167,0,94151
143333000400000,SW 417,Residential,33000,56069,0,89069
143333000500000,SW 417,Residential,33789,55988,0,89777
143333000600000,SW 417,Residential,28200,51389,0,79589
143333000700000,SW 417,Residential,28200,56589,0,84789
143333000800000,SW 417,Residential,28200,49604,0,77804
143333000900000,SW 417,Residential,28200,47588,0,75788
143333001000000,SW 417,Residential,32490,52685,0,85175
143333001100000,SW 417,Residential,34800,72457,0,107257
143333001200000,SW 417,Residential,33170,62209,0,95379
143333001300000,SW 417,Residential,33480,57205,0,90685
143333001400000,SW 417,Residential,28200,53581,0,81781
143333001500000,SW 417,Residential,28200,59818,0,88018
143333001600000,SW 417,Residential,29853,63576,0,93429
143333001700000,SW 417,Residential,31927,62510,0,94437
143333001800000,SW 417,Residential,33072,65515,0,98587
143333001900000,SW 417,Residential,34650,56513,0,91163
143333002000000,SW 417,Residential,32875,71837,0,104712
143333002100000,SW 417,Residential,31882,61857,0,93739
143333002200000,SW 417,Residential,28200,55864,0,84064
143333002300000,SW 417,Residential,28200,63104,0,91304
143333002400000,SW 417,Residential,28200,58975,0,87175
143333002500000,SW 417,Residential,32542,81265,0,113807
143333002600000,SW 417,Residential,32430,47855,0,80285
143333002700000,SW 417,Residential,34216,75210,0,109426
143333002800000,SW 417,Residential,33277,49171,0,82448
143333002900000,SW 417,Residential,28200,57333,0,85533
143333003000000,SW 417,Residential,28200,50685,0,78885
143333003100000,SW 417,Residential,28200,56901,0,85101
143333003200000,SW 417,Residential,28200,55574,0,83774
143333003300000,SW 417,Residential,28200,64975,0,93175
143333003400000,SW 417,Residential,31840,49617,0,81457
143333100100000,SW 417,Residential,35092,78388,0,113480
143333100200000,SW 417,Residential,33240,70014,0,103254
143333100300000,SW 417,Residential,31492,42279,0,73771
143333100400000,SW 417,Residential,30600,70312,0,100912
143333100500000,SW 417,Residential,30600,50470,0,81070
143333100600000,SW 417,Residential,33074,43733,0,76807
143333100700000,SW 417,Residential,32559,53872,0,86431
143333100800000,SW 417,Residential,33507,57913,0,91420
143333100900000,SW 417,Residential,26875,87693,0,114568
143333101000000,SW 417,Residential,29627,61906,0,91533
143333101100000,SW 417,Residential,33180,71209,0,104389
143333101200000,SW 417,Residential,32368,67481,0,99849
143333101300000,SW 417,Residential,31850,58702,0,90552
143333101400000,SW 417,Residential,32273,55201,0,87474
143333101500000,SW 417,Residential,32974,48270,0,81244
143333101600000,SW 417,Residential,30525,52239,0,82764
143333101700000,SW 417,Residential,29700,53246,0,82946
143333101800000,SW 417,Residential,31498,56525,0,88023
143333101900000,SW 417,Residential,33725,68128,0,101853
143333102000000,SW 417,Residential,30317,108659,0,138976
143333102100000,SW 417,Residential,33934,62381,0,96315
143333102200000,SW 417,Residential,34580,52845,0,87425
143333102300000,SW 417,Residential,32500,44997,0,77497
143333200100000,SW 417,Residential,28761,51814,0,80575
143333200200000,SW 417,Residential,29100,51663,0,80763
143333200300000,SW 417,Residential,29100,52558,0,81658
143333200400000,SW 417,Residential,29100,66148,0,95248
143333200500000,SW 417,Residential,29100,46312,0,75412
143333200600000,SW 417,Residential,30555,55377,0,85932
143333200700000,SW 417,Residential,30953,54855,0,85808
143333300100000,SW 417,Residential,29941,48887,0,78828
143333300200000,SW 417,Residential,31927,52389,0,84316
143333300300000,SW 417,Residential,36907,61989,0,98896
143333300400000,SW 417,Residential,33262,50708,0,83970
143333300500000,SW 417,Residential,30690,66796,0,97486
143333300600000,SW 417,Residential,32743,58461,0,91204
143333300700000,SW 417,Residential,34968,53204,0,88172
143333300800000,SW 417,Residential,31809,53039,0,84848
143333300900000,SW 417,Residential,32007,76159,0,108166
143333301000000,SW 417,Residential,31587,54385,0,85972
143333301100000,SW 417,Residential,31752,93100,0,124852
143333301200000,SW 417,Residential,29340,58184,0,87524
143333301300000,SW 417,Residential,31920,52651,0,84571
143333301400000,SW 417,Residential,31490,49504,0,80994
143333301500000,SW 417,Residential,30550,57117,0,87667
143333301600000,SW 417,Residential,30550,56399,0,86949
143333301700000,SW 417,Residential,30600,30140,0,60740
143333301800000,SW 417,Residential,31200,48852,0,80052
143333301900000,SW 417,Residential,32300,51805,0,84105
143333302000000,SW 417,Residential,31200,68134,0,99334
143333400100000,SW 417,Residential,31667,51286,0,82953
143333400200000,SW 417,Residential,31525,59511,0,91036
143333400300000,SW 417,Residential,29700,56043,0,85743
143333400400000,SW 417,Residential,28333,63094,0,91427
143333400500000,SW 417,Residential,29667,52280,0,81947
143333400600000,SW 417,Residential,32292,56089,0,88381
143333400700000,SW 417,Residential,32754,53341,0,86095
143333400800000,SW 417,Residential,32627,56951,0,89578
143333400900000,SW 417,Residential,33075,47524,0,80599
143333401000000,SW 417,Residential,33598,66881,0,100479
143333401100000,SW 417,Residential,34457,95884,0,130341
143333401200000,SW 417,Residential,32521,52999,0,85520
143333401300000,SW 417,Residential,29425,61182,0,90607
143333401400000,SW 417,Residential,30520,51862,0,82382
143333401500000,SW 417,Residential,32221,66265,0,98486
143333401600000,SW 417,Residential,31973,68524,0,100497
143333401700000,SW 417,Residential,29067,70703,0,99770
143333401800000,SW 417,Residential,32375,55138,0,87513
143333401900000,SW 417,Residential,31850,60221,0,92071
143333402000000,SW 417,Residential,28800,76700,0,105500
143333500100000,SW 417,Residential,31027,71217,0,102244
143333500200000,SW 417,Residential,30625,48827,0,79452
143333500300000,SW 417,Residential,32700,54952,0,87652
143333500400000,SW 417,Residential,34352,44595,0,78947
143333500500000,SW 417,Residential,32870,49281,0,82151
143333500600000,SW 417,Residential,33345,81395,0,114740
143333500700000,SW 417,Residential,38867,57080,0,95947
143335100200000,SW 417,Residential,30600,44364,0,74964
143335100300000,SW 417,Residential,30600,49886,0,80486
143335100400000,SW 417,Residential,30600,67460,0,98060
143335100500000,SW 417,Residential,30600,48747,0,79347
143335100600000,SW 417,Residential,30600,40808,0,71408
143335100800000,SW 417,Residential,30600,80972,0,111572
143335100900000,SW 417,Residential,30600,58820,0,89420
143335101000000,SW 417,Residential,30600,50960,0,81560
143335101100000,SW 417,Residential,30600,46647,0,77247
143335101200000,SW 417,Residential,30600,53292,0,83892
143335200100000,SW 417,Residential,26176,117210,0,143386
143335200200000,SW 417,Residential,21400,66531,0,87931
143335200300000,SW 417,Residential,29520,87917,0,117437
143335200400000,SW 417,Residential,29520,63389,0,92909
143335200500000,SW 417,Residential,29520,55125,0,84645
143335200600000,SW 417,Residential,29520,59986,0,89506
143335200700000,SW 417,Residential,29520,98165,0,127685
143335200800000,SW 417,Residential,29520,87268,0,116788
143335200900000,SW 417,Residential,29520,103174,0,132694
143335201000000,SW 417,Residential,29520,91780,0,121300
143335201100000,SW 417,Residential,29520,47800,0,77320
143335201200000,SW 417,Residential,27820,78093,0,105913
143335201300000,SW 417,Residential,24192,51851,0,76043
143335201400000,COMM SW,Commercial,106434,0,190196,296630
143335201500000,COMM SW,Commercial,170856,0,79144,250000
143335201600000,COMM SW,Commercial,137970,0,172998,310968
143335201700000,COMM SW,Commercial,243000,0,145154,388154
143335201800000,SW 417,Residential,29520,99550,0,129070
143335201900000,SW 417,Residential,28782,3939,0,32721
143335202000000,SW 417,Residential,25092,80351,0,105443
143335202100000,SW 417,Residential,24600,62123,0,86723
143335202200000,SW 417,Residential,24600,34383,0,58983
143335202300000,SW 417,Residential,24600,39160,0,63760
143335202400000,SW 417,Residential,24600,100600,0,125200
143335202500000,SW 417,Residential,24600,87671,0,112271
143335202600000,SW 417,Residential,29520,88922,0,118442
143335202700000,SW 417,Residential,29520,76832,0,106352
143335202800000,SW 417,Residential,29520,122225,0,151745
143335202900000,SW 417,Residential,24600,80501,0,105101
143335203000000,SW 417,Residential,24600,108409,0,133009
143335203100000,SW 417,Residential,32472,81441,0,113913
143335300100000,SW 417,Residential,21400,65081,0,86481
143335300200000,SW 417,Residential,3200,0,0,3200
143335300300000,SW 417,Residential,24600,86039,0,110639
143335300400000,SW 417,Residential,21400,98732,0,120132
143335300500000,SW 417,Residential,25020,79789,0,104809
143335300700000,SW 417,Residential,29520,95653,0,125173
143335300800000,SW 417,Residential,29520,37458,0,66978
143335300900000,SW 417,Residential,20400,59733,0,80133
143335301000000,SW 417,Residential,20400,47569,0,67969
143335301100000,SW 417,Residential,8400,0,0,8400
143335301200000,SW 417,Residential,24600,51168,0,75768
143335301300000,SW 417,Residential,24600,51190,0,75790
143335301400000,SW 417,Residential,24600,73163,0,97763
143335301600000,CONDO 500,Residential,0,0,0,0
143335301701000,CONDO 500,Residential,4000,51039,0,55039
143335301701001,CONDO 500,Residential,4000,51039,0,55039
143335301701002,CONDO 500,Residential,4000,51039,0,55039
143335301701003,CONDO 500,Residential,4000,51039,0,55039
143335301800000,APTS SW,Commercial,14541,0,129486,144027
143335301900000,COMM SW,Commercial,48182,0,4379,52561
143335302000000,COMM SW,Commercial,48600,0,5079,53679
143335302201000,CONDO 505,Residential,4000,58556,0,62556
143335302201001,CONDO 505,Residential,4000,58556,0,62556
143335302201002,CONDO 505,Residential,4000,58556,0,62556
143335302201003,CONDO 505,Residential,4000,58556,0,62556
143335302201004,CONDO 505,Residential,4000,58556,0,62556
143335302201005,CONDO 505,Residential,4000,58556,0,62556
143335302201006,CONDO 505,Residential,4000,58556,0,62556
143335302201007,CONDO 505,Residential,4000,58556,0,62556
143335302201008,CONDO 505,Residential,4000,58556,0,62556
143335302201009,CONDO 505,Residential,4000,58556,0,62556
143335302201010,CONDO 505,Residential,4000,58556,0,62556
143335302201011,CONDO 505,Residential,4000,58556,0,62556
143335302300000,COMM SW,Commercial,148824,0,244618,393442
143335302400000,COMM SW,Commercial,143856,0,427140,570996
143335302500000,E-05 STATE,Exempt,0,0,0,0
143335302600000,SW 417,Residential,25560,28754,0,54314
143335302700000,SW 417,Residential,20800,33949,0,54749
143335400100000,E-40 CHURCHES,Exempt,76680,0,315690,392370
143335400700000,SW 417,Residential,29120,84034,0,113154
143335401300000,SW 417,Residential,27975,77169,0,105144
143335401400000,SW 417,Residential,28125,103672,0,131797
143335401500000,SW 417,Residential,25000,63581,0,88581
143335401600000,SW 417,Residential,25000,62184,0,87184
143335401700000,SW 417,Residential,5400,0,0,5400
143335401800000,COMM SW,Commercial,43675,0,0,43675
143335401900000,SW 417,Residential,19400,89401,0,108801
143335402000000,SW 417,Residential,29120,116167,0,145287
143335402100000,SW 417,Residential,29120,115568,0,144688
143335402200000,SW 417,Residential,29120,108421,0,137541
143335402300000,SW 417,Residential,35700,80236,0,115936
143335402400000,SW 417,Residential,28860,49222,0,78082
143335402500000,E-70 CHARITY OTHER,Exempt,41904,0,444243,486147
143337600100000,SW 416,Residential,31320,95199,0,126519
143337600200000,SW 416,Residential,30246,81856,0,112102
143337600300000,SW 416,Residential,45475,66192,0,111667
143337600400000,SW 416,Residential,22377,99315,0,121692
143337600500000,SW 416,Residential,22050,94049,0,116099
143337600600000,SW 416,Residential,22050,66830,0,88880
143337600700000,SW 416,Residential,22050,70055,0,92105
143337600800000,SW 416,Residential,22600,75780,0,98380
143337600900000,SW 416,Residential,27247,97233,0,124480
143337601000000,SW 416,Residential,27010,86214,0,113224
143337601100000,SW 416,Residential,32878,100181,0,133059
143337601200000,SW 416,Residential,29880,57947,0,87827
143337601300000,SW 416,Residential,29520,73525,0,103045
143337601400000,SW 416,Residential,33408,40765,0,74173
143337700100000,SW 417,Residential,42570,101844,0,144414
143337700200000,SW 417,Exempt,29980,0,117042,147022
143337800100000,SW 416,Residential,23680,60741,0,84421
143337800200000,SW 416,Residential,23600,63644,0,87244
143337800300000,SW 416,Residential,23600,69047,0,92647
143337800400000,SW 416,Residential,23600,77489,0,101089
143337800500000,SW 416,Residential,23600,78530,0,102130
143337800600000,SW 416,Residential,30680,61847,0,92527
143337800700000,SW 416,Residential,17700,84305,0,102005
143337800900000,SW 416,Residential,26550,99284,0,125834
143337801000000,SW 416,Residential,23600,113687,0,137287
143337801100000,SW 416,Residential,23600,83864,0,107464
143337801200000,SW 416,Residential,26260,54543,0,80803
143337801300000,SW 416,Residential,30373,65303,0,95676
143337801400000,SW 416,Residential,24662,80476,0,105138
143337801500000,SW 416,Residential,30680,89486,0,120166
143337801600000,SW 416,Residential,30680,70242,0,100922
143337801700000,SW 416,Residential,30680,65646,0,96326
143337801800000,SW 416,Residential,30680,112392,0,143072
143337801900000,SW 416,Residential,30680,42608,0,73288
143337802000000,SW 416,Residential,32400,68146,0,100546
143337802200000,SW 416,Residential,22200,63177,0,85377
143337802300000,SW 416,Residential,22200,64187,0,86387
143337802400000,SW 416,Residential,29600,95980,0,125580
143337802500000,SW 416,Residential,30192,49361,0,79553
143337802600000,SW 416,Residential,8850,0,0,8850
143337900100000,SW 417,Residential,32472,52756,0,85228
143337900200000,SW 417,Residential,30602,0,0,30602
143337900300000,SW 417,Residential,30602,74272,0,104874
143338000100000,SW 416,Residential,29098,60177,0,89275
143338000200000,SW 416,Residential,20000,58107,0,78107
143338000300000,SW 416,Exempt,35107,0,221980,257087
143338000400000,SW 416,Residential,23600,30515,0,54115
143338000500000,SW 416,Residential,23600,89061,0,112661
143338000600000,SW 416,Residential,30680,29883,0,60563
143338000700000,SW 416,Residential,20000,54927,0,74927
143338000800000,SW 416,Residential,24480,77972,0,102452
143338000900000,SW 416,Residential,30680,62081,0,92761
143338001000000,SW 416,Residential,30680,94969,0,125649
143338001100000,SW 416,Residential,28025,113485,0,141510
143338001200000,SW 416,Residential,10594,0,0,10594
143338100100000,SW 417,Residential,25092,64246,0,89338
143340100100000,COMM SW,Commercial,64260,0,78755,143015
143340100200000,COMM SW,Commercial,127613,0,15000,142613
143340100700000,SW 414,Residential,24998,54603,0,79601
143340100800000,SW 414,Residential,24998,61375,0,86373
143340100900000,SW 414,Residential,24998,51876,0,76874
143340101000000,SW 414,Residential,27270,48366,0,75636
143340101100000,SW 414,Residential,27270,77368,0,104638
143340101200000,SW 414,Residential,38784,73944,0,112728
143340101300000,SW 414,Residential,22220,57462,0,79682
143340101400000,SW 414,Residential,37774,95285,0,133059
143340101600000,SW 414,Residential,38896,129326,0,168222
143340101700000,COMM SW,Commercial,63202,0,94812,158014
143340200100000,SW 414,Residential,30001,70429,0,100430
143340200200000,SW 414,Residential,30492,83136,0,113628
143340200300000,SW 414,Residential,29700,95194,0,124894
143340200400000,SW 414,Residential,29399,94420,0,123819
143340200500000,SW 414,Residential,17820,118748,0,136568
143340200600000,SW 414,Residential,32640,107669,0,140309
143340200700000,SW 414,Residential,32640,99787,0,132427
143340200800000,SW 414,Residential,22220,94452,0,116672
143340200900000,SW 414,Residential,23028,75339,0,98367
143340201000000,SW 414,Residential,14760,58321,0,73081
143340201100000,SW 414,Residential,29610,80917,0,110527
143340201200000,SW 414,Residential,34211,89284,0,123495
143340201300000,SW 414,Residential,33413,71053,0,104466
143340201400000,SW 414,Residential,33413,106996,0,140409
143340201500000,SW 414,Residential,33879,71653,0,105532
143340201600000,SW 414,Residential,27353,85405,0,112758
143340201700000,SW 414,Residential,27000,88394,0,115394
143340201800000,SW 414,Residential,27000,69350,0,96350
143340201900000,SW 414,Residential,27000,67325,0,94325
143340202000000,SW 414,Residential,27564,74690,0,102254
143340202100000,SW 414,Residential,38546,79666,0,118212
143340300100000,SW 414,Residential,27750,60982,0,88732
143340300200000,SW 414,Residential,36630,45810,0,82440
143340300300000,SW 414,Residential,35200,111137,0,146337
143340300400000,SW 414,Residential,38085,59685,0,97770
143340300500000,SW 414,Residential,30625,135641,0,166266
143340300600000,SW 414,Residential,36570,133880,0,170450
143340300700000,SW 414,Residential,29145,111187,0,140332
143340300800000,SW 414,Residential,29453,99732,0,129185
143340300900000,SW 414,Residential,37317,159487,0,196804
143340301000000,SW 414,Residential,37048,148141,0,185189
143340301100000,Empty,Exempt,0,0,0,0
143340301200000,SW 414,Residential,40547,119767,0,160314
143340301300000,SW 414,Residential,37057,124303,0,161360
143340301400000,SW 414,Residential,34300,126473,0,160773
143340301500000,SW 414,Residential,34300,128333,0,162633
143340301600000,SW 414,Residential,37125,124336,0,161461
143340301700000,SW 414,Residential,35371,76742,0,112113
143340301800000,SW 414,Residential,31392,75056,0,106448
143340301900000,SW 414,Residential,32130,105981,0,138111
143340302000000,SW 414,Residential,32900,101478,0,134378
143340302100000,SW 414,Residential,32760,94988,0,127748
143340302200000,SW 414,Residential,32760,102560,0,135320
143340302300000,SW 414,Residential,33228,92639,0,125867
143340302400000,SW 414,Residential,33228,89791,0,123019
143340302500000,SW 414,Residential,29952,83694,0,113646
143340302600000,SW 414,Residential,29952,77013,0,106965
143340302700000,SW 414,Residential,31886,92882,0,124768
143340302800000,SW 414,Residential,28492,81576,0,110068
143340302900000,SW 414,Residential,28080,119757,0,147837
143340303000000,SW 414,Residential,33325,102316,0,135641
143340303100000,SW 414,Residential,27668,96862,0,124530
143340303200000,SW 414,Residential,32719,98274,0,130993
143340400100000,SW 414,Residential,30969,79785,0,110754
143340400200000,SW 414,Residential,30600,104444,0,135044
143340400300000,SW 414,Residential,30600,101524,0,132124
143340400400000,SW 414,Residential,30251,119474,0,149725
143340400500000,SW 414,Residential,34264,118891,0,153155
143340400600000,SW 414,Residential,29952,111163,0,141115
143340400700000,SW 414,Residential,29952,105461,0,135413
143340400800000,SW 414,Residential,28548,79492,0,108040
143340400900000,SW 413,Residential,25668,85119,0,110787
143340401000000,SW 414,Residential,32063,93652,0,125715
143340401100000,SW 414,Residential,30668,93090,0,123758
143340401200000,SW 414,Residential,26285,83308,0,109593
143340401300000,SW 414,Residential,23868,102579,0,126447
143340401400000,SW 414,Residential,27612,116782,0,144394
143340401500000,SW 414,Residential,30276,110643,0,140919
143340401600000,SW 414,Residential,36644,62638,0,99282
143340500100000,SW 414,Residential,30951,91876,0,122827
143340500200000,SW 414,Residential,30600,77519,0,108119
143340500300000,SW 414,Residential,30600,78558,0,109158
143340500400000,SW 414,Residential,30713,85076,0,115789
143340500500000,SW 414,Residential,33588,107881,0,141469
143340500600000,SW 414,Residential,35438,90864,0,126302
143340500700000,SW 414,Residential,35438,96947,0,132385
143340500800000,SW 414,Residential,35438,78275,0,113713
143340500900000,SW 414,Residential,35636,95469,0,131105
143340501000000,SW 414,Residential,35334,105393,0,140727
143340501100000,SW 414,Residential,34010,115180,0,149190
143340501200000,SW 414,Residential,33776,107047,0,140823
143340501300000,SW 414,Residential,35568,85148,0,120716
143340501400000,SW 414,Residential,33620,100358,0,133978
143340600100000,SW 414,Residential,32320,80103,0,112423
143340600200000,SW 414,Residential,36360,97330,0,133690
143340600300000,SW 414,Residential,27275,117705,0,144980
143340600400000,SW 414,Residential,27314,73982,0,101296
143340600500000,SW 414,Residential,28233,77142,0,105375
143340600600000,SW 414,Residential,29254,74383,0,103637
143340700100000,SW 414,Residential,29849,108528,0,138377
143340700200000,SW 414,Residential,28512,86881,0,115393
143340700300000,SW 414,Residential,28174,88611,0,116785
143340700400000,SW 414,Residential,25468,85364,0,110832
143340700500000,SW 414,Residential,24758,90407,0,115165
143340700600000,SW 414,Residential,25949,83494,0,109443
143340700700000,SW 414,Residential,25056,79785,0,104841
143340700800000,SW 414,Residential,31725,100287,0,132012
143340800100000,SW 414,Residential,25764,92731,0,118495
143340800200000,SW 414,Residential,32400,92278,0,124678
143340800300000,SW 414,Residential,30240,91216,0,121456
143340800400000,SW 414,Residential,28944,86456,0,115400
143340800500000,SW 414,Residential,28341,90131,0,118472
143340800600000,SW 414,Residential,31104,98586,0,129690
143340800700000,SW 414,Residential,31320,104225,0,135545
143340800800000,SW 414,Residential,25980,94956,0,120936
143340900100000,SW 414,Residential,29376,80316,0,109692
143340900200000,SW 414,Residential,32832,92803,0,125635
143340900300000,SW 414,Residential,35190,88918,0,124108
143340900400000,SW 414,Residential,32620,95702,0,128322
143340900500000,SW 414,Residential,29952,81191,0,111143
143340900600000,SW 414,Residential,30659,78200,0,108859
143340900700000,SW 414,Residential,27648,84195,0,111843
143340900800000,SW 414,Residential,31104,72802,0,103906
143340900900000,SW 414,Residential,28512,106161,0,134673
143340901000000,SW 414,Residential,29376,77431,0,106807
143340901100000,SW 414,Residential,28512,94005,0,122517
143340901200000,SW 414,Residential,28809,101379,0,130188
143340901300000,SW 414,Residential,29070,78247,0,107317
143341000100000,SW 414,Residential,36701,97760,0,134461
143341000200000,SW 414,Residential,28735,95503,0,124238
143341000300000,SW 414,Residential,28592,106683,0,135275
143341000400000,SW 414,Residential,28049,125420,0,153469
143341000500000,SW 414,Residential,32193,90585,0,122778
143341000600000,SW 414,Residential,29547,99651,0,129198
143342600100000,SW 416,Residential,34560,94582,0,129142
143342600200000,SW 416,Residential,28800,70111,0,98911
143342600300000,SW 416,Residential,26773,54292,0,81065
143342600400000,SW 416,Residential,26773,87526,0,114299
143342600500000,SW 416,Residential,27192,68372,0,95564
143342600600000,SW 416,Residential,27192,53935,0,81127
143342600700000,SW 416,Residential,27192,83392,0,110584
143342600800000,SW 416,Residential,25872,100883,0,126755
143342600900000,SW 416,Residential,33947,81320,0,115267
143342601000000,SW 416,Residential,21560,115587,0,137147
143342601100000,SW 416,Residential,14896,35490,0,50386
143342601200000,SW 416,Residential,14896,46825,0,61721
143342601300000,SW 416,Residential,14896,38777,0,53673
143342601400000,SW 416,Residential,14896,68728,0,83624
143342601500000,SW 416,Residential,14896,100303,0,115199
143342601600000,SW 416,Residential,28248,64568,0,92816
143342601700000,SW 416,Residential,27192,106293,0,133485
143342601800000,SW 416,Residential,27192,68992,0,96184
143342601900000,SW 416,Residential,27192,60472,0,87664
143342602000000,SW 416,Residential,32320,0,0,32320
143342602100000,SW 416,Residential,34613,143765,0,178378
143342700100000,Empty,Exempt,0,0,0,0
143342700102000,COMM SW,Commercial,0,0,11938,11938
143342700200000,SW 416,Residential,27440,88409,0,115849
143342700300000,SW 416,Residential,17640,61403,0,79043
143342700400000,SW 416,Residential,15680,55390,0,71070
143342700500000,SW 416,Residential,23520,58488,0,82008
143342700600000,SW 416,Residential,23520,54067,0,77587
143342700700000,SW 416,Residential,15680,42259,0,57939
143342700800000,SW 416,Residential,32928,67429,0,100357
143342700900000,SW 416,Residential,15680,75843,0,91523
143342701000000,SW 416,Residential,15680,81754,0,97434
143342701100000,SW 416,Residential,15680,54605,0,70285
143342701200000,SW 416,Residential,15680,61692,0,77372
143342701300000,SW 416,Residential,15680,67402,0,83082
143342701400000,SW 416,Residential,15680,64298,0,79978
143342701500000,SW 416,Residential,31360,50884,0,82244
143342701600000,SW 416,Residential,31360,75319,0,106679
143342701700000,SW 416,Residential,15680,63343,0,79023
143342800100000,SW 414,Residential,39258,171406,0,210664
143342800200000,SW 416,Residential,23357,94942,0,118299
143342800300000,SW 416,Residential,23660,69077,0,92737
143342800400000,SW 416,Residential,23660,71888,0,95548
143342800500000,SW 416,Residential,25480,95220,0,120700
143342800600000,SW 416,Residential,25480,71497,0,96977
143342800700000,SW 416,Residential,23660,70401,0,94061
143342800800000,SW 416,Residential,23400,66455,0,89855
143342800900000,SW 416,Residential,23400,107997,0,131397
143342801000000,SW 416,Residential,23400,89009,0,112409
143342801100000,SW 416,Residential,23400,93286,0,116686
143342801200000,SW 416,Residential,23400,99263,0,122663
143342801300000,SW 416,Residential,21900,85580,0,107480
143342801400000,SW 416,Residential,38372,172726,0,211098
143342801600000,SW 414,Residential,35250,144259,0,179509
143342801700000,SW 414,Residential,31525,140516,0,172041
143342801800000,SW 414,Residential,31527,139661,0,171188
143342801900000,SW 414,Residential,34290,105883,0,140173
143342802000000,SW 414,Residential,40159,176781,0,216940
143342900100000,SW 416,Residential,28382,74544,0,102926
143342900200000,SW 416,Residential,20440,56853,0,77293
143342900300000,SW 416,Residential,17520,42062,0,59582
143342900400000,SW 416,Residential,14720,55914,0,70634
143342900500000,SW 416,Residential,14720,47913,0,62633
143342900600000,SW 416,Residential,15688,55665,0,71353
143342900700000,SW 416,Residential,18232,51800,0,70032
143342900800000,SW 416,Residential,16960,101630,0,118590
143342900900000,SW 416,Residential,16960,70340,0,87300
143342901000000,SW 416,Residential,16960,77270,0,94230
143342901100000,SW 416,Residential,16960,76708,0,93668
143342901200000,SW 416,Residential,25440,83240,0,108680
143342901300000,SW 416,Residential,25440,146983,0,172423
143342901400000,SW 416,Residential,16960,73010,0,89970
143342901500000,SW 416,Residential,25440,67066,0,92506
143342901600000,SW 416,Residential,25440,80751,0,106191
143342901700000,SW 416,Residential,16960,72584,0,89544
143342901800000,SW 416,Residential,16960,53721,0,70681
143342901900000,SW 416,Residential,25440,74343,0,99783
143342902000000,SW 416,Residential,21200,91682,0,112882
143342902100000,SW 416,Residential,21200,64695,0,85895
143342902200000,SW 416,Residential,27341,75414,0,102755
143342902300000,SW 416,Residential,19584,20329,0,39913
143342902400000,SW 416,Residential,24106,60781,0,84887
143342902500000,SW 416,Residential,23654,76788,0,100442
143342902600000,SW 416,Residential,30528,68771,0,99299
143342902700000,SW 416,Residential,30528,80256,0,110784
143342902800000,SW 416,Residential,30528,77460,0,107988
143342902900000,SW 416,Residential,30528,64184,0,94712
143342903000000,SW 416,Residential,16960,29195,0,46155
143342903100000,SW 416,Residential,16960,66628,0,83588
143342903200000,SW 416,Residential,30528,76718,0,107246
143342903300000,SW 416,Residential,16960,72714,0,89674
143342903400000,SW 416,Residential,16960,30378,0,47338
143342903500000,SW 416,Residential,16960,29548,0,46508
143342903600000,SW 416,Residential,16960,59789,0,76749
143342903900000,SW 416,Residential,16960,45190,0,62150
143342904000000,SW 416,Residential,30528,89488,0,120016
143345100100000,SW 416,Residential,26000,61727,0,87727
143345100200000,SW 416,Residential,33800,64388,0,98188
143345100300000,SW 416,Residential,31383,62290,0,93673
143345100400000,SW 416,Residential,29342,133438,0,162780
143345100500000,SW 416,Residential,24729,71750,0,96479
143345100600000,SW 416,Residential,21400,58965,0,80365
143345100700000,SW 416,Residential,21800,52693,0,74493
143345100800000,SW 416,Residential,22200,65675,0,87875
143345200100000,SW 416,Residential,30274,109631,0,139905
143345200200000,SW 416,Residential,29815,88177,0,117992
143345200300000,SW 416,Residential,33068,69149,0,102217
143345200400000,SW 416,Residential,25568,46797,0,72365
143345200500000,SW 416,Residential,18424,55865,0,74289
143345200600000,SW 416,Residential,19461,59631,0,79092
143345200700000,SW 416,Residential,19440,81704,0,101144
143345200800000,SW 416,Residential,19440,129116,0,148556
143345200900000,SW 416,Residential,22846,75764,0,98610
143345201000000,SW 416,Residential,19656,83067,0,102723
143345201100000,SW 416,Residential,26136,88673,0,114809
143345201200000,SW 416,Residential,21414,78748,0,100162
143345300100000,SW 416,Residential,24060,100583,0,124643
143345300200000,SW 416,Residential,31541,60911,0,92452
143345300300000,SW 416,Residential,28000,39351,0,67351
143345300400000,SW 416,Residential,27200,71881,0,99081
143345300500000,SW 416,Residential,45875,130495,0,176370
143345300600000,SW 416,Residential,45925,0,0,45925
143345300700000,Empty,Exempt,0,0,0,0
143345300800000,SW 416,Residential,29505,58036,0,87541
143345300900000,SW 416,Residential,19600,85456,0,105056
143345301000000,SW 416,Residential,23520,79544,0,103064
143345301100000,SW 416,Residential,23520,51262,0,74782
143345301200000,SW 416,Residential,25480,93607,0,119087
143345301300000,SW 416,Residential,21560,72073,0,93633
143345301400000,SW 416,Residential,23520,57094,0,80614
143345301500000,SW 416,Residential,29400,63145,0,92545
143345301600000,SW 416,Residential,34104,93203,0,127307
143345301700000,SW 416,Residential,31008,50031,0,81039
143345301800000,SW 416,Residential,32967,90196,0,123163
143345301900000,SW 416,Residential,33253,83021,0,116274
143345302000000,SW 416,Residential,35100,74997,0,110097
143345302100000,SW 416,Residential,35573,65805,0,101378
143345302200000,SW 416,Residential,35496,85770,0,121266
143345302300000,SW 416,Residential,28080,78729,0,106809
143345302400000,SW 416,Residential,32713,42632,0,75345
143345302500000,SW 416,Residential,39350,77654,0,117004
143345302600000,SW 416,Residential,42284,68926,0,111210
143345302700000,SW 416,Residential,20200,60763,0,80963
143345302800000,SW 416,Residential,21037,28288,0,49325
143345400100000,SW 416,Residential,29385,42933,0,72318
143345400200000,SW 416,Residential,33120,79171,0,112291
143345400300000,SW 416,Residential,35505,51409,0,86914
143345400400000,SW 416,Residential,35343,95255,0,130598
143345400500000,SW 416,Residential,36689,39468,0,76157
143345400600000,SW 416,Residential,28712,50280,0,78992
143345400700000,SW 416,Residential,24563,71510,0,96073
143345400800000,SW 416,Residential,25239,85220,0,110459
143345400900000,SW 416,Residential,22272,29695,0,51967
143345401000000,SW 416,Residential,28520,64257,0,92777
143345401100000,SW 416,Residential,25232,69858,0,95090
143345401200000,SW 416,Residential,27572,79830,0,107402
143345401300000,SW 416,Residential,21840,54000,0,75840
143345401400000,SW 416,Residential,21840,49257,0,71097
143345401500000,SW 416,Residential,22272,45564,0,67836
143345401600000,SW 416,Residential,22349,53070,0,75419
143345401700000,SW 416,Residential,23000,57929,0,80929
143345401800000,SW 416,Residential,23000,54666,0,77666
143345401900000,SW 416,Residential,23000,67568,0,90568
143345402000000,SW 416,Residential,23000,73468,0,96468
143345402100000,SW 416,Residential,23000,84460,0,107460
143345402200000,SW 416,Residential,19200,55294,0,74494
143345402300000,SW 416,Residential,28160,58930,0,87090
143345402400000,SW 416,Residential,27080,89370,0,116450
143345402500000,SW 416,Residential,28400,75810,0,104210
143345402600000,SW 416,Residential,23600,97933,0,121533
143345402700000,SW 416,Residential,23400,73109,0,96509
143345402800000,SW 416,Residential,34800,45587,0,80387
143345402900000,SW 416,Residential,32544,123497,0,156041
143345403000000,SW 416,Residential,30800,72651,0,103451
143345403100000,SW 416,Residential,32100,80195,0,112295
143345403200000,SW 416,Residential,31200,96892,0,128092
143345403300000,SW 416,Residential,27592,74203,0,101795
143345403400000,SW 416,Residential,25680,68497,0,94177
143345403500000,SW 416,Residential,25440,87012,0,112452
143345403600000,SW 416,Residential,32760,94322,0,127082
143347600100000,SW 414,Residential,35611,98088,0,133699
143347600200000,SW 414,Residential,28735,92501,0,121236
143347600300000,SW 414,Residential,35756,130368,0,166124
143347600400000,SW 414,Residential,29182,124046,0,153228
143347600500000,SW 414,Residential,30906,89787,0,120693
143347600600000,SW 414,Residential,32724,112012,0,144736
143347700100000,SW 414,Residential,29952,98192,0,128144
143347700200000,SW 414,Residential,32625,99157,0,131782
143347700300000,SW 414,Residential,32625,107070,0,139695
143347700400000,SW 414,Residential,36166,63201,0,99367
143347700500000,SW 414,Residential,32400,89629,0,122029
143347700600000,SW 414,Residential,37950,66687,0,104637
143347700700000,SW 414,Residential,37179,145209,0,182388
143347700800000,SW 414,Residential,42120,151097,0,193217
143347700900000,SW 414,Residential,32400,96515,0,128915
143347701000000,SW 414,Residential,40500,94963,0,135463
143347701100000,SW 414,Residential,40500,119621,0,160121
143347701200000,SW 414,Residential,27000,89474,0,116474
143347701300000,SW 414,Residential,40500,111215,0,151715
143347701400000,SW 414,Residential,36450,61371,0,97821
143347701500000,SW 414,Residential,36450,129650,0,166100
143347701600000,SW 414,Residential,37102,118771,0,155873
143347701700000,SW 414,Residential,37102,45762,0,82864
143347701800000,SW 414,Residential,36225,85428,0,121653
143347701900000,SW 414,Residential,27169,144904,0,172073
143347702000000,SW 414,Residential,36865,156025,0,192890
143347702100000,SW 414,Residential,27725,76653,0,104378
143347702200000,SW 414,Residential,27725,80010,0,107735
143347702300000,SW 414,Residential,27725,94527,0,122252
143347702400000,SW 414,Residential,26888,87860,0,114748
143347702500000,SW 414,Residential,38671,94027,0,132698
143347702600000,SW 414,Residential,38324,107026,0,145350
143347702700000,SW 414,Residential,37420,109499,0,146919
143347702800000,SW 414,Residential,35568,97202,0,132770
143347702900000,SW 414,Residential,35568,112608,0,148176
143347703000000,SW 414,Residential,35568,114888,0,150456
143347703100000,SW 414,Residential,35100,90033,0,125133
143347703200000,SW 414,Residential,35100,103021,0,138121
143347703300000,SW 414,Residential,29250,130021,0,159271
143347703400000,SW 414,Residential,36270,97759,0,134029
143347703500000,SW 414,Residential,33462,109891,0,143353
143347703600000,SW 414,Residential,33930,92426,0,126356
143347703700000,SW 414,Residential,33696,87203,0,120899
143347703800000,SW 414,Residential,32760,87122,0,119882
143347800200000,SW 416,Residential,29000,53905,0,82905
143347800300000,SW 416,Residential,29000,33344,0,62344
143347800400000,SW 416,Residential,29000,90756,0,119756
143347800500000,SW 416,Residential,26000,51703,0,77703
143347800600000,SW 416,Residential,22600,62458,0,85058
143347800700000,SW 416,Residential,38520,109122,0,147642
143347800800000,SW 416,Residential,29988,75764,0,105752
143347800900000,SW 416,Residential,28080,80978,0,109058
143347801000000,SW 416,Residential,27000,84412,0,111412
143347801100000,SW 416,Residential,27000,21693,0,48693
143347801200000,SW 416,Residential,22500,65533,0,88033
143347801300000,SW 416,Residential,22500,86792,0,109292
143347801400000,SW 416,Residential,35700,144636,0,180336
143347801500000,SW 416,Residential,38250,126040,0,164290
143347900100000,SW 414,Residential,37091,96535,0,133626
143347900200000,SW 414,Residential,34025,118349,0,152374
143347900300000,SW 414,Residential,35447,100041,0,135488
143347900400000,SW 414,Residential,29500,88414,0,117914
143347900500000,SW 414,Residential,31815,102471,0,134286
143347900600000,SW 414,Residential,31815,91894,0,123709
143347900700000,SW 414,Residential,34564,109917,0,144481
143347900800000,SW 414,Residential,34335,110062,0,144397
143347900900000,SW 414,Residential,37278,124718,0,161996
143347901000000,SW 414,Residential,31392,101213,0,132605
143347901100000,SW 414,Residential,35316,86361,0,121677
143347901200000,SW 414,Residential,33354,106050,0,139404
143347901300000,SW 414,Residential,31392,111498,0,142890
143347901400000,SW 414,Residential,31392,99599,0,130991
143347901500000,SW 414,Residential,35084,121554,0,156638
143347901600000,SW 414,Residential,31937,121948,0,153885
143347901700000,SW 414,Residential,37867,109289,0,147156
143347901800000,SW 414,Residential,38091,66296,0,104387
143347901900000,SW 414,Residential,21840,92021,0,113861
143347902000000,SW 414,Residential,21840,0,0,21840
143347902100000,E-40 CHURCHES,Exempt,187380,0,882376,1069756
143347902200000,COMM SW,Commercial,150163,0,254483,404646
143348000100000,SW 416,Residential,22560,30724,0,53284
143348000200000,SW 416,Residential,29280,67392,0,96672
143348000300000,SW 416,Residential,29719,82265,0,111984
143348000400000,SW 416,Residential,30598,47689,0,78287
143348000500000,SW 416,Residential,31536,107006,0,138542
143348000600000,SW 416,Residential,32166,63028,0,95194
143348000700000,E-46 RELIG PARKING,Exempt,37206,0,0,37206
143348000800000,SW 416,Residential,37760,61679,0,99439
143348000900000,SW 416,Residential,19800,71863,0,91663
143348001000000,E-40 CHURCHES,Exempt,73980,0,614518,688498
143410100100000,SE 242,Residential,20952,42101,0,63053
143415100100000,Empty,Exempt,0,0,0,0
143415100200000,E-70 CHARITY OTHER,Exempt,1138320,0,3754520,4892840
143415100300000,Empty,Other,0,0,0,0
143420100100000,Empty,Exempt,0,0,0,0
143420100200000,Empty,Exempt,0,0,0,0
143422600100000,Empty,Exempt,0,0,0,0
143422600200000,Empty,Exempt,0,0,0,0
143422600300000,SW 412,Residential,15480,0,0,15480
143422600400000,SW 412,Residential,9800,0,0,9800
143422600500000,SW 412,Residential,5000,0,0,5000
143422600600000,SW 412,Residential,5000,0,0,5000
143422600700000,SW 412,Residential,9600,0,0,9600
143422600800000,SW 412,Residential,5000,0,0,5000
143422600900000,SW 412,Residential,9600,0,0,9600
143422601000000,SW 412,Residential,5000,0,0,5000
143422601100000,SW 412,Residential,5000,0,0,5000
143422601200000,SW 412,Residential,14700,59734,0,74434
143422601300000,SW 412,Residential,14700,42230,0,56930
143422601400000,SW 412,Residential,14700,46678,0,61378
143422601500000,SW 412,Residential,23082,45322,0,68404
143422601600000,SW 412,Residential,23225,89244,0,112469
143422601700000,Empty,Exempt,0,0,0,0
143422601800000,SW 412,Residential,9800,1544,0,11344
143422700100000,SW 412,Residential,9400,0,0,9400
143422700200000,SW 412,Residential,5000,0,0,5000
143422700300000,SW 412,Residential,5000,0,0,5000
143422700400000,SW 412,Residential,10000,0,0,10000
143422700500000,SW 412,Residential,10000,0,0,10000
143422700600000,SW 412,Residential,12500,27752,0,40252
143422700700000,SW 412,Residential,7500,0,0,7500
143422700800000,SW 412,Residential,5000,0,0,5000
143422700900000,SW 409,Residential,10000,0,0,10000
143422701000000,SW 412,Residential,9000,0,0,9000
143422701100000,SW 412,Residential,5000,0,0,5000
143422701200000,SW 412,Residential,5000,0,0,5000
143422701300000,SW 412,Residential,5000,0,0,5000
143422701400000,SW 412,Residential,5000,0,0,5000
143422701500000,APTS SW,Commercial,5476,0,53924,59400
143422701600000,SW 412,Residential,5000,0,0,5000
143422701700000,SW 412,Residential,5000,0,0,5000
143422701800000,SW 412,Residential,9600,0,0,9600
143422701900000,SW 412,Residential,9600,0,0,9600
143422702000000,SW 412,Residential,5000,0,0,5000
143422702100000,SW 412,Residential,5000,0,0,5000
143422702200000,SW 412,Residential,5000,0,0,5000
143422702300000,SW 412,Residential,5000,0,0,5000
143422702400000,SW 412,Residential,5000,0,0,5000
143422702500000,SW 412,Residential,10480,0,0,10480
143422800100000,SW 402,Residential,10000,0,0,10000
143422900100000,SW 402,Residential,5000,0,0,5000
143422900200000,SW 402,Residential,5000,0,0,5000
143422900300000,SW 402,Residential,10000,0,0,10000
143422900400000,SW 402,Residential,10000,0,0,10000
143423000100000,SW 412,Residential,19276,68408,0,87684
143423000200000,SW 412,Residential,20976,95646,0,116622
143423000400000,SW 412,Residential,20160,94118,0,114278
143423000500000,SW 412,Residential,22080,116664,0,138744
143423000600000,SW 412,Residential,23520,83093,0,106613
143423000700000,SW 412,Residential,24480,65264,0,89744
143423000800000,SW 412,Residential,25440,67999,0,93439
143423000900000,SW 412,Residential,26160,67893,0,94053
143423001000000,SW 412,Residential,22101,83817,0,105918
143423001100000,SW 412,Residential,19800,61542,0,81342
143423001200000,SW 412,Residential,23760,100476,0,124236
143423001300000,SW 412,Residential,14137,55873,0,70010
143423001400000,SW 412,Residential,27901,104707,0,132608
143423001500000,SW 412,Residential,23375,58950,0,82325
143423001600000,SW 412,Residential,23375,77707,0,101082
143423001700000,SW 412,Residential,17500,0,0,17500
143423001800000,APTS SW,Commercial,16185,0,92744,108929
143423001900000,SW 412,Residential,26630,93424,0,120054
143423002000000,SW 412,Residential,28564,85806,0,114370
143423002100000,SW 412,Residential,28318,85555,0,113873
143423002200000,SW 412,Residential,26880,105559,0,132439
143423002300000,SW 412,Residential,28560,80837,0,109397
143423002400000,SW 412,Residential,23520,82925,0,106445
143423002500000,SW 412,Residential,22080,63493,0,85573
143423002600000,SW 412,Residential,20160,73133,0,93293
143423002700000,SW 412,Residential,17568,64978,0,82546
143423002800000,SW 412,Residential,17568,4206,0,21774
143423100100000,SW 412,Residential,6000,0,0,6000
143423100200000,SW 412,Residential,5000,0,0,5000
143423100300000,SW 412,Residential,5000,0,0,5000
143423100400000,SW 412,Residential,12000,46916,0,58916
143423100500000,SW 412,Residential,12000,35381,0,47381
143423100600000,SW 412,Residential,12000,41460,0,53460
143423100700000,SW 412,Residential,12000,46401,0,58401
143423100800000,SW 412,Residential,12000,0,0,12000
143423100900000,SW 412,Residential,5000,0,0,5000
143423101000000,SW 412,Residential,6000,0,0,6000
143423101100000,SW 412,Residential,5000,0,0,5000
143423101200000,COMM SW,Commercial,8991,0,7926,16917
143423101300000,SW 412,Residential,15200,0,0,15200
143423101400000,SW 412,Residential,15000,62824,0,77824
143423101500000,SW 412,Residential,15000,52243,0,67243
143423101600000,SW 412,Residential,15000,0,0,15000
143423101700000,SW 412,Residential,10000,0,0,10000
143423101800000,SW 412,Residential,15000,47933,0,62933
143423101900000,SW 412,Residential,15000,40244,0,55244
143423102000000,SW 412,Residential,15000,37257,0,52257
143423200100000,SW 412,Residential,17000,92618,0,109618
143423200200000,SW 412,Residential,17000,51717,0,68717
143423200300000,SW 412,Residential,10000,0,0,10000
143423200400000,SW 412,Residential,17000,68567,0,85567
143423200500000,SW 412,Residential,19420,51882,0,71302
143423200600000,SW 412,Residential,19420,24054,0,43474
143423200700000,SW 412,Residential,16830,57131,0,73961
143425100100000,E-30 CEMETARY,Exempt,0,0,0,0
143425100200000,Empty,Exempt,0,0,0,0
143425100300000,APTS SW,Commercial,30482,0,204658,235140
143425100400000,APTS SW,Commercial,26013,0,93355,119368
143425100500000,APTS SW,Commercial,26013,0,93164,119177
143425100600000,E-70 CHARITY OTHER,Exempt,33137,0,195688,228825
143425100700000,APTS SW,Commercial,32584,0,310192,342776
143425100800000,APTS SW,Commercial,27474,0,90503,117977
143425100900000,APTS SW,Commercial,27474,0,91646,119120
143425101000000,APTS SW,Commercial,25511,0,207773,233284
143425101100000,APTS SW,Commercial,45332,0,210257,255589
143425101200000,APTS SW,Commercial,35117,0,203116,238233
143425101300000,APTS SW,Commercial,34873,0,320830,355703
143425101400000,APTS SW,Commercial,40350,0,328765,369115
143425101500000,Empty,Exempt,0,0,0,0
143427600100000,APTS SW,Commercial,502200,0,4282503,4784703
143427600200000,SW 410,Residential,30064,120067,0,150131
143427600300000,SW 410,Residential,29400,117418,0,146818
143427600400000,APTS SW,Commercial,26547,0,184248,210795
143427600500000,APTS SW,Commercial,35844,0,201995,237839
143427600600000,COMM SW,Commercial,36504,0,0,36504
143427600700000,E-73 LOW RENT HOUSE,Exempt,56106,0,1054255,1110361
143427600800000,APTS SW,Commercial,19116,0,165186,184302
143427600900000,APTS SW,Commercial,28943,0,161383,190326
143427601000000,APTS SW,Commercial,15186,0,165606,180792
143427700100000,SW 410,Residential,36993,70949,0,107942
143427800100000,SW 410,Residential,15714,39162,0,54876
143427800200000,SW 410,Residential,31827,0,0,31827
143427800300000,SW 410,Residential,30179,110199,0,140378
143427800400000,SW 410,Residential,28280,89059,0,117339
143427800500000,SW 430,Residential,37440,97401,0,134841
143427800600000,SW 430,Residential,37125,104251,0,141376
143427800700000,SW 430,Residential,33787,99367,0,133154
143427800800000,SW 430,Residential,35030,101653,0,136683
143427800900000,SW 430,Residential,35030,105257,0,140287
143427801000000,SW 430,Residential,35030,100285,0,135315
143427801100000,SW 430,Residential,35030,83970,0,119000
143427801200000,SW 430,Residential,30070,90314,0,120384
143427801300000,SW 430,Residential,34726,101873,0,136599
143427801400000,SW 430,Residential,30742,82819,0,113561
143427801500000,SW 410,Residential,33512,77101,0,110613
143427801600000,SW 410,Residential,19975,65366,0,85341
143427801700000,SW 410,Residential,31987,62957,0,94944
143427801800000,SW 410,Residential,18400,72641,0,91041
143427801900000,SW 410,Residential,18400,44571,0,62971
143427802000000,SW 410,Residential,15640,0,0,15640
143427900100000,SW 430,Residential,38697,82946,0,121643
143427900200000,SW 430,Residential,30133,80508,0,110641
143427900300000,SW 430,Residential,29848,111175,0,141023
143427900400000,SW 430,Residential,33280,82962,0,116242
143427900500000,SW 430,Residential,33810,106816,0,140626
143427900600000,SW 430,Residential,35112,79965,0,115077
143427900700000,SW 430,Residential,31000,86871,0,117871
143427900800000,SW 430,Residential,31000,104827,0,135827
143427900900000,SW 430,Residential,31000,86747,0,117747
143427901000000,SW 430,Residential,31000,93069,0,124069
143427901100000,SW 430,Residential,31000,84756,0,115756
143427901200000,SW 430,Residential,31000,90607,0,121607
143427901300000,SW 430,Residential,31000,86941,0,117941
143427901400000,SW 430,Residential,31000,91633,0,122633
143427901500000,SW 430,Residential,31000,98740,0,129740
143427901600000,SW 430,Residential,31000,106502,0,137502
143427901700000,SW 430,Residential,35833,96224,0,132057
143427901800000,SW 430,Residential,34667,91190,0,125857
143427901900000,SW 430,Residential,31000,89249,0,120249
143427902000000,SW 430,Residential,31000,76019,0,107019
143427902100000,SW 430,Residential,31000,91005,0,122005
143427902200000,SW 430,Residential,31000,97234,0,128234
143427902300000,SW 430,Residential,31000,92244,0,123244
143427902400000,SW 430,Residential,31000,93092,0,124092
143427902500000,SW 430,Residential,36192,94950,0,131142
143427902600000,SW 430,Residential,36023,79149,0,115172
143427902700000,SW 430,Residential,33330,79743,0,113073
143428000100000,SW 430,Residential,27963,98015,0,125978
143428000200000,SW 430,Residential,28340,91433,0,119773
143428000300000,SW 430,Residential,33600,107208,0,140808
143428000400000,SW 430,Residential,30896,78402,0,109298
143428000500000,SW 430,Residential,33920,84488,0,118408
143428000600000,SW 430,Residential,30855,83113,0,113968
143428000700000,SW 430,Residential,28827,87019,0,115846
143428000800000,SW 430,Residential,29140,102757,0,131897
143428000900000,SW 430,Residential,29140,80387,0,109527
143428001000000,SW 430,Residential,29140,86400,0,115540
143428001100000,SW 430,Residential,29140,115468,0,144608
143428001200000,SW 430,Residential,29140,93029,0,122169
143428001300000,SW 430,Residential,29140,89761,0,118901
143428001400000,SW 430,Residential,29140,89224,0,118364
143428001500000,SW 430,Residential,29140,83420,0,112560
143428001600000,SW 430,Residential,29140,75600,0,104740
143428001700000,SW 430,Residential,29140,83042,0,112182
143428001800000,SW 430,Residential,32649,108624,0,141273
143430100100000,SW 410,Residential,26740,49070,0,75810
143430100200000,SW 410,Residential,22600,91830,0,114430
143430100300000,SW 410,Residential,22600,60765,0,83365
143430100400000,SW 410,Residential,20000,79674,0,99674
143430100500000,SW 410,Residential,19797,100965,0,120762
143430100600000,SW 410,Residential,19797,45977,0,65774
143430100700000,SW 410,Residential,25600,121767,0,147367
143430100800000,SW 410,Residential,24000,44000,0,68000
143430100900000,SW 410,Residential,24000,51970,0,75970
143430101000000,SW 410,Residential,24000,3870,0,27870
143430101100000,SW 410,Residential,24000,89698,0,113698
143430101200000,SW 410,Residential,24000,79202,0,103202
143430101300000,SW 410,Residential,24000,43247,0,67247
143430101400000,SW 410,Residential,24000,55948,0,79948
143430101500000,SW 410,Residential,24000,29008,0,53008
143430101600000,SW 410,Residential,24000,52004,0,76004
143430101700000,SW 410,Residential,24000,39457,0,63457
143430101800000,SW 410,Residential,24000,54373,0,78373
143430101900000,SW 410,Residential,24000,88652,0,112652
143430102000000,SW 410,Residential,24000,87491,0,111491
143430102100000,SW 410,Residential,24000,66245,0,90245
143430102200000,SW 410,Residential,24000,90855,0,114855
143430102300000,SW 410,Residential,24000,68923,0,92923
143430102400000,SW 410,Residential,24000,57011,0,81011
143430102500000,SW 410,Residential,24000,53227,0,77227
143430102600000,SW 410,Residential,24000,42247,0,66247
143430102700000,SW 410,Residential,24000,17961,0,41961
143430102800000,SW 410,Residential,23800,45045,0,68845
143430200100000,SW 410,Residential,25608,0,0,25608
143430200200000,SW 410,Residential,22800,75267,0,98067
143430200300000,SW 410,Residential,29184,47499,0,76683
143430200400000,SW 410,Residential,27132,88805,0,115937
143430200500000,SW 410,Residential,22800,77329,0,100129
143430200600000,SW 430,Residential,27350,66728,0,94078
143430200700000,SW 430,Residential,24024,84191,0,108215
143430200800000,SW 430,Residential,30600,89905,0,120505
143430200900000,SW 430,Residential,30600,75388,0,105988
143430201000000,SW 430,Residential,30600,74970,0,105570
143430201100000,SW 430,Residential,30600,91648,0,122248
143430201200000,SW 430,Residential,30600,73971,0,104571
143430201300000,SW 430,Residential,30600,83893,0,114493
143430201400000,SW 430,Residential,30600,76646,0,107246
143430201500000,SW 430,Residential,30600,98187,0,128787
143430201600000,SW 430,Residential,30600,99762,0,130362
143430201700000,SW 430,Residential,33150,98897,0,132047
143430201800000,SW 430,Residential,30600,74730,0,105330
143430201900000,SW 430,Residential,33660,79490,0,113150
143430202000000,SW 430,Residential,30090,98407,0,128497
143430202100000,SW 430,Residential,31875,80533,0,112408
143430202200000,SW 430,Residential,31875,84797,0,116672
143430202300000,SW 430,Residential,32555,98217,0,130772
143430202400000,SW 430,Residential,32462,82450,0,114912
143430202500000,SW 430,Residential,35842,75075,0,110917
143430202600000,SW 430,Residential,38881,78212,0,117093
143430202700000,SW 410,Residential,24000,76259,0,100259
143430202800000,SW 410,Residential,36000,36918,0,72918
143430202900000,SW 410,Residential,24000,31201,0,55201
143430203000000,SW 410,Residential,24000,101408,0,125408
143430203100000,SW 410,Residential,24000,59193,0,83193
143430203200000,SW 410,Residential,24000,90897,0,114897
143430203300000,SW 410,Residential,24000,115041,0,139041
143430203400000,SW 410,Residential,24000,68285,0,92285
143430203500000,SW 410,Residential,24000,106416,0,130416
143430203600000,SW 410,Residential,24000,54121,0,78121
143430203700000,SW 410,Residential,24000,49156,0,73156
143430203800000,SW 410,Residential,24000,45842,0,69842
143430203900000,SW 410,Residential,24000,116438,0,140438
143430204000000,SW 410,Residential,24000,47782,0,71782
143430204100000,SW 410,Residential,24000,57912,0,81912
143430204200000,SW 410,Residential,24000,71596,0,95596
143430204300000,SW 410,Residential,24000,41487,0,65487
143430204400000,SW 410,Residential,24000,68160,0,92160
143430204500000,SW 410,Residential,24000,87920,0,111920
143430204600000,SW 410,Residential,24000,45271,0,69271
143430204700000,SW 410,Residential,15200,42354,0,57554
143430204800000,SW 410,Residential,15200,45267,0,60467
143430300100000,SW 430,Residential,24024,108885,0,132909
143430300200000,SW 430,Residential,24000,76187,0,100187
143430300300000,SW 430,Residential,24000,76857,0,100857
143430300400000,SW 430,Residential,23733,91774,0,115507
143430300500000,SW 430,Residential,30000,89705,0,119705
143430300600000,SW 430,Residential,30000,79164,0,109164
143430300700000,SW 430,Residential,30000,72562,0,102562
143430300800000,SW 430,Residential,30000,81787,0,111787
143430300900000,SW 430,Residential,30000,108710,0,138710
143430301000000,SW 430,Residential,30000,87252,0,117252
143430301100000,SW 430,Residential,30000,101308,0,131308
143430301200000,SW 430,Residential,30000,87732,0,117732
143430301300000,SW 430,Residential,30000,84455,0,114455
143430301400000,SW 430,Residential,31250,86810,0,118060
143430301500000,SW 430,Residential,31250,80120,0,111370
143430301600000,SW 430,Residential,32400,82399,0,114799
143430301700000,SW 430,Residential,26500,99341,0,125841
143430301800000,SW 430,Residential,31250,90619,0,121869
143430301900000,SW 430,Residential,31250,103321,0,134571
143430302000000,SW 430,Residential,31875,72435,0,104310
143430302100000,SW 430,Residential,32400,103134,0,135534
143430302200000,SW 430,Residential,33488,125396,0,158884
143430302300000,SW 430,Residential,31650,77580,0,109230
143430302400000,SW 430,Residential,32500,77999,0,110499
143430302500000,SW 430,Residential,30000,106050,0,136050
143430302600000,SW 430,Residential,31250,93834,0,125084
143430302700000,SW 430,Residential,31250,82631,0,113881
143430302800000,SW 430,Residential,28500,105314,0,133814
143430302900000,SW 430,Residential,34000,73573,0,107573
143430303000000,SW 430,Residential,30000,89480,0,119480
143430303100000,SW 430,Residential,30000,77431,0,107431
143430303200000,SW 430,Residential,30000,84851,0,114851
143430303300000,SW 430,Residential,30000,88629,0,118629
143430303400000,SW 430,Residential,30000,83215,0,113215
143430303500000,SW 430,Residential,30000,78191,0,108191
143430303600000,SW 430,Residential,30000,86838,0,116838
143430303700000,SW 430,Residential,30000,71976,0,101976
143430303800000,SW 430,Residential,30000,85110,0,115110
143430400100000,SW 430,Residential,24267,82555,0,106822
143430400200000,SW 430,Residential,23971,74224,0,98195
143430400300000,SW 430,Residential,30000,76098,0,106098
143430400400000,SW 430,Residential,30000,77789,0,107789
143430400500000,SW 430,Residential,30000,80882,0,110882
143430400600000,SW 430,Residential,30000,77650,0,107650
143430400700000,SW 430,Residential,30000,121562,0,151562
143430400800000,SW 430,Residential,33250,150118,0,183368
143430400900000,SW 430,Residential,25000,83846,0,108846
143430401000000,SW 430,Residential,30000,85370,0,115370
143430401100000,SW 430,Residential,30000,77275,0,107275
143430401200000,SW 430,Residential,33250,114569,0,147819
143430401300000,SW 430,Residential,27500,126483,0,153983
143430401400000,SW 430,Residential,31250,83727,0,114977
143430401500000,SW 430,Residential,31250,97813,0,129063
143430401600000,SW 430,Residential,37500,103377,0,140877
143430401700000,SW 430,Residential,37700,116460,0,154160
143430401800000,SW 430,Residential,33036,80260,0,113296
143430401900000,SW 430,Residential,41220,84115,0,125335
143432600100000,Empty,Exempt,0,0,0,0
143432600200000,SW 414,Residential,21800,52867,0,74667
143432600300000,SW 414,Residential,38016,88100,0,126116
143432600400000,SW 414,Residential,28904,86145,0,115049
143432600500000,SW 414,Residential,29952,82975,0,112927
143432600600000,SW 414,Residential,29952,76489,0,106441
143432600700000,SW 414,Residential,29952,74574,0,104526
143432600800000,SW 414,Residential,29952,78754,0,108706
143432600900000,SW 414,Residential,29952,100444,0,130396
143432601000000,SW 414,Residential,29952,101076,0,131028
143432601100000,SW 414,Residential,29952,85813,0,115765
143432601200000,SW 414,Residential,29952,92603,0,122555
143432601300000,SW 414,Residential,29952,80017,0,109969
143432601400000,SW 414,Residential,29952,85445,0,115397
143432601500000,SW 414,Residential,33696,95798,0,129494
143432601600000,SW 414,Residential,29952,108888,0,138840
143432601700000,SW 414,Residential,34632,116775,0,151407
143432601800000,SW 414,Residential,35100,95450,0,130550
143432601900000,SW 414,Residential,27540,91029,0,118569
143432602000000,SW 414,Residential,35024,111414,0,146438
143432700100000,SW 414,Residential,25440,75936,0,101376
143432700200000,SW 414,Residential,31800,75459,0,107259
143432700300000,SW 414,Residential,36338,94380,0,130718
143432700400000,SW 414,Residential,38632,88649,0,127281
143432700500000,SW 414,Residential,35872,85461,0,121333
143432700600000,SW 414,Residential,25534,106453,0,131987
143432700700000,SW 414,Residential,32414,81131,0,113545
143432700800000,SW 414,Residential,25534,103148,0,128682
143432700900000,SW 414,Residential,33957,102995,0,136952
143432701000000,SW 414,Residential,33516,83740,0,117256
143432701100000,SW 414,Residential,32414,101449,0,133863
143432701200000,SW 414,Residential,26460,78142,0,104602
143432701300000,SW 414,Residential,32414,80053,0,112467
143432701400000,SW 414,Residential,26460,76809,0,103269
143432701500000,SW 414,Residential,26901,76819,0,103720
143432701600000,SW 414,Residential,28621,94873,0,123494
143432701700000,SW 414,Residential,30870,99823,0,130693
143432701800000,SW 414,Residential,24802,91059,0,115861
143432701900000,SW 414,Residential,29693,83708,0,113401
143432702000000,SW 414,Residential,34632,90204,0,124836
143432702100000,SW 414,Residential,29952,94540,0,124492
143432702200000,SW 414,Residential,33696,96588,0,130284
143432702300000,SW 414,Residential,31356,82778,0,114134
143432702400000,SW 414,Residential,29952,83901,0,113853
143432702500000,SW 414,Residential,29484,85429,0,114913
143432702600000,SW 414,Residential,29484,74050,0,103534
143432702700000,SW 414,Residential,29016,66193,0,95209
143432702800000,SW 414,Residential,29952,71042,0,100994
143432702900000,SW 414,Residential,29484,97641,0,127125
143432703000000,SW 414,Residential,29484,84559,0,114043
143432703100000,SW 414,Residential,29484,76702,0,106186
143432703200000,SW 414,Residential,29484,71891,0,101375
143432703300000,SW 414,Residential,29716,79028,0,108744
143432800100000,COMM SW,Commercial,90898,0,82786,173684
143432800200000,SW 414,Residential,37373,90486,0,127859
143432800300000,SW 414,Residential,28329,79254,0,107583
143432800400000,SW 414,Residential,27063,76203,0,103266
143432800500000,SW 414,Residential,33611,103513,0,137124
143432800600000,SW 414,Residential,32083,92910,0,124993
143432800700000,SW 414,Residential,31865,91638,0,123503
143432800800000,SW 414,Residential,30992,80799,0,111791
143432800900000,SW 414,Residential,32083,110985,0,143068
143432801000000,SW 414,Residential,27281,70991,0,98272
143432801100000,SW 414,Residential,28329,81358,0,109687
143432801200000,SW 414,Residential,26627,75925,0,102552
143432801300000,SW 414,Residential,28071,108673,0,136744
143432801400000,SW 414,Residential,28329,78712,0,107041
143432801500000,SW 414,Residential,26161,95761,0,121922
143432900100000,SW 414,Residential,32489,79351,0,111840
143432900200000,SW 414,Residential,30906,86810,0,117716
143432900300000,SW 414,Residential,33727,117409,0,151136
143432900400000,SW 414,Residential,26169,116918,0,143087
143432900500000,SW 414,Residential,26864,123869,0,150733
143432900600000,SW 414,Residential,38193,114148,0,152341
143435100100000,SW 414,Residential,27833,75423,0,103256
143435100200000,SW 414,Residential,28350,79123,0,107473
143435100300000,SW 414,Residential,28350,81977,0,110327
143435100400000,SW 414,Residential,28350,94321,0,122671
143435100500000,SW 414,Residential,27900,92681,0,120581
143435100600000,SW 414,Residential,27900,90483,0,118383
143435100700000,SW 414,Residential,36000,110261,0,146261
143435100800000,SW 414,Residential,31019,140886,0,171905
143435100900000,SW 414,Residential,30600,139023,0,169623
143435101000000,SW 414,Residential,36000,100961,0,136961
143435101100000,SW 414,Residential,29250,116177,0,145427
143435101200000,SW 414,Residential,36000,115686,0,151686
143435101300000,SW 414,Residential,36000,87758,0,123758
143435101400000,SW 414,Residential,36000,97692,0,133692
143435101500000,SW 414,Residential,36000,113893,0,149893
143435101600000,SW 414,Residential,36000,115237,0,151237
143435101700000,SW 414,Residential,36000,94951,0,130951
143435101800000,SW 414,Residential,36320,99610,0,135930
143435200100000,SW 414,Residential,28590,81492,0,110082
143435200200000,SW 414,Residential,27000,72340,0,99340
143435200300000,SW 414,Residential,27000,74756,0,101756
143435200400000,SW 414,Residential,27000,68413,0,95413
143435200500000,SW 414,Residential,27000,78787,0,105787
143435200600000,SW 414,Residential,28800,87461,0,116261
143435200700000,SW 414,Residential,28203,70352,0,98555
143435300100000,SW 414,Residential,27517,80440,0,107957
143435300200000,SW 414,Residential,27281,74670,0,101951
143435300300000,SW 414,Residential,27281,78621,0,105902
143435300400000,SW 414,Residential,27046,78495,0,105541
143435300500000,SW 414,Residential,29600,86271,0,115871
143435300600000,SW 414,Residential,29088,96334,0,125422
143435300700000,SW 414,Residential,31815,103612,0,135427
143435300800000,SW 414,Residential,29088,74963,0,104051
143435300900000,SW 414,Residential,29088,85227,0,114315
143435301000000,SW 414,Residential,32769,88558,0,121327
143435301100000,SW 414,Residential,32421,84826,0,117247
143435301200000,SW 414,Residential,34749,120664,0,155413
143435301300000,SW 414,Residential,31428,94826,0,126254
143435301400000,SW 414,Residential,36660,116607,0,153267
143435301500000,SW 414,Residential,34200,142577,0,176777
143435301600000,SW 414,Residential,33696,89573,0,123269
143435301700000,SW 414,Residential,29988,101293,0,131281
143435301800000,SW 414,Residential,36157,98630,0,134787
143435301900000,SW 414,Residential,35451,99258,0,134709
143435302000000,SW 414,Residential,31212,100548,0,131760
143435302100000,SW 414,Residential,29376,87731,0,117107
143435302200000,SW 414,Residential,29376,84892,0,114268
143435302300000,SW 414,Residential,29376,103576,0,132952
143435302400000,SW 414,Residential,28743,93066,0,121809
143435400100000,SW 414,Residential,29126,78325,0,107451
143435400200000,SW 414,Residential,28800,96759,0,125559
143435400300000,SW 414,Residential,27000,78763,0,105763
143435400400000,SW 414,Residential,30600,76052,0,106652
143435400500000,SW 414,Residential,31500,79849,0,111349
143435400600000,SW 414,Residential,31500,81482,0,112982
143435400700000,SW 414,Residential,31185,92950,0,124135
143435400800000,SW 414,Residential,35491,95211,0,130702
143435400900000,SW 414,Residential,32076,80512,0,112588
143435401000000,SW 414,Residential,28665,85517,0,114182
143435401100000,SW 414,Residential,28080,99694,0,127774
143435401200000,SW 414,Residential,31773,92869,0,124642
143435401300000,SW 414,Residential,33412,105251,0,138663
143435401400000,SW 414,Residential,38587,92067,0,130654
143435401500000,SW 414,Residential,28849,100758,0,129607
143435401600000,SW 414,Residential,28800,102440,0,131240
143435401700000,SW 414,Residential,28553,132567,0,161120
143435401800000,SW 414,Residential,29831,84073,0,113904
143435401900000,SW 414,Residential,28800,91729,0,120529
143435402000000,SW 414,Residential,28800,78155,0,106955
143435402100000,SW 414,Residential,28800,96803,0,125603
143435402200000,SW 414,Residential,31551,99404,0,130955
143437600100000,SW 410,Residential,23800,126223,0,150023
143437600200000,SW 410,Residential,23800,69101,0,92901
143437600300000,SW 410,Residential,23800,53793,0,77593
143437600400000,SW 410,Residential,23800,70370,0,94170
143437600500000,SW 410,Residential,23800,128764,0,152564
143437600600000,SW 410,Residential,28560,37325,0,65885
143437600700000,SW 410,Residential,28560,80168,0,108728
143437600800000,SW 410,Residential,28560,51527,0,80087
143437600900000,SW 410,Residential,23800,66067,0,89867
143437601000000,SW 410,Residential,23800,56776,0,80576
143437601100000,SW 410,Residential,23800,83126,0,106926
143437601200000,SW 410,Residential,28560,50671,0,79231
143437601300000,SW 410,Residential,23800,47668,0,71468
143437601400000,SW 410,Residential,23800,64339,0,88139
143437601500000,SW 410,Residential,23800,41721,0,65521
143437601600000,SW 410,Residential,23800,76237,0,100037
143437601700000,SW 410,Residential,23800,43020,0,66820
143437601800000,SW 410,Residential,23800,106859,0,130659
143437601900000,SW 410,Residential,23800,130897,0,154697
143437602000000,SW 410,Residential,23800,58735,0,82535
143437602100000,SW 410,Residential,23800,137091,0,160891
143437602200000,Empty,Exempt,0,0,0,0
143437700100000,SW 410,Residential,23800,72265,0,96065
143437700200000,Empty,Exempt,0,0,0,0
143437700300000,SW 410,Residential,27799,72726,0,100525
143437700400000,SW 410,Residential,23800,92451,0,116251
143437700500000,SW 410,Residential,23800,40845,0,64645
143437700600000,SW 410,Residential,23800,54317,0,78117
143437700700000,SW 410,Residential,23800,56088,0,79888
143437700800000,SW 410,Residential,23800,0,0,23800
143437700900000,SW 410,Residential,28560,119671,0,148231
143437701000000,SW 410,Residential,28560,66436,0,94996
143437701100000,SW 410,Residential,23800,63058,0,86858
143437701200000,SW 410,Residential,28560,39563,0,68123
143437701300000,SW 410,Residential,28560,41785,0,70345
143437701400000,SW 410,Residential,23800,55728,0,79528
143437701500000,SW 410,Residential,23800,41118,0,64918
143437701600000,SW 410,Residential,23800,68585,0,92385
143437701700000,SW 410,Residential,23800,66692,0,90492
143437701800000,SW 410,Residential,23800,101353,0,125153
143437701900000,SW 410,Residential,23800,64887,0,88687
143437702000000,SW 410,Residential,23800,76568,0,100368
143437702100000,SW 410,Residential,23800,69124,0,92924
143437702200000,SW 410,Residential,23800,79209,0,103009
143437702300000,SW 410,Residential,23800,76649,0,100449
143440100100000,Empty,Exempt,0,0,0,0
143440200100000,SW 411,Residential,53125,70537,0,123662
143440300100000,SW 411,Residential,5000,787,0,5787
143440300200000,SW 411,Residential,11750,0,0,11750
143442600100000,SW 411,Residential,34158,57842,0,92000
143442600200000,SW 411,Residential,33495,8394,0,41889
143442600300000,SW 411,Residential,33495,79888,0,113383
143442600400000,SW 411,Residential,33495,62057,0,95552
143442600500000,SW 411,Residential,33495,50326,0,83821
143442600600000,SW 411,Residential,33495,77785,0,111280
143442600700000,E-70 CHARITY OTHER,Exempt,27000,0,0,27000
143442600800000,E-70 CHARITY OTHER,Exempt,35284,0,111007,146291
143442600900000,SW 411,Exempt,33495,96894,0,130389
143442601000000,E-70 CHARITY OTHER,Exempt,54000,0,0,54000
143442601100000,E-70 CHARITY OTHER,Exempt,49302,0,350,49652
143442601200000,E-70 CHARITY OTHER,Exempt,27815,0,0,27815
143442601300000,E-70 CHARITY OTHER,Exempt,24057,0,0,24057
143442700300000,SW 431,Residential,34794,141899,0,176693
143442700400000,SW 431,Residential,32640,139434,0,172074
143442700500000,SW 431,Residential,28000,134000,0,162000
143442700600000,SW 431,Residential,29557,132322,0,161879
143442700700000,SW 431,Residential,31243,149429,0,180672
143442700800000,SW 431,Residential,29436,166764,0,196200
143442700900000,SW 411,Residential,41752,64627,0,106379
143442701000000,SW 411,Residential,26000,0,0,26000
143442701100000,SW 431,Residential,28563,142720,0,171283
143442701200000,SW 431,Residential,25716,0,0,25716
143442701300000,SW 411,Residential,50000,0,0,50000
143442701400000,SW 411,Residential,45800,116243,0,162043
143442800100000,SW 411,Residential,20790,85713,0,106503
143442800200000,SW 411,Residential,20790,0,0,20790
143442800300000,SW 411,Residential,20790,0,0,20790
143442800400000,SW 411,Residential,27720,84264,0,111984
143442800500000,SW 411,Residential,27720,91750,0,119470
143442800600000,SW 411,Residential,27720,90932,0,118652
143442800700000,SW 411,Residential,28298,79154,0,107452
143442800800000,SW 411,Residential,31474,139838,0,171312
143442800900000,SW 411,Residential,26775,136765,0,163540
143442801000000,SW 411,Residential,33916,123007,0,156923
143442801100000,SW 411,Residential,32680,133345,0,166025
143442801200000,SW 411,Residential,26136,44919,0,71055
143442801300000,SW 411,Residential,27143,122828,0,149971
143442801400000,SW 411,Residential,27720,104685,0,132405
143442801500000,SW 411,Residential,27720,91048,0,118768
143442801600000,SW 411,Residential,27720,97549,0,125269
143442801700000,SW 411,Residential,37422,39619,0,77041
143442900100000,SW 411,Residential,33495,160207,0,193702
143442900200000,SW 411,Residential,33495,160448,0,193943
143442900300000,SW 411,Residential,33495,132438,0,165933
143442900400000,SW 411,Residential,35496,83565,0,119061
143442900500000,SW 411,Residential,38592,93346,0,131938
143442900600000,SW 411,Residential,53750,216337,0,270087
143442900700000,SW 411,Residential,45075,80055,0,125130
143442900800000,SW 411,Residential,33495,101819,0,135314
143443000100000,SW 411,Residential,22176,49271,0,71447
143443000200000,SW 411,Residential,24552,46040,0,70592
143443000300000,SW 411,Residential,47425,64651,0,112076
143443000500000,SW 411,Residential,24000,0,0,24000
143443000600000,SW 411,Residential,25000,0,0,25000
143443000700000,SW 411,Residential,25000,0,0,25000
143443000800000,SW 411,Residential,29952,170048,0,200000
143443000900000,SW 431,Residential,29224,115079,0,144303
143443001000000,SW 431,Residential,33040,145477,0,178517
143443001100000,SW 431,Residential,31640,135815,0,167455
143443001200000,SW 431,Residential,29120,126960,0,156080
143443001300000,SW 431,Residential,35468,199711,0,235179
143443001400000,SW 431,Residential,37484,186941,0,224425
143443001500000,SW 412,Residential,32992,53223,0,86215
143443001700000,SW 431,Residential,28630,140913,0,169543
143443001800000,SW 431,Residential,32934,179325,0,212259
143445100100000,SW 411,Residential,42591,77897,0,120488
143445100300000,Empty,Exempt,0,0,0,0
143445100400000,SW 411,Residential,59250,170298,0,229548
143445100500000,SW 411,Residential,45900,85112,0,131012
143445100700000,SW 431,Residential,31214,156550,0,187764
143445100800000,SW 431,Residential,30600,159250,0,189850
143445101100000,SW 431,Residential,3612,0,0,3612
143445101200000,SW 431,Residential,38420,183037,0,221457
143445101300000,SW 431,Residential,43430,0,0,43430
143445101400000,SW 431,Residential,57304,261363,0,318667
143445101500000,SW 431,Residential,42784,0,0,42784
143445101600000,SW 431,Exempt,0,0,0,0
143445101700000,SW 431,Residential,28480,0,0,28480
143445101800000,SW 431,Residential,29760,0,0,29760
143445200100000,SW 431,Residential,25760,150086,0,175846
143445200200000,SW 431,Residential,33651,152785,0,186436
143445200300000,SW 431,Residential,35968,0,0,35968
143445200400000,SW 431,Residential,20788,0,0,20788
143445200500000,SW 431,Residential,29440,168094,0,197534
143447600100000,SW 411,Residential,47750,68085,0,115835
143447600200000,SW 411,Residential,46875,32542,0,79417
143447600300000,SW 411,Residential,49775,17901,0,67676
143510100100000,SE 239,Residential,48000,170000,0,218000
143510100200000,SE 239,Residential,86600,114414,0,201014
143510100300000,SE 239,Residential,20,0,0,20
143510100400000,Empty,Exempt,0,0,0,0
143510100500000,SE 239,Residential,45500,94155,0,139655
143510100600000,SE 239,Residential,47980,78678,0,126658
143512600100000,SE 239,Residential,83100,56813,0,139913
143515100100000,SE 239,Ag Dwelling,20727,133985,3988,158700
143515100200000,SE 239,Residential,24476,73641,0,98117
143515100300000,SE 239,Residential,30625,133501,0,164126
143515100400000,SE 239,Residential,11010,0,0,11010
143515100500000,SE 239,Residential,44475,121580,0,166055
143517600100000,SE 239,Ag Land,19074,0,0,19074
143520100100000,SE 242,Residential,55760,622,0,56382
143520100200000,SE 242,Ag Land,11018,0,0,11018
143520100300000,SE 242,Residential,21000,61560,0,82560
143520200100000,SE 242,Residential,35496,98511,0,134007
143520200200000,Empty,Exempt,0,0,0,0
143520200400000,SE 242,Residential,24453,91736,0,116189
143520200500000,SE 242,Residential,9487,81774,0,91261
143520200600000,SE 242,Residential,21091,0,0,21091
143520200700000,SE 242,Residential,35632,92447,0,128079
143520200800000,SE 242,Residential,37500,80515,0,118015
143520200900000,SE 242,Residential,5025,0,0,5025
143520201000000,SE 242,Residential,42425,206636,0,249061
143520201100000,SE 242,Residential,31977,43513,0,75490
143520201200000,SE 242,Residential,36924,178794,0,215718
143520201300000,SE 242,Residential,39513,150234,0,189747
143520201400000,SE 242,Residential,18693,0,0,18693
143520201500000,SE 242,Residential,18693,144549,0,163242
143520201600000,SE 242,Residential,26705,191274,0,217979
143522600100000,SE 242,Residential,23000,139353,0,162353
143522600200000,SE 242,Residential,23000,81283,0,104283
143522600300000,SE 242,Residential,25875,152998,0,178873
143522600400000,SE 242,Residential,26860,91285,0,118145
143522600500000,SE 242,Residential,23426,177863,0,201289
143522600600000,SE 242,Residential,15680,104320,0,120000
143522600700000,SE 242,Residential,20052,77081,0,97133
143522600800000,SE 242,Residential,13860,95747,0,109607
143522700100000,SE 242,Residential,12980,127309,0,140289
143522700200000,SE 242,Residential,19470,79052,0,98522
143522700300000,SE 242,Residential,19470,0,0,19470
143522700400000,SE 242,Residential,23364,63133,0,86497
143522700500000,SE 242,Residential,12980,3504,0,16484
143522800100000,SE 242,Residential,28500,40821,0,69321
143522800200000,SE 242,Residential,7750,0,0,7750
143522800300000,SE 242,Residential,17142,47858,0,65000
143522800400000,SE 242,Residential,26904,123692,0,150596
143522800500000,SE 242,Residential,26550,143450,0,170000
143522800600000,SE 242,Residential,17700,0,0,17700
143522800900000,SE 242,Residential,29628,188112,0,217740
143522801000000,SE 242,Residential,29250,203996,0,233246
143522801100000,SE 242,Residential,28500,178160,0,206660
143522801200000,SE 242,Residential,28500,118742,0,147242
143522801300000,SE 242,Residential,44250,195741,0,239991
143522900100000,SE 242,Residential,27568,57877,0,85445
143522900200000,SE 242,Residential,13712,0,0,13712
143522900300000,SE 242,Residential,4460,1846,0,6306
143522900400000,SE 242,Residential,9086,62151,0,71237
143522900500000,SE 242,Residential,12980,144350,0,157330
143522900600000,SE 242,Residential,27472,120947,0,148419
143522900700000,SE 242,Residential,2900,3114,0,6014
143522900800000,SE 242,Residential,20944,127874,0,148818
143522900900000,SE 242,Residential,22517,57184,0,79701
143522901000000,SE 242,Residential,22738,1887,0,24625
143522901100000,SE 242,Residential,11700,96771,0,108471
143522901200000,SE 242,Residential,11700,125225,0,136925
143522901300000,SE 242,Residential,17708,0,0,17708
143522901400000,SE 242,Residential,13024,134752,0,147776
143522901500000,SE 242,Residential,14040,141633,0,155673
143525100100000,SE 242,Residential,12870,0,0,12870
143525100200000,SE 242,Residential,14610,91864,0,106474
143525100300000,SE 242,Residential,10500,89640,0,100140
143525100400000,SE 242,Residential,10500,89692,0,100192
143525200100000,SE 242,Residential,19997,83003,0,103000
143525300100000,SE 242,Residential,9000,28415,0,37415
143525400100000,SE 242,Residential,33925,153788,0,187713
143525400200000,SE 242,Ag Dwelling,20779,32779,994,54552
143525400300000,SE 242,Ag Land,8818,0,0,8818
143525400400000,SE 242,Residential,3982,0,0,3982
143525400500000,SE 242,Residential,5376,85679,0,91055
143525400600000,SE 242,Residential,5974,1649,0,7623
143525401000000,SE 242,Residential,8850,88848,0,97698
143525401100000,SE 242,Residential,8850,57958,0,66808
143525401200000,SE 242,Residential,8850,67071,0,75921
143525401300000,SE 242,Residential,8850,53305,0,62155
143525401400000,SE 242,Residential,13748,0,0,13748
143525401500000,COMM SE,Commercial,1798,0,0,1798
143525401600000,SE 242,Residential,13275,83966,0,97241
143527600100000,SE 242,Ag Land,3050,0,0,3050
143527600200000,SE 242,Ag Land,6723,0,0,6723
143527700100000,SE 242,Residential,14926,130736,0,145662
143527700200000,SE 242,Residential,23600,182067,0,205667
143527700300000,SE 242,Residential,20800,108705,0,129505
143527700400000,SE 242,Residential,21800,46435,0,68235
143527700500000,SE 242,Residential,13560,78352,0,91912
143527700600000,SE 242,Residential,13920,0,0,13920
143527700700000,SE 242,Residential,30200,216976,0,247176
143527700800000,SE 242,Residential,31025,151178,0,182203
143527700900000,SE 242,Residential,31625,142691,0,174316
143527701000000,SE 242,Residential,15262,0,0,15262
143527701100000,Empty,Exempt,0,0,0,0
143527701200000,SE 242,Residential,10620,66740,0,77360
143527701300000,SE 242,Residential,8850,0,0,8850
143527701400000,SE 242,Residential,8606,106454,0,115060
143527701500000,SE 242,Residential,9720,118697,0,128417
143527701600000,SE 242,Residential,19440,33605,0,53045
143527701700000,SE 242,Residential,10737,87561,0,98298
143527701800000,SE 242,Residential,21060,74154,0,95214
143527701900000,SE 242,Residential,9990,89158,0,99148
143527702000000,SE 242,Residential,16050,45597,0,61647
143530100100000,SE 242,Residential,21999,92413,0,114412
143530100200000,SE 242,Residential,15930,113920,0,129850
143530100300000,SE 242,Residential,9270,68991,0,78261
143530100400000,SE 242,Residential,8820,87924,0,96744
143530100500000,SE 242,Residential,9103,58509,0,67612
143530100600000,SE 242,Residential,5000,4037,0,9037
143530100700000,SE 242,Residential,5000,0,0,5000
143530100800000,SE 242,Residential,5505,60086,0,65591
143530100900000,SE 242,Residential,8518,9861,0,18379
143530200100000,SE 242,Residential,8950,73661,0,82611
143530200200000,SE 242,Residential,6184,55409,0,61593
143530200300000,SE 242,Residential,6184,45947,0,52131
143530200400000,SE 242,Residential,6184,43610,0,49794
143530200500000,SE 242,Residential,9562,0,0,9562
143530200600000,SE 242,Residential,7459,40413,0,47872
143530200700000,SE 242,Residential,7459,67068,0,74527
143530200800000,SE 242,Residential,7459,57333,0,64792
143530200900000,SE 242,Residential,6375,54118,0,60493
143530201000000,SE 242,Residential,1275,0,0,1275
143530201100000,SE 242,Residential,6375,56744,0,63119
143530201200000,SE 242,Residential,1275,0,0,1275
143530201300000,SE 242,Residential,6375,46844,0,53219
143530201400000,SE 242,Residential,1275,0,0,1275
143530201500000,SE 242,Residential,6375,47291,0,53666
143530201600000,SE 242,Residential,1275,0,0,1275
143530201700000,SE 242,Residential,6375,47593,0,53968
143530201800000,SE 242,Residential,1275,0,0,1275
143530201900000,SE 242,Residential,7020,0,0,7020
143530202100000,SE 242,Residential,5000,59039,0,64039
143530202200000,SE 242,Residential,5000,0,0,5000
143530202300000,SE 242,Residential,5000,0,0,5000
143530202400000,SE 242,Residential,5000,0,0,5000
143530202500000,SE 242,Residential,5000,0,0,5000
143530202600000,SE 242,Residential,5265,14244,0,19509
143530202700000,SE 242,Residential,7897,0,0,7897
143530202800000,SE 242,Residential,5000,0,0,5000
143530202900000,SE 242,Residential,5000,0,0,5000
143530203000000,SE 242,Residential,8950,18066,0,27016
143530203100000,SE 242,Residential,11188,74242,0,85430
143530203200000,SE 242,Residential,8950,55530,0,64480
143530203300000,SE 242,Residential,7459,40192,0,47651
143530203400000,SE 242,Residential,7459,27043,0,34502
143530203500000,SE 242,Residential,7459,58359,0,65818
143530203600000,SE 242,Residential,7459,67592,0,75051
143530300100000,SE 242,Residential,17442,0,0,17442
143530300300000,SE 242,Residential,5390,0,0,5390
143530300400000,SE 242,Residential,7267,0,0,7267
143530300500000,SE 242,Residential,7267,26246,0,33513
143530300600000,SE 242,Residential,5000,0,0,5000
143530300700000,SE 242,Residential,5000,0,0,5000
143530300800000,SE 242,Residential,5000,0,0,5000
143530300900000,SE 242,Residential,5000,0,0,5000
143530301000000,SE 242,Residential,5000,0,0,5000
143530301100000,SE 242,Residential,5000,0,0,5000
143530301200000,SE 242,Residential,5000,0,0,5000
143530301300000,SE 242,Residential,5000,0,0,5000
143530301400000,SE 242,Residential,5000,0,0,5000
143530301500000,SE 242,Residential,5000,0,0,5000
143530301600000,SE 242,Residential,5130,35031,0,40161
143530301700000,SE 242,Residential,5000,0,0,5000
143530301800000,SE 242,Residential,7695,0,0,7695
143530301900000,SE 242,Residential,5000,13951,0,18951
143530302000000,SE 242,Residential,7267,30538,0,37805
143530302100000,SE 242,Residential,7267,26507,0,33774
143530302200000,SE 242,Residential,5000,0,0,5000
143530302300000,SE 242,Residential,10901,0,0,10901
143530302400000,SE 242,Residential,10901,0,0,10901
143530400100000,SE 242,Residential,5000,30529,0,35529
143530400200000,SE 242,Residential,5000,0,0,5000
143530400300000,SE 242,Residential,5000,0,0,5000
143530400400000,SE 242,Residential,5000,8702,0,13702
143530400500000,SE 242,Residential,5085,30843,0,35928
143530400600000,SE 242,Residential,5085,36625,0,41710
143530400700000,SE 242,Residential,5000,33534,0,38534
143530400800000,SE 242,Residential,5000,0,0,5000
143530400900000,SE 242,Residential,5000,0,0,5000
143530401000000,SE 242,Residential,5000,0,0,5000
143530401100000,SE 242,Residential,5000,0,0,5000
143530401200000,SE 242,Residential,5000,0,0,5000
143530401300000,SE 242,Residential,5000,0,0,5000
143530401400000,SE 242,Residential,5599,49114,0,54713
143530401500000,SE 242,Residential,5000,0,0,5000
143532600100000,SE 242,Residential,7522,69896,0,77418
143532600200000,SE 242,Residential,7522,66524,0,74046
143532600300000,SE 242,Residential,5000,0,0,5000
143532600400000,SE 242,Residential,7522,46994,0,54516
143532600500000,SE 242,Residential,11283,74375,0,85658
143532600600000,SE 242,Residential,7522,31847,0,39369
143532600700000,SE 242,Residential,7522,0,0,7522
143532600800000,SE 242,Residential,7522,220,0,7742
143532600900000,SE 242,Residential,5000,0,0,5000
143532601000000,SE 242,Residential,5000,0,0,5000
143532601100000,SE 242,Residential,5000,0,0,5000
143532601200000,SE 242,Residential,5000,0,0,5000
143532700100000,COMM SE,Exempt,0,0,0,0
143532700200000,COMM SE,Exempt,0,0,0,0
143532700300000,Empty,Other,0,0,0,0
143535100100000,Empty,Exempt,0,0,0,0
143537700100000,COMM SE,Exempt,0,0,0,0
143540100100000,SE 242,Ag Dwelling,31595,96160,3650,131405
143540100200000,SE 242,Residential,37050,78298,0,115348
143540100300000,SE 242,Residential,22800,183296,0,206096
143540100400000,SE 242,Residential,1243,0,0,1243
143542600100000,SE 242,Ag Dwelling,11257,100016,0,111273
143542700100000,SE 242,Residential,45460,0,0,45460
143542700200000,SE 242,Residential,14232,81248,0,95480
143542700300000,SE 242,Residential,14216,121636,0,135852
143542700400000,SE 242,Residential,8362,63359,0,71721
143542700500000,SE 242,Residential,8362,49188,0,57550
143542700600000,SE 242,Residential,16775,0,0,16775
143542700800000,SE 242,Residential,19501,0,0,19501
143542700900000,SE 242,Residential,21800,76928,0,98728
143542701000000,SE 242,Residential,21800,143779,0,165579
143542701100000,SE 242,Residential,17440,0,0,17440
143542701200000,SE 242,Residential,12208,0,0,12208
143542701300000,SE 242,Residential,12208,109867,0,122075
143542701400000,SE 242,Residential,17440,102699,0,120139
143542701500000,SE 242,Residential,21840,62614,0,84454
143542701600000,SE 242,Residential,24619,0,0,24619
143542701700000,SE 242,Residential,20411,0,0,20411
143542701800000,SE 242,Residential,30500,82448,0,112948
143542701900000,SE 242,Residential,30000,303000,0,333000
143542702000000,SE 242,Residential,8849,0,0,8849
143542702100000,SE 242,Residential,15043,153291,0,168334
143542702200000,SE 242,Residential,14216,0,0,14216
143542702300000,SE 242,Residential,15618,155983,0,171601
143542702400000,SE 242,Residential,15752,109988,0,125740
143542702500000,SE 242,Residential,14216,0,0,14216
143542702600000,SE 242,Residential,8849,85486,0,94335
143542702700000,SE 242,Residential,8849,0,0,8849
143545100100000,Empty,Exempt,0,0,0,0
143545200100000,COMM SE,Exempt,0,0,0,0
143547600100000,SE 242,Ag Dwelling,31054,102265,1332,134651
143547700100000,SE 242,Exempt,0,0,0,0
143547700200000,Empty,Other,0,0,0,0
143640200100000,Empty,Exempt,0,0,0,0
143647600200000,COMM SW,Commercial,257796,0,35928,293724
143647600300000,COMM SW,Commercial,151200,0,0,151200
143647700100000,Empty,Exempt,0,0,0,0
151815100400000,SE 244,Residential,11030,0,0,11030
151815100500000,SE 244,Residential,11521,0,0,11521
151815100600000,SE 244,Residential,16507,0,0,16507
151815100700000,SE 244,Residential,13889,0,0,13889
151815100800000,SE 244,Residential,28787,0,0,28787
151815100900000,SE 244,Residential,121500,113205,0,234705
151822600900000,SE 244,Residential,444,0,0,444
151822601000000,SE 244,Residential,402,0,0,402
151822601100000,SE 244,Residential,102805,422195,0,525000
151822601200000,COMM SE,Commercial,64260,0,0,64260
151822601202000,COMM SE,Commercial,0,0,275395,275395
151822601300000,SE 244,Residential,479,0,0,479
151822601400000,SE 244,Residential,392,0,0,392
151822601500000,SE 244,Residential,390,0,0,390
151822601600000,SE 244,Residential,373,0,0,373
151822700100000,SE 244,Residential,359,0,0,359
151822700400000,SE 244,Residential,298,0,0,298
151822700500000,SE 244,Residential,80080,343894,0,423974
151822700600000,SE 244,Residential,82940,463622,0,546562
151822700700000,SE 244,Residential,81717,460930,0,542647
151822700800000,SE 244,Residential,81703,533556,0,615259
151822700900000,SE 244,Residential,78663,491120,0,569783
151822701000000,SE 244,Residential,168939,1052398,0,1221337
151825100500000,SE 244,Residential,333,0,0,333
151825100600000,SE 244,Residential,151850,522117,0,673967
151825100700000,SE 244,Residential,86487,493740,0,580227
151825100800000,SE 244,Residential,1260,0,0,1260
151827600200000,SE 244,Residential,112000,0,0,112000
151827600300000,SE 244,Residential,112000,423842,0,535842
151827600400000,SE 244,Residential,119200,0,0,119200
151827600500000,SE 244,Residential,98400,0,0,98400
151827600800000,SE 244,Residential,161250,0,0,161250
151827600900000,SE 205,Residential,128250,0,0,128250
151827601000000,SE 244,Residential,160000,692295,0,852295
151827601100000,SE 244,Residential,160000,107511,0,267511
151827601200000,SE 244,Residential,0,0,0,0
151827700100000,SE 244,Residential,120000,0,0,120000
151827700200000,SE 244,Residential,88000,0,0,88000
151827700300000,SE 244,Residential,108000,0,0,108000
151827700400000,SE 244,Residential,106200,546101,0,652301
151827700500000,SE 244,Residential,106200,0,0,106200
151827700600000,SE 244,Residential,108000,0,0,108000
151827700700000,SE 244,Residential,106200,585303,0,691503
151827700800000,SE 244,Residential,2705,0,0,2705
151827700900000,SE 244,Residential,5993,0,0,5993
151827701000000,SE 244,Residential,6291,0,0,6291
151827701100000,SE 244,Residential,5904,0,0,5904
151827800100000,SE 244,Residential,91000,443755,0,534755
151827800200000,SE 244,Residential,96000,0,0,96000
151827800300000,SE 244,Residential,96000,516267,0,612267
151827800400000,SE 244,Residential,96000,0,0,96000
151827800500000,SE 244,Residential,107200,0,0,107200
151827800600000,SE 244,Residential,182400,567600,0,750000
151827800800000,SE 244,Residential,168000,655000,0,823000
151827800900000,SE 244,Residential,120000,0,0,120000
151827900100000,SE 244,Residential,2456,0,0,2456
151827900200000,SE 244,Residential,2340,0,0,2340
151827900300000,SE 244,Residential,2258,0,0,2258
151827900400000,SE 244,Residential,2986,0,0,2986
151827900500000,SE 244,Residential,4323,0,0,4323
151830100300000,SE 205,Residential,7560,0,0,7560
151830100400000,SE 244,Residential,106200,0,0,106200
151830100500000,SE 244,Residential,106200,549675,0,655875
151830100600000,SE 244,Residential,106200,535379,0,641579
151830100700000,SE 244,Residential,124250,0,0,124250
151830100800000,SE 244,Residential,119700,664176,0,783876
151830100900000,SE 244,Residential,112500,450331,0,562831
151830101000000,SE 244,Residential,208800,872168,0,1080968
151830101100000,SE 244,Residential,121500,0,0,121500
151830101200000,SE 244,Residential,126000,0,0,126000
151830101300000,SE 244,Residential,94500,0,0,94500
151830101400000,SE 205,Residential,0,0,0,0
151830101500000,SE 244,Residential,190000,961536,0,1151536
151830101600000,SE 244,Residential,180000,916858,0,1096858
151830101700000,SE 244,Residential,10522,0,0,10522
151830101800000,SE 244,Residential,3599,0,0,3599
151830101900000,SE 244,Residential,155000,465426,0,620426
151830102000000,SE 244,Residential,9637,0,0,9637
151830102100000,SE 244,Residential,7897,0,0,7897
151830200100000,SE 244,Residential,156000,0,0,156000
151830200200000,SE 244,Residential,144000,681788,0,825788
151830200300000,SE 244,Residential,160000,618372,0,778372
151830200400000,SE 244,Residential,136800,0,0,136800
151830300100000,SE 244,Residential,68250,0,0,68250
151830300200000,SE 244,Residential,63000,0,0,63000
151830300300000,SE 244,Residential,76500,0,0,76500
151832600400000,SE 244,Residential,116800,0,0,116800
151832600500000,SE 244,Residential,112000,0,0,112000
151832600600000,SE 244,Residential,120000,0,0,120000
151832600700000,SE 244,Residential,106200,0,0,106200
151832600800000,SE 205,Residential,20550,0,0,20550
151835100300000,SE 244,Residential,118800,0,0,118800
151837600200000,SE 244,Residential,126000,0,0,126000
151837600300000,SE 244,Residential,241500,0,0,241500
151837600400000,SE 244,Residential,198000,0,0,198000
151842600400000,SE 244,Residential,2120,0,0,2120
151842600500000,SE 244,Residential,63280,0,0,63280
151842600600000,SE 244,Residential,7410,0,0,7410
151842600700000,SE 244,Residential,144000,744292,0,888292
151842600800000,SE 244,Residential,153000,704851,0,857851
151842600900000,SE 244,Residential,10113,0,0,10113
151842601000000,SE 244,Residential,7808,0,0,7808
151842601100000,SE 244,Residential,180000,681253,0,861253
151842601200000,SE 244,Residential,14337,0,0,14337
151842601300000,SE 244,Residential,237000,93504,0,330504
151842601400000,SE 244,Residential,12557,0,0,12557
151842601500000,SE 244,Residential,9353,0,0,9353
151842601600000,SE 244,Residential,10629,0,0,10629
151842601700000,SE 244,Residential,150000,9657,0,159657
151842601800000,SE 244,Residential,0,0,0,0
151930300500000,SE 220,Residential,32264,162981,0,195245
151930300600000,SE 220,Residential,31080,209957,0,241037
151930300700000,SE 220,Residential,33156,161651,0,194807
151930300800000,SE 220,Residential,32461,0,0,32461
151930300900000,SE 220,Residential,33557,230462,0,264019
151930301000000,SE 220,Residential,34962,243453,0,278415
151930301100000,SE 220,Residential,33454,187298,0,220752
151930301200000,SE 220,Residential,34189,199817,0,234006
151930301300000,SE 220,Residential,36269,188796,0,225065
151930301400000,SE 220,Residential,34306,328711,0,363017
151930301500000,SE 220,Residential,27922,86107,0,114029
151930400700000,SE 220,Residential,61750,101653,0,163403
151932600100000,SE 220,Residential,37080,148624,0,185704
151932600200000,SE 220,Residential,32960,149771,0,182731
151932600300000,SE 220,Residential,41200,207899,0,249099
151932600400000,SE 220,Residential,37080,178753,0,215833
151932600500000,SE 220,Residential,37217,221052,0,258269
151932600600000,SE 220,Residential,40491,183933,0,224424
151932600700000,SE 220,Residential,35490,209834,0,245324
151932600800000,SE 220,Residential,37080,188955,0,226035
151932600900000,SE 220,Residential,37080,223722,0,260802
151932601000000,SE 220,Residential,37080,140045,0,177125
151932601100000,SE 220,Residential,41369,169810,0,211179
151932601300000,SE 220,Residential,426,0,0,426
151932601600000,SE 220,Residential,249,0,0,249
151932601700000,SE 220,Residential,37858,161777,0,199635
151932601800000,SE 220,Residential,35280,191242,0,226522
151932601900000,SE 220,Residential,35280,154034,0,189314
151932602000000,SE 220,Residential,35280,151660,0,186940
151932602100000,SE 220,Residential,34920,170860,0,205780
151932602200000,SE 220,Residential,30468,211285,0,241753
151932602300000,SE 220,Residential,33840,154946,0,188786
151932602400000,SE 220,Residential,33840,149509,0,183349
151932602500000,SE 220,Residential,33840,109160,0,143000
151932602600000,SE 220,Residential,33840,127024,0,160864
151932602700000,SE 220,Residential,35600,227716,0,263316
151932602800000,SE 220,Residential,38963,189064,0,228027
151932602900000,SE 220,Residential,41485,185703,0,227188
151932603000000,SE 220,Residential,34855,180078,0,214933
151932603100000,SE 220,Residential,35640,181006,0,216646
151932603200000,SE 220,Residential,35640,215074,0,250714
151932603300000,SE 220,Residential,38333,241017,0,279350
151932603400000,SE 220,Residential,52879,231048,0,283927
151932603600000,Empty,Exempt,0,0,0,0
151932603700000,SE 220,Residential,71350,437454,0,508804
151932603800000,SE 220,Residential,37240,151308,0,188548
151932603900000,SE 220,Residential,36040,155123,0,191163
151932604000000,SE 220,Residential,36380,169088,0,205468
151932604100000,SE 220,Residential,36380,156970,0,193350
151932604200000,SE 220,Residential,36720,178582,0,215302
151932604300000,SE 220,Residential,37060,125790,0,162850
151932604400000,SE 220,Residential,39265,194685,0,233950
151932604500000,SE 220,Residential,39900,266457,0,306357
151932604600000,SE 220,Residential,34497,151122,0,185619
151932604700000,SE 220,Residential,32049,167837,0,199886
151932604800000,SE 220,Residential,32724,146012,0,178736
151932604900000,SE 220,Residential,32400,139620,0,172020
151932605000000,SE 220,Residential,32400,233530,0,265930
151932605100000,SE 220,Residential,32400,141400,0,173800
151932605200000,SE 220,Residential,39027,168495,0,207522
151932605300000,SE 220,Residential,33721,153401,0,187122
151932605400000,SE 220,Residential,32761,123503,0,156264
151932605500000,SE 220,Residential,28501,169672,0,198173
151935100400000,SE 220,Residential,48350,166911,0,215261
151935100500000,SE 220,Residential,39300,252159,0,291459
151935100600000,SE 220,Residential,45240,245899,0,291139
151935100700000,SE 220,Residential,47810,229301,0,277111
151935100800000,SE 220,Residential,46710,270435,0,317145
151935100900000,SE 220,Residential,46340,278409,0,324749
151935101000000,SE 220,Residential,47070,286502,0,333572
151935101100000,SE 220,Residential,52600,0,0,52600
151935101200000,SE 220,Residential,45710,231744,0,277454
151935101300000,SE 220,Residential,62400,281848,0,344248
151935101400000,SE 220,Residential,51300,242538,0,293838
151935101500000,SE 220,Residential,51200,261851,0,313051
151935101600000,SE 220,Residential,51000,282473,0,333473
151935101700000,SE 220,Residential,47810,0,0,47810
151935101800000,SE 220,Residential,53200,293468,0,346668
151935101900000,COMM SE,Commercial,45765,0,88886,134651
151935103000000,SE 220,Residential,2840,0,0,2840
151935103100000,Empty,Exempt,0,0,0,0
152935100200000,Empty,Exempt,0,0,0,0
153032600200000,SE 246,Residential,161420,273583,0,435003
153032600300000,SE 246,Residential,192100,1000465,0,1192565
153032600400000,SE 246,Residential,130000,248939,0,378939
153040300100000,Empty,Exempt,0,0,0,0
153210200100000,Empty,Exempt,0,0,0,0
153212600200000,Empty,Other,0,0,0,0
153222600100000,Empty,Exempt,0,0,0,0
153322700100000,Empty,Other,0,0,0,0
153322700102000,COMM SE,Exempt,0,0,0,0
153325100100000,SE 246,Exempt,0,0,0,0
153330100100000,SE 246,Exempt,0,0,0,0
153332600100000,SE 246,Exempt,0,0,0,0
153335100100000,SE 246,Exempt,0,0,0,0
153337700100000,SE 246,Exempt,0,0,0,0
180622600100000,SW 422,Residential,383800,0,0,383800
180625100100000,SW 422,Residential,411500,0,0,411500
180632600200000,SW 422,Residential,200000,0,0,200000
180635100200000,SW 422,Residential,15000,0,0,15000
180715100200000,SW 401,Residential,943,0,0,943
180715200100000,SW 401,Residential,834,0,0,834
180715200200000,SW 401,Residential,758,0,0,758
180715200300000,SW 401,Residential,1410,0,0,1410
180715200400000,SW 401,Residential,1046,0,0,1046
180715200500000,SW 401,Residential,1165,0,0,1165
180715200600000,SW 401,Residential,916,0,0,916
180715200700000,SW 401,Residential,987,0,0,987
180715200800000,SW 401,Residential,1682,0,0,1682
180715200900000,SW 401,Residential,1494,0,0,1494
180715201000000,SW 401,Residential,1251,0,0,1251
180715201100000,SW 401,Residential,1450,0,0,1450
180715201200000,SW 401,Residential,1045,0,0,1045
180720100900000,SW 401,Residential,979,0,0,979
180720101000000,SW 401,Residential,974,0,0,974
180720101100000,SW 401,Residential,2079,0,0,2079
180720101200000,SW 401,Residential,1092,0,0,1092
180720200100000,SW 401,Residential,983,0,0,983
180720200200000,SW 401,Residential,1104,0,0,1104
180727700100000,SW 401,Residential,1205,0,0,1205
180727700200000,SW 401,Residential,1278,0,0,1278
180727700300000,SW 401,Residential,1079,0,0,1079
180727700400000,SW 401,Residential,1628,0,0,1628
180727700500000,SW 401,Residential,1501,0,0,1501
180727700600000,SW 401,Residential,1305,0,0,1305
180727700700000,SW 401,Residential,1147,0,0,1147
180727700800000,SW 401,Residential,924,0,0,924
180727800100000,SW 401,Residential,161758,669850,0,831608
180727800200000,SW 401,Residential,128410,546375,0,674785
180727800300000,SW 401,Residential,132100,674484,0,806584
180727900100000,SW 401,Residential,1075,0,0,1075
190110100100000,COMM SW,Commercial,378000,0,0,378000
190115100100000,COMM SW,Commercial,702000,0,0,702000
190117600100000,SW 422,Residential,400000,0,0,400000
190140100100000,SW 422,Residential,400000,0,0,400000
190142600100000,SW 422,Residential,400000,0,0,400000
190145100100000,SW 422,Residential,400000,0,0,400000
190147600100000,SW 422,Residential,400000,0,0,400000
190210100100000,Empty,Exempt,0,0,0,0
190210100200000,SW 422,Ag Land,31929,0,0,31929
190212600100000,Empty,Exempt,0,0,0,0
190215100100000,Empty,Exempt,0,0,0,0
190215200100000,SW 422,Residential,38325,44203,0,82528
190215200200000,SW 422,Ag Land,2267,0,0,2267
190215200400000,SW 422,Ag Land,5317,0,0,5317
190217600100000,Empty,Exempt,0,0,0,0
190217700100000,SW 422,Residential,21900,0,0,21900
190217700200000,SW 422,Residential,4885,6989,0,11874
190217700300000,SW 422,Residential,9200,0,0,9200
190217800100000,SW 422,Residential,50250,229,0,50479
190217800200000,SW 422,Residential,57100,117346,0,174446
190220100100000,COMM SE,Exempt,0,0,0,0
190220200100000,Empty,Other,0,0,0,0
190222600100000,Empty,Exempt,0,0,0,0
190222700100000,COMM SW,Commercial,47628,0,78309,125937
190222700200000,SW 422,Residential,25070,97639,0,122709
190222800100000,Empty,Other,0,0,0,0
190225100100000,Empty,Other,0,0,0,0
190225100200000,Empty,Other,0,0,0,0
190225200100000,COMM SW,Commercial,167400,0,0,167400
190225200200000,Empty,Other,0,0,0,0
190225300100000,SW 422,Residential,39562,57639,0,97201
190225300200000,SW 422,Residential,53250,24984,0,78234
190225300300000,COMM SW,Commercial,151308,0,282203,433511
190225400100000,Empty,Other,0,0,0,0
190225400200000,Empty,Other,0,0,0,0
190227600100000,Empty,Other,0,0,0,0
190227600200000,Empty,Exempt,0,0,0,0
190227700100000,COMM SW,Commercial,120636,0,161194,281830
190227700200000,SW 422,Residential,86250,0,0,86250
190227700300000,SW 422,Residential,59900,0,0,59900
190227700600000,COMM SW,Commercial,40759,0,153787,194546
190227700800000,COMM SW,Commercial,16848,0,30146,46994
190227700900000,COMM SW,Commercial,59616,0,0,59616
190227701000000,COMM SW,Commercial,68256,0,69978,138234
190230100100000,SW 422,Ag Land,3522,0,0,3522
190230100200000,SW 422,Ag Land,43791,0,0,43791
190232600100000,SW 422,Residential,53850,83893,0,137743
190232600200000,E-30 CEMETARY,Exempt,104976,0,467,105443
190232700100000,SW 422,Ag Land,11812,0,0,11812
190232800100000,COMM SW,Commercial,190323,0,0,190323
190232800200000,COMM SW,Commercial,180684,0,0,180684
190235100100000,SW 422,Residential,40120,94624,0,134744
190235200100000,SW 422,Ag Land,848,0,0,848
190235300100000,COMM SW,Commercial,7387,0,0,7387
190235300200000,INDUSTRIAL,Industrial,376900,0,4323100,4700000
190235300300000,COMM SW,Commercial,91714,0,0,91714
190235300400000,COMM SW,Commercial,22993,0,13495,36488
190237600100000,SW 422,Residential,50000,114490,0,164490
190237600200000,SW 422,Ag Dwelling,23320,144464,11896,179680
190237600300000,SW 422,Residential,51570,88989,0,140559
190237600400000,SW 422,Residential,29760,131479,0,161239
190237600500000,SW 422,Residential,51093,134096,0,185189
190237600600000,SW 422,Residential,28340,67357,0,95697
190237600700000,SW 422,Residential,12700,0,0,12700
190237600800000,SW 422,Residential,69000,68701,0,137701
190240100100000,SW 422,Residential,70000,0,0,70000
190240100300000,SW 422,Ag Land,21050,0,0,21050
190242600200000,SW 422,Residential,71650,50272,0,121922
190242600300000,SW 422,Ag Dwelling,34693,811,0,35504
190245100100000,SW 422,Ag Land,41134,0,0,41134
190245100200000,SW 422,Residential,56400,0,0,56400
190247600100000,SW 422,Ag Land,34562,0,2725,37287
190247600200000,SW 422,Residential,50750,124983,0,175733
190310100100000,Empty,Exempt,0,0,0,0
190310100200000,Empty,Other,0,0,0,0
190315100100000,INDUSTRIAL,Industrial,120000,0,0,120000
190317600100000,Empty,Other,0,0,0,0
190317600200000,Empty,Other,0,0,0,0
190317600300000,COMM SW,Commercial,342576,0,0,342576
190317600400000,INDUSTRIAL,Industrial,179400,0,0,179400
190320100100000,Empty,Exempt,0,0,0,0
190322600101000,CONDO 501,Residential,6000,77263,0,83263
190322600101001,CONDO 501,Residential,6000,73113,0,79113
190322600101002,CONDO 501,Residential,6000,73531,0,79531
190322600101003,CONDO 501,Residential,6000,73888,0,79888
190322600101004,CONDO 501,Residential,6000,75695,0,81695
190322600101005,CONDO 501,Residential,6000,72599,0,78599
190322600101006,CONDO 501,Residential,6000,72557,0,78557
190322600101007,CONDO 501,Residential,6000,79250,0,85250
190322600101008,CONDO 501,Residential,6000,73315,0,79315
190322600101009,CONDO 501,Residential,6000,75776,0,81776
190322600101010,CONDO 501,Residential,7000,78231,0,85231
190322600101011,CONDO 501,Residential,7000,80374,0,87374
190322600101012,CONDO 501,Residential,7000,75489,0,82489
190322600101013,CONDO 501,Residential,7000,79062,0,86062
190322600101014,CONDO 501,Residential,7000,79019,0,86019
190322600101015,CONDO 501,Residential,7000,78188,0,85188
190322600101016,CONDO 501,Residential,7000,79537,0,86537
190322600101017,CONDO 501,Residential,7000,78616,0,85616
190322600101018,CONDO 501,Residential,7000,77802,0,84802
190322600101019,CONDO 501,Residential,7000,78458,0,85458
190322600101020,CONDO 501,Residential,7000,77802,0,84802
190322600101021,CONDO 501,Residential,7000,81375,0,88375
190322600101022,CONDO 501,Residential,7000,77802,0,84802
190322600101023,CONDO 501,Residential,7000,75061,0,82061
190322600101024,CONDO 501,Residential,1000,4953,0,5953
190322600101025,CONDO 501,Residential,3000,38673,0,41673
190322600101026,CONDO 501,Residential,4000,56511,0,60511
190322600101027,CONDO 501,Residential,4000,57574,0,61574
190322600101028,CONDO 501,Residential,4000,56096,0,60096
190322600101029,CONDO 501,Residential,4000,56591,0,60591
190322600101030,CONDO 501,Residential,4000,56591,0,60591
190322600101031,CONDO 501,Residential,4000,56591,0,60591
190322600101032,CONDO 501,Residential,3000,40071,0,43071
190322600101033,CONDO 501,Residential,3000,39174,0,42174
190322600101034,CONDO 501,Residential,3000,39150,0,42150
190322600101035,CONDO 501,Residential,4000,57382,0,61382
190322600101036,CONDO 501,Residential,4000,60052,0,64052
190322600101037,CONDO 501,Residential,4000,57382,0,61382
190322600101038,CONDO 501,Residential,4000,57382,0,61382
190322600101039,CONDO 501,Residential,4000,57901,0,61901
190322600101040,CONDO 501,Residential,4000,57901,0,61901
190322600101041,CONDO 501,Residential,3000,40463,0,43463
190322600101042,CONDO 501,Residential,3000,40909,0,43909
190322600101043,CONDO 501,Residential,0,32416,0,32416
190322600201000,CONDO 500,Residential,5800,56706,0,62506
190322600201001,CONDO 500,Residential,5800,59003,0,64803
190322600201002,CONDO 500,Residential,5800,58400,0,64200
190322600201003,CONDO 500,Residential,5800,59003,0,64803
190322600201004,CONDO 500,Residential,5800,59003,0,64803
190322600201005,CONDO 500,Residential,5800,58400,0,64200
190322600300000,SW 415,Residential,40579,67373,0,107952
190322600400000,SW 415,Residential,23497,76414,0,99911
190322600500000,SW 415,Residential,28601,76868,0,105469
190322600600000,SW 415,Residential,24723,77515,0,102238
190322600700000,SW 415,Residential,24979,88395,0,113374
190322600800000,COMM SW,Commercial,10368,0,0,10368
190322600900000,SW 415,Residential,25696,88168,0,113864
190322601000000,SW 415,Residential,33220,106685,0,139905
190322601100000,SW 415,Residential,27642,66368,0,94010
190322601200000,SW 415,Residential,24480,69778,0,94258
190322601300000,SW 415,Residential,25503,73778,0,99281
190322601400000,SW 415,Residential,22717,92659,0,115376
190322601500000,SW 415,Residential,24240,89177,0,113417
190322601600000,SW 415,Residential,24240,78079,0,102319
190322601700000,SW 415,Residential,24240,79501,0,103741
190322601800000,SW 415,Residential,30300,93556,0,123856
190322601900000,SW 415,Residential,30300,89136,0,119436
190322602000000,SW 415,Residential,28349,61778,0,90127
190322602100000,SW 415,Residential,28412,90211,0,118623
190322700100000,SW 415,Residential,24000,76477,0,100477
190322700200000,SW 415,Residential,24000,82212,0,106212
190322700300000,SW 415,Residential,24320,89212,0,113532
190322700400000,SW 415,Residential,27654,96221,0,123875
190322700500000,SW 415,Residential,23532,118050,0,141582
190322700600000,SW 415,Residential,25003,117799,0,142802
190322700700000,SW 415,Residential,25456,98079,0,123535
190322700800000,SW 415,Residential,24630,91750,0,116380
190322700900000,SW 415,Residential,6261,0,0,6261
190322701000000,SW 415,Residential,26081,88014,0,114095
190322701100000,SW 415,Residential,28977,69980,0,98957
190322701200000,SW 415,Residential,29400,95179,0,124579
190322701300000,SW 415,Residential,27899,74628,0,102527
190322701400000,SW 415,Residential,26065,73115,0,99180
190322701500000,SW 415,Residential,24720,87551,0,112271
190322701600000,SW 415,Residential,22660,80542,0,103202
190322701700000,SW 415,Residential,22660,83200,0,105860
190322701800000,SW 415,Residential,22660,98999,0,121659
190322701900000,SW 415,Residential,24335,80553,0,104888
190322800100000,SW 415,Residential,24617,81052,0,105669
190322800200000,SW 415,Residential,24013,81556,0,105569
190322800300000,SW 415,Residential,25200,82827,0,108027
190322800400000,SW 415,Residential,25200,86218,0,111418
190322800500000,SW 415,Residential,25992,103122,0,129114
190322800600000,SW 415,Residential,24548,86043,0,110591
190322800700000,SW 415,Residential,25704,86070,0,111774
190322800800000,SW 415,Residential,25704,90834,0,116538
190325100100000,SW 415,Residential,32927,97836,0,130763
190325100200000,SW 415,Residential,27548,88749,0,116297
190325100300000,SW 415,Residential,28065,85086,0,113151
190325100400000,SW 415,Residential,27000,74744,0,101744
190325100500000,SW 415,Residential,27178,86517,0,113695
190325100600000,SW 415,Residential,21997,77867,0,99864
190325100700000,SW 415,Residential,27561,84754,0,112315
190327600100000,Empty,Exempt,0,0,0,0
190327600200000,Empty,Other,0,0,0,0
190327600300000,Empty,Other,0,0,0,0
190327600400000,Empty,Exempt,0,0,0,0
190327600500000,Empty,Other,0,0,0,0
190330100100000,COMM SW,Commercial,182974,0,104626,287600
190330100200000,Empty,Other,0,0,0,0
190330100300000,COMM SW,Commercial,192240,0,274147,466387
190330100400000,COMM SW,Commercial,324,0,0,324
190330100500000,Empty,Other,0,0,0,0
190330200100000,SW 422,Residential,17650,0,0,17650
190330200200000,Empty,Other,0,0,0,0
190332600100000,SW 422,Residential,40250,0,0,40250
190332600200000,Empty,Other,0,0,0,0
190332600300000,Empty,Exempt,0,0,0,0
190332600400000,SW 422,Residential,30057,0,0,30057
190332600500000,Empty,Other,0,0,0,0
190332700100000,COMM SW,Commercial,208818,0,102462,311280
190332700200000,COMM SW,Commercial,53406,0,30688,84094
190332700300000,COMM SW,Commercial,112320,0,223192,335512
190332700400000,COMM SW,Commercial,110044,0,227561,337605
190332700500000,COMM SW,Commercial,68504,0,191868,260372
190332700600000,COMM SW,Commercial,42018,0,35977,77995
190335100100000,COMM SW,Commercial,343980,0,38282,382262
190335100200000,INDUSTRIAL,Industrial,1350216,0,3996054,5346270
190337600200000,INDUSTRIAL,Industrial,460000,0,3120876,3580876
190337600300000,INDUSTRIAL,Industrial,250900,0,1633820,1884720
190337600400000,COMM SW,Commercial,152064,0,870936,1023000
190337600500000,COMM SW,Commercial,228312,0,564595,792907
190337600600000,COMM SW,Commercial,156384,0,399710,556094
190337600700000,COMM SW,Commercial,12312,0,9198,21510
190337600800000,COMM SW,Commercial,175392,0,646434,821826
190337600900000,COMM SW,Commercial,182304,0,0,182304
190340100100000,INDUSTRIAL,Industrial,659050,0,7962939,8621989
190342600100000,INDUSTRIAL,Industrial,292050,0,0,292050
190345100200000,COMM SW,Commercial,628506,0,7741068,8369574
190345100300000,INDUSTRIAL,Industrial,725440,0,10211150,10936590
190347600200000,COMM SW,Commercial,375786,0,961218,1337004
190347600300000,COMM SW,Commercial,432216,0,623881,1056097
190410100100000,SW 428,Residential,28980,159848,0,188828
190410100200000,SW 428,Residential,31968,43603,0,75571
190410100300000,SW 428,Residential,31166,102973,0,134139
190410100400000,SW 428,Residential,31036,122829,0,153865
190410100500000,SW 428,Residential,24900,38964,0,63864
190410100600000,SW 428,Residential,26640,100108,0,126748
190410100700000,SW 428,Residential,26640,113797,0,140437
190410100800000,SW 428,Residential,27501,112941,0,140442
190410100900000,SW 428,Residential,33300,100561,0,133861
190410101000000,SW 428,Residential,33300,84360,0,117660
190410101100000,SW 428,Residential,33300,120255,0,153555
190410101200000,SW 428,Residential,33300,169412,0,202712
190410101300000,SW 428,Residential,33300,92070,0,125370
190410101400000,SW 428,Residential,33300,103666,0,136966
190410101500000,SW 428,Residential,33300,61151,0,94451
190410101600000,SW 428,Residential,33300,52736,0,86036
190410101700000,SW 428,Residential,30355,79932,0,110287
190410101800000,SW 428,Residential,27989,55013,0,83002
190410101900000,SW 428,Residential,24696,65301,0,89997
190410102000000,SW 428,Residential,21340,0,0,21340
190410102100000,SW 428,Residential,23251,107969,0,131220
190410102200000,SW 428,Residential,28350,68179,0,96529
190410102300000,SW 428,Residential,28350,83753,0,112103
190410102400000,SW 428,Residential,28350,77465,0,105815
190410102500000,SW 428,Residential,27825,71681,0,99506
190410102600000,SW 428,Residential,27825,83702,0,111527
190410102700000,SW 428,Residential,27825,124757,0,152582
190410102800000,SW 428,Residential,28612,50572,0,79184
190410102900000,SW 428,Residential,25752,97992,0,123744
190410103000000,SW 428,Residential,24798,81170,0,105968
190410103100000,SW 428,Residential,24500,80959,0,105459
190410103200000,SW 428,Residential,26001,0,0,26001
190410200100000,SW 428,Residential,25819,45984,0,71803
190410200200000,SW 428,Residential,25819,70551,0,96370
190410200300000,SW 428,Residential,34965,42895,0,77860
190410200400000,SW 428,Residential,34965,102078,0,137043
190410200500000,SW 428,Residential,30600,36153,0,66753
190410200600000,SW 428,Residential,32640,60268,0,92908
190410200700000,SW 428,Residential,33300,81867,0,115167
190410200800000,SW 428,Residential,33300,64596,0,97896
190410200900000,SW 428,Residential,33744,80255,0,113999
190410201000000,SW 428,Residential,26640,101063,0,127703
190410201100000,SW 428,Residential,24420,89204,0,113624
190410201200000,SW 428,Residential,31968,92605,0,124573
190410201300000,SW 428,Residential,33300,84406,0,117706
190410201400000,SW 428,Residential,33300,67222,0,100522
190410201500000,SW 428,Residential,22200,80622,0,102822
190410201600000,SW 428,Residential,22200,51635,0,73835
190410201700000,SW 428,Residential,50780,28562,0,79342
190410201800000,SW 428,Residential,21840,96373,0,118213
190410201900000,SW 428,Residential,21840,0,0,21840
190410202000000,SW 428,Residential,27273,89836,0,117109
190410202100000,SW 428,Residential,29070,114036,0,143106
190410202200000,SW 428,Residential,26640,104094,0,130734
190410202300000,SW 428,Residential,34632,95439,0,130071
190410202400000,SW 428,Residential,27972,86757,0,114729
190410202500000,SW 428,Residential,33300,96197,0,129497
190410202600000,SW 428,Residential,33300,51173,0,84473
190410202700000,SW 428,Residential,33300,88724,0,122024
190410202800000,SW 428,Residential,33300,72375,0,105675
190410202900000,SW 428,Residential,33300,78307,0,111607
190410203000000,SW 428,Residential,33300,64977,0,98277
190410203100000,SW 428,Residential,23152,75333,0,98485
190410203200000,SW 428,Residential,23280,98416,0,121696
190410300100000,SW 428,Residential,31280,65466,0,96746
190410300200000,SW 428,Residential,33300,85507,0,118807
190410300300000,SW 428,Residential,33300,93298,0,126598
190410300400000,SW 428,Residential,18200,71663,0,89863
190410300500000,SW 428,Residential,17325,86203,0,103528
190410300600000,SW 415,Residential,23310,79237,0,102547
190410300700000,SW 415,Residential,23380,91351,0,114731
190410300800000,SW 428,Residential,32760,120470,0,153230
190410300900000,SW 415,Residential,18550,102993,0,121543
190410301000000,SW 415,Residential,18550,50747,0,69297
190410301100000,SW 428,Residential,29274,0,0,29274
190410301200000,SW 428,Residential,30462,58424,0,88886
190410301300000,SW 428,Residential,28800,97927,0,126727
190410301400000,SW 415,Residential,22000,63765,0,85765
190410301500000,SW 428,Residential,29646,85324,0,114970
190410301600000,SW 428,Residential,22200,114135,0,136335
190410301700000,SW 428,Residential,22200,79622,0,101822
190410301800000,SW 428,Residential,33300,47534,0,80834
190410301900000,SW 428,Residential,33300,74954,0,108254
190410302000000,SW 428,Residential,22200,93851,0,116051
190410302100000,SW 428,Residential,22200,87981,0,110181
190410302200000,SW 428,Residential,28900,75658,0,104558
190410400100000,SW 415,Residential,23252,84682,0,107934
190410500100000,SW 415,Residential,28170,94423,0,122593
190410500200000,SW 415,Residential,31185,90683,0,121868
190410500300000,SW 415,Residential,23651,74948,0,98599
190410500400000,SW 415,Residential,22400,76075,0,98475
190410500500000,SW 415,Residential,22400,76547,0,98947
190410500600000,SW 415,Residential,22400,90184,0,112584
190412600100000,SW 416,Residential,23664,111437,0,135101
190412600200000,SW 416,Residential,23664,107805,0,131469
190412600300000,SW 416,Residential,20184,87538,0,107722
190412600400000,SW 416,Residential,18919,98847,0,117766
190412600500000,SW 416,Residential,17942,113829,0,131771
190412600600000,SW 416,Residential,24521,58377,0,82898
190412600700000,SW 428,Residential,30975,105621,0,136596
190412600800000,SW 428,Residential,30187,65807,0,95994
190412600900000,SW 428,Residential,28875,103735,0,132610
190412700100000,SW 416,Residential,20532,77506,0,98038
190412700200000,SW 416,Residential,20880,66745,0,87625
190412700300000,SW 416,Residential,25440,80088,0,105528
190412700400000,SW 416,Residential,25680,76017,0,101697
190412700500000,COMM SW,Commercial,100359,0,332262,432621
190412700600000,SW 415,Residential,41191,131849,0,173040
190412700700000,SW 415,Residential,35401,141020,0,176421
190412700800000,SW 415,Residential,31956,86046,0,118002
190412700900000,SW 415,Residential,28016,83873,0,111889
190412701000000,SW 415,Residential,29199,72017,0,101216
190412701100000,SW 415,Residential,28840,84506,0,113346
190412701200000,SW 415,Residential,27560,84822,0,112382
190412701300000,SW 415,Residential,27560,88044,0,115604
190412701400000,SW 415,Residential,28153,91266,0,119419
190412701500000,SW 415,Residential,28436,100667,0,129103
190412701600000,SW 415,Residential,28322,76889,0,105211
190412701700000,SW 415,Residential,29101,79865,0,108966
190412701800000,SW 415,Residential,28016,69139,0,97155
190412701900000,SW 415,Residential,28718,73664,0,102382
190412702000000,SW 428,Residential,26894,75602,0,102496
190412702100000,SW 428,Residential,54800,66362,0,121162
190412702200000,SW 428,Residential,25466,82002,0,107468
190412702300000,SW 428,Residential,27058,101882,0,128940
190412702400000,SW 416,Residential,25163,95776,0,120939
190412702500000,SW 416,Residential,20715,66824,0,87539
190412800100000,SW 416,Residential,41246,106231,0,147477
190412800200000,SW 416,Residential,24480,103871,0,128351
190412800300000,SW 416,Residential,24720,122188,0,146908
190412800400000,SW 416,Residential,24270,80730,0,105000
190412800500000,SW 428,Residential,51850,54526,0,106376
190412800600000,SW 428,Residential,25660,77260,0,102920
190412800700000,SW 428,Residential,24439,115364,0,139803
190412800800000,SW 428,Residential,57250,90169,0,147419
190412800900000,SW 428,Residential,63950,68203,0,132153
190412801000000,SW 415,Residential,25017,83415,0,108432
190412801100000,SW 415,Residential,24765,84480,0,109245
190412801200000,SW 415,Residential,23310,78182,0,101492
190412801300000,SW 415,Residential,27040,70827,0,97867
190412801400000,SW 415,Residential,28000,75774,0,103774
190412801500000,SW 415,Residential,28000,78699,0,106699
190412801600000,SW 415,Residential,28564,91566,0,120130
190412801700000,SW 415,Residential,28044,89553,0,117597
190412801800000,SW 415,Residential,28704,76326,0,105030
190412900100000,SW 416,Residential,29019,81408,0,110427
190412900200000,SW 416,Residential,25840,116814,0,142654
190412900300000,SW 416,Residential,25048,80266,0,105314
190412900400000,SW 416,Residential,24440,76485,0,100925
190412900500000,SW 416,Residential,27741,121067,0,148808
190412900600000,SW 428,Residential,19200,59237,0,78437
190412900700000,Empty,Other,0,0,0,0
190412900800000,SW 428,Residential,21120,73988,0,95108
190412900900000,SW 428,Residential,21042,77597,0,98639
190412901000000,SW 428,Residential,20880,69446,0,90326
190412901100000,SW 428,Residential,20640,69966,0,90606
190412901200000,SW 428,Residential,20376,87252,0,107628
190412901300000,SW 428,Residential,22003,74296,0,96299
190412901400000,SW 428,Residential,20109,72344,0,92453
190412901500000,SW 428,Residential,25216,97436,0,122652
190412901600000,SW 428,Residential,31600,120318,0,151918
190412901700000,SW 428,Residential,29359,60116,0,89475
190412901800000,SW 428,Residential,12583,0,0,12583
190412901900000,SW 428,Residential,12854,0,0,12854
190412902000000,SW 428,Residential,60200,0,0,60200
190412902100000,SW 428,Residential,8620,0,0,8620
190412902200000,SW 428,Residential,11224,52965,0,64189
190412902300000,SW 428,Residential,11224,0,0,11224
190412902400000,SW 428,Residential,10577,0,0,10577
190412902500000,SW 428,Residential,22611,83809,0,106420
190412902600000,SW 428,Residential,26837,40687,0,67524
190412902700000,SW 428,Residential,19307,83547,0,102854
190412902800000,SW 428,Residential,20025,64665,0,84690
190412902900000,SW 428,Residential,25291,82854,0,108145
190412903000000,SW 428,Residential,24937,79867,0,104804
190412903100000,SW 428,Residential,24937,78936,0,103873
190412903200000,SW 428,Residential,25505,0,0,25505
190412903300000,COMM SW,Commercial,23328,0,94456,117784
190413000100000,SW 415,Residential,22575,80289,0,102864
190413000200000,SW 415,Residential,22575,76535,0,99110
190413000300000,SW 415,Residential,22983,73250,0,96233
190413000400000,SW 415,Residential,29109,88170,0,117279
190413000500000,SW 415,Residential,28599,105138,0,133737
190413000600000,SW 415,Residential,24960,80089,0,105049
190413000700000,SW 415,Residential,24960,89719,0,114679
190413000800000,SW 415,Residential,27197,76946,0,104143
190413000900000,SW 415,Residential,28970,91315,0,120285
190413100100000,SW 415,Residential,27996,46351,0,74347
190413100200000,SW 415,Residential,25600,80126,0,105726
190413100300000,SW 415,Residential,25600,86636,0,112236
190413100400000,SW 415,Residential,25600,79063,0,104663
190413100500000,SW 415,Residential,25600,89275,0,114875
190413100600000,SW 415,Residential,25600,72827,0,98427
190413100700000,SW 415,Residential,25200,79694,0,104894
190413100800000,SW 415,Residential,25600,100807,0,126407
190413100900000,SW 415,Residential,26800,79165,0,105965
190413101000000,SW 415,Residential,26800,89435,0,116235
190413101100000,SW 415,Residential,26800,83773,0,110573
190413101200000,SW 415,Residential,26800,80424,0,107224
190413101300000,SW 415,Residential,26800,78530,0,105330
190413101400000,SW 415,Residential,35429,93207,0,128636
190413101500000,SW 415,Residential,28077,75687,0,103764
190413101600000,SW 415,Residential,22050,78569,0,100619
190413101700000,SW 415,Residential,22050,80954,0,103004
190413101800000,SW 415,Residential,22400,79382,0,101782
190413101900000,SW 415,Residential,22400,78044,0,100444
190413102000000,SW 415,Residential,22400,77776,0,100176
190413102100000,SW 415,Residential,22400,73705,0,96105
190413102200000,SW 415,Residential,22400,80942,0,103342
190413102300000,SW 415,Residential,22400,75358,0,97758
190413102400000,SW 415,Residential,22400,74553,0,96953
190413102500000,SW 415,Residential,22400,74621,0,97021
190413102600000,SW 415,Residential,22400,86294,0,108694
190413102700000,SW 415,Residential,22400,84202,0,106602
190413102800000,SW 415,Residential,22400,82886,0,105286
190413102900000,SW 415,Residential,22400,76943,0,99343
190415100100000,SW 428,Residential,30712,118723,0,149435
190415100200000,SW 428,Residential,30712,84740,0,115452
190415100300000,SW 428,Residential,30712,90574,0,121286
190415100400000,SW 428,Residential,30712,61058,0,91770
190415100500000,SW 415,Residential,28196,74589,0,102785
190415100600000,SW 415,Residential,28196,83856,0,112052
190415100700000,SW 415,Residential,28196,79352,0,107548
190415100800000,SW 415,Residential,28840,82998,0,111838
190415100900000,SW 415,Residential,28497,85672,0,114169
190415101000000,SW 415,Residential,27348,80107,0,107455
190415101100000,SW 415,Residential,27348,66473,0,93821
190415101200000,SW 415,Residential,27348,71170,0,98518
190415101300000,SW 415,Residential,26574,77957,0,104531
190415101400000,SW 415,Residential,32083,62882,0,94965
190415101500000,SW 428,Residential,45150,116548,0,161698
190415101600000,SW 428,Residential,44100,56174,0,100274
190415101700000,SW 428,Residential,22295,104406,0,126701
190415101800000,SW 428,Residential,24360,127275,0,151635
190415101900000,SW 428,Residential,42040,0,0,42040
190415200100000,SW 415,Residential,28196,73063,0,101259
190415200200000,APTS SW,Commercial,164700,0,1939348,2104048
190415200300000,COMM SW,Commercial,32805,0,0,32805
190415200400000,COMM SW,Commercial,115992,0,251104,367096
190415200500000,COMM SW,Commercial,40500,0,0,40500
190415200600000,COMM SW,Commercial,40500,0,0,40500
190415200700000,COMM SW,Commercial,67262,0,360191,427453
190415200800000,COMM SW,Commercial,2311,0,0,2311
190415201000000,COMM SW,Commercial,54000,0,146193,200193
190415201100000,COMM SW,Commercial,68364,0,199887,268251
190415201200000,Empty,Other,0,0,0,0
190415201300000,COMM SW,Commercial,181440,0,1744159,1925599
190415201400000,SW 415,Residential,20429,71590,0,92019
190415201500000,SW 415,Residential,20426,66928,0,87354
190415201600000,SW 415,Residential,18886,35752,0,54638
190415201700000,SW 415,Residential,28584,72786,0,101370
190415201800000,SW 415,Residential,28599,79328,0,107927
190415201900000,SW 415,Residential,28599,82341,0,110940
190415202000000,SW 415,Residential,28599,89683,0,118282
190415202100000,SW 415,Residential,28599,79673,0,108272
190415202200000,SW 415,Residential,28069,84573,0,112642
190415202300000,SW 415,Residential,28196,80567,0,108763
190415202400000,SW 415,Residential,28196,84778,0,112974
190415300100000,SW 428,Residential,29736,53219,0,82955
190415300200000,SW 428,Residential,29736,66556,0,96292
190415300300000,SW 428,Residential,29736,76460,0,106196
190415300400000,SW 428,Residential,33040,100811,0,133851
190415300500000,SW 428,Residential,33040,99752,0,132792
190415300600000,SW 428,Residential,33040,62116,0,95156
190415300700000,SW 428,Residential,15000,0,0,15000
190415300800000,SW 428,Residential,33040,41960,0,75000
190415300900000,SW 428,Residential,33040,77522,0,110562
190415301000000,SW 428,Residential,33040,78963,0,112003
190415301100000,SW 428,Residential,26019,4005,0,30024
190415301200000,COMM SW,Commercial,76896,0,177164,254060
190415301300000,COMM SW,Commercial,66636,0,163483,230119
190417600100000,SW 428,Residential,22563,64093,0,86656
190417600200000,SW 428,Residential,17640,92559,0,110199
190417600300000,SW 428,Residential,17850,80355,0,98205
190417600400000,SW 428,Residential,18883,76054,0,94937
190417600500000,SW 428,Residential,24756,52615,0,77371
190417600600000,SW 428,Residential,29970,95788,0,125758
190417600700000,SW 428,Residential,30510,82269,0,112779
190417600800000,SW 428,Residential,30780,47408,0,78188
190417600900000,SW 428,Residential,18038,106203,0,124241
190417601000000,SW 428,Residential,21000,47166,0,68166
190417601100000,SW 428,Residential,24651,98498,0,123149
190417601200000,SW 428,Residential,29401,59361,0,88762
190417601300000,SW 428,Residential,17797,68759,0,86556
190417601400000,SW 428,Residential,17797,54671,0,72468
190417601500000,SW 428,Residential,19775,82769,0,102544
190417601600000,SW 428,Residential,19775,72808,0,92583
190417700100000,SW 428,Residential,27005,123092,0,150097
190417700200000,SW 428,Residential,30712,205295,0,236007
190417700300000,SW 428,Residential,30712,77719,0,108431
190417700400000,SW 415,Residential,18550,71481,0,90031
190417700500000,SW 415,Residential,27133,5867,0,33000
190417700600000,SW 415,Residential,27132,0,0,27132
190417700700000,SW 415,Residential,24947,84661,0,109608
190417700800000,SW 415,Residential,18550,82223,0,100773
190417700900000,SW 415,Residential,18550,91025,0,109575
190417701000000,SW 415,Residential,18900,71389,0,90289
190417701100000,SW 415,Residential,18900,89003,0,107903
190417701200000,SW 428,Residential,1605,0,0,1605
190417701300000,SW 428,Residential,1605,0,0,1605
190417701400000,SW 428,Residential,24120,145007,0,169127
190417701500000,SW 428,Residential,41580,39894,0,81474
190417701600000,SW 428,Residential,39567,62316,0,101883
190417701700000,SW 428,Residential,54600,65896,0,120496
190417701800000,SW 428,Residential,36540,76980,0,113520
190417701900000,SW 428,Residential,34212,60554,0,94766
190417702000000,SW 428,Residential,19125,89740,0,108865
190417702100000,SW 428,Residential,26400,95998,0,122398
190417800100000,SW 428,Residential,29270,114581,0,143851
190417800200000,SW 428,Residential,27877,85556,0,113433
190417800300000,SW 428,Residential,18585,52698,0,71283
190417800400000,SW 428,Residential,18585,54269,0,72854
190417800500000,SW 428,Residential,18585,65810,0,84395
190417800600000,COMM SW,Commercial,56700,0,252899,309599
190417800700000,SW 428,Residential,26762,68636,0,95398
190417800800000,SW 428,Residential,31223,91220,0,122443
190417800900000,SW 428,Residential,29736,112878,0,142614
190417801000000,SW 428,Residential,29736,62777,0,92513
190417801100000,SW 428,Residential,25276,65431,0,90707
190417801200000,SW 428,Residential,31223,60233,0,91456
190417801300000,SW 428,Residential,27877,59365,0,87242
190417801400000,SW 428,Residential,29736,73644,0,103380
190417900100000,E-10 COUNTY,Exempt,0,0,0,0
190417900200000,Empty,Exempt,0,0,0,0
190417900300000,INDUSTRIAL,Industrial,28800,0,0,28800
190417900400000,Empty,Other,0,0,0,0
190420100100000,E-70 CHARITY OTHER,Exempt,909900,6050628,0,6960528
190420100200000,COMM SW,Commercial,454831,0,2347665,2802496
190422600100000,APTS SW,Commercial,1179900,0,8670100,9850000
190422600200000,COMM SW,Commercial,56376,0,0,56376
190422600300000,COMM SW,Commercial,497880,0,308195,806075
190422600400000,COMM SW,Commercial,296352,0,0,296352
190422600500000,COMM SW,Commercial,244935,0,280947,525882
190422600600000,COMM SW,Commercial,91689,0,257526,349215
190422600700000,COMM SW,Commercial,74455,0,4860,79315
190422600800000,COMM SW,Commercial,59386,0,59303,118689
190422600900000,COMM SW,Commercial,133229,0,218776,352005
190422601000000,COMM SW,Commercial,260820,0,671364,932184
190422601100000,COMM SW,Commercial,553500,0,1518923,2072423
190422601200000,COMM SW,Commercial,253109,0,292031,545140
190422601300000,COMM SW,Commercial,365904,0,324751,690655
190422700100000,COMM SW,Commercial,199530,0,632727,832257
190422701400000,COMM SW,Commercial,1441,0,0,1441
190425100100000,COMM SW,Commercial,372816,0,277703,650519
190425100200000,COMM SW,Commercial,249696,0,409851,659547
190425100300000,COMM SW,Commercial,187920,0,13576,201496
190425100400000,COMM SW,Commercial,616950,0,2084017,2700967
190425100500000,COMM SW,Commercial,576450,0,1175957,1752407
190425200100000,COMM SW,Commercial,274752,0,943191,1217943
190425200200000,COMM SW,Commercial,330480,0,706164,1036644
190425200300000,COMM SW,Commercial,285120,0,394880,680000
190425200400000,COMM SW,Commercial,459961,0,2381695,2841656
190425200500000,COMM SW,Commercial,291773,0,746106,1037879
190425200600000,COMM SW,Commercial,419580,0,402528,822108
190425200700000,COMM SW,Commercial,421718,0,606691,1028409
190425200800000,COMM SW,Commercial,166730,0,1698,168428
190425200900000,COMM SW,Commercial,366120,0,353587,719707
190425300100000,COMM SW,Commercial,434160,0,461065,895225
190425300200000,COMM SW,Commercial,324000,0,1976000,2300000
190425300300000,COMM SW,Commercial,560520,0,881485,1442005
190425300400000,COMM SW,Commercial,774792,0,3409710,4184502
190425300500000,COMM SW,Commercial,391608,0,579510,971118
190425300600000,COMM SW,Commercial,362988,0,782431,1145419
190425300700000,COMM SW,Commercial,105751,0,405453,511204
190425400600000,COMM SW,Commercial,117331,0,374210,491541
190425400700000,COMM SW,Commercial,117331,0,397519,514850
190425400800000,COMM SW,Commercial,157950,0,394073,552023
190427600100000,COMM SW,Commercial,366336,0,520340,886676
190427600200000,COMM SW,Commercial,298944,0,524881,823825
190427600300000,COMM SW,Commercial,206669,0,479666,686335
190427600400000,COMM SW,Commercial,53901,0,111561,165462
190427600500000,COMM SW,Commercial,54305,0,374502,428807
190427600600000,COMM SW,Commercial,96394,0,198258,294652
190427600700000,COMM SW,Commercial,158378,0,640160,798538
190427600800000,COMM SW,Commercial,127367,0,825705,953072
190427600900000,COMM SW,Commercial,130118,0,334770,464888
190427601000000,COMM SW,Commercial,232848,0,1020339,1253187
190427601100000,COMM SW,Commercial,97481,0,225465,322946
190427601102000,COMM SW,Commercial,0,0,8442,8442
190427601200000,COMM SW,Commercial,76967,0,418659,495626
190427601300000,COMM SW,Commercial,82434,0,251566,334000
190427601400000,COMM SW,Commercial,98986,0,430558,529544
190430100100000,COMM SW,Commercial,213570,0,1449208,1662778
190430200100000,INDUSTRIAL,Industrial,204885,0,187359,392244
190430200102000,COMM SW,Commercial,0,0,41644,41644
190430200200000,COMM SW,Commercial,58752,0,109606,168358
190430200300000,COMM SW,Commercial,22637,0,2390,25027
190430200400000,COMM SW,Commercial,47952,0,180428,228380
190430200500000,COMM SW,Commercial,177336,0,0,177336
190430200502000,COMM SW,Commercial,0,0,41644,41644
190430300102000,COMM SW,Commercial,0,0,43244,43244
190432600100000,COMM SW,Commercial,246294,0,1601935,1848229
190432600200000,COMM SW,Commercial,92988,0,58604,151592
190435100200000,COMM SW,Commercial,93258,0,89132,182390
190435100300000,COMM SW,Commercial,974970,0,26424983,27399953
190435200100000,COMM SW,Commercial,91311,0,0,91311
190435200200000,E-05 STATE,Exempt,0,0,0,0
190435300100000,COMM SW,Commercial,44237,0,165472,209709
190435300200000,Empty,Other,0,0,0,0
190435300300000,Empty,Exempt,0,0,0,0
190435300400000,E-05 STATE,Exempt,0,0,0,0
190435300500000,COMM SW,Commercial,65664,0,22428,88092
190437600100000,Empty,Other,0,0,0,0
190437600200000,Empty,Other,0,0,0,0
190437700100000,COMM SW,Commercial,27216,0,43244,70460
190440100100000,Empty,Exempt,0,0,0,0
190440100200000,Empty,Exempt,0,0,0,0
190440100300000,Empty,Exempt,0,0,0,0
190440100400000,Empty,Other,0,0,0,0
190440200200000,E-70 CHARITY OTHER,Exempt,420098,0,1881848,2301946
190440200300000,COMM SW,Commercial,83025,0,48716,131741
190440200400000,SW 422,Residential,69525,45480,0,115005
190442600100000,INDUSTRIAL,Industrial,172395,0,276631,449026
190442600200000,INDUSTRIAL,Industrial,253450,0,0,253450
190442600300000,COMM SW,Commercial,175000,0,94519,269519
190442600400000,COMM SW,Commercial,162702,0,292644,455346
190442600500000,Empty,Exempt,0,0,0,0
190442600600000,Empty,Other,0,0,0,0
190445100100000,Empty,Other,0,0,0,0
190445100200000,Empty,Other,0,0,0,0
190445100300000,Empty,Exempt,0,0,0,0
190445100400000,SW 422,Residential,168435,94515,0,262950
190447600100000,COMM SW,Commercial,91584,0,61210,152794
190447600200000,SW 422,Residential,66400,52685,0,119085
190447600300000,COMM SW,Commercial,41298,0,78749,120047
190447600400000,COMM SW,Commercial,111456,0,211906,323362
190447600500000,SW 422,Residential,23837,0,0,23837
190447600600000,SW 422,Residential,21808,0,0,21808
190447600700000,SW 422,Residential,28841,0,0,28841
190447600800000,SW 422,Residential,42800,59485,0,102285
190447700100000,INDUSTRIAL,Industrial,258550,0,1540342,1798892
190447700200000,COMM SW,Commercial,202986,0,302699,505685
190447700300000,Empty,Other,0,0,0,0
190447700400000,COMM SW,Commercial,331776,0,399861,731637
190510100100000,COMM SW,Commercial,199066,0,213045,412111
190510100200000,COMM SW,Commercial,119232,0,3709,122941
190510100300000,COMM SW,Commercial,246672,0,337468,584140
190510100400000,COMM SW,Commercial,90720,0,249058,339778
190510100500000,COMM SW,Commercial,25574,0,0,25574
190510100600000,COMM SW,Commercial,117504,0,0,117504
190510100700000,COMM SW,Commercial,151200,0,373051,524251
190510100800000,COMM SW,Commercial,118368,0,0,118368
190510100900000,COMM SW,Commercial,70848,0,240102,310950
190510101000000,COMM SW,Commercial,160056,0,189944,350000
190510101100000,COMM SW,Commercial,135432,0,166984,302416
190510101200000,COMM SW,Commercial,177120,0,2064,179184
190510101300000,COMM SW,Commercial,99576,0,228300,327876
190510200100000,COMM SW,Commercial,134514,0,88400,222914
190510200200000,E-10 COUNTY,Exempt,0,0,0,0
190510200300000,COMM SW,Commercial,89424,0,255402,344826
190510200400000,COMM SW,Commercial,60718,0,4335,65053
190510200500000,COMM SW,Commercial,53525,0,159706,213231
190510200600000,COMM SW,Commercial,44712,0,0,44712
190510200700000,COMM SW,Commercial,81648,0,0,81648
190510201300000,COMM SW,Commercial,53050,0,94055,147105
190510201400000,E-63 BOY SCOUTS,Exempt,130464,0,584957,715421
190510201402001,COMM SW,Commercial,0,0,14146,14146
190510201500000,COMM SW,Commercial,220320,0,645733,866053
190510201700000,COMM SW,Commercial,125866,0,168191,294057
190510201800000,COMM SW,Commercial,44712,0,196949,241661
190510201900000,COMM SW,Commercial,279648,0,2642560,2922208
190512600300000,COMM SW,Commercial,50544,0,0,50544
190512600500000,E-05 STATE,Exempt,0,0,0,0
190512700100000,COMM SW,Commercial,290520,0,297945,588465
190512700200000,INDUSTRIAL,Industrial,138200,0,605572,743772
190512700400000,COMM SW,Commercial,74412,0,134451,208863
190512700500000,COMM SW,Commercial,71928,0,109250,181178
190512700600000,COMM SW,Commercial,155520,0,363418,518938
190512700700000,COMM SW,Commercial,59098,0,265368,324466
190512700800000,COMM SW,Commercial,60826,0,237984,298810
190512700900000,COMM SW,Commercial,175392,0,549608,725000
190512701000000,COMM SW,Commercial,35078,0,83127,118205
190512701100000,COMM SW,Commercial,56765,0,87240,144005
190515100101000,COMM SW,Commercial,141199,0,738464,879663
190515100101001,INDUSTRIAL,Industrial,227286,0,1890283,2117569
190515100101002,E-05 STATE,Exempt,0,0,0,0
190515100101003,E-05 STATE,Exempt,0,0,0,0
190515100101004,INDUSTRIAL,Industrial,14498,0,171059,185557
190515100101005,INDUSTRIAL,Industrial,137988,0,1337533,1475521
190515200100000,COMM SW,Commercial,316764,0,1618926,1935690
190515200200000,COMM SW,Commercial,306882,0,1563351,1870233
190515200300000,COMM SW,Commercial,247806,0,2316966,2564772
190515300100000,COMM SW,Commercial,269460,0,967789,1237249
190515300200000,COMM SW,Commercial,265140,0,1053450,1318590
190517600100000,COMM SW,Commercial,165456,0,9694,175150
190517600200000,COMM SW,Commercial,59011,0,422048,481059
190517600300000,COMM SW,Commercial,103680,0,537520,641200
190517600400000,INDUSTRIAL,Industrial,209200,0,1310694,1519894
190517600500000,COMM SW,Commercial,286200,0,2548805,2835005
190517600600000,COMM SW,Commercial,221940,0,433060,655000
190517600700000,COMM SW,Commercial,89640,0,0,89640
190517600800000,COMM SW,Commercial,176040,0,0,176040
190517600900000,COMM SW,Commercial,219456,0,1256325,1475781
190517601000000,COMM SW,Commercial,171696,0,965059,1136755
190517601100000,COMM SW,Commercial,209642,0,446645,656287
190517601200000,COMM SW,Commercial,434700,0,453170,887870
190517601300000,INDUSTRIAL,Industrial,77639,0,327843,405482
190517601400000,COMM SW,Commercial,248400,0,0,248400
190517700100000,COMM SW,Commercial,150336,0,319386,469722
190517700200000,COMM SW,Commercial,139806,0,0,139806
190517700300000,COMM SW,Commercial,217350,0,610372,827722
190517700400000,COMM SW,Commercial,138834,0,28929,167763
190517700500000,COMM SW,Commercial,257040,0,694612,951652
190517700600000,COMM SW,Commercial,149040,0,289103,438143
190517700700000,COMM SW,Commercial,83290,0,305507,388797
190517800100000,COMM SW,Commercial,160920,0,346981,507901
190517800200000,COMM SW,Commercial,128736,0,694328,823064
190520100300000,INDUSTRIAL,Industrial,1000,0,0,1000
190520100400000,COMM SW,Commercial,15660,0,44275,59935
190520100600000,COMM SW,Commercial,70740,0,51788,122528
190520100700000,COMM SW,Commercial,365526,0,2974459,3339985
190520100800000,COMM SW,Commercial,216292,0,716807,933099
190520100900000,COMM SW,Commercial,152712,0,0,152712
190520200100000,SW 418,Ag Land,12928,0,0,12928
190522600100000,SW 418,Ag Land,16937,0,0,16937
190522600200000,Empty,Other,0,0,0,0
190522700100000,SW 418,Ag Land,12064,0,0,12064
190525100100000,SW 418,Ag Land,23569,0,0,23569
190525200100000,Empty,Exempt,0,0,0,0
190525200200000,Empty,Exempt,0,0,0,0
190525200300000,SW 418,Residential,36250,0,0,36250
190527600100000,COMM SW,Commercial,70783,0,95984,166767
190527600200000,COMM SW,Commercial,96606,0,220147,316753
190527700100000,SW 418,Ag Land,8056,0,0,8056
190527800100000,SW 418,Ag Land,14984,0,0,14984
190530100100000,SW 418,Ag Land,35202,0,0,35202
190532600100000,SW 418,Ag Land,41990,0,0,41990
190535100100000,Empty,Exempt,0,0,0,0
190535200100000,INDUSTRIAL,Industrial,34620,0,0,34620
190537600100000,COMM SW,Commercial,63353,0,0,63353
190537600200000,Empty,Exempt,0,0,0,0
190537700100000,Empty,Other,0,0,0,0
190540100200000,INDUSTRIAL,Industrial,606850,0,4597091,5203941
190540200100000,COMM SW,Commercial,32076,0,62047,94123
190540200200000,COMM SW,Commercial,353052,0,213220,566272
190540200300000,COMM SW,Commercial,78732,0,1031,79763
190540200400000,COMM SW,Commercial,19764,0,24,19788
190540200500000,COMM SW,Commercial,19602,0,488,20090
190540200600000,COMM SW,Commercial,38394,0,87817,126211
190542600200000,Empty,Other,0,0,0,0
190542600300000,SW 418,Ag Land,394,0,0,394
190542600400000,SW 418,Ag Land,20545,0,0,20545
190545100100000,COMM SW,Commercial,201096,0,62389,263485
190545100200000,COMM SW,Commercial,21708,0,0,21708
190545200100000,COMM SW,Commercial,82080,0,145495,227575
190545200200000,COMM SW,Commercial,32292,0,207708,240000
190545200400000,COMM SW,Other,0,0,0,0
190545300100000,COMM SW,Commercial,44712,0,4693,49405
190545300200000,SW 418,Residential,53450,45493,0,98943
190545300300000,SW 418,Residential,53100,95042,0,148142
190547600100000,COMM SW,Commercial,78246,0,4908,83154
190547700100000,COMM SW,Commercial,151087,0,119240,270327
190547700102000,COMM SW,Commercial,0,0,36108,36108
190547700200000,INDUSTRIAL,Industrial,70275,0,186548,256823
190547700300000,COMM SW,Commercial,30402,0,240258,270660
190547700400000,COMM SW,Commercial,241596,0,1772299,2013895
190547700500000,COMM SW,Commercial,15131,0,1645,16776
190610100200000,SW 418,Ag Land,11447,0,0,11447
190610100500000,SW 420,Residential,41693,6572,0,48265
190610100600000,SW 420,Residential,285,0,0,285
190610100700000,SW 420,Residential,285,0,0,285
190610100800000,SW 420,Residential,46548,152766,0,199314
190610100900000,SW 420,Residential,46318,202088,0,248406
190610101000000,SW 420,Residential,42682,153302,0,195984
190610101100000,SW 420,Residential,374,0,0,374
190610101200000,SW 420,Residential,42560,142457,0,185017
190610101300000,SW 420,Residential,46683,110441,0,157124
190610101400000,SW 420,Residential,51948,201932,0,253880
190610101500000,SW 420,Exempt,0,0,0,0
190610101600000,SW 420,Residential,47682,201976,0,249658
190610101700000,SW 420,Residential,406,0,0,406
190610101800000,SW 420,Residential,41803,73682,0,115485
190610101900000,SW 420,Residential,232,0,0,232
190610102000000,SW 420,Residential,228,0,0,228
190610102100000,SW 420,Residential,43050,9222,0,52272
190610102200000,SW 420,Residential,203,0,0,203
190610102300000,SW 420,Residential,208,0,0,208
190610102400000,SW 420,Residential,40075,176695,0,216770
190610102500000,SW 420,Residential,8145,0,0,8145
190610200100000,SW 420,Residential,235,0,0,235
190610200200000,SW 420,Residential,245,0,0,245
190610200300000,SW 420,Residential,43389,168967,0,212356
190610200400000,SW 420,Residential,51502,186926,0,238428
190610200500000,SW 420,Residential,214,0,0,214
190612600400000,Empty,Exempt,0,0,0,0
190612600700000,SW 420,Residential,44917,206127,0,251044
190612600800000,SW 420,Residential,45510,166295,0,211805
190612600900000,SW 420,Residential,48240,171580,0,219820
190612601000000,SW 420,Residential,51750,177520,0,229270
190612601100000,SW 420,Residential,43691,239581,0,283272
190612601200000,SW 420,Residential,41085,229084,0,270169
190612601300000,SW 420,Residential,44633,169601,0,214234
190612601400000,SW 420,Residential,48141,199555,0,247696
190612601500000,SW 420,Residential,39693,205165,0,244858
190612601600000,SW 420,Residential,37450,206078,0,243528
190612601700000,SW 420,Residential,42660,210749,0,253409
190612601800000,SW 420,Residential,42800,185155,0,227955
190612601900000,SW 420,Residential,42087,195667,0,237754
190612602000000,SW 418,Ag Dwelling,13986,75402,3268,92656
190612602300000,SW 420,Residential,42800,214151,0,256951
190612602400000,SW 420,Residential,53592,218645,0,272237
190612602500000,SW 420,Residential,53410,174879,0,228289
190612602600000,SW 420,Residential,36915,146667,0,183582
190612602700000,SW 420,Residential,40280,171136,0,211416
190612602800000,SW 420,Residential,38160,182578,0,220738
190612602900000,SW 420,Residential,42400,188226,0,230626
190612603000000,SW 420,Residential,40280,204606,0,244886
190612603100000,SW 420,Residential,38160,164582,0,202742
190612603200000,SW 420,Residential,41195,158613,0,199808
190612603300000,SW 420,Residential,34240,151508,0,185748
190612603400000,SW 420,Residential,40280,165546,0,205826
190612700100000,SW 420,Residential,43160,243194,0,286354
190612700200000,SW 420,Residential,41990,158123,0,200113
190612700300000,SW 420,Residential,40000,206241,0,246241
190612700400000,SW 420,Residential,50642,200963,0,251605
190612700500000,SW 420,Residential,45180,190045,0,235225
190612700600000,SW 420,Residential,42400,186659,0,229059
190612700700000,SW 420,Residential,37100,177827,0,214927
190612700800000,SW 420,Residential,40280,201905,0,242185
190612701200000,SW 420,Residential,46782,156294,0,203076
190612701300000,SW 420,Residential,44405,170798,0,215203
190612701400000,SW 420,Residential,45616,159030,0,204646
190612701500000,SW 420,Residential,38160,172069,0,210229
190612701700000,SW 420,Residential,42180,180387,0,222567
190612701800000,SW 420,Residential,40280,206697,0,246977
190612800100000,SW 420,Residential,33790,180069,0,213859
190612800200000,SW 420,Residential,41420,146664,0,188084
190612800300000,SW 420,Residential,33790,154987,0,188777
190612800400000,SW 420,Residential,50685,150750,0,201435
190612800500000,SW 420,Residential,37060,143742,0,180802
190615100100000,SW 418,Residential,86700,29788,0,116488
190615100200000,SW 418,Residential,69350,0,0,69350
190615100300000,SW 418,Residential,77900,91207,0,169107
190615100400000,SW 418,Residential,76500,75892,0,152392
190615100500000,SW 418,Residential,78750,111267,0,190017
190615100600000,SW 418,Residential,78750,92145,0,170895
190615100700000,SW 418,Residential,77750,3840,0,81590
190615100800000,SW 418,Residential,66800,155134,0,221934
190617600100000,SW 418,Residential,33050,0,0,33050
190617600400000,SW 432,Residential,23152,153529,0,176681
190617600500000,SW 432,Residential,24528,144568,0,169096
190617600600000,SW 432,Residential,24528,145175,0,169703
190617600700000,SW 432,Residential,24528,137879,0,162407
190617600800000,SW 432,Residential,24528,158397,0,182925
190617600900000,SW 432,Residential,24528,152097,0,176625
190617601000000,SW 432,Residential,24528,147367,0,171895
190617601100000,SW 432,Residential,24528,152660,0,177188
190617601200000,SW 432,Residential,24528,152553,0,177081
190617601300000,SW 432,Residential,24528,159460,0,183988
190617601400000,SW 432,Residential,24528,152293,0,176821
190617601500000,SW 432,Residential,24528,147171,0,171699
190617601600000,SW 432,Residential,24578,138743,0,163321
190617601700000,SW 432,Residential,26999,132173,0,159172
190617601800000,SW 432,Residential,31763,170205,0,201968
190617601900000,SW 432,Residential,26999,174839,0,201838
190617602000000,SW 432,Residential,27037,173459,0,200496
190617602100000,SW 432,Residential,27395,183018,0,210413
190617602200000,SW 432,Residential,27339,154303,0,181642
190617602300000,SW 432,Residential,27339,165510,0,192849
190617602400000,SW 432,Residential,27339,153177,0,180516
190617602500000,SW 432,Residential,27339,152772,0,180111
190617602600000,SW 432,Residential,27339,194332,0,221671
190617602700000,SW 432,Residential,31244,165219,0,196463
190617602800000,SW 432,Residential,27339,169806,0,197145
190617602900000,SW 432,Residential,27339,148177,0,175516
190617603000000,SW 432,Residential,27339,189338,0,216677
190617603100000,SW 432,Residential,27339,146455,0,173794
190617603200000,SW 432,Residential,23594,180824,0,204418
190617603300000,SW 432,Residential,27845,186424,0,214269
190617700100000,SW 432,Residential,22131,144964,0,167095
190617700200000,SW 432,Residential,25200,190720,0,215920
190617700300000,SW 432,Residential,24528,137783,0,162311
190617700400000,SW 432,Residential,24528,148060,0,172588
190617700500000,SW 432,Residential,24898,162949,0,187847
190617700600000,SW 418,Ag Dwelling,9061,56245,11832,77138
190617700700000,SW 432,Residential,22848,137475,0,160323
190617700800000,SW 432,Residential,24528,149611,0,174139
190617700900000,SW 432,Residential,24528,142850,0,167378
190617701000000,SW 432,Residential,24528,149667,0,174195
190617701100000,SW 432,Residential,24528,155450,0,179978
190617701200000,SW 432,Residential,24528,147057,0,171585
190617701300000,SW 432,Residential,24528,152111,0,176639
190617701400000,SW 432,Residential,24579,153467,0,178046
190617800200000,SW 432,Residential,76249,221470,0,297719
190617800400000,SW 432,Residential,31171,199591,0,230762
190617800500000,SW 432,Residential,31171,180786,0,211957
190617800600000,SW 432,Residential,31171,205804,0,236975
190617800700000,SW 432,Residential,31171,191443,0,222614
190617800800000,SW 432,Residential,31171,153463,0,184634
190617800900000,SW 432,Residential,31171,157602,0,188773
190617801000000,SW 432,Residential,31427,193274,0,224701
190617801100000,SW 432,Residential,31427,172204,0,203631
190617801200000,SW 432,Residential,28413,153724,0,182137
190617801300000,SW 432,Residential,31877,150825,0,182702
190617801400000,SW 432,Residential,34939,162752,0,197691
190617801500000,SW 432,Residential,30417,174243,0,204660
190617801600000,SW 432,Residential,26990,145851,0,172841
190620100200000,SW 421,Residential,32246,97308,0,129554
190620100300000,SW 421,Residential,28800,93611,0,122411
190620100400000,SW 421,Residential,26675,88010,0,114685
190620100500000,SW 421,Residential,26675,88561,0,115236
190620100600000,SW 421,Residential,26675,85043,0,111718
190620100700000,SW 421,Residential,26950,79951,0,106901
190620100800000,SW 421,Residential,26950,90568,0,117518
190620100900000,SW 421,Residential,26950,91143,0,118093
190620101000000,SW 421,Residential,26950,88548,0,115498
190620101100000,SW 421,Residential,26950,86400,0,113350
190620101200000,SW 421,Residential,26950,86711,0,113661
190620101300000,SW 421,Residential,27225,79308,0,106533
190620101400000,SW 421,Residential,27225,86406,0,113631
190620101500000,SW 421,Residential,27225,80603,0,107828
190620101600000,SW 421,Residential,27225,86249,0,113474
190620101700000,SW 421,Residential,29552,96546,0,126098
190620101800000,SW 421,Residential,33069,86927,0,119996
190620101900000,SW 421,Residential,29540,92067,0,121607
190620102000000,SW 421,Residential,28600,48664,0,77264
190620102100000,SW 421,Residential,28600,81262,0,109862
190620102200000,SW 421,Residential,26000,98714,0,124714
190620102300000,SW 421,Residential,31200,93680,0,124880
190620102400000,SW 421,Residential,31882,87600,0,119482
190620102500000,SW 421,Residential,29662,88076,0,117738
190620102600000,SW 421,Residential,27500,73822,0,101322
190620102700000,SW 421,Residential,27500,74064,0,101564
190620102800000,SW 421,Residential,27500,96462,0,123962
190620102900000,SW 421,Residential,27500,85908,0,113408
190620103000000,SW 421,Residential,27500,70539,0,98039
190620103100000,SW 421,Residential,27500,90118,0,117618
190620103200000,SW 421,Residential,27500,89779,0,117279
190620103300000,SW 421,Residential,27500,81623,0,109123
190620103400000,SW 421,Residential,27500,75567,0,103067
190620103500000,SW 421,Residential,27500,85961,0,113461
190620103600000,SW 421,Residential,27500,56134,0,83634
190620103700000,SW 421,Residential,30000,84383,0,114383
190620103800000,SW 421,Residential,30000,95618,0,125618
190620103900000,SW 421,Residential,28500,84376,0,112876
190620104000000,SW 421,Residential,31715,90954,0,122669
190620104100000,SW 421,Residential,31570,81737,0,113307
190620104200000,SW 421,Residential,28500,75102,0,103602
190620104300000,SW 421,Residential,28500,83581,0,112081
190620104400000,SW 421,Residential,28500,83975,0,112475
190620104500000,SW 421,Residential,27500,71718,0,99218
190620104600000,SW 421,Residential,27500,75685,0,103185
190620104700000,SW 421,Residential,27500,73472,0,100972
190620104800000,SW 421,Residential,27500,84648,0,112148
190620104900000,SW 421,Residential,27500,81972,0,109472
190620105000000,SW 421,Residential,27500,85069,0,112569
190620105100000,SW 421,Residential,27500,100114,0,127614
190620105200000,SW 421,Residential,27500,76250,0,103750
190620105300000,SW 421,Residential,27500,85986,0,113486
190620105400000,SW 421,Residential,27500,81132,0,108632
190620105500000,SW 421,Residential,27500,92399,0,119899
190620105600000,SW 421,Residential,27500,80643,0,108143
190620105700000,SW 421,Residential,27500,80504,0,108004
190620105800000,SW 421,Residential,27500,85578,0,113078
190620105900000,SW 421,Residential,27500,87087,0,114587
190620106000000,SW 421,Residential,27500,83633,0,111133
190620106100000,SW 421,Residential,30566,102021,0,132587
190620106200000,SW 421,Residential,22732,84770,0,107502
190620106300000,SW 421,Residential,21412,87848,0,109260
190620106400000,SW 421,Residential,23028,92192,0,115220
190620106500000,SW 421,Residential,26422,92255,0,118677
190620106600000,SW 421,Residential,27472,105364,0,132836
190620106700000,SW 421,Residential,28280,96680,0,124960
190620106800000,SW 421,Residential,28280,95099,0,123379
190620106900000,SW 421,Residential,28000,86534,0,114534
190620107000000,SW 421,Residential,27093,85928,0,113021
190620107100000,E-40 CHURCHES,Exempt,70470,0,89878,160348
190620107200000,SW 418,Residential,7150,0,0,7150
190620107300000,SW 420,Residential,39242,164669,0,203911
190620107400000,SW 420,Residential,36300,167364,0,203664
190620107500000,SW 420,Residential,37206,161419,0,198625
190620107600000,SW 420,Residential,35678,167801,0,203479
190620107700000,SW 420,Residential,33405,185617,0,219022
190620107800000,SW 420,Residential,33278,176310,0,209588
190620107900000,SW 418,Residential,34300,167678,0,201978
190620108000000,SW 418,Residential,35963,227007,0,262970
190620108100000,SW 418,Residential,36023,162487,0,198510
190620108200000,SW 418,Residential,40698,174634,0,215332
190620108300000,SW 418,Residential,38048,157763,0,195811
190620108400000,SW 418,Residential,36907,203469,0,240376
190620108500000,SW 418,Residential,38950,208379,0,247329
190620108600000,SW 418,Residential,38154,189847,0,228001
190620108700000,SW 418,Residential,37333,143748,0,181081
190620108800000,SW 418,Residential,42229,221892,0,264121
190620108900000,SW 418,Residential,40417,218548,0,258965
190620109000000,SW 418,Residential,41045,183955,0,225000
190620109100000,SW 418,Residential,41329,161417,0,202746
190620109200000,SW 418,Residential,35350,164317,0,199667
190620109300000,SW 418,Residential,38873,174863,0,213736
190620109400000,SW 418,Residential,41613,249517,0,291130
190620109500000,SW 418,Residential,36865,181629,0,218494
190620109600000,SW 420,Residential,39483,176758,0,216241
190620109700000,SW 420,Residential,44820,187136,0,231956
190620200100000,SW 421,Residential,29601,101311,0,130912
190620200200000,SW 421,Residential,31580,88771,0,120351
190620200300000,SW 421,Residential,28500,85417,0,113917
190620200400000,SW 421,Residential,28500,74752,0,103252
190620200500000,SW 421,Residential,28500,91527,0,120027
190620200600000,SW 421,Residential,30000,74849,0,104849
190620200700000,SW 421,Residential,28500,77826,0,106326
190620200800000,SW 421,Residential,28500,77795,0,106295
190620200900000,SW 421,Residential,28500,87328,0,115828
190620201000000,SW 421,Residential,30000,57608,0,87608
190620201100000,SW 421,Residential,27500,78238,0,105738
190620201200000,SW 421,Residential,27500,77290,0,104790
190620201300000,SW 421,Residential,27500,84593,0,112093
190620201400000,SW 421,Residential,27500,82368,0,109868
190620201500000,SW 421,Residential,27500,72840,0,100340
190620201600000,SW 421,Residential,29452,72379,0,101831
190620201700000,SW 421,Residential,29155,89797,0,118952
190620201800000,SW 421,Residential,27225,83648,0,110873
190620201900000,SW 421,Residential,27225,87534,0,114759
190620202000000,SW 421,Residential,27225,81101,0,108326
190620202100000,SW 421,Residential,27225,84777,0,112002
190620202200000,SW 421,Residential,27225,76096,0,103321
190620202300000,SW 421,Residential,28215,94113,0,122328
190620202400000,SW 421,Residential,28215,88139,0,116354
190620202500000,SW 421,Residential,28215,89424,0,117639
190620202600000,SW 421,Residential,28215,87949,0,116164
190620202700000,SW 421,Residential,28215,87435,0,115650
190620202800000,SW 421,Residential,29700,92206,0,121906
190620202900000,SW 421,Residential,28215,91944,0,120159
190620203000000,SW 421,Residential,28215,92493,0,120708
190620300100000,Empty,Exempt,0,0,0,0
190620300200000,SW 420,Residential,39204,192836,0,232040
190620300300000,SW 420,Residential,34884,228317,0,263201
190620300400000,SW 420,Residential,36414,215716,0,252130
190620300500000,SW 420,Residential,36720,207500,0,244220
190620300600000,SW 420,Residential,35980,261441,0,297421
190620300700000,SW 420,Residential,37761,176197,0,213958
190620300800000,SW 420,Residential,36936,161930,0,198866
190620300900000,SW 420,Residential,37699,188787,0,226486
190620301000000,SW 420,Residential,41219,158361,0,199580
190620301100000,SW 420,Residential,42588,153719,0,196307
190620301200000,SW 420,Residential,39498,156620,0,196118
190620301300000,SW 420,Residential,40508,182034,0,222542
190620301400000,SW 420,Residential,36936,179226,0,216162
190620301500000,SW 420,Residential,36297,156925,0,193222
190620301600000,SW 420,Residential,34320,167482,0,201802
190620301700000,SW 420,Residential,36050,153807,0,189857
190620301800000,SW 420,Residential,35226,156397,0,191623
190620301900000,SW 420,Residential,33990,148847,0,182837
190620302000000,SW 420,Residential,36050,174062,0,210112
190620302100000,SW 420,Residential,36050,195904,0,231954
190620302200000,SW 420,Residential,37080,233979,0,271059
190620302300000,SW 418,Residential,38128,203819,0,241947
190620302400000,SW 418,Residential,32670,167330,0,200000
190620302500000,SW 418,Residential,34650,201764,0,236414
190620302600000,SW 418,Residential,34650,177225,0,211875
190620302700000,SW 420,Residential,42402,208735,0,251137
190620302800000,SW 420,Residential,43853,198667,0,242520
190622600100000,SW 421,Residential,28552,85240,0,113792
190622600200000,SW 421,Residential,26164,78801,0,104965
190622600300000,SW 421,Residential,24957,64895,0,89852
190622600400000,SW 421,Residential,25803,86822,0,112625
190622600500000,SW 421,Residential,22560,79236,0,101796
190622600600000,SW 421,Residential,22560,82013,0,104573
190622600700000,SW 421,Residential,23876,98209,0,122085
190622600800000,SW 421,Residential,23876,70771,0,94647
190622600900000,SW 421,Residential,22560,86587,0,109147
190622601000000,SW 421,Residential,22560,94020,0,116580
190622601100000,SW 421,Residential,22560,81687,0,104247
190622601200000,SW 421,Residential,22560,91903,0,114463
190622601300000,SW 421,Residential,23876,92193,0,116069
190622601400000,SW 421,Residential,23876,75647,0,99523
190622601500000,SW 421,Residential,22560,94892,0,117452
190622601600000,SW 421,Residential,22560,80307,0,102867
190622601700000,SW 421,Residential,22560,95653,0,118213
190622601800000,SW 421,Residential,25568,89593,0,115161
190622601900000,SW 421,Residential,31960,79371,0,111331
190622602000000,SW 421,Residential,28200,97463,0,125663
190622602100000,SW 421,Residential,28200,68949,0,97149
190622602200000,SW 421,Residential,28200,77954,0,106154
190622602300000,SW 421,Residential,29845,70792,0,100637
190622602400000,SW 421,Residential,29845,86287,0,116132
190622602500000,SW 421,Residential,28200,79270,0,107470
190622602600000,SW 421,Residential,28200,84869,0,113069
190622602700000,SW 421,Residential,28200,79774,0,107974
190622602800000,SW 421,Residential,28200,86951,0,115151
190622602900000,SW 421,Residential,29845,75849,0,105694
190622603000000,SW 421,Residential,29845,69344,0,99189
190622603100000,SW 421,Residential,28200,81835,0,110035
190622603200000,SW 421,Residential,28200,76187,0,104387
190622603300000,SW 421,Residential,28200,57219,0,85419
190622603400000,SW 421,Residential,28200,73836,0,102036
190622603500000,SW 421,Residential,30732,92431,0,123163
190622603600000,SW 421,Residential,31725,89872,0,121597
190622700100000,SW 421,Residential,19907,86905,0,106812
190622700200000,SW 421,Residential,19907,86424,0,106331
190622700300000,SW 421,Residential,28735,78506,0,107241
190622700400000,SW 421,Residential,26460,64577,0,91037
190622700500000,SW 421,Residential,26460,75455,0,101915
190622700600000,SW 421,Residential,26460,70067,0,96527
190622700700000,SW 421,Residential,25972,64590,0,90562
190622700800000,SW 421,Residential,25704,76712,0,102416
190622700900000,SW 421,Residential,25704,68726,0,94430
190622701000000,SW 421,Residential,25436,88853,0,114289
190622701100000,SW 421,Residential,25436,85047,0,110483
190622701200000,SW 421,Residential,29610,76745,0,106355
190622800100000,SW 421,Residential,31725,95225,0,126950
190622800200000,SW 421,Residential,32187,76655,0,108842
190622800300000,SW 421,Residential,28200,83094,0,111294
190622800400000,SW 421,Residential,28200,84024,0,112224
190622800500000,SW 421,Residential,28200,91823,0,120023
190622800600000,SW 421,Residential,28200,88957,0,117157
190622800700000,SW 421,Residential,29845,83382,0,113227
190622800800000,SW 421,Residential,29845,66991,0,96836
190622800900000,SW 421,Residential,28200,86354,0,114554
190622801000000,SW 421,Residential,28200,87228,0,115428
190622801100000,SW 421,Residential,28200,83866,0,112066
190622801200000,SW 421,Residential,28200,83036,0,111236
190622801300000,SW 421,Residential,29845,91662,0,121507
190622801400000,SW 421,Residential,29845,80779,0,110624
190622801500000,SW 421,Residential,28200,84125,0,112325
190622801600000,SW 421,Residential,28200,78349,0,106549
190622801700000,SW 421,Residential,28200,90286,0,118486
190622801800000,SW 421,Residential,30362,86490,0,116852
190622801900000,SW 421,Residential,30362,79758,0,110120
190622802000000,SW 421,Residential,28200,93668,0,121868
190622802100000,SW 421,Residential,28200,79642,0,107842
190622802200000,SW 421,Residential,28200,81211,0,109411
190622802300000,SW 421,Residential,29845,89502,0,119347
190622802400000,SW 421,Residential,29845,76707,0,106552
190622802500000,SW 421,Residential,28200,90235,0,118435
190622802600000,SW 421,Residential,28200,94047,0,122247
190622802700000,SW 421,Residential,28200,79289,0,107489
190622802800000,SW 421,Residential,28200,97552,0,125752
190622802900000,SW 421,Residential,29845,85035,0,114880
190622803000000,SW 421,Residential,29845,82503,0,112348
190622803100000,SW 421,Residential,28200,92286,0,120486
190622803200000,SW 421,Residential,28200,87778,0,115978
190622803300000,SW 421,Residential,28200,82872,0,111072
190622803400000,SW 421,Residential,28200,81360,0,109560
190622803500000,SW 421,Residential,33848,68600,0,102448
190622803600000,SW 421,Residential,31725,77189,0,108914
190622900100000,SW 421,Residential,30600,89159,0,119759
190622900200000,SW 421,Residential,29100,86085,0,115185
190622900300000,SW 421,Residential,29949,80659,0,110608
190622900400000,SW 421,Residential,29416,87457,0,116873
190622900500000,SW 421,Residential,28200,78635,0,106835
190622900600000,SW 421,Residential,28200,80173,0,108373
190622900700000,SW 421,Residential,28200,86871,0,115071
190622900800000,SW 421,Residential,28200,88116,0,116316
190622900900000,SW 421,Residential,28200,76318,0,104518
190622901000000,SW 421,Residential,28200,62669,0,90869
190622901100000,SW 421,Residential,28200,84837,0,113037
190622901200000,SW 421,Residential,28200,75031,0,103231
190622901300000,SW 421,Residential,27645,82863,0,110508
190622901400000,SW 421,Residential,27751,74811,0,102562
190622901500000,SW 421,Residential,28200,76770,0,104970
190622901600000,SW 421,Residential,28200,81471,0,109671
190622901700000,SW 421,Residential,28200,81191,0,109391
190622901800000,SW 421,Residential,28200,81402,0,109602
190622901900000,SW 421,Residential,28200,82636,0,110836
190622902000000,SW 421,Residential,28200,76175,0,104375
190622902100000,SW 421,Residential,28200,76681,0,104881
190622902200000,SW 421,Residential,28200,92403,0,120603
190622902300000,SW 421,Residential,28520,71210,0,99730
190623000100000,SW 421,Residential,29949,81392,0,111341
190623000200000,SW 421,Residential,28701,74589,0,103290
190623000300000,SW 421,Residential,29100,66425,0,95525
190623000400000,SW 421,Residential,29100,75358,0,104458
190623000500000,SW 421,Residential,29100,79264,0,108364
190623000600000,SW 421,Residential,27160,91832,0,118992
190623000700000,SW 421,Residential,27160,78577,0,105737
190623000800000,SW 421,Residential,27160,90226,0,117386
190623000900000,SW 421,Residential,28130,92161,0,120291
190623001000000,SW 421,Residential,28130,82318,0,110448
190623001100000,SW 421,Residential,27160,73753,0,100913
190623001200000,SW 421,Residential,27160,92343,0,119503
190623001300000,SW 421,Residential,27160,80997,0,108157
190623001400000,SW 421,Residential,27160,73188,0,100348
190623001500000,SW 421,Residential,30555,93105,0,123660
190623001600000,SW 421,Residential,30555,89131,0,119686
190623001700000,SW 421,Residential,27160,86335,0,113495
190623001800000,SW 421,Residential,27160,85204,0,112364
190623001900000,SW 421,Residential,27160,84493,0,111653
190623002000000,SW 421,Residential,27160,79141,0,106301
190623002100000,SW 421,Residential,28130,79606,0,107736
190623002200000,SW 421,Residential,28130,82179,0,110309
190623002300000,SW 421,Residential,27160,79166,0,106326
190623002400000,SW 421,Residential,27160,91103,0,118263
190623002500000,SW 421,Residential,27160,91629,0,118789
190623002600000,SW 421,Residential,29100,93906,0,123006
190623002700000,SW 421,Residential,29100,77525,0,106625
190623002800000,SW 421,Residential,29100,84705,0,113805
190623002900000,SW 421,Residential,30570,80957,0,111527
190623003000000,SW 421,Residential,31525,90438,0,121963
190623100100000,SW 421,Residential,30550,96576,0,127126
190623100200000,SW 421,Residential,28639,84930,0,113569
190623100300000,SW 421,Residential,28200,75349,0,103549
190623100400000,SW 421,Residential,28200,74392,0,102592
190623100500000,SW 421,Residential,28200,81925,0,110125
190623100600000,SW 421,Residential,28200,86937,0,115137
190623100700000,SW 421,Residential,28200,96536,0,124736
190623100800000,SW 421,Residential,28200,76442,0,104642
190623100900000,SW 421,Residential,28200,77878,0,106078
190623101000000,SW 421,Residential,28701,74065,0,102766
190623101100000,SW 421,Residential,28526,78175,0,106701
190623101200000,SW 421,Residential,28200,72385,0,100585
190623101300000,SW 421,Residential,28200,66299,0,94499
190623101400000,SW 421,Residential,28200,89964,0,118164
190623101500000,SW 421,Residential,28200,92833,0,121033
190623101600000,SW 421,Residential,28200,74036,0,102236
190623101700000,SW 421,Residential,28200,93439,0,121639
190623101800000,SW 421,Residential,28200,92773,0,120973
190623101900000,SW 421,Residential,28701,81884,0,110585
190623102000000,SW 421,Residential,30550,79699,0,110249
190623200100000,SW 421,Residential,30005,86509,0,116514
190623200200000,SW 421,Residential,28200,81513,0,109713
190623200300000,SW 421,Residential,28200,80921,0,109121
190623200400000,SW 421,Residential,28200,68224,0,96424
190623200500000,SW 421,Residential,25380,79554,0,104934
190623200600000,SW 421,Residential,27754,72999,0,100753
190623200700000,E-44 PARSONAGE-MANSE,Exempt,64260,0,309675,373935
190623200800000,SW 421,Residential,31392,137781,0,169173
190623200900000,SW 421,Residential,28666,87428,0,116094
190623201000000,SW 421,Residential,23970,98913,0,122883
190623201100000,SW 421,Residential,24480,97343,0,121823
190623201200000,SW 421,Residential,26702,95427,0,122129
190623201300000,SW 421,Residential,30550,97587,0,128137
190623201400000,SW 421,Residential,30550,82074,0,112624
190623201500000,SW 421,Residential,30550,74423,0,104973
190623201600000,SW 421,Residential,29370,87936,0,117306
190623300100000,SW 421,Residential,30550,83446,0,113996
190623300200000,SW 421,Residential,28639,78721,0,107360
190623300300000,SW 421,Residential,28200,82567,0,110767
190623300400000,SW 421,Residential,28200,84269,0,112469
190623300500000,SW 421,Residential,28200,90831,0,119031
190623300600000,SW 421,Residential,28200,81120,0,109320
190623300700000,SW 421,Residential,28200,89662,0,117862
190623300800000,SW 421,Residential,28200,84717,0,112917
190623300900000,SW 421,Residential,28200,82225,0,110425
190623301000000,SW 421,Residential,28701,93192,0,121893
190623301100000,SW 421,Residential,23043,97607,0,120650
190623301200000,SW 421,Residential,22309,94059,0,116368
190623301300000,SW 421,Residential,22320,75622,0,97942
190623301400000,SW 421,Residential,22320,87199,0,109519
190623301500000,SW 421,Residential,22320,84852,0,107172
190623301600000,SW 421,Residential,22080,76126,0,98206
190623301700000,SW 421,Residential,22080,78821,0,100901
190623301800000,SW 421,Residential,21840,97972,0,119812
190623301900000,SW 421,Residential,22095,79482,0,101577
190623302000000,SW 421,Residential,23660,89097,0,112757
190625100100000,SW 421,Residential,22944,81749,0,104693
190625100200000,SW 421,Residential,25768,96543,0,122311
190625100300000,SW 421,Residential,26220,97562,0,123782
190625100400000,SW 421,Residential,26617,90614,0,117231
190625100500000,SW 421,Residential,26676,97043,0,123719
190625100600000,SW 421,Residential,27876,85058,0,112934
190625100700000,SW 421,Residential,27472,96691,0,124163
190625100800000,SW 421,Residential,26917,89690,0,116607
190625100900000,SW 421,Residential,27504,70715,0,98219
190625101000000,SW 421,Residential,27504,102267,0,129771
190625101100000,SW 421,Residential,25632,88678,0,114310
190625101200000,SW 421,Residential,26313,83352,0,109665
190625101300000,SW 421,Residential,26136,93655,0,119791
190625101400000,SW 421,Residential,24997,85712,0,110709
190625101500000,SW 421,Residential,31882,89900,0,121782
190625101600000,SW 421,Residential,29315,84162,0,113477
190625101700000,SW 421,Residential,24997,90928,0,115925
190625101800000,SW 421,Residential,24008,85604,0,109612
190625101900000,SW 421,Residential,24008,95977,0,119985
190625102000000,SW 421,Residential,27228,88702,0,115930
190625102100000,SW 421,Residential,29812,92543,0,122355
190625102200000,SW 421,Residential,27022,83860,0,110882
190625102300000,SW 421,Residential,26496,85348,0,111844
190625102400000,SW 421,Residential,26592,86825,0,113417
190625102500000,SW 421,Residential,26463,80923,0,107386
190625102600000,SW 421,Residential,26849,88962,0,115811
190625102700000,SW 421,Residential,29563,85232,0,114795
190625102800000,SW 421,Residential,26045,90639,0,116684
190625102900000,SW 421,Residential,26649,94839,0,121488
190625103000000,SW 421,Residential,28400,100852,0,129252
190625103100000,SW 421,Residential,26520,96201,0,122721
190625103200000,SW 421,Residential,27936,92075,0,120011
190625103300000,SW 421,Residential,25920,87208,0,113128
190625103400000,SW 421,Residential,27702,87096,0,114798
190625103500000,SW 421,Residential,26362,74274,0,100636
190625103600000,SW 421,Residential,25852,80195,0,106047
190625103700000,SW 421,Residential,23808,97119,0,120927
190625103800000,SW 421,Residential,23760,82746,0,106506
190625103900000,SW 421,Residential,23796,93847,0,117643
190625104000000,SW 421,Residential,23981,86474,0,110455
190625104100000,SW 429,Residential,17854,156367,0,174221
190625104200000,SW 429,Residential,18540,110070,0,128610
190625104300000,SW 429,Residential,18540,136442,0,154982
190625104400000,SW 429,Residential,18540,134142,0,152682
190625105500000,SW 429,Residential,18540,146086,0,164626
190625105600000,SW 429,Residential,18540,155357,0,173897
190625105700000,SW 429,Residential,18540,139728,0,158268
190625105800000,SW 429,Residential,18360,130802,0,149162
190625105900000,SW 429,Residential,18360,124917,0,143277
190625106000000,SW 429,Residential,19075,162644,0,181719
190625106100000,SW 429,Residential,26610,150615,0,177225
190625106300000,SW 429,Residential,21083,154644,0,175727
190625106400000,SW 429,Residential,22159,147444,0,169603
190625106500000,SW 429,Residential,24752,150436,0,175188
190625106600000,SW 429,Residential,21482,154599,0,176081
190625106700000,SW 429,Residential,19507,141309,0,160816
190625106800000,SW 429,Residential,20655,161506,0,182161
190625106900000,SW 429,Residential,21693,138788,0,160481
190625107000000,SW 429,Residential,21128,151317,0,172445
190625107100000,SW 429,Residential,20639,174704,0,195343
190625107200000,SW 429,Residential,21588,160812,0,182400
190625107300000,SW 429,Residential,21043,124172,0,145215
190625107400000,SW 429,Residential,20452,141896,0,162348
190625200100000,SW 421,Residential,28585,79554,0,108139
190625200200000,SW 421,Residential,26313,91177,0,117490
190625200300000,SW 421,Residential,27254,96836,0,124090
190625200400000,SW 421,Residential,26581,84551,0,111132
190625200500000,SW 421,Residential,26522,82399,0,108921
190625200600000,SW 421,Residential,26945,107853,0,134798
190625200700000,SW 421,Residential,26646,99989,0,126635
190625200800000,SW 421,Residential,26460,98864,0,125324
190625200900000,SW 421,Residential,28764,84743,0,113507
190625201000000,SW 421,Residential,26936,89668,0,116604
190625201100000,SW 421,Residential,28764,94461,0,123225
190625201200000,SW 421,Residential,27369,90012,0,117381
190625201300000,SW 421,Residential,27150,91159,0,118309
190625201400000,SW 421,Residential,27105,97028,0,124133
190625201500000,SW 421,Residential,27105,99200,0,126305
190625201600000,SW 421,Residential,27105,96844,0,123949
190625201700000,SW 421,Residential,27930,84699,0,112629
190625300100000,SW 429,Residential,18314,150992,0,169306
190625300200000,SW 429,Residential,24725,138177,0,162902
190625300300000,SW 429,Residential,24970,122379,0,147349
190625300400000,SW 429,Residential,26538,150515,0,177053
190625300501000,CONDO 501,Residential,11000,99815,0,110815
190625300501001,CONDO 501,Residential,11000,99281,0,110281
190625300501002,CONDO 501,Residential,13000,89563,0,102563
190625300501003,CONDO 501,Residential,14000,100115,0,114115
190625300501004,CONDO 501,Residential,11000,107496,0,118496
190625300501005,CONDO 501,Residential,11000,115067,0,126067
190625300501006,CONDO 501,Residential,11000,115617,0,126617
190625300501007,CONDO 501,Residential,11000,112618,0,123618
190625300601000,CONDO 501,Residential,9000,94358,0,103358
190625300601001,CONDO 501,Residential,10000,112507,0,122507
190625300601002,CONDO 501,Residential,9000,95896,0,104896
190625300701000,CONDO 501,Residential,8000,94574,0,102574
190625300701001,CONDO 501,Residential,8000,94736,0,102736
190625300701002,CONDO 501,Residential,8000,94169,0,102169
190625300701003,CONDO 501,Residential,8000,93460,0,101460
190625300801000,CONDO 500,Residential,4000,55009,0,59009
190625300801001,CONDO 500,Residential,4000,55009,0,59009
190625300801002,CONDO 500,Residential,4000,55009,0,59009
190625300801003,CONDO 500,Residential,4000,55009,0,59009
190625300801004,CONDO 500,Residential,4000,55380,0,59380
190625300801005,CONDO 500,Residential,4000,55380,0,59380
190625300801006,CONDO 500,Residential,4000,55380,0,59380
190625300801007,CONDO 500,Residential,4000,55380,0,59380
190625300901000,CONDO 500,Residential,4000,55009,0,59009
190625300901001,CONDO 500,Residential,4000,55009,0,59009
190625300901002,CONDO 500,Residential,4000,55009,0,59009
190625300901003,CONDO 500,Residential,4000,55009,0,59009
190625300901004,CONDO 500,Residential,4000,55380,0,59380
190625300901005,CONDO 500,Residential,4000,55380,0,59380
190625300901006,CONDO 500,Residential,4000,55380,0,59380
190625300901007,CONDO 500,Residential,4000,55380,0,59380
190625301001000,CONDO 500,Residential,4000,54970,0,58970
190625301001001,CONDO 500,Residential,4000,54970,0,58970
190625301001002,CONDO 500,Residential,4000,54970,0,58970
190625301001003,CONDO 500,Residential,4000,54970,0,58970
190625301001004,CONDO 500,Residential,4000,55341,0,59341
190625301001005,CONDO 500,Residential,4000,55341,0,59341
190625301001006,CONDO 500,Residential,4000,51858,0,55858
190625301001007,CONDO 500,Residential,4000,51858,0,55858
190625301400000,SW 429,Residential,18540,137930,0,156470
190625301500000,SW 429,Residential,18540,134359,0,152899
190625301600000,SW 429,Residential,18540,120007,0,138547
190625301700000,SW 429,Residential,18540,126381,0,144921
190625301800000,SW 429,Residential,19706,156823,0,176529
190625301900000,SW 429,Residential,18540,144653,0,163193
190625302000000,SW 429,Residential,18540,148468,0,167008
190625302100000,SW 429,Residential,18540,131374,0,149914
190625302200000,SW 429,Residential,18540,143139,0,161679
190625302300000,SW 429,Residential,20181,132960,0,153141
190625302400000,SW 429,Residential,18540,126999,0,145539
190625302500000,SW 429,Residential,20184,112802,0,132986
190625302600000,SW 429,Residential,18540,153550,0,172090
190625302700000,SW 429,Residential,18540,127417,0,145957
190625302800000,SW 429,Residential,18540,153417,0,171957
190625302900000,SW 429,Residential,18540,149220,0,167760
190625303000000,SW 429,Residential,18540,127700,0,146240
190625303100000,SW 429,Residential,18540,169459,0,187999
190625303200000,SW 429,Residential,18540,142622,0,161162
190625303301000,CONDO 500,Residential,4000,54970,0,58970
190625303301001,CONDO 500,Residential,4000,54970,0,58970
190625303301002,CONDO 500,Residential,4000,54970,0,58970
190625303301003,CONDO 500,Residential,4000,54970,0,58970
190625303301004,CONDO 500,Residential,4000,55341,0,59341
190625303301005,CONDO 500,Residential,4000,55341,0,59341
190625303301006,CONDO 500,Residential,4000,55341,0,59341
190625303301007,CONDO 500,Residential,4000,55341,0,59341
190625303401000,CONDO 500,Residential,4000,56889,0,60889
190625303401001,CONDO 500,Residential,4000,56889,0,60889
190625303401002,CONDO 500,Residential,4000,56889,0,60889
190625303401003,CONDO 500,Residential,4000,56889,0,60889
190625303401004,CONDO 500,Residential,4000,57272,0,61272
190625303401005,CONDO 500,Residential,4000,57272,0,61272
190625303401006,CONDO 500,Residential,4000,57272,0,61272
190625303401007,CONDO 500,Residential,4000,57272,0,61272
190625303501000,CONDO 500,Residential,4000,56889,0,60889
190625303501001,CONDO 500,Residential,4000,56889,0,60889
190625303501002,CONDO 500,Residential,4000,56889,0,60889
190625303501003,CONDO 500,Residential,4000,56889,0,60889
190625303501004,CONDO 500,Residential,4000,57272,0,61272
190625303501005,CONDO 500,Residential,4000,57272,0,61272
190625303501006,CONDO 500,Residential,4000,57272,0,61272
190625303501007,CONDO 500,Residential,4000,57272,0,61272
190625304500000,SW 429,Residential,18540,153376,0,171916
190625304600000,SW 429,Residential,18540,145559,0,164099
190625304700000,SW 429,Residential,18540,144116,0,162656
190625304800000,SW 429,Residential,18540,175275,0,193815
190625304900000,SW 429,Residential,18540,136568,0,155108
190625305000000,SW 429,Residential,20255,143262,0,163517
190625305100000,SW 429,Residential,20252,137863,0,158115
190625305200000,SW 429,Residential,18540,155080,0,173620
190625305300000,SW 429,Residential,18540,139911,0,158451
190625305400000,SW 429,Residential,18540,153161,0,171701
190625400100000,SW 429,Residential,24763,126469,0,151232
190625400200000,SW 421,Residential,36391,82232,0,118623
190625400300000,APTS SW,Commercial,191160,0,1640196,1831356
190625400400000,COMM SW,Commercial,250290,0,0,250290
190625400500000,COMM SW,Commercial,235467,0,517308,752775
190625400600000,COMM SW,Commercial,103140,0,416538,519678
190627600100000,SW 418,Residential,66550,97162,0,163712
190627600200000,SW 418,Residential,66550,57962,0,124512
190627600300000,SW 418,Residential,35640,109991,0,145631
190627600400000,SW 418,Residential,46900,92171,0,139071
190627600500000,SW 418,Residential,46350,45003,0,91353
190627600600000,SW 421,Residential,25380,39506,0,64886
190627600900000,SW 421,Residential,45747,146335,0,192082
190627601000000,SW 421,Residential,40680,83954,0,124634
190627601100000,SW 418,Residential,80200,111429,0,191629
190627601200000,SW 418,Residential,73450,253842,0,327292
190627601300000,SW 418,Residential,60000,119621,0,179621
190627601400000,SW 418,Residential,73500,174674,0,248174
190627601500000,SW 429,Residential,53340,82784,0,136124
190627601600000,SW 429,Residential,29400,0,0,29400
190627601700000,SW 429,Residential,32550,262240,0,294790
190627601800000,SW 429,Exempt,0,0,0,0
190627601900000,SW 429,Residential,26705,0,0,26705
190627602000000,SW 429,Residential,29376,0,0,29376
190627602100000,SW 429,Residential,29376,247970,0,277346
190627602200000,SW 429,Residential,32550,238709,0,271259
190627602300000,SW 429,Residential,32550,263626,0,296176
190627602400000,SW 429,Residential,32550,278317,0,310867
190627602500000,SW 429,Residential,29566,288909,0,318475
190627602600000,SW 429,Residential,29566,239133,0,268699
190627602700000,SW 429,Residential,29295,70185,0,99480
190627602800000,SW 429,Exempt,0,0,0,0
190627602900000,SW 429,Residential,28420,214495,0,242915
190627603000000,SW 429,Residential,62937,271206,0,334143
190627700100000,SW 429,Residential,33170,0,0,33170
190627700200000,SW 429,Residential,31446,0,0,31446
190627700300000,SW 429,Residential,31446,234183,0,265629
190627700400000,SW 429,Residential,31446,234675,0,266121
190627700500000,SW 429,Residential,31446,225019,0,256465
190627700600000,SW 429,Residential,31446,261053,0,292499
190627700700000,SW 429,Residential,31446,0,0,31446
190627700800000,SW 429,Residential,31029,0,0,31029
190627800100000,SW 429,Residential,31238,0,0,31238
190627800200000,SW 429,Residential,28256,0,0,28256
190627800300000,SW 429,Residential,28256,0,0,28256
190627800600000,SW 429,Residential,35868,0,0,35868
190627800700000,SW 429,Residential,48855,373380,0,422235
190630100100000,SW 418,Residential,43820,111711,0,155531
190630100200000,SW 418,Residential,44345,222058,0,266403
190630100300000,SW 418,Residential,51280,0,0,51280
190630100400000,SW 418,Residential,79350,219643,0,298993
190630100600000,SW 429,Residential,25916,155772,0,181688
190630100700000,SW 429,Residential,23814,147873,0,171687
190630100800000,SW 429,Residential,23814,137407,0,161221
190630100900000,SW 429,Residential,23814,148988,0,172802
190630101000000,SW 429,Residential,23814,160315,0,184129
190630101100000,SW 429,Residential,23814,144744,0,168558
190630101200000,SW 429,Residential,25940,147485,0,173425
190630101300000,SW 429,Residential,26008,149227,0,175235
190630101400000,SW 429,Residential,23814,137783,0,161597
190630101500000,SW 429,Residential,23814,159431,0,183245
190630101600000,SW 429,Residential,23814,141113,0,164927
190630101700000,SW 429,Residential,23814,155747,0,179561
190630101800000,SW 429,Residential,23814,149205,0,173019
190630101900000,SW 429,Residential,25822,135182,0,161004
190630200100000,Empty,Exempt,0,0,0,0
190630200200000,SW 429,Residential,23744,144900,0,168644
190630200300000,SW 429,Residential,24411,135605,0,160016
190630200400000,SW 429,Residential,24486,138641,0,163127
190630200500000,SW 429,Residential,24486,162116,0,186602
190630200600000,SW 429,Residential,24486,156195,0,180681
190630200700000,SW 429,Residential,27166,151103,0,178269
190630200800000,SW 429,Residential,24486,155949,0,180435
190630300100000,SW 429,Residential,26434,142209,0,168643
190630300200000,SW 429,Residential,24035,156759,0,180794
190630300300000,SW 429,Residential,23814,140919,0,164733
190630300400000,SW 429,Residential,23814,141771,0,165585
190630300500000,SW 429,Residential,23814,142497,0,166311
190630300600000,SW 429,Residential,23814,141948,0,165762
190630300700000,SW 429,Residential,25696,139517,0,165213
190630400100000,SW 429,Residential,26984,259617,0,286601
190630400200000,SW 429,Residential,23436,159746,0,183182
190630400300000,SW 429,Residential,23436,166564,0,190000
190630400400000,SW 429,Residential,23436,139172,0,162608
190630400500000,SW 429,Residential,23436,128888,0,152324
190630400600000,SW 429,Residential,23436,160788,0,184224
190630400700000,SW 429,Residential,23436,133784,0,157220
190630400800000,SW 429,Residential,23436,169161,0,192597
190630400900000,SW 429,Residential,23436,152564,0,176000
190630401000000,SW 429,Residential,24459,171913,0,196372
190632600100000,SW 429,Residential,24320,145652,0,169972
190632600200000,SW 429,Residential,24253,145387,0,169640
190632600300000,SW 429,Residential,22491,164096,0,186587
190632600400000,SW 429,Residential,22491,146680,0,169171
190632600500000,SW 429,Residential,22491,141935,0,164426
190632600600000,SW 429,Residential,22491,150868,0,173359
190632600700000,SW 429,Residential,22491,139509,0,162000
190632600800000,SW 429,Residential,24276,157506,0,181782
190632600900000,SW 429,Residential,24276,158224,0,182500
190632601000000,SW 429,Residential,22491,137177,0,159668
190632601100000,SW 429,Residential,22491,138586,0,161077
190632601200000,SW 429,Residential,22491,159769,0,182260
190632601300000,SW 429,Residential,22491,135998,0,158489
190632601400000,SW 429,Residential,22491,138466,0,160957
190632700100000,SW 429,Residential,24192,151574,0,175766
190632700200000,SW 429,Residential,24125,157275,0,181400
190632700300000,SW 429,Residential,22491,135611,0,158102
190632700400000,SW 429,Residential,22491,134106,0,156597
190632700500000,SW 429,Residential,22491,149122,0,171613
190632700600000,SW 429,Residential,22491,147040,0,169531
190632700700000,SW 429,Residential,22491,122334,0,144825
190632700800000,SW 429,Residential,24276,168033,0,192309
190632700900000,SW 429,Residential,24276,144304,0,168580
190632701000000,SW 429,Residential,22491,139992,0,162483
190632701100000,SW 429,Residential,22491,138025,0,160516
190632701200000,SW 429,Residential,22491,134886,0,157377
190632701300000,SW 429,Residential,22491,166291,0,188782
190632701400000,SW 429,Residential,22491,128143,0,150634
190632800200000,COMM SW,Commercial,485634,0,1168272,1653906
190632800300000,COMM SW,Commercial,258211,0,599714,857925
190632900100000,SW 429,Residential,26712,126148,0,152860
190632900200000,SW 429,Residential,26712,153187,0,179899
190632900300000,SW 429,Residential,23744,150565,0,174309
190632900400000,SW 429,Residential,23744,144292,0,168036
190632900500000,SW 429,Residential,23744,160633,0,184377
190632900600000,SW 429,Residential,23744,144735,0,168479
190632900700000,SW 429,Residential,23744,137398,0,161142
190632900800000,SW 429,Residential,23744,133180,0,156924
190632900900000,SW 429,Residential,24041,160895,0,184936
190632901000000,SW 429,Residential,23744,164112,0,187856
190633000100000,SW 429,Residential,26091,162155,0,188246
190633000200000,SW 429,Residential,24035,147851,0,171886
190633000300000,SW 429,Residential,24035,161797,0,185832
190633000400000,SW 429,Residential,24035,140138,0,164173
190633000500000,SW 429,Residential,24035,142652,0,166687
190633000600000,SW 429,Residential,24035,142552,0,166587
190633000700000,SW 429,Residential,25942,156952,0,182894
190635100100000,COMM SW,Commercial,363744,0,2551943,2915687
190635100300000,COMM SW,Commercial,201690,0,0,201690
190637600200000,COMM SW,Commercial,237060,0,249744,486804
190637600300000,COMM SW,Commercial,430002,0,1639075,2069077
190637600400000,COMM SW,Commercial,200000,0,0,200000
190640100100000,SW 418,Ag Dwelling,21198,223796,964,245958
190640100200000,Empty,Exempt,0,0,0,0
190640100300000,Empty,Other,0,0,0,0
190640200100000,SW 418,Residential,35200,148919,0,184119
190642600200000,Empty,Exempt,0,0,0,0
190642600300000,SW 418,Residential,48576,80976,0,129552
190642600400000,SW 418,Residential,35407,54160,0,89567
190642600500000,SW 418,Residential,31444,74813,0,106257
190642600600000,SW 418,Residential,63700,1140,0,64840
190645100100000,Empty,Exempt,0,0,0,0
190645200100000,INDUSTRIAL,Industrial,6345,0,0,6345
190647600100000,Empty,Exempt,0,0,0,0
190647600200000,Empty,Other,0,0,0,0
190647700100000,INDUSTRIAL,Industrial,26220,0,0,26220
190647700102000,COMM SW,Commercial,0,0,55634,55634
190710100100000,INDUSTRIAL,Industrial,10140,0,0,10140
190710200100000,Empty,Other,0,0,0,0
190710200102000,COMM SW,Commercial,0,0,38305,38305
190712600100000,Empty,Other,0,0,0,0
190712600200000,SW 418,Ag Land,25907,0,0,25907
190715100100000,SW 418,Ag Land,30189,0,0,30189
190720100100000,Empty,Other,0,0,0,0
190720200100000,Empty,Exempt,0,0,0,0
190720200200000,COMM SW,Commercial,1037,0,0,1037
190722600100000,COMM SW,Commercial,351534,0,0,351534
190722600200000,Empty,Exempt,0,0,0,0
190722700100000,Empty,Exempt,0,0,0,0
190722700200000,Empty,Other,0,0,0,0
190727600100000,SW 418,Ag Land,2205,0,0,2205
190727700100000,COMM SW,Commercial,176640,0,43467,220107
190730100100000,COMM SW,Commercial,199779,0,0,199779
190732600300000,COMM SW,Commercial,116871,0,87640,204511
190732600400000,SW 418,Residential,60000,136945,0,196945
190735100100000,SW 418,Ag Land,49153,0,0,49153
190735100200000,Empty,Other,0,0,0,0
190737600100000,COMM SW,Commercial,206890,0,0,206890
190742600100000,SW 418,Ag Land,47856,0,0,47856
190745100100000,INDUSTRIAL,Industrial,949775,0,0,949775
190747600100000,SW 418,Ag Land,17619,0,0,17619
190810100100000,E-69 AGRI ASSN,Exempt,1608908,0,1964587,3573495
190810100102000,COMM SW,Commercial,0,0,8081,8081
190812600100000,COMM SW,Commercial,31104,0,25164,56268
190812700100000,SW 418,Residential,49250,0,0,49250
190812700200000,SW 418,Residential,71250,105989,0,177239
190812700300000,Empty,Exempt,0,0,0,0
190815100100000,INDUSTRIAL,Industrial,202100,0,1223391,1425491
190820100100000,INDUSTRIAL,Industrial,38790,0,0,38790
190820200100000,Empty,Other,0,0,0,0
190820200200000,Empty,Other,0,0,0,0
190822600100000,INDUSTRIAL,Industrial,12225,0,0,12225
190822600102000,COMM SW,Commercial,0,0,11075,11075
190822700100000,Empty,Other,0,0,0,0
190825100100000,Empty,Other,0,0,0,0
190825200100000,INDUSTRIAL,Industrial,2422850,0,13327150,15750000
190827600400000,INDUSTRIAL,Industrial,1392950,0,30761082,32154032
190830100300000,COMM SW,Commercial,201906,0,406123,608029
190830100400000,COMM SW,Commercial,35964,0,15702,51666
190830100500000,Empty,Exempt,0,0,0,0
190830100600000,COMM SW,Commercial,85860,0,317342,403202
190830100700000,INDUSTRIAL,Industrial,150000,0,0,150000
190830100800000,COMM SW,Commercial,62775,0,233136,295911
190830100900000,COMM SW,Commercial,42525,0,94104,136629
190830101000000,COMM SW,Commercial,93960,0,225125,319085
190830101100000,Empty,Exempt,0,0,0,0
190830101200000,INDUSTRIAL,Industrial,186500,0,395483,581983
190830101300000,Empty,Other,0,0,0,0
190835100100000,SW 418,Ag Land,36333,0,0,36333
190837600200000,COMM SW,Commercial,224910,0,123529,348439
190837600300000,COMM SW,Commercial,220698,0,380498,601196
190837600400000,COMM SW,Commercial,216648,0,358440,575088
190837600500000,COMM SW,Commercial,216000,0,434372,650372
190840100100000,INDUSTRIAL,Industrial,182325,0,337675,520000
190840100200000,INDUSTRIAL,Industrial,9920,0,0,9920
190840100300000,SW 418,Residential,19500,0,0,19500
190840100400000,COMM SW,Commercial,123930,0,245794,369724
190840100500000,INDUSTRIAL,Industrial,224640,0,394904,619544
190840100600000,COMM SW,Commercial,28350,0,0,28350
190840100700000,INDUSTRIAL,Industrial,48187,0,92428,140615
190840100800000,E-70 CHARITY OTHER,Exempt,288630,0,2236718,2525348
190840100900000,INDUSTRIAL,Industrial,222912,0,1523197,1746109
190842600100000,SW 418,Residential,43000,76118,0,119118
190842600200000,SW 418,Residential,31279,47867,0,79146
190842700400000,INDUSTRIAL,Industrial,440150,0,4016072,4456222
190845100300000,INDUSTRIAL,Industrial,124900,0,71515,196415
190845100500000,INDUSTRIAL,Industrial,113100,0,116091,229191
190845100600000,INDUSTRIAL,Industrial,86900,0,387660,474560
190845100700000,Empty,Other,0,0,0,0
190845100800000,INDUSTRIAL,Industrial,460850,0,2204618,2665468
190845101000000,INDUSTRIAL,Industrial,74250,0,240093,314343
190845101400000,INDUSTRIAL,Industrial,454700,0,9534443,9989143
190847600200000,COMM SW,Commercial,314658,0,826927,1141585
190847600300000,INDUSTRIAL,Industrial,190000,0,501604,691604
190847600400000,COMM SW,Commercial,116640,0,452617,569257
190847600500000,COMM SW,Commercial,67959,0,177773,245732
190847600600000,COMM SW,Commercial,67959,0,147459,215418
190847600700000,COMM SW,Commercial,41877,0,83751,125628
190847600800000,COMM SW,Commercial,57834,0,84985,142819
190847600900000,COMM SW,Commercial,729,0,0,729
190847601000000,COMM SW,Commercial,165402,0,444690,610092
190847601100000,COMM SW,Commercial,106312,0,0,106312
190847601200000,COMM SW,Commercial,151470,0,177092,328562
190847601300000,COMM SW,Commercial,67959,0,229416,297375
190847601400000,COMM SW,Commercial,67959,0,66066,134025
190847601500000,COMM SW,Commercial,92664,0,112561,205225
190847601600000,COMM SW,Commercial,182520,0,459605,642125
190847601700000,COMM SW,Commercial,96660,0,337544,434204
190847601800000,COMM SW,Commercial,66204,0,25329,91533
190847601900000,COMM SW,Commercial,61398,0,66081,127479
190847602000000,COMM SW,Commercial,37438,0,128144,165582
190847602100000,COMM SW,Commercial,124740,0,99638,224378
190847602200000,INDUSTRIAL,Industrial,76683,0,0,76683
190847602300000,COMM SW,Industrial,20700,0,0,20700
190910100100000,INDUSTRIAL,Industrial,419050,0,0,419050
190910100102000,COMM SW,Commercial,0,0,0,0
190910100200000,INDUSTRIAL,Industrial,781300,0,3790233,4571533
190912600100000,INDUSTRIAL,Industrial,87150,0,0,87150
190912600200000,E-10 COUNTY,Exempt,0,0,0,0
190912600300000,COMM SW,Commercial,79731,0,0,79731
190912600400000,Empty,Other,0,0,0,0
190912600500000,COMM SW,Commercial,20844,0,150,20994
190912600600000,COMM SW,Commercial,161006,0,185257,346263
190912600700000,COMM SW,Commercial,51030,0,142603,193633
190912600702000,COMM SW,Commercial,0,0,16659,16659
190912600800000,COMM SW,Commercial,48600,0,74078,122678
190912600900000,COMM SW,Commercial,41310,0,210733,252043
190912601000000,E-25 WAR VETS,Exempt,65126,0,265738,330864
190912601100000,SW 422,Residential,28381,120314,0,148695
190912601200000,SW 422,Residential,31535,0,0,31535
190912601300000,SW 422,Residential,28381,95345,0,123726
190912601400000,COMM SW,Commercial,36450,0,303308,339758
190912601600000,COMM SW,Commercial,196560,0,264165,460725
190912601700000,COMM SW,Commercial,127008,0,427288,554296
190912601800000,COMM SW,Commercial,186462,0,88268,274730
190912601900000,COMM SW,Commercial,81648,0,388973,470621
190912602000000,COMM SW,Commercial,104112,0,796224,900336
190915100100000,COMM SW,Commercial,307692,0,3467728,3775420
190915100200000,Empty,Other,0,0,0,0
190915100300000,COMM SW,Commercial,13608,0,0,13608
190915200100000,COMM SW,Commercial,266598,0,569515,836113
190915200200000,E-10 COUNTY,Exempt,0,0,0,0
190915200300000,COMM SW,Commercial,93312,0,215493,308805
190915200400000,COMM SW,Commercial,235224,0,500122,735346
190915200500000,COMM SW,Commercial,271944,0,1071089,1343033
190915200600000,E-70 CHARITY OTHER,Exempt,196992,0,1164100,1361092
190917600100000,INDUSTRIAL,Industrial,438850,0,2318382,2757232
190920100100000,COMM SW,Commercial,38880,0,63301,102181
190920100200000,COMM SW,Commercial,200448,0,397647,598095
190920100300000,INDUSTRIAL,Industrial,73400,0,160984,234384
190920100400000,COMM SW,Commercial,230472,0,449031,679503
190920100500000,COMM SW,Commercial,210816,0,744649,955465
190920100600000,COMM SW,Commercial,242622,0,257378,500000
190920100700000,COMM SW,Commercial,44064,0,839,44903
190920100800000,COMM SW,Commercial,158976,0,327231,486207
190920200100000,Empty,Exempt,0,0,0,0
190922600100000,Empty,Exempt,0,0,0,0
190922600200000,COMM SW,Commercial,171840,0,716988,888828
190922600300000,COMM SW,Commercial,50625,0,64551,115176
190922600400000,COMM SW,Commercial,164781,0,385160,549941
190922700100000,COMM SW,Commercial,71734,0,354349,426083
190925100100000,Empty,Exempt,0,0,0,0
190925100200000,COMM SW,Commercial,89856,0,311381,401237
190925100300000,COMM SW,Commercial,32746,0,0,32746
190925100400000,COMM SW,Commercial,16502,0,14386,30888
190925100500000,INDUSTRIAL,Industrial,226300,0,392309,618609
190925100600000,COMM SW,Commercial,254610,0,37355,291965
190925200100000,COMM SW,Commercial,68408,0,477540,545948
190925200200000,COMM SW,Commercial,50123,0,257135,307258
190925200300000,COMM SW,Commercial,48195,0,197364,245559
190925200400000,COMM SW,Commercial,239220,0,310315,549535
190927600100000,COMM SW,Commercial,224424,0,1073332,1297756
190927600200000,SW 425,Residential,35652,67606,0,103258
190927600300000,SW 425,Residential,29106,134722,0,163828
190927600400000,COMM SW,Commercial,28948,0,156730,185678
190930100100000,COMM SW,Commercial,178864,0,549129,727993
190930100200000,Empty,Exempt,0,0,0,0
190930100300000,SW 426,Residential,26460,56230,0,82690
190930100400000,SW 426,Residential,27720,57573,0,85293
190930100500000,SW 426,Residential,27720,58752,0,86472
190930100600000,SW 426,Residential,27720,58496,0,86216
190930100700000,SW 426,Residential,27720,44434,0,72154
190930100800000,SW 426,Residential,27720,61400,0,89120
190930100900000,SW 426,Residential,27720,58021,0,85741
190930101000000,SW 426,Residential,27720,56492,0,84212
190930200100000,SW 426,Residential,29959,61688,0,91647
190930200200000,SW 426,Residential,29296,71863,0,101159
190930200300000,SW 426,Residential,29296,85156,0,114452
190930200400000,SW 426,Residential,30277,75658,0,105935
190930200500000,SW 426,Residential,29182,86966,0,116148
190930200600000,SW 426,Residential,29182,63721,0,92903
190930300100000,SW 426,Residential,29383,106478,0,135861
190930300200000,SW 426,Residential,30429,74894,0,105323
190930300300000,SW 426,Residential,29417,59348,0,88765
190932600100000,COMM SW,Commercial,172800,0,463861,636661
190932600200000,COMM SW,Commercial,169560,0,70206,239766
190932600300000,COMM SW,Commercial,87480,0,428710,516190
190932600400000,COMM SW,Commercial,92340,0,238663,331003
190932600500000,COMM SW,Commercial,133650,0,0,133650
190932600600000,COMM SW,Commercial,206118,0,1259844,1465962
190932600800000,COMM SW,Commercial,237546,0,485850,723396
190932600900000,COMM SW,Commercial,212544,0,124534,337078
190932601000000,COMM SW,Commercial,174960,0,691400,866360
190932601100000,COMM SW,Commercial,227340,0,355303,582643
190932601200000,COMM SW,Commercial,224748,0,0,224748
190935100100000,COMM SW,Commercial,154710,0,559515,714225
190935100500000,COMM SW,Commercial,146610,0,451897,598507
190935100700000,COMM SW,Commercial,205200,0,174020,379220
190935100701000,COMM SW,Commercial,6840,0,83969,90809
190935100701001,COMM SW,Commercial,6840,0,93172,100012
190935100701002,COMM SW,Commercial,6840,0,63626,70466
190935100701003,COMM SW,Commercial,6840,0,58600,65440
190935100701004,COMM SW,Commercial,6840,0,58766,65606
190935100701005,COMM SW,Commercial,6840,0,80128,86968
190935100701006,COMM SW,Commercial,6840,0,58766,65606
190935100701007,COMM SW,Commercial,6840,0,59264,66104
190935100701008,COMM SW,Commercial,6840,0,58600,65440
190935100701009,COMM SW,Commercial,6840,0,59264,66104
190935100701010,COMM SW,Commercial,6840,0,61582,68422
190935100701011,COMM SW,Commercial,6840,0,59264,66104
190935100701012,COMM SW,Commercial,6840,0,58600,65440
190935100701013,COMM SW,Commercial,6840,0,63908,70748
190935100701014,COMM SW,Commercial,6840,0,104652,111492
190935100701015,COMM SW,Commercial,6840,0,100006,106846
190935100702000,COMM SW,Commercial,0,0,63492,63492
190935200300000,COMM SW,Commercial,253800,0,271200,525000
190935200400000,COMM SW,Commercial,144990,0,547907,692897
190935200500000,COMM SW,Commercial,103680,0,159203,262883
190935200600000,COMM SW,Commercial,135011,0,866438,1001449
190935200700000,COMM SW,Commercial,129600,0,0,129600
190935200800000,COMM SW,Commercial,184140,0,237023,421163
190935200900000,INDUSTRIAL,Industrial,68040,0,0,68040
190935201000000,INDUSTRIAL,Industrial,217782,0,788655,1006437
190935300100000,COMM SW,Commercial,94770,0,297017,391787
190935300200000,COMM SW,Commercial,59454,0,5524,64978
190935300300000,COMM SW,Commercial,66258,0,154647,220905
190935300400000,COMM SW,Commercial,141480,0,520429,661909
190935300600000,SW 425,Residential,99700,167653,0,267353
190935301000000,COMM SW,Commercial,11672,0,0,11672
190935301100000,SW 425,Residential,149400,0,0,149400
190935301200000,COMM SW,Commercial,180144,0,768471,948615
190937600100000,SW 426,Residential,29144,78039,0,107183
190937600200000,SW 426,Residential,29144,63005,0,92149
190937600300000,SW 426,Residential,29144,99617,0,128761
190937600400000,SW 426,Residential,29144,68139,0,97283
190937600500000,SW 426,Residential,29106,50716,0,79822
190937600600000,SW 426,Residential,29106,64199,0,93305
190937600700000,SW 426,Residential,29106,107706,0,136812
190937600800000,SW 426,Residential,29106,77836,0,106942
190937600900000,SW 426,Residential,29106,62938,0,92044
190937601000000,SW 426,Residential,29144,77542,0,106686
190937601100000,SW 426,Residential,29144,65675,0,94819
190937601200000,SW 426,Residential,29144,63496,0,92640
190937601300000,SW 426,Residential,29182,62824,0,92006
190937601400000,SW 426,Residential,30277,55858,0,86135
190937601500000,SW 426,Residential,29296,82901,0,112197
190937601600000,SW 426,Residential,29296,82925,0,112221
190937601700000,SW 426,Residential,29959,62386,0,92345
190937601800000,SW 426,Residential,29182,59931,0,89113
190937601900000,SW 426,Residential,29144,67689,0,96833
190937602000000,SW 426,Residential,29144,95720,0,124864
190937602100000,SW 426,Residential,29144,62265,0,91409
190937602200000,SW 426,Residential,29106,102595,0,131701
190937602300000,SW 426,Residential,29106,104524,0,133630
190937602400000,SW 426,Residential,29106,59812,0,88918
190937602500000,SW 426,Residential,29106,74342,0,103448
190937602600000,SW 426,Residential,29106,64024,0,93130
190937602700000,SW 426,Residential,29144,57477,0,86621
190937602800000,SW 426,Residential,29144,60922,0,90066
190937700100000,SW 426,Residential,30648,57267,0,87915
190937700200000,SW 425,Ag Land,7728,0,0,7728
190937700300000,SW 426,Residential,30174,57782,0,87956
190937700400000,SW 426,Residential,30030,73740,0,103770
190937700500000,SW 426,Residential,30648,60541,0,91189
190937700600000,SW 426,Residential,31237,83873,0,115110
190937700700000,SW 426,Residential,31515,95748,0,127263
190937700800000,SW 426,Residential,31809,57229,0,89038
190937700900000,SW 426,Residential,37422,59150,0,96572
190937701000000,SW 426,Residential,31832,73438,0,105270
190937701100000,SW 426,Residential,31249,71051,0,102300
190937900100000,SW 426,Residential,28375,75582,0,103957
190937900200000,SW 426,Residential,29484,60922,0,90406
190937900300000,SW 426,Residential,29484,85702,0,115186
190937900400000,SW 426,Residential,29484,97651,0,127135
190937900500000,SW 426,Residential,27922,65609,0,93531
190938000100000,SW 426,Residential,30878,93163,0,124041
190938000200000,SW 426,Residential,30029,64550,0,94579
190940100100000,COMM SW,Commercial,93139,0,307874,401013
190940100200000,COMM SW,Commercial,24019,0,10038,34057
190940100300000,COMM SW,Commercial,79396,0,130651,210047
190940100401000,CONDO 500,Residential,2000,41662,0,43662
190940100401001,CONDO 500,Residential,4000,58587,0,62587
190940100401002,CONDO 500,Residential,4000,58587,0,62587
190940100401003,CONDO 500,Residential,4000,58587,0,62587
190940100401004,CONDO 500,Residential,4000,58587,0,62587
190940100401005,CONDO 500,Residential,4000,59904,0,63904
190940100401006,CONDO 500,Residential,4000,58587,0,62587
190940100401007,CONDO 500,Residential,4000,58587,0,62587
190940100401008,CONDO 500,Residential,4000,58587,0,62587
190940100401009,CONDO 500,Residential,4000,58587,0,62587
190940100401010,CONDO 500,Residential,4000,59904,0,63904
190940100401011,CONDO 500,Residential,4000,58587,0,62587
190940100401012,CONDO 500,Residential,4000,58587,0,62587
190940100401013,CONDO 500,Residential,4000,58587,0,62587
190940100401014,CONDO 500,Residential,4000,58587,0,62587
190940100601000,CONDO 500,Residential,5000,56273,0,61273
190940100601001,CONDO 500,Residential,5000,56273,0,61273
190940100601002,CONDO 500,Residential,5000,56273,0,61273
190940100601003,CONDO 500,Residential,5000,56273,0,61273
190940100601004,CONDO 500,Residential,5000,57230,0,62230
190940100601005,CONDO 500,Residential,5000,57230,0,62230
190940100601006,CONDO 500,Residential,5000,57230,0,62230
190940100601007,CONDO 500,Residential,5000,57230,0,62230
190940100601008,CONDO 500,Residential,5000,56237,0,61237
190940100601009,CONDO 500,Residential,5000,56237,0,61237
190940100601010,CONDO 500,Residential,5000,56237,0,61237
190940100601011,CONDO 500,Residential,5000,56237,0,61237
190940100601012,CONDO 500,Residential,5000,57057,0,62057
190940100601013,CONDO 500,Residential,5000,57057,0,62057
190940100601014,CONDO 500,Residential,5000,57057,0,62057
190940100601015,CONDO 500,Residential,5000,56801,0,61801
190940100601016,CONDO 500,Residential,5000,56275,0,61275
190940100601017,CONDO 500,Residential,5000,56275,0,61275
190940100601018,CONDO 500,Residential,5000,56275,0,61275
190940100601019,CONDO 500,Residential,5000,56275,0,61275
190940100601020,CONDO 500,Residential,5000,57095,0,62095
190940100601021,CONDO 500,Residential,5000,57095,0,62095
190940100601022,CONDO 500,Residential,5000,56903,0,61903
190940100601023,CONDO 500,Residential,5000,56903,0,61903
190940100601024,CONDO 500,Residential,5000,56857,0,61857
190940100601025,CONDO 500,Residential,5000,56857,0,61857
190940100601026,CONDO 500,Residential,5000,56857,0,61857
190940100601027,CONDO 500,Residential,5000,56857,0,61857
190940100601028,CONDO 500,Residential,5000,57685,0,62685
190940100601029,CONDO 500,Residential,5000,57685,0,62685
190940100601030,CONDO 500,Residential,5000,57685,0,62685
190940100601031,CONDO 500,Residential,5000,57685,0,62685
190940100700000,APTS SW,Commercial,40446,0,259554,300000
190940100800000,APTS SW,Commercial,64260,0,773658,837918
190940101001000,CONDO 500,Residential,2000,41662,0,43662
190940101001001,CONDO 500,Residential,4000,58587,0,62587
190940101001002,CONDO 500,Residential,4000,58587,0,62587
190940101001003,CONDO 500,Residential,4000,58587,0,62587
190940101001004,CONDO 500,Residential,4000,58587,0,62587
190940101001005,CONDO 500,Residential,4000,59904,0,63904
190940101001006,CONDO 500,Residential,4000,58587,0,62587
190940101001007,CONDO 500,Residential,4000,58587,0,62587
190940101001008,CONDO 500,Residential,4000,58587,0,62587
190940101001009,CONDO 500,Residential,4000,58587,0,62587
190940101001010,CONDO 500,Residential,4000,59904,0,63904
190940101001011,CONDO 500,Residential,4000,58587,0,62587
190940101001012,CONDO 500,Residential,4000,58587,0,62587
190940101001013,CONDO 500,Residential,4000,58587,0,62587
190940101001014,CONDO 500,Residential,4000,58587,0,62587
190940200100000,COMM SW,Commercial,221184,0,378868,600052
190940200200000,E-70 CHARITY OTHER,Exempt,438048,0,0,438048
190940200202000,COMM SW,Commercial,0,0,10122,10122
190940200301000,CONDO 500,Residential,7000,79752,0,86752
190940200301001,CONDO 500,Residential,7000,76022,0,83022
190940200301002,CONDO 500,Residential,7000,79752,0,86752
190940200301003,CONDO 500,Residential,7000,79752,0,86752
190940200301004,CONDO 500,Residential,7000,80694,0,87694
190940200301005,CONDO 500,Residential,7000,80694,0,87694
190940200301006,CONDO 500,Residential,7000,80694,0,87694
190940200301007,CONDO 500,Residential,7000,80694,0,87694
190940200301008,CONDO 500,Residential,7000,80694,0,87694
190940200301009,CONDO 500,Residential,7000,80694,0,87694
190940200301010,CONDO 500,Residential,7000,80694,0,87694
190940200301011,CONDO 500,Residential,7000,80694,0,87694
190940200301012,CONDO 500,Residential,7000,79752,0,86752
190940200301013,CONDO 500,Residential,7000,76022,0,83022
190940200301014,CONDO 500,Residential,7000,79752,0,86752
190940200301015,CONDO 500,Residential,7000,79752,0,86752
190940200301016,CONDO 500,Residential,7000,80694,0,87694
190940200301017,CONDO 500,Residential,7000,80694,0,87694
190940200301018,CONDO 500,Residential,7000,80694,0,87694
190940200301019,CONDO 500,Residential,7000,80694,0,87694
190940200301020,CONDO 500,Residential,7000,80694,0,87694
190940200301021,CONDO 500,Residential,7000,80694,0,87694
190940200301022,CONDO 500,Residential,7000,80694,0,87694
190940200301023,CONDO 500,Residential,7000,80694,0,87694
190940200301024,CONDO 500,Residential,7000,79752,0,86752
190940200301025,CONDO 500,Residential,7000,79752,0,86752
190940200301026,CONDO 500,Residential,7000,79752,0,86752
190940200301027,CONDO 500,Residential,7000,76022,0,83022
190940200301028,CONDO 500,Residential,7000,79752,0,86752
190940200301029,CONDO 500,Residential,7000,79752,0,86752
190940200301030,CONDO 500,Residential,7000,80694,0,87694
190940200301031,CONDO 500,Residential,7000,80694,0,87694
190940200301032,CONDO 500,Residential,7000,80694,0,87694
190940200301033,CONDO 500,Residential,7000,80694,0,87694
190940200301034,CONDO 500,Residential,7000,80694,0,87694
190940200301035,CONDO 500,Residential,7000,80694,0,87694
190940200301036,CONDO 500,Residential,7000,80694,0,87694
190940200301037,CONDO 500,Residential,7000,80694,0,87694
190940200301038,CONDO 500,Residential,7000,80694,0,87694
190940200301039,CONDO 500,Residential,7000,80694,0,87694
190940200301040,CONDO 500,Residential,7000,80694,0,87694
190940200301041,CONDO 500,Residential,7000,80694,0,87694
190940200301042,CONDO 500,Residential,7000,79752,0,86752
190940200301043,CONDO 500,Residential,7000,79752,0,86752
190940200301044,CONDO 500,Residential,7000,76022,0,83022
190940200301045,CONDO 500,Residential,7000,79752,0,86752
190940200301046,CONDO 500,Residential,7000,79752,0,86752
190940200301047,CONDO 500,Residential,7000,79752,0,86752
190940200301048,CONDO 500,Residential,7000,80694,0,87694
190940200301049,CONDO 500,Residential,7000,80694,0,87694
190940200301050,CONDO 500,Residential,7000,80694,0,87694
190940200301051,CONDO 500,Residential,7000,80694,0,87694
190940200301052,CONDO 500,Residential,7000,80694,0,87694
190940200301053,CONDO 500,Residential,7000,80694,0,87694
190940200301054,CONDO 500,Residential,7000,80694,0,87694
190940200301055,CONDO 500,Residential,7000,80694,0,87694
190940200301056,CONDO 500,Residential,7000,80694,0,87694
190940200301057,CONDO 500,Residential,7000,80694,0,87694
190940200301058,CONDO 500,Residential,7000,80694,0,87694
190940200301059,CONDO 500,Residential,7000,80694,0,87694
190942600100000,SW 426,Residential,31185,64769,0,95954
190942600200000,SW 426,Residential,31185,74404,0,105589
190942700100000,COMM SW,Commercial,286851,0,1586074,1872925
190942700200000,SW 426,Residential,27720,53005,0,80725
190942700300000,SW 426,Residential,27720,82439,0,110159
190942700400000,SW 426,Residential,27720,98944,0,126664
190942700500000,SW 426,Residential,27720,68058,0,95778
190942700600000,SW 426,Residential,27720,81975,0,109695
190942700700000,SW 426,Residential,31779,68966,0,100745
190942700800000,SW 426,Residential,29960,70861,0,100821
190942700900000,SW 426,Residential,29960,90796,0,120756
190942701000000,SW 426,Residential,29960,100976,0,130936
190942701100000,SW 426,Residential,29960,59997,0,89957
190942701200000,SW 426,Residential,31779,88598,0,120377
190942701300000,SW 426,Residential,29732,117752,0,147484
190942701400000,SW 426,Residential,28875,68379,0,97254
190942701500000,SW 426,Residential,28231,61757,0,89988
190942800100000,SW 426,Residential,22750,105241,0,127991
190942800200000,SW 426,Residential,30520,4432,0,34952
190942800300000,SW 426,Residential,34125,117144,0,151269
190942800400000,SW 426,Residential,19443,81621,0,101064
190942800500000,SW 426,Residential,32151,94184,0,126335
190942900100000,SW 426,Residential,30644,93298,0,123942
190942900200000,SW 426,Residential,29054,68006,0,97060
190942900300000,SW 426,Residential,29750,60434,0,90184
190942900400000,SW 426,Residential,29750,63275,0,93025
190942900500000,SW 426,Residential,29750,94588,0,124338
190942900600000,SW 426,Residential,28996,89912,0,118908
190942900700000,SW 426,Residential,28996,108327,0,137323
190942900800000,SW 426,Residential,28996,88997,0,117993
190942900900000,SW 426,Residential,28996,78209,0,107205
190942901000000,SW 426,Residential,28996,65000,0,93996
190943000100000,SW 426,Residential,30236,82871,0,113107
190943000200000,SW 426,Residential,29839,74837,0,104676
190943000300000,SW 426,Residential,30817,74281,0,105098
190943000400000,SW 426,Residential,29417,63415,0,92832
190943000500000,SW 426,Residential,29750,64213,0,93963
190943000600000,SW 426,Residential,31475,51840,0,83315
190943100100000,SW 426,Residential,30508,69577,0,100085
190943100200000,SW 426,Residential,30047,70683,0,100730
190943100300000,SW 426,Residential,29306,63928,0,93234
190943100400000,SW 426,Residential,29839,60201,0,90040
190943100500000,SW 426,Residential,29839,65767,0,95606
190945100100000,SW 426,Residential,31249,61488,0,92737
190945100200000,SW 426,Residential,30648,75385,0,106033
190945100300000,SW 426,Residential,29738,85256,0,114994
190945100400000,SW 426,Residential,30523,74753,0,105276
190945100500000,SW 426,Residential,30336,68263,0,98599
190945100600000,SW 426,Residential,30336,63173,0,93509
190945100700000,SW 426,Residential,30336,74200,0,104536
190945100800000,SW 426,Residential,30631,96060,0,126691
190945100900000,SW 426,Residential,28929,73018,0,101947
190945200100000,SW 426,Residential,28996,93663,0,122659
190945200200000,SW 426,Residential,29750,67035,0,96785
190945200300000,SW 426,Residential,29750,64033,0,93783
190945200400000,SW 426,Residential,29750,63224,0,92974
190945200500000,SW 426,Residential,29344,95200,0,124544
190945200600000,SW 426,Residential,30200,103107,0,133307
190945200700000,SW 426,Residential,29940,62954,0,92894
190945200800000,SW 426,Residential,31238,67647,0,98885
190945200900000,SW 426,Residential,30138,62552,0,92690
190945201000000,SW 426,Residential,31372,85566,0,116938
190945201100000,SW 426,Residential,32178,98240,0,130418
190945201200000,SW 426,Residential,31187,58831,0,90018
190945201300000,SW 426,Residential,33130,72086,0,105216
190945201400000,SW 426,Residential,29750,81695,0,111445
190945201500000,SW 426,Residential,30335,65706,0,96041
190945201600000,SW 426,Residential,29960,66711,0,96671
190945201700000,SW 426,Residential,29960,78439,0,108399
190945201800000,SW 426,Residential,33630,95664,0,129294
190945201900000,SW 426,Residential,29055,92881,0,121936
190945202000000,SW 426,Residential,28996,93658,0,122654
190945202100000,SW 426,Residential,28996,115468,0,144464
190945202200000,SW 426,Residential,28996,65328,0,94324
190945202300000,SW 426,Residential,30522,75072,0,105594
190945202400000,SW 426,Residential,28996,64020,0,93016
190945202500000,SW 426,Residential,28996,62098,0,91094
190945202600000,SW 426,Residential,28996,68072,0,97068
190945202700000,SW 426,Residential,28996,89922,0,118918
190945300100000,SW 426,Residential,29750,89108,0,118858
190945300200000,SW 426,Residential,30139,58590,0,88729
190945300300000,SW 426,Residential,30051,87502,0,117553
190945300400000,SW 426,Residential,29383,67278,0,96661
190945300500000,SW 426,Residential,30051,87279,0,117330
190945300600000,SW 426,Residential,30986,61303,0,92289
190945300700000,SW 426,Residential,31080,65482,0,96562
190945300800000,SW 426,Residential,31360,88810,0,120170
190945300900000,SW 426,Residential,31360,75790,0,107150
190945301000000,SW 426,Residential,32340,62110,0,94450
190945301100000,SW 426,Residential,29750,58492,0,88242
190945400100000,SW 426,Residential,29780,81673,0,111453
190945400200000,SW 426,Residential,29780,58997,0,88777
190945400300000,SW 426,Residential,29780,71878,0,101658
190945400400000,SW 426,Residential,29750,83485,0,113235
190945400500000,SW 426,Residential,29750,105450,0,135200
190945400600000,SW 426,Residential,29750,55103,0,84853
190945400700000,SW 426,Residential,29750,65049,0,94799
190945400800000,SW 426,Residential,29780,62546,0,92326
190945400900000,SW 426,Residential,29780,82080,0,111860
190945401000000,SW 426,Residential,29839,60368,0,90207
190945401100000,SW 426,Residential,29336,90468,0,119804
190945401200000,SW 426,Residential,30047,93136,0,123183
190945401300000,SW 426,Residential,30338,89675,0,120013
190945401400000,SW 426,Residential,29839,68450,0,98289
190945401500000,SW 426,Residential,29780,75414,0,105194
190945401600000,SW 426,Residential,29780,60363,0,90143
190945401700000,SW 426,Residential,29750,85942,0,115692
190945401800000,SW 426,Residential,29750,68597,0,98347
190945401900000,SW 426,Residential,29750,69668,0,99418
190945402000000,SW 426,Residential,29750,56321,0,86071
190945402100000,SW 426,Residential,29780,75845,0,105625
190945500100000,SW 426,Residential,31280,101578,0,132858
190945500200000,SW 426,Residential,29207,63776,0,92983
190945500300000,SW 426,Residential,29207,66226,0,95433
190945500400000,SW 426,Residential,29207,81807,0,111014
190945600100000,SW 426,Residential,32794,74846,0,107640
190945600200000,SW 426,Residential,2075,0,0,2075
190945600300000,SW 426,Residential,29736,75104,0,104840
190945600400000,SW 426,Residential,29640,66978,0,96618
190945600500000,SW 426,Residential,29484,98089,0,127573
190945600600000,SW 426,Residential,30047,80377,0,110424
190945600700000,SW 426,Residential,30047,73836,0,103883
190945600800000,SW 426,Residential,29750,78192,0,107942
190945700100000,SW 426,Residential,35742,108105,0,143847
190945700200000,SW 426,Residential,31436,75375,0,106811
190945700300000,SW 426,Residential,29210,74014,0,103224
190945700400000,SW 426,Residential,30926,64064,0,94990
190945800100000,SW 426,Residential,28917,65078,0,93995
190945800200000,SW 426,Residential,29750,85648,0,115398
190945800300000,SW 426,Residential,30206,74736,0,104942
190945800400000,SW 426,Residential,30127,65343,0,95470
190945800500000,SW 426,Residential,29373,77126,0,106499
190947600200000,APTS SW,Commercial,255420,0,2044580,2300000
190947600300000,Empty,Other,0,0,0,0
190947600400000,E-70 CHARITY OTHER,Exempt,792774,0,4202622,4995396
190947600500000,COMM SW,Commercial,110700,0,264624,375324
191010100100000,INDUSTRIAL,Industrial,2078800,0,43942068,46020868
191020100100000,Empty,Other,0,0,0,0
191020100500000,COMM SW,Commercial,351540,0,5865144,6216684
191020100700000,COMM SW,Commercial,364932,0,0,364932
191020100800000,SW 422,Ag Land,6248,0,0,6248
191020200100000,COMM SW,Commercial,254124,0,1511986,1766110
191020200200000,COMM SW,Commercial,264106,0,670466,934572
191022600200000,INDUSTRIAL,Industrial,45000,0,0,45000
191022600300000,INDUSTRIAL,Industrial,310000,0,3476907,3786907
191022600400000,COMM SW,Commercial,144176,0,0,144176
191022700200000,COMM SW,Commercial,157594,0,0,157594
191022700300000,INDUSTRIAL,Industrial,243850,0,3391817,3635667
191022700400000,COMM SW,Commercial,432000,0,883643,1315643
191025100100000,COMM SW,Commercial,190080,0,576839,766919
191025100200000,COMM SW,Commercial,216000,0,1195735,1411735
191025100300000,COMM SW,Commercial,186624,0,551329,737953
191025100400000,COMM SW,Commercial,150237,0,0,150237
191025200100000,INDUSTRIAL,Industrial,364045,0,1369331,1733376
191025200200000,COMM SW,Commercial,418176,0,1410860,1829036
191027600100000,COMM SW,Commercial,259632,0,959944,1219576
191027600200000,COMM SW,Commercial,224640,0,813637,1038277
191027700200000,COMM SW,Commercial,388463,0,1622613,2011076
191027700300000,COMM SW,Commercial,4612,0,0,4612
191032600200000,SW 422,Ag Land,20145,0,0,20145
191035100100000,E-05 STATE,Exempt,0,0,0,0
191035100300000,APTS SW,Commercial,56700,0,776692,833392
191035100400000,APTS SW,Commercial,69120,0,745632,814752
191035100500000,APTS SW,Commercial,66420,0,755382,821802
191035100600000,COMM SW,Commercial,231120,0,487108,718228
191035100700000,APTS SW,Commercial,279180,0,2763175,3042355
191035100900000,APTS SW,Commercial,226800,0,3142121,3368921
191035101000000,COMM SW,Commercial,160380,0,1276815,1437195
191035101100000,COMM SW,Commercial,25650,0,105592,131242
191035101200000,COMM SW,Commercial,116640,0,192879,309519
191035101300000,COMM SW,Commercial,255526,0,3108253,3363779
191037600100000,COMM SW,Commercial,3780108,0,2537576,6317684
191040100200000,COMM SW,Ag Land,3802,0,0,3802
191040100300000,COMM SW,Commercial,341264,0,0,341264
191040100400000,COMM SW,Commercial,545184,0,7592642,8137826
191040200100000,COMM SW,Commercial,152194,0,0,152194
191040300100000,COMM SW,Commercial,1426,0,0,1426
191042600100000,COMM SW,Ag Land,3832,0,0,3832
191042600200000,COMM SW,Ag Land,5000,0,0,5000
191042600300000,E-76 EDU CLASS BLDG,Exempt,423400,0,965525,1388925
191042600400000,COMM SW,Ag Land,7427,0,0,7427
191042600500000,COMM SW,Ag Land,7338,0,0,7338
191042600600000,COMM SW,Ag Land,5829,0,0,5829
191042600700000,COMM SW,Ag Land,5267,0,0,5267
191042600800000,COMM SW,Ag Land,4779,0,0,4779
191045100200000,COMM SW,Commercial,164700,0,1906282,2070982
191045100300000,SW 422,Ag Land,5592,0,0,5592
191047600200000,COMM SW,Commercial,224100,0,0,224100
191047600300000,SW 422,Ag Land,51449,0,1375,52824
191110100100000,SW 422,Ag Land,24198,0,0,24198
191110100200000,SW 422,Ag Land,12503,0,0,12503
191112600100000,SW 423,Residential,36300,277715,0,314015
191112600200000,SW 423,Residential,36300,130082,0,166382
191112600300000,SW 423,Residential,36600,180963,0,217563
191112700100000,SW 423,Ag Land,28830,0,0,28830
191112700200000,Empty,Exempt,0,0,0,0
191112700300000,SW 423,Residential,45450,55370,0,100820
191112700400000,SW 423,Residential,45150,178583,0,223733
191112700500000,SW 423,Residential,37500,43943,0,81443
191112700600000,SW 423,Residential,36900,110785,0,147685
191112700700000,SW 423,Residential,11520,0,0,11520
191112700800000,SW 423,Residential,36720,83589,0,120309
191112700900000,SW 423,Residential,34200,92650,0,126850
191112701100000,SW 423,Residential,34200,81254,0,115454
191112701200000,SW 423,Residential,35190,49291,0,84481
191115100100000,SW 423,Residential,36600,168569,0,205169
191115100200000,SW 423,Residential,36600,72254,0,108854
191115100300000,SW 423,Residential,36600,131804,0,168404
191115100400000,SW 423,Residential,36600,122040,0,158640
191115100500000,SW 423,Residential,36600,79993,0,116593
191115100600000,SW 423,Residential,36600,83969,0,120569
191115100700000,SW 423,Residential,36900,116271,0,153171
191115100800000,SW 423,Residential,57950,77438,0,135388
191115200100000,SW 423,Residential,33150,84956,0,118106
191115200200000,SW 423,Residential,49650,74294,0,123944
191115200300000,SW 423,Residential,40162,17260,0,57422
191115200400000,SW 423,Residential,39487,60639,0,100126
191115200500000,SW 423,Residential,43605,34340,0,77945
191115200600000,SW 423,Residential,39600,36980,0,76580
191115200700000,SW 423,Residential,32940,33745,0,66685
191115200800000,SW 423,Residential,14285,103678,0,117963
191115200900000,SW 423,Residential,22125,57813,0,79938
191115201000000,SW 423,Residential,21938,45675,0,67613
191115201100000,SW 423,Residential,37294,66137,0,103431
191115201200000,SW 423,Residential,36965,57797,0,94762
191115201300000,SW 423,Residential,36975,74740,0,111715
191115201400000,SW 423,Residential,29848,129466,0,159314
191115201500000,SW 423,Residential,11761,508,0,12269
191115300100000,SW 423,Residential,44505,59440,0,103945
191115300200000,SW 423,Residential,47900,82775,0,130675
191115300300000,SW 423,Residential,46800,42703,0,89503
191115300400000,SW 423,Residential,7000,0,0,7000
191115300500000,SW 423,Residential,37584,140157,0,177741
191117600100000,SW 422,Ag Land,39208,0,0,39208
191117800100000,SW 423,Residential,58750,128062,0,186812
191120100100000,SW 422,Residential,207800,0,0,207800
191120100200000,SW 423,Residential,33210,93887,0,127097
191120100300000,SW 423,Residential,33300,111801,0,145101
191120100400000,SW 423,Residential,45630,67467,0,113097
191120100500000,SW 423,Residential,35400,31367,0,66767
191120100600000,SW 423,Residential,35400,159333,0,194733
191120100700000,SW 423,Residential,35400,118674,0,154074
191120100800000,SW 423,Residential,35400,118928,0,154328
191120100900000,SW 423,Residential,35700,2279,0,37979
191120101000000,SW 423,Residential,48900,13590,0,62490
191120101100000,SW 423,Residential,45250,58433,0,103683
191120101200000,SW 423,Residential,45550,16958,0,62508
191120101300000,SW 433,Residential,38749,203410,0,242159
191120101400000,SW 433,Residential,36860,151099,0,187959
191120101500000,SW 433,Residential,32253,139491,0,171744
191120101600000,SW 433,Residential,36860,151396,0,188256
191120101700000,SW 433,Residential,34556,146056,0,180612
191120101800000,SW 433,Residential,32253,144127,0,176380
191120101900000,SW 433,Residential,34556,166748,0,201304
191120102000000,SW 433,Residential,36860,133362,0,170222
191120102100000,SW 433,Residential,32253,126822,0,159075
191120102200000,SW 433,Residential,36860,154926,0,191786
191120102300000,SW 433,Residential,36860,149628,0,186488
191120102400000,SW 433,Residential,34556,0,0,34556
191120102500000,SW 433,Residential,32253,0,0,32253
191120102600000,SW 433,Residential,29949,0,0,29949
191120102700000,SW 433,Residential,32253,0,0,32253
191120102800000,SW 433,Residential,29949,132676,0,162625
191120102900000,SW 433,Residential,32253,0,0,32253
191120103000000,SW 433,Residential,39101,0,0,39101
191120200100000,SW 433,Residential,37003,209504,0,246507
191120200200000,SW 433,Residential,39216,191692,0,230908
191120200300000,SW 433,Residential,38988,172664,0,211652
191120200400000,SW 433,Residential,4800,0,0,4800
191120200500000,SW 433,Residential,37506,144018,0,181524
191120200600000,SW 433,Residential,37506,224186,0,261692
191120300100000,SW 433,Residential,39395,195588,0,234983
191120300200000,SW 433,Residential,34096,141943,0,176039
191120300300000,SW 433,Residential,32253,154113,0,186366
191120300400000,SW 433,Residential,37782,188718,0,226500
191120300500000,SW 433,Residential,32253,155293,0,187546
191120300600000,SW 433,Residential,34096,175233,0,209329
191120300700000,SW 433,Residential,32253,156782,0,189035
191120300800000,SW 433,Residential,37782,172465,0,210247
191120300900000,SW 433,Residential,32253,0,0,32253
191120301000000,SW 433,Residential,35496,180271,0,215767
191120301100000,SW 433,Residential,39395,115770,0,155165
191120301200000,SW 433,Residential,41468,163431,0,204899
191120301300000,SW 433,Residential,35496,145512,0,181008
191120301400000,SW 433,Residential,32253,164789,0,197042
191120301500000,SW 433,Residential,37782,171291,0,209073
191120301600000,SW 433,Residential,32253,153344,0,185597
191120301700000,SW 433,Residential,34096,145079,0,179175
191120301800000,SW 433,Residential,32253,150924,0,183177
191120301900000,SW 433,Residential,37782,129735,0,167517
191120302000000,SW 433,Residential,32253,127732,0,159985
191120302100000,SW 433,Residential,34096,142099,0,176195
191120302200000,SW 433,Residential,5578,0,0,5578
191120400100000,SW 433,Residential,39330,0,0,39330
191120400200000,SW 433,Residential,35913,139663,0,175576
191120400300000,SW 433,Residential,36273,151042,0,187315
191120400400000,Empty,Exempt,0,0,0,0
191120400500000,SW 433,Residential,32775,138685,0,171460
191120400600000,SW 433,Residential,32775,163254,0,196029
191120400700000,SW 433,Residential,30590,153993,0,184583
191120400800000,SW 433,Residential,30590,168060,0,198650
191120400900000,SW 433,Residential,30590,158679,0,189269
191120500100000,SW 433,Residential,41468,189707,0,231175
191120500200000,SW 433,Residential,4587,0,0,4587
191120500300000,SW 433,Residential,4339,0,0,4339
191120500400000,SW 433,Residential,5082,0,0,5082
191120500500000,SW 433,Residential,32253,128460,0,160713
191120500600000,SW 433,Residential,34096,196776,0,230872
191120500700000,SW 433,Residential,4339,0,0,4339
191120500800000,SW 433,Residential,37782,166622,0,204404
191120500900000,SW 433,Residential,4339,0,0,4339
191120501000000,SW 433,Residential,4775,0,0,4775
191120501100000,SW 433,Residential,41468,103211,0,144679
191122600100000,SW 422,Ag Land,2159,0,0,2159
191122700100000,COMM SW,Commercial,90180,0,26989,117169
191122700102000,COMM SW,Commercial,0,0,14146,14146
191122700200000,INDUSTRIAL,Industrial,468700,0,4892748,5361448
191122700300000,Empty,Other,0,0,0,0
191122700700000,INDUSTRIAL,Industrial,304000,0,3533171,3837171
191125100100000,INDUSTRIAL,Industrial,332550,0,0,332550
191127600200000,SW 423,Residential,45150,50979,0,96129
191127600300000,SW 423,Residential,38247,95154,0,133401
191127600400000,SW 423,Residential,12465,3635,0,16100
191127600500000,SW 423,Residential,7515,37721,0,45236
191127600600000,SW 423,Residential,24525,0,0,24525
191127600700000,SW 423,Residential,2740,0,0,2740
191127600800000,SW 423,Residential,5620,0,0,5620
191127600900000,SW 423,Residential,41265,73096,0,114361
191127601000000,SW 423,Residential,40800,40089,0,80889
191127601100000,SW 423,Residential,37471,66337,0,103808
191127601200000,SW 423,Residential,35635,56933,0,92568
191127601300000,SW 423,Residential,41625,89552,0,131177
191127601400000,SW 423,Residential,37584,105624,0,143208
191127601500000,SW 423,Residential,34749,51702,0,86451
191127601600000,SW 423,Residential,35343,43837,0,79180
191127601700000,SW 423,Residential,35700,59914,0,95614
191127601800000,SW 423,Residential,45900,60146,0,106046
191127601900000,SW 423,Residential,40650,7850,0,48500
191127602000000,SW 423,Residential,24945,76202,0,101147
191127602100000,SW 423,Residential,25847,167451,0,193298
191127602300000,SW 423,Residential,37296,178443,0,215739
191127602400000,SW 423,Residential,32046,0,0,32046
191127602500000,SW 423,Residential,46154,0,0,46154
191127700100000,SW 422,Residential,49400,124274,0,173674
191127700200000,SW 422,Residential,5000,0,0,5000
191127700300000,SW 422,Residential,46700,89063,0,135763
191127900100000,SW 423,Residential,31987,102449,0,134436
191127900200000,SW 423,Residential,32825,142794,0,175619
191127900300000,SW 423,Residential,48500,126869,0,175369
191127900400000,SW 423,Residential,2315,0,0,2315
191127900500000,SW 423,Residential,31473,87574,0,119047
191132600100000,COMM SW,Commercial,754164,0,7624481,8378645
191135100200000,SW 422,Residential,35776,0,0,35776
191135100300000,SW 422,Residential,35880,109116,0,144996
191135100400000,SW 422,Residential,36068,172122,0,208190
191135100500000,SW 422,Residential,36984,135803,0,172787
191135100600000,SW 422,Residential,35880,164132,0,200012
191135100700000,SW 422,Residential,35880,157588,0,193468
191135100800000,SW 422,Residential,35880,128548,0,164428
191135100900000,SW 422,Residential,35880,157477,0,193357
191135101000000,SW 422,Residential,35880,132010,0,167890
191135101100000,SW 422,Residential,35880,132037,0,167917
191135101200000,SW 422,Residential,36239,140304,0,176543
191135101300000,SW 422,Residential,35521,0,0,35521
191135101401000,CONDO 505,Residential,7000,149853,0,156853
191135101401001,CONDO 505,Residential,7000,125726,0,132726
191135101401002,CONDO 505,Residential,7000,126237,0,133237
191135101401003,CONDO 505,Residential,7000,149853,0,156853
191135101401004,CONDO 505,Residential,7000,107836,0,114836
191135101401005,CONDO 505,Residential,7000,111146,0,118146
191135101401006,CONDO 505,Residential,7000,111100,0,118100
191135101401007,CONDO 505,Residential,7000,111720,0,118720
191135101401008,CONDO 505,Residential,7000,108414,0,115414
191135101401009,CONDO 505,Residential,7000,115555,0,122555
191135101401010,CONDO 505,Residential,7000,128906,0,135906
191135101401011,CONDO 505,Residential,7000,120486,0,127486
191135101401012,CONDO 505,Residential,7000,121026,0,128026
191135101401013,CONDO 505,Residential,7000,128906,0,135906
191135101401014,CONDO 505,Residential,7000,92155,0,99155
191135101401015,CONDO 505,Residential,7000,92317,0,99317
191135101401016,CONDO 505,Residential,7000,94162,0,101162
191135101401017,CONDO 505,Residential,7000,89727,0,96727
191135101401018,CONDO 505,Residential,7000,92317,0,99317
191135101401019,CONDO 505,Residential,7000,90310,0,97310
191135101401020,CONDO 505,Residential,7000,137172,0,144172
191135101401021,CONDO 505,Residential,7000,127728,0,134728
191135101401022,CONDO 505,Residential,7000,127728,0,134728
191135101401023,CONDO 505,Residential,7000,137172,0,144172
191135101401024,CONDO 505,Residential,7000,106685,0,113685
191135101401025,CONDO 505,Residential,7000,111146,0,118146
191135101401026,CONDO 505,Residential,7000,94351,0,101351
191135101401027,CONDO 505,Residential,7000,94351,0,101351
191135101401028,CONDO 505,Residential,7000,111146,0,118146
191135101401029,CONDO 505,Residential,7000,108461,0,115461
191135101401030,CONDO 505,Residential,7000,87234,0,94234
191135101401031,CONDO 505,Residential,7000,89727,0,96727
191135101401032,CONDO 505,Residential,7000,94252,0,101252
191135101401033,CONDO 505,Residential,7000,89727,0,96727
191135101401034,CONDO 505,Residential,7000,89727,0,96727
191135101401035,CONDO 505,Residential,7000,87720,0,94720
191135101401036,CONDO 505,Residential,7000,120545,0,127545
191135101401037,CONDO 505,Residential,7000,121026,0,128026
191135101401038,CONDO 505,Residential,7000,121026,0,128026
191135101401039,CONDO 505,Residential,7000,148111,0,155111
191135101401040,CONDO 505,Residential,7000,121781,0,128781
191135101401041,CONDO 505,Residential,7000,121026,0,128026
191135101401042,CONDO 505,Residential,7000,127157,0,134157
191135101401043,CONDO 505,Residential,7000,129315,0,136315
191135101401044,CONDO 505,Residential,7000,121204,0,128204
191135101401045,CONDO 505,Residential,7000,119427,0,126427
191135101401046,CONDO 505,Residential,7000,117515,0,124515
191135101401047,CONDO 505,Residential,7000,120518,0,127518
191135101401048,CONDO 505,Residential,7000,108230,0,115230
191135101401049,CONDO 505,Residential,7000,108230,0,115230
191135101401050,CONDO 505,Residential,7000,108230,0,115230
191135101401051,CONDO 505,Residential,7000,108230,0,115230
191135101401052,CONDO 505,Residential,7000,94936,0,101936
191135101401053,CONDO 505,Residential,7000,94936,0,101936
191135101401054,CONDO 505,Residential,7000,94936,0,101936
191135101401055,CONDO 505,Residential,7000,94936,0,101936
191135101401056,CONDO 505,Residential,7000,94936,0,101936
191135101401057,CONDO 505,Residential,7000,94936,0,101936
191135101401058,CONDO 505,Residential,7000,109305,0,116305
191135101401059,CONDO 505,Residential,7000,95238,0,102238
191135101401060,CONDO 505,Residential,7000,95238,0,102238
191135101401061,CONDO 505,Residential,7000,112298,0,119298
191135101401062,CONDO 505,Residential,7000,109305,0,116305
191135101401063,CONDO 505,Residential,7000,95238,0,102238
191135101401064,CONDO 505,Residential,7000,95238,0,102238
191135101401065,CONDO 505,Residential,7000,125490,0,132490
191135101401066,CONDO 505,Residential,7000,94720,0,101720
191135101401067,CONDO 505,Residential,7000,94720,0,101720
191135101401068,CONDO 505,Residential,7000,94720,0,101720
191135101401069,CONDO 505,Residential,7000,94720,0,101720
191135101401070,CONDO 505,Residential,7000,94720,0,101720
191135101401071,CONDO 505,Residential,7000,94720,0,101720
191135101401072,CONDO 505,Residential,7000,94936,0,101936
191135101401073,CONDO 505,Residential,7000,47468,0,54468
191135101401074,CONDO 505,Residential,7000,47468,0,54468
191135101401075,CONDO 505,Residential,7000,47468,0,54468
191135101401076,CONDO 505,Residential,7000,94936,0,101936
191135101401077,CONDO 505,Residential,7000,94936,0,101936
191135101600000,SW 422,Residential,33033,0,0,33033
191135101700000,SW 422,Residential,29548,0,0,29548
191135101900000,SW 422,Residential,38749,122424,0,161173
191135102000000,SW 422,Residential,43708,144105,0,187813
191135102100000,SW 422,Residential,44100,117502,0,161602
191135102200000,SW 422,Residential,38640,0,0,38640
191135102300000,SW 422,Residential,51798,143638,0,195436
191135102401000,CONDO 500,Residential,5000,61371,0,66371
191135102401001,CONDO 500,Residential,5000,61371,0,66371
191135102401002,CONDO 500,Residential,5000,61371,0,66371
191135102401003,CONDO 500,Residential,5000,61371,0,66371
191135102401004,CONDO 500,Residential,5000,62300,0,67300
191135102401005,CONDO 500,Residential,5000,62300,0,67300
191135102401006,CONDO 500,Residential,5000,62300,0,67300
191135102401007,CONDO 500,Residential,5000,62300,0,67300
191135102401008,CONDO 500,Residential,5000,62300,0,67300
191135102401009,CONDO 500,Residential,5000,62300,0,67300
191135102401010,CONDO 500,Residential,5000,62300,0,67300
191135102401011,CONDO 500,Residential,5000,62300,0,67300
191135102401012,CONDO 500,Residential,5000,61371,0,66371
191135102401013,CONDO 500,Residential,5000,61371,0,66371
191135102401014,CONDO 500,Residential,5000,61371,0,66371
191135102401015,CONDO 500,Residential,5000,61371,0,66371
191135102401016,CONDO 500,Residential,5000,62300,0,67300
191135102401017,CONDO 500,Residential,5000,62300,0,67300
191135102401018,CONDO 500,Residential,5000,62300,0,67300
191135102401019,CONDO 500,Residential,5000,62300,0,67300
191135102401020,CONDO 500,Residential,5000,62300,0,67300
191135102401021,CONDO 500,Residential,5000,62300,0,67300
191135102401022,CONDO 500,Residential,5000,62300,0,67300
191135102401023,CONDO 500,Residential,5000,62300,0,67300
191135102401024,CONDO 500,Residential,5000,61371,0,66371
191135102401025,CONDO 500,Residential,5000,61371,0,66371
191135102401026,CONDO 500,Residential,5000,61371,0,66371
191135102401027,CONDO 500,Residential,5000,61371,0,66371
191135102401028,CONDO 500,Residential,5000,62300,0,67300
191135102401029,CONDO 500,Residential,5000,62300,0,67300
191135102401030,CONDO 500,Residential,5000,62300,0,67300
191135102401031,CONDO 500,Residential,5000,62300,0,67300
191135102401032,CONDO 500,Residential,5000,62300,0,67300
191135102401033,CONDO 500,Residential,5000,62300,0,67300
191135102401034,CONDO 500,Residential,5000,62300,0,67300
191135102401035,CONDO 500,Residential,5000,62300,0,67300
191135102401036,CONDO 500,Residential,5000,61371,0,66371
191135102401037,CONDO 500,Residential,5000,61371,0,66371
191135102401038,CONDO 500,Residential,5000,61371,0,66371
191135102401039,CONDO 500,Residential,5000,61371,0,66371
191135102401040,CONDO 500,Residential,5000,62300,0,67300
191135102401041,CONDO 500,Residential,5000,62300,0,67300
191135102401042,CONDO 500,Residential,5000,62300,0,67300
191135102401043,CONDO 500,Residential,5000,62300,0,67300
191135102401044,CONDO 500,Residential,5000,62300,0,67300
191135102401045,CONDO 500,Residential,5000,62300,0,67300
191135102401046,CONDO 500,Residential,5000,62300,0,67300
191135102401047,CONDO 500,Residential,5000,62300,0,67300
191135102401048,CONDO 500,Residential,5000,61371,0,66371
191135102401049,CONDO 500,Residential,5000,61371,0,66371
191135102401050,CONDO 500,Residential,5000,61371,0,66371
191135102401051,CONDO 500,Residential,5000,61371,0,66371
191135102401052,CONDO 500,Residential,5000,62300,0,67300
191135102401053,CONDO 500,Residential,5000,62300,0,67300
191135102401054,CONDO 500,Residential,5000,62300,0,67300
191135102401055,CONDO 500,Residential,5000,62300,0,67300
191135102401056,CONDO 500,Residential,5000,62300,0,67300
191135102401057,CONDO 500,Residential,5000,62300,0,67300
191135102401058,CONDO 500,Residential,5000,62300,0,67300
191135102401059,CONDO 500,Residential,5000,53611,0,58611
191135102401060,CONDO 500,Residential,5000,61371,0,66371
191135102401061,CONDO 500,Residential,5000,61371,0,66371
191135102401062,CONDO 500,Residential,5000,61371,0,66371
191135102401063,CONDO 500,Residential,5000,61371,0,66371
191135102401064,CONDO 500,Residential,5000,62300,0,67300
191135102401065,CONDO 500,Residential,5000,62300,0,67300
191135102401066,CONDO 500,Residential,5000,62300,0,67300
191135102401067,CONDO 500,Residential,5000,62300,0,67300
191135102401068,CONDO 500,Residential,5000,62300,0,67300
191135102401069,CONDO 500,Residential,5000,62300,0,67300
191135102401070,CONDO 500,Residential,5000,62300,0,67300
191135102401071,CONDO 500,Residential,5000,62300,0,67300
191135102401072,CONDO 500,Residential,5000,61371,0,66371
191135102401073,CONDO 500,Residential,5000,61371,0,66371
191135102401074,CONDO 500,Residential,5000,61371,0,66371
191135102401075,CONDO 500,Residential,5000,61371,0,66371
191135102401076,CONDO 500,Residential,5000,62300,0,67300
191135102401077,CONDO 500,Residential,5000,62300,0,67300
191135102401078,CONDO 500,Residential,5000,62300,0,67300
191135102401079,CONDO 500,Residential,5000,62300,0,67300
191135102401080,CONDO 500,Residential,5000,62300,0,67300
191135102401081,CONDO 500,Residential,5000,62300,0,67300
191135102401082,CONDO 500,Residential,5000,62300,0,67300
191135102401083,CONDO 500,Residential,5000,62300,0,67300
191135102401084,CONDO 500,Residential,5000,61371,0,66371
191135102401085,CONDO 500,Residential,5000,61371,0,66371
191135102401086,CONDO 500,Residential,5000,61371,0,66371
191135102401087,CONDO 500,Residential,5000,61371,0,66371
191135102401088,CONDO 500,Residential,5000,62300,0,67300
191135102401089,CONDO 500,Residential,5000,62300,0,67300
191135102401090,CONDO 500,Residential,5000,62300,0,67300
191135102401091,CONDO 500,Residential,5000,62300,0,67300
191135102401092,CONDO 500,Residential,5000,62300,0,67300
191135102401093,CONDO 500,Residential,5000,62300,0,67300
191135102401094,CONDO 500,Residential,5000,62300,0,67300
191135102401095,CONDO 500,Residential,5000,62300,0,67300
191135102401096,CONDO 500,Residential,5000,61371,0,66371
191135102401097,CONDO 500,Residential,5000,61371,0,66371
191135102401098,CONDO 500,Residential,5000,61371,0,66371
191135102401099,CONDO 500,Residential,5000,61371,0,66371
191135102401100,CONDO 500,Residential,5000,62300,0,67300
191135102401101,CONDO 500,Residential,5000,62300,0,67300
191135102401102,CONDO 500,Residential,5000,62300,0,67300
191135102401103,CONDO 500,Residential,5000,62300,0,67300
191135102401104,CONDO 500,Residential,5000,62300,0,67300
191135102401105,CONDO 500,Residential,5000,62300,0,67300
191135102401106,CONDO 500,Residential,5000,62300,0,67300
191135102401107,CONDO 500,Residential,5000,62300,0,67300
191135102401108,CONDO 500,Residential,5000,61371,0,66371
191135102401109,CONDO 500,Residential,5000,61371,0,66371
191135102401110,CONDO 500,Residential,5000,61371,0,66371
191135102401111,CONDO 500,Residential,5000,61371,0,66371
191135102401112,CONDO 500,Residential,5000,62300,0,67300
191135102401113,CONDO 500,Residential,5000,62300,0,67300
191135102401114,CONDO 500,Residential,5000,62300,0,67300
191135102401115,CONDO 500,Residential,5000,62300,0,67300
191135102401116,CONDO 500,Residential,5000,62300,0,67300
191135102401117,CONDO 500,Residential,5000,62300,0,67300
191135102401118,CONDO 500,Residential,5000,62300,0,67300
191135102401119,CONDO 500,Residential,5000,62300,0,67300
191135102401120,CONDO 500,Residential,5000,61371,0,66371
191135102401121,CONDO 500,Residential,5000,61371,0,66371
191135102401122,CONDO 500,Residential,5000,61371,0,66371
191135102401123,CONDO 500,Residential,5000,61371,0,66371
191135102401124,CONDO 500,Residential,5000,62300,0,67300
191135102401125,CONDO 500,Residential,5000,62300,0,67300
191135102401126,CONDO 500,Residential,5000,62300,0,67300
191135102401127,CONDO 500,Residential,5000,62300,0,67300
191135102401128,CONDO 500,Residential,5000,62300,0,67300
191135102401129,CONDO 500,Residential,5000,62300,0,67300
191135102401130,CONDO 500,Residential,5000,62300,0,67300
191135102401131,CONDO 500,Residential,5000,62300,0,67300
191135102401132,CONDO 500,Residential,5000,61371,0,66371
191135102401133,CONDO 500,Residential,5000,61371,0,66371
191135102401134,CONDO 500,Residential,5000,61371,0,66371
191135102401135,CONDO 500,Residential,5000,61371,0,66371
191135102401136,CONDO 500,Residential,5000,62300,0,67300
191135102401137,CONDO 500,Residential,5000,62300,0,67300
191135102401138,CONDO 500,Residential,5000,62300,0,67300
191135102401139,CONDO 500,Residential,5000,62300,0,67300
191135102401140,CONDO 500,Residential,5000,62300,0,67300
191135102401141,CONDO 500,Residential,5000,62300,0,67300
191135102401142,CONDO 500,Residential,5000,62300,0,67300
191135102401143,CONDO 500,Residential,5000,62300,0,67300
191135200100000,SW 422,Residential,36679,131173,0,167852
191135200200000,SW 422,Residential,34366,154104,0,188470
191135300100000,SW 422,Residential,36256,138612,0,174868
191135300200000,SW 422,Residential,39318,130965,0,170283
191135300300000,SW 422,Residential,35880,149023,0,184903
191135300400000,SW 422,Residential,37168,143277,0,180445
191135400100000,SW 422,Residential,35878,137932,0,173810
191135400200000,SW 422,Residential,35880,159107,0,194987
191135400300000,SW 422,Residential,35880,125146,0,161026
191135400400000,SW 422,Residential,45080,0,0,45080
191135400500000,SW 422,Residential,37720,135528,0,173248
191135400600000,SW 422,Residential,37720,153390,0,191110
191135400700000,SW 422,Residential,37168,154735,0,191903
191135400800000,SW 422,Residential,35880,155753,0,191633
191135500100000,COMM SW,Commercial,376099,0,0,376099
191135500200000,COMM SW,Commercial,157421,0,206097,363518
191135500300000,COMM SW,Commercial,325685,0,1139130,1464815
191135600100000,COMM SW,Commercial,228096,0,610285,838381
191135700100000,SW 422,Residential,36860,175347,0,212207
191135700200000,SW 422,Residential,33464,0,0,33464
191137700200000,Empty,Exempt,0,0,0,0
191137701200000,SW 422,Residential,23279,120721,0,144000
191137701300000,SW 422,Residential,37818,148479,0,186297
191137701400000,SW 422,Residential,36252,0,0,36252
191137701500000,SW 422,Residential,37580,146420,0,184000
191137701600000,Empty,Exempt,0,0,0,0
191137701700000,SW 422,Residential,37720,129858,0,167578
191137701800000,SW 422,Residential,37310,150597,0,187907
191137701900000,SW 422,Residential,37674,185853,0,223527
191137702000000,SW 422,Residential,38916,159976,0,198892
191137702100000,SW 422,Residential,38540,127783,0,166323
191137702200000,SW 422,Residential,37224,170464,0,207688
191137702300000,SW 422,Residential,37224,146456,0,183680
191137702400000,SW 422,Residential,36942,153322,0,190264
191137702500000,SW 422,Residential,36942,176520,0,213462
191137702600000,SW 422,Residential,36660,170040,0,206700
191137702700000,SW 422,Residential,42420,127119,0,169539
191137702800000,SW 422,Residential,38907,182989,0,221896
191137702900000,SW 422,Residential,43050,127372,0,170422
191137703000000,SW 422,Residential,59438,133479,0,192917
191137703100000,SW 422,Residential,48112,164069,0,212181
191137703200000,SW 422,Residential,38456,132703,0,171159
191137703300000,SW 422,Residential,35880,154430,0,190310
191137703400000,SW 422,Residential,33304,0,0,33304
191137800100000,SW 422,Residential,43134,123216,0,166350
191137800200000,SW 422,Residential,38640,143010,0,181650
191137800300000,SW 422,Residential,39480,129919,0,169399
191137800400000,SW 422,Residential,39900,136089,0,175989
191137800500000,SW 422,Residential,40320,150863,0,191183
191137800600000,SW 422,Residential,41710,150878,0,192588
191137800700000,SW 422,Residential,37789,0,0,37789
191137800800000,SW 422,Residential,35880,133678,0,169558
191137800900000,SW 422,Residential,35880,142331,0,178211
191137801000000,SW 422,Residential,36156,143227,0,179383
191222600100000,SW 422,Residential,265410,7840,0,273250
191222600200000,Empty,Exempt,0,0,0,0
191222600300000,SW 422,Residential,52992,7840,0,60832
191222600400000,SW 422,Residential,85260,232572,0,317832
191225100100000,SW 422,Residential,8456,0,0,8456
191225200100000,SW 422,Residential,855,0,0,855
191225200200000,SW 422,Residential,156,0,0,156
191225200300000,SW 422,Residential,54927,116873,0,171800
191225200400000,SW 422,Residential,137,0,0,137
191225200500000,SW 422,Residential,54121,154372,0,208493
191225200600000,SW 422,Residential,62176,153872,0,216048
191225200700000,SW 422,Residential,200,0,0,200
191225200800000,SW 422,Residential,212,0,0,212
191225200900000,SW 422,Residential,55862,195870,0,251732
191225201000000,SW 422,Residential,51520,190208,0,241728
191225201100000,SW 422,Residential,64768,140920,0,205688
191225201200000,SW 422,Residential,56,0,0,56
191225201300000,SW 422,Residential,137,0,0,137
191225201400000,SW 422,Residential,50838,182455,0,233293
191225201500000,SW 422,Residential,55745,240685,0,296430
191225201600000,SW 422,Residential,55200,234093,0,289293
191225201700000,SW 422,Residential,52992,286355,0,339347
191225201800000,SW 422,Residential,55200,226731,0,281931
191225201900000,SW 422,Residential,57408,161419,0,218827
191225202000000,SW 422,Residential,57408,213161,0,270569
191225202100000,SW 422,Residential,52992,216438,0,269430
191225202200000,SW 422,Residential,187,0,0,187
191225202300000,SW 422,Residential,1231,0,0,1231
191225300100000,SW 422,Residential,57408,202177,0,259585
191225300200000,SW 422,Residential,137,0,0,137
191225300300000,SW 422,Residential,55200,238830,0,294030
191225300400000,SW 422,Residential,55200,223423,0,278623
191225300500000,SW 422,Residential,58880,153956,0,212836
191225300600000,SW 422,Residential,55200,192105,0,247305
191225300700000,SW 422,Residential,52992,201617,0,254609
191225300800000,SW 422,Residential,57408,210125,0,267533
191225300900000,SW 422,Residential,144,0,0,144
191225301000000,SW 422,Residential,44,0,0,44
191225400100000,SW 422,Residential,618,0,0,618
191225400200000,SW 422,Residential,219,0,0,219
191225400300000,SW 422,Residential,80784,244676,0,325460
191225400400000,SW 422,Residential,64615,227065,0,291680
191225400500000,SW 422,Residential,61336,262930,0,324266
191225400600000,SW 422,Residential,162,0,0,162
191225400700000,SW 422,Residential,162,0,0,162
191225400800000,SW 422,Residential,58717,214560,0,273277
191225400900000,SW 422,Residential,58717,152057,0,210774
191225401000000,SW 422,Residential,58064,199564,0,257628
191225401100000,SW 422,Residential,2973,0,0,2973
191412700200000,SW 422,Residential,45080,0,0,45080
191412700300000,SW 422,Residential,46500,0,0,46500
191412700400000,SW 422,Residential,47000,0,0,47000
191412700500000,SW 422,Residential,47500,0,0,47500
191412700600000,SW 422,Residential,48000,0,0,48000
191412700700000,SW 422,Residential,48000,0,0,48000
191412700800000,SW 422,Residential,48500,0,0,48500
191412700900000,SW 422,Residential,48500,0,0,48500
191412800100000,SW 422,Residential,43610,0,0,43610
191412800200000,SW 422,Residential,43120,0,0,43120
191412800300000,SW 422,Residential,43610,0,0,43610
191412800400000,SW 422,Residential,43833,0,0,43833
191412800500000,SW 422,Residential,44590,0,0,44590
191412800600000,SW 422,Residential,52183,0,0,52183
191412800700000,SW 422,Residential,56160,0,0,56160
191412900100000,SW 422,Residential,45540,0,0,45540
191412900200000,SW 422,Residential,46000,0,0,46000
191412900300000,SW 422,Residential,46000,173242,0,219242
191412900400000,SW 422,Residential,47198,182017,0,229215
191412900500000,SW 422,Residential,46000,187973,0,233973
191412900600000,SW 422,Residential,46000,192217,0,238217
191412900700000,SW 422,Residential,52780,180350,0,233130
191412900800000,SW 422,Residential,44500,0,0,44500
191412900900000,SW 422,Residential,43200,190212,0,233412
191412901000000,SW 422,Residential,48000,231061,0,279061
191412901100000,SW 422,Residential,46500,226057,0,272557
191412901200000,SW 422,Residential,46217,0,0,46217
191412901300000,SW 422,Residential,64350,231566,0,295916
191412901400000,SW 422,Residential,60066,260788,0,320854
191412901500000,SW 422,Residential,46560,234321,0,280881
191412901600000,SW 422,Residential,62032,0,0,62032
191412901700000,SW 422,Residential,46713,0,0,46713
191412901800000,SW 422,Residential,46410,0,0,46410
191412901900000,SW 422,Residential,47763,0,0,47763
191412902000000,SW 422,Residential,46000,0,0,46000
191413000100000,SW 422,Residential,50298,218610,0,268908
191413000200000,SW 422,Residential,50925,219268,0,270193
191413000300000,SW 422,Residential,53025,190408,0,243433
191413000400000,SW 422,Residential,47000,200704,0,247704
191413000500000,SW 422,Residential,46000,0,0,46000
191413000600000,SW 422,Residential,46000,238366,0,284366
191413000700000,SW 422,Residential,46460,178305,0,224765
191413000800000,SW 422,Residential,46460,0,0,46460
191413000900000,SW 422,Residential,46000,192636,0,238636
191413001000000,SW 422,Residential,46000,237343,0,283343
191413001100000,SW 422,Residential,46000,227371,0,273371
191413100100000,SW 422,Residential,2974,0,0,2974
191413100200000,SW 422,Residential,46920,0,0,46920
191413100300000,SW 422,Residential,46920,0,0,46920
191415200200000,SW 422,Ag Land,2161,0,0,2161
191415300100000,SW 422,Residential,48500,0,0,48500
191415300200000,SW 422,Residential,48000,0,0,48000
191415400100000,SW 422,Residential,46000,0,0,46000
191415400200000,SW 422,Residential,46000,0,0,46000
191415400300000,SW 422,Residential,46000,0,0,46000
191415400400000,SW 422,Residential,46000,0,0,46000
191415400500000,SW 422,Residential,46000,0,0,46000
191415400600000,SW 422,Residential,46000,220258,0,266258
191415400700000,SW 422,Residential,47000,0,0,47000
191415400800000,SW 422,Residential,71624,257994,0,329618
191415400900000,SW 422,Residential,47040,0,0,47040
191415401000000,SW 422,Residential,46000,159856,0,205856
191415401100000,SW 422,Residential,46000,174255,0,220255
191415401200000,SW 422,Residential,47840,0,0,47840
191415401300000,SW 422,Residential,47840,0,0,47840
191415401400000,SW 422,Residential,46000,0,0,46000
191415401500000,SW 422,Residential,46000,0,0,46000
191415401600000,SW 422,Residential,46000,0,0,46000
191415401700000,SW 422,Residential,46000,220955,0,266955
191415401800000,SW 422,Residential,46000,223735,0,269735
191415401900000,SW 422,Residential,48500,163705,0,212205
191415402000000,SW 422,Residential,48000,233157,0,281157
191415402100000,SW 422,Residential,48500,257143,0,305643
191415402200000,SW 422,Residential,48567,152960,0,201527
191415402300000,SW 422,Residential,404,0,0,404
191415402400000,SW 422,Residential,56160,340807,0,396967
191415402500000,SW 422,Residential,54035,132253,0,186288
191415402600000,SW 422,Residential,52430,192843,0,245273
191415402700000,SW 422,Residential,486,0,0,486
191415402800000,SW 422,Residential,534,0,0,534
191415402900000,SW 422,Residential,492,0,0,492
191415403000000,SW 422,Residential,538,0,0,538
191415403100000,SW 422,Residential,635,0,0,635
191415403200000,SW 422,Residential,425,0,0,425
191415403300000,SW 422,Residential,396,0,0,396
191415403400000,SW 422,Residential,499,0,0,499
191415403500000,SW 422,Residential,452,0,0,452
191415403600000,SW 422,Residential,389,0,0,389
191415500100000,SW 422,Residential,46000,190062,0,236062
191415500200000,SW 422,Residential,44620,238120,0,282740
191415500300000,SW 422,Residential,46460,293590,0,340050
191415500400000,SW 422,Residential,406,0,0,406
191415500500000,SW 422,Residential,44000,47077,0,91077
191415500600000,SW 422,Residential,46000,265022,0,311022
191415500700000,SW 422,Residential,42315,176518,0,218833
191415500800000,SW 422,Residential,42780,44424,0,87204
191415500900000,SW 422,Residential,42780,187926,0,230706
191415501000000,SW 422,Residential,43240,191629,0,234869
191415501100000,SW 422,Residential,42780,187697,0,230477
191415501200000,SW 422,Residential,404,0,0,404
191415501300000,SW 422,Residential,42320,172803,0,215123
191415501400000,SW 422,Residential,45500,160951,0,206451
191415600100000,SW 422,Residential,41400,0,0,41400
191415600200000,SW 422,Residential,45927,0,0,45927
191415600300000,SW 422,Residential,43000,0,0,43000
191415600400000,SW 422,Residential,45000,237197,0,282197
191415600500000,SW 422,Residential,46000,227032,0,273032
191415600600000,SW 422,Residential,48000,203752,0,251752
191415600700000,SW 422,Residential,48500,163697,0,212197
191415600800000,SW 422,Residential,48500,206129,0,254629
191415600900000,SW 422,Residential,45407,309420,0,354827
191415601000000,SW 422,Residential,406,0,0,406
191415601100000,SW 422,Residential,464,0,0,464
191415601200000,SW 422,Residential,491,0,0,491
191415601300000,SW 422,Residential,434,0,0,434
191415601400000,SW 422,Residential,417,0,0,417
191415601500000,SW 422,Residential,400,0,0,400
191415601600000,SW 422,Residential,383,0,0,383
191415601700000,SW 422,Residential,389,0,0,389
191415601800000,SW 422,Residential,377,0,0,377
191415700100000,SW 422,Residential,517,0,0,517
191415700200000,SW 422,Residential,799,0,0,799
191415700300000,SW 422,Residential,386,0,0,386
191415700400000,SW 422,Residential,318,0,0,318
191415700500000,SW 422,Residential,383,0,0,383
191415700600000,SW 422,Residential,319,0,0,319
191415700700000,SW 422,Residential,388,0,0,388
191415700800000,SW 422,Residential,44100,165628,0,209728
191415700900000,SW 422,Exempt,0,0,0,0
191415800100000,SW 422,Residential,342,0,0,342
191415800200000,SW 422,Residential,323,0,0,323
191415800300000,SW 422,Residential,325,0,0,325
191415800400000,SW 422,Residential,42750,210626,0,253376
191415800500000,SW 422,Residential,326,0,0,326
191415800600000,SW 422,Residential,327,0,0,327
191415800700000,SW 422,Residential,329,0,0,329
191415800800000,SW 422,Residential,342,0,0,342
191415800900000,SW 422,Residential,377,0,0,377
191415801000000,SW 422,Exempt,0,0,0,0
191417700200000,SW 422,Residential,35000,196925,0,231925
191417700300000,SW 422,Residential,551,0,0,551
191417700400000,SW 422,Residential,454,0,0,454
191417700500000,SW 422,Residential,411,0,0,411
191417700600000,SW 422,Residential,433,0,0,433
191417700700000,SW 422,Residential,530,0,0,530
191417800100000,SW 422,Residential,536,0,0,536
191417800200000,SW 422,Residential,494,0,0,494
191417800300000,SW 422,Residential,468,0,0,468
191417800400000,SW 422,Residential,428,0,0,428
191417900100000,SW 422,Residential,652,0,0,652
191417900200000,SW 422,Residential,428,0,0,428
191417900300000,SW 422,Residential,363,0,0,363
191417900400000,SW 422,Exempt,0,0,0,0
191418000100000,SW 422,Residential,368,0,0,368
191418000200000,SW 422,Residential,42750,137078,0,179828
191418000300000,SW 422,Residential,381,0,0,381
191420100200000,E-83 EDU OTHER,Exempt,35000,0,0,35000
191420100300000,SW 422,Residential,56515,0,0,56515
191420100400000,SW 422,Residential,47500,0,0,47500
191420100500000,SW 422,Residential,47000,0,0,47000
191420100600000,SW 422,Residential,47000,0,0,47000
191420100700000,SW 422,Residential,51360,234710,0,286070
191420100800000,SW 422,Residential,66733,202416,0,269149
191420100900000,SW 422,Residential,60426,276172,0,336598
191420101000000,SW 422,Residential,58684,291316,0,350000
191420101100000,SW 422,Residential,63178,206717,0,269895
191420101200000,SW 422,Residential,53500,197393,0,250893
191420101300000,SW 422,Residential,50500,176942,0,227442
191420101400000,SW 422,Residential,46000,0,0,46000
191420101500000,SW 422,Residential,53093,0,0,53093
191420101600000,SW 422,Residential,52000,210967,0,262967
191420101700000,SW 422,Residential,66810,279648,0,346458
191420101800000,SW 422,Residential,48015,206437,0,254452
191420101900000,SW 422,Residential,48500,181930,0,230430
191420102000000,SW 422,Residential,48000,216006,0,264006
191420102100000,SW 422,Residential,48000,262429,0,310429
191420102200000,SW 422,Residential,52165,213719,0,265884
191420102300000,SW 422,Residential,59160,212587,0,271747
191420102400000,SW 422,Residential,50133,205489,0,255622
191420200100000,SW 422,Residential,51000,241364,0,292364
191420200200000,SW 422,Residential,49000,222225,0,271225
191420200300000,SW 422,Residential,51615,183650,0,235265
191420200400000,SW 422,Residential,46000,0,0,46000
191420200500000,SW 422,Residential,43650,0,0,43650
191420200600000,SW 422,Residential,48760,0,0,48760
191420200700000,SW 422,Residential,45080,0,0,45080
191420200800000,SW 422,Residential,45080,0,0,45080
191420200900000,SW 422,Residential,45233,0,0,45233
191420201000000,SW 422,Residential,48723,0,0,48723
191422600100000,SW 422,Ag Dwelling,28214,55200,4761,88175
191422600200000,SW 422,Residential,66000,83054,0,149054
191422600400000,SW 422,Ag Land,48145,0,0,48145
191422700100000,SW 422,Residential,274,0,0,274
191422800100000,SW 422,Residential,275,0,0,275
191422800200000,SW 422,Residential,237,0,0,237
191422800300000,SW 422,Residential,257,0,0,257
191422800400000,SW 422,Residential,257,0,0,257
191422800500000,SW 422,Residential,241,0,0,241
191422800600000,SW 422,Residential,241,0,0,241
191422800700000,SW 422,Residential,241,0,0,241
191422800800000,SW 422,Residential,35244,137944,0,173188
191422800900000,SW 422,Residential,274,0,0,274
191422900100000,SW 422,Residential,247,0,0,247
191422900200000,SW 422,Ag Land,1009,0,0,1009
191423000100000,SW 422,Residential,305,0,0,305
191423000200000,SW 422,Residential,40950,180658,0,221608
191423000300000,SW 422,Residential,38220,134280,0,172500
191423000400000,SW 422,Residential,36036,132520,0,168556
191423000500000,SW 422,Residential,36364,146071,0,182435
191423000600000,SW 422,Residential,38220,142528,0,180748
191423000700000,SW 422,Residential,287,0,0,287
191423000800000,SW 422,Residential,910,0,0,910
191427600200000,SW 422,Ag Land,50881,0,0,50881
191427600300000,SW 422,Residential,5380,0,0,5380
191510100200000,COMM SW,Commercial,3038904,0,22461096,25500000
191510100300000,COMM SW,Commercial,669492,0,15415985,16085477
191520100100000,Empty,Exempt,0,0,0,0
191520100102000,COMM SW,Commercial,437400,0,1916760,2354160
191525100100000,SW 422,Residential,98700,73574,0,172274
191530100100000,Empty,Exempt,0,0,0,0
191530100101000,COMM SW,Commercial,32400,0,440474,472874
191530100101001,Empty,Exempt,0,0,0,0
191530100101002,Empty,Exempt,0,0,0,0
191530100101003,COMM SW,Commercial,5508,0,28687,34195
191530100102000,COMM SW,Commercial,0,0,16681,16681
191530100102001,COMM SW,Commercial,0,0,6086,6086
191530100102002,COMM SW,Commercial,0,0,7356,7356
191530100102003,COMM SW,Commercial,0,0,12172,12172
191530100102004,COMM SW,Commercial,0,0,6403,6403
191532600100000,COMM SW,Commercial,337716,0,4055557,4393273
191535100100000,Empty,Exempt,0,0,0,0
191540100300000,E-83 EDU OTHER,Exempt,0,0,0,0
191540200100000,SW 422,Ag Land,40335,0,0,40335
191540200201009,CONDO 500,Residential,8000,80566,0,88566
191540200201010,CONDO 500,Residential,8000,80566,0,88566
191540200201011,CONDO 500,Residential,8000,76797,0,84797
191540200201012,CONDO 500,Residential,8000,80566,0,88566
191540200201013,CONDO 500,Residential,8000,80566,0,88566
191540200201014,CONDO 500,Residential,8000,80566,0,88566
191540200201015,CONDO 500,Residential,8000,81518,0,89518
191540200201016,CONDO 500,Residential,8000,81518,0,89518
191540200201017,CONDO 500,Residential,8000,81518,0,89518
191540200201018,CONDO 500,Residential,8000,81518,0,89518
191540200201019,CONDO 500,Residential,8000,81518,0,89518
191540200201020,CONDO 500,Residential,8000,81518,0,89518
191540200201021,CONDO 500,Residential,8000,80566,0,88566
191540200201022,CONDO 500,Residential,8000,80566,0,88566
191540200201023,CONDO 500,Residential,8000,76797,0,84797
191540200201024,CONDO 500,Residential,8000,80566,0,88566
191540200201025,CONDO 500,Residential,8000,80566,0,88566
191540200201026,CONDO 500,Residential,8000,80566,0,88566
191540200201027,CONDO 500,Residential,8000,81518,0,89518
191540200201028,CONDO 500,Residential,8000,81518,0,89518
191540200201029,CONDO 500,Residential,8000,81518,0,89518
191540200201030,CONDO 500,Residential,8000,81518,0,89518
191540200201031,CONDO 500,Residential,8000,81518,0,89518
191540200201032,CONDO 500,Residential,8000,81518,0,89518
191540200201033,CONDO 500,Residential,8000,80566,0,88566
191540200201034,CONDO 500,Residential,8000,80566,0,88566
191540200201035,CONDO 500,Residential,8000,76797,0,84797
191540200201036,CONDO 500,Residential,8000,80566,0,88566
191540200201037,CONDO 500,Residential,8000,81518,0,89518
191540200201038,CONDO 500,Residential,8000,81518,0,89518
191540200201039,CONDO 500,Residential,8000,81518,0,89518
191540200201040,CONDO 500,Residential,8000,81518,0,89518
191540200201041,CONDO 500,Residential,8000,81518,0,89518
191540200201042,CONDO 500,Residential,8000,81518,0,89518
191540200201043,CONDO 500,Residential,8000,81518,0,89518
191540200201044,CONDO 500,Residential,8000,81518,0,89518
191540200201045,CONDO 500,Residential,8000,80566,0,88566
191540200201046,CONDO 500,Residential,8000,80566,0,88566
191540200201047,CONDO 500,Residential,8000,76797,0,84797
191540200201048,CONDO 500,Residential,8000,80566,0,88566
191540200201049,CONDO 500,Residential,8000,81518,0,89518
191540200201050,CONDO 500,Residential,8000,81518,0,89518
191540200201051,CONDO 500,Residential,8000,81518,0,89518
191540200201052,CONDO 500,Residential,8000,81518,0,89518
191540200201053,CONDO 500,Residential,8000,81518,0,89518
191540200201054,CONDO 500,Residential,8000,81518,0,89518
191540200201055,CONDO 500,Residential,8000,81518,0,89518
191540200201056,CONDO 500,Residential,8000,81518,0,89518
191540200201057,CONDO 500,Residential,8000,80566,0,88566
191540200201058,CONDO 500,Residential,8000,80566,0,88566
191540200201059,CONDO 500,Residential,8000,76797,0,84797
191540200201060,CONDO 500,Residential,8000,80566,0,88566
191540200201061,CONDO 500,Residential,8000,81518,0,89518
191540200201062,CONDO 500,Residential,8000,81518,0,89518
191540200201063,CONDO 500,Residential,8000,81518,0,89518
191540200201064,CONDO 500,Residential,8000,81518,0,89518
191540200201065,CONDO 500,Residential,8000,81518,0,89518
191540200201066,CONDO 500,Residential,8000,81518,0,89518
191540200201067,CONDO 500,Residential,8000,81518,0,89518
191540200201068,CONDO 500,Residential,8000,81518,0,89518
191540200201069,CONDO 500,Residential,4000,0,0,4000
191540200201070,CONDO 500,Residential,4000,0,0,4000
191540200201071,CONDO 500,Residential,4000,0,0,4000
191540200201072,CONDO 500,Residential,4000,0,0,4000
191540200201073,CONDO 500,Residential,4000,0,0,4000
191540200201074,CONDO 500,Residential,4000,0,0,4000
191540200201075,CONDO 500,Residential,4000,0,0,4000
191540200201076,CONDO 500,Residential,4000,0,0,4000
191540200201077,CONDO 500,Residential,4000,0,0,4000
191540200201078,CONDO 500,Residential,4000,0,0,4000
191540200201079,CONDO 500,Residential,4000,0,0,4000
191540200201080,CONDO 500,Residential,4000,0,0,4000
191540200201081,CONDO 500,Residential,4000,0,0,4000
191540200201082,CONDO 500,Residential,4000,0,0,4000
191540200201083,CONDO 500,Residential,4000,0,0,4000
191540200201084,CONDO 500,Residential,4000,0,0,4000
191540200201085,CONDO 500,Residential,4000,0,0,4000
191540200201086,CONDO 500,Residential,4000,0,0,4000
191540200201087,CONDO 500,Residential,4000,0,0,4000
191540200201088,CONDO 500,Residential,4000,0,0,4000
191540200201089,CONDO 500,Residential,4000,0,0,4000
191540200201090,CONDO 500,Residential,4000,0,0,4000
191540200201091,CONDO 500,Residential,4000,0,0,4000
191540200201092,CONDO 500,Residential,4000,0,0,4000
191540200201093,CONDO 500,Residential,4000,0,0,4000
191540200201094,CONDO 500,Residential,4000,0,0,4000
191540200201095,CONDO 500,Residential,4000,0,0,4000
191540200201096,CONDO 500,Residential,4000,0,0,4000
191540200201097,CONDO 500,Residential,4000,0,0,4000
191540200201098,CONDO 500,Residential,4000,0,0,4000
191540200201099,CONDO 500,Residential,4000,0,0,4000
191540200201100,CONDO 500,Residential,4000,0,0,4000
191540200201101,CONDO 500,Residential,4000,0,0,4000
191540200201102,CONDO 500,Residential,4000,0,0,4000
191540200201103,CONDO 500,Residential,4000,0,0,4000
191540200201104,CONDO 500,Residential,4000,0,0,4000
191540200201105,CONDO 500,Residential,4000,0,0,4000
191540200201106,CONDO 500,Residential,4000,0,0,4000
191540200201107,CONDO 500,Residential,4000,0,0,4000
191540200201108,CONDO 500,Residential,4000,0,0,4000
191540200201109,CONDO 500,Residential,4000,0,0,4000
191540200201110,CONDO 500,Residential,4000,0,0,4000
191540200201111,CONDO 500,Residential,4000,0,0,4000
191540200201112,CONDO 500,Residential,4000,0,0,4000
191540200201113,CONDO 500,Residential,4000,0,0,4000
191540200201114,CONDO 500,Residential,4000,0,0,4000
191540200201115,CONDO 500,Residential,4000,0,0,4000
191540200201116,CONDO 500,Residential,4000,0,0,4000
191540200201117,CONDO 500,Residential,4000,0,0,4000
191540200201118,CONDO 500,Residential,4000,0,0,4000
191540200201119,CONDO 500,Residential,4000,0,0,4000
191540200201120,CONDO 500,Residential,4000,0,0,4000
191540200201121,CONDO 500,Residential,4000,0,0,4000
191540200201122,CONDO 500,Residential,4000,0,0,4000
191540200201123,CONDO 500,Residential,4000,0,0,4000
191540200201124,CONDO 500,Residential,4000,0,0,4000
191540200201125,CONDO 500,Residential,4000,0,0,4000
191540200201126,CONDO 500,Residential,4000,0,0,4000
191540200201127,CONDO 500,Residential,4000,0,0,4000
191540200201128,CONDO 500,Residential,4000,0,0,4000
191540200201129,CONDO 500,Residential,4000,0,0,4000
191540200201130,CONDO 500,Residential,4000,0,0,4000
191540200201131,CONDO 500,Residential,4000,0,0,4000
191540200201132,CONDO 500,Residential,4000,0,0,4000
191540200201133,CONDO 500,Residential,4000,0,0,4000
191540200201134,CONDO 500,Residential,4000,0,0,4000
191540200201135,CONDO 500,Residential,4000,0,0,4000
191540200201136,CONDO 500,Residential,4000,0,0,4000
191540200201137,CONDO 500,Residential,4000,0,0,4000
191540200201138,CONDO 500,Residential,4000,0,0,4000
191540200201139,CONDO 500,Residential,4000,0,0,4000
191540200201140,CONDO 500,Residential,4000,0,0,4000
191540200201141,CONDO 500,Residential,4000,0,0,4000
191540200201142,CONDO 500,Residential,4000,0,0,4000
191540200201143,CONDO 500,Residential,4000,0,0,4000
191540200201144,CONDO 500,Residential,4000,0,0,4000
191540200201145,CONDO 500,Residential,4000,0,0,4000
191540200201146,CONDO 500,Residential,4000,0,0,4000
191540200201147,CONDO 500,Residential,4000,0,0,4000
191540200201148,CONDO 500,Residential,4000,0,0,4000
191540200201149,CONDO 500,Residential,4000,0,0,4000
191540200201150,CONDO 500,Residential,4000,0,0,4000
191540200201151,CONDO 500,Residential,4000,0,0,4000
191540200201152,CONDO 500,Residential,4000,0,0,4000
191540200201153,CONDO 500,Residential,4000,0,0,4000
191540200201154,CONDO 500,Residential,4000,0,0,4000
191540200201155,CONDO 500,Residential,4000,0,0,4000
191540200201156,CONDO 500,Residential,4000,0,0,4000
191540200201157,CONDO 500,Residential,4000,0,0,4000
191540200201158,CONDO 500,Residential,4000,0,0,4000
191540200201159,CONDO 500,Residential,4000,0,0,4000
191540200201160,CONDO 500,Residential,4000,0,0,4000
191540200201161,CONDO 500,Residential,4000,0,0,4000
191540200201162,CONDO 500,Residential,4000,0,0,4000
191540200201163,CONDO 500,Residential,4000,0,0,4000
191540200201164,CONDO 500,Residential,4000,0,0,4000
191540200201189,CONDO 500,Residential,8000,80566,0,88566
191540200201190,CONDO 500,Residential,8000,80566,0,88566
191540200201191,CONDO 500,Residential,8000,76797,0,84797
191540200201192,CONDO 500,Residential,8000,80566,0,88566
191540200201193,CONDO 500,Residential,8000,81518,0,89518
191540200201194,CONDO 500,Residential,8000,81518,0,89518
191540200201195,CONDO 500,Residential,8000,81518,0,89518
191540200201196,CONDO 500,Residential,8000,81518,0,89518
191540200201197,CONDO 500,Residential,8000,81518,0,89518
191540200201198,CONDO 500,Residential,8000,81518,0,89518
191540200201199,CONDO 500,Residential,8000,81518,0,89518
191540200201200,CONDO 500,Residential,8000,81518,0,89518
191540200201201,CONDO 500,Residential,8000,80566,0,88566
191540200201202,CONDO 500,Residential,8000,80566,0,88566
191540200201203,CONDO 500,Residential,8000,76797,0,84797
191540200201204,CONDO 500,Residential,8000,80566,0,88566
191540200201205,CONDO 500,Residential,8000,81518,0,89518
191540200201206,CONDO 500,Residential,8000,81518,0,89518
191540200201207,CONDO 500,Residential,8000,81518,0,89518
191540200201208,CONDO 500,Residential,8000,81518,0,89518
191540200201209,CONDO 500,Residential,8000,81518,0,89518
191540200201210,CONDO 500,Residential,8000,81518,0,89518
191540200201211,CONDO 500,Residential,8000,81518,0,89518
191540200201212,CONDO 500,Residential,8000,81518,0,89518
191540200201213,CONDO 500,Residential,4000,0,0,4000
191540200201214,CONDO 500,Residential,4000,0,0,4000
191540200201215,CONDO 500,Residential,4000,0,0,4000
191540200201216,CONDO 500,Residential,4000,0,0,4000
191540200201217,CONDO 500,Residential,4000,0,0,4000
191540200201218,CONDO 500,Residential,4000,0,0,4000
191540200201219,CONDO 500,Residential,4000,0,0,4000
191540200201220,CONDO 500,Residential,4000,0,0,4000
191540200201221,CONDO 500,Residential,4000,0,0,4000
191540200201222,CONDO 500,Residential,4000,0,0,4000
191540200201223,CONDO 500,Residential,4000,0,0,4000
191540200201224,CONDO 500,Residential,4000,0,0,4000
191540200201225,CONDO 500,Residential,4000,0,0,4000
191540200201226,CONDO 500,Residential,4000,0,0,4000
191540200201227,CONDO 500,Residential,4000,0,0,4000
191540200201228,CONDO 500,Residential,4000,0,0,4000
191540200201229,CONDO 500,Residential,4000,0,0,4000
191540200201230,CONDO 500,Residential,4000,0,0,4000
191540200201231,CONDO 500,Residential,4000,0,0,4000
191540200201232,CONDO 500,Residential,4000,0,0,4000
191540200201233,CONDO 500,Residential,4000,0,0,4000
191540200201234,CONDO 500,Residential,4000,0,0,4000
191540200201235,CONDO 500,Residential,4000,0,0,4000
191540200201236,CONDO 500,Residential,4000,0,0,4000
191540200201237,COMM SW,Commercial,33750,0,27538,61288
191540200201238,COMM SW,Commercial,33750,0,27538,61288
191540200201239,CONDO 500,Residential,8000,82287,0,90287
191540200201240,CONDO 500,Residential,8000,68021,0,76021
191540200201241,CONDO 500,Residential,8000,68021,0,76021
191540200201242,CONDO 500,Residential,8000,68021,0,76021
191540200201243,CONDO 500,Residential,8000,68021,0,76021
191540200201244,CONDO 500,Residential,8000,68021,0,76021
191540200201245,CONDO 500,Residential,8000,68021,0,76021
191540200201246,CONDO 500,Residential,8000,68021,0,76021
191540200201247,CONDO 500,Residential,8000,68021,0,76021
191540200201248,CONDO 500,Residential,8000,80566,0,88566
191540200201249,CONDO 500,Residential,8000,80566,0,88566
191540200201250,CONDO 500,Residential,8000,80566,0,88566
191540200201251,CONDO 500,Residential,8000,80566,0,88566
191540200201252,CONDO 500,Residential,8000,80566,0,88566
191540200201253,CONDO 500,Residential,8000,80566,0,88566
191540200201254,CONDO 500,Residential,8000,81518,0,89518
191540200201255,CONDO 500,Residential,8000,81518,0,89518
191540200201256,CONDO 500,Residential,8000,81518,0,89518
191540200201257,CONDO 500,Residential,8000,81518,0,89518
191540200201258,CONDO 500,Residential,8000,81518,0,89518
191540200201259,CONDO 500,Residential,8000,81518,0,89518
191540200201260,CONDO 500,Residential,8000,81518,0,89518
191540200201261,CONDO 500,Residential,8000,81518,0,89518
191540200201262,CONDO 500,Residential,8000,81518,0,89518
191540200201263,CONDO 500,Residential,8000,81518,0,89518
191540200201264,CONDO 500,Residential,8000,81518,0,89518
191540200201265,CONDO 500,Residential,8000,81518,0,89518
191540200201266,CONDO 500,Residential,8000,80566,0,88566
191540200201267,CONDO 500,Residential,8000,80566,0,88566
191540200201268,CONDO 500,Residential,8000,80566,0,88566
191540200201269,CONDO 500,Residential,8000,80566,0,88566
191540200201270,CONDO 500,Residential,8000,80566,0,88566
191540200201271,CONDO 500,Residential,8000,80566,0,88566
191540200201272,CONDO 500,Residential,8000,81518,0,89518
191540200201273,CONDO 500,Residential,8000,81518,0,89518
191540200201274,CONDO 500,Residential,8000,81518,0,89518
191540200201275,CONDO 500,Residential,8000,81518,0,89518
191540200201276,CONDO 500,Residential,8000,81518,0,89518
191540200201277,CONDO 500,Residential,8000,81518,0,89518
191540200201278,CONDO 500,Residential,8000,81518,0,89518
191540200201279,CONDO 500,Residential,8000,81518,0,89518
191540200201280,CONDO 500,Residential,8000,81518,0,89518
191540200201281,CONDO 500,Residential,8000,81518,0,89518
191540200201282,CONDO 500,Residential,8000,81518,0,89518
191540200201283,CONDO 500,Residential,8000,81518,0,89518
191547600100000,E-83 EDU OTHER,Exempt,26461,0,0,26461
191547600200000,Empty,Exempt,0,0,0,0
191610100100000,SW 426,Residential,27791,96081,0,123872
191610100200000,SW 426,Residential,27072,93104,0,120176
191610100300000,SW 426,Residential,27072,100958,0,128030
191610100400000,SW 426,Residential,27072,102728,0,129800
191610100500000,SW 426,Residential,27072,101855,0,128927
191610100600000,SW 426,Residential,27072,80191,0,107263
191610100700000,SW 426,Residential,26696,70714,0,97410
191610100800000,SW 426,Residential,26696,107769,0,134465
191610100900000,SW 426,Residential,26696,82094,0,108790
191610101000000,SW 426,Residential,26696,96309,0,123005
191610101100000,SW 426,Residential,26696,109769,0,136465
191610101200000,SW 426,Residential,26696,88761,0,115457
191610101300000,SW 426,Residential,26696,89034,0,115730
191610101400000,SW 426,Residential,26696,74203,0,100899
191610101500000,SW 426,Residential,29856,69180,0,99036
191610101600000,SW 426,Residential,29792,106904,0,136696
191610101700000,SW 426,Residential,29508,140128,0,169636
191610101800000,SW 426,Residential,28269,67106,0,95375
191610101900000,SW 426,Residential,26320,104720,0,131040
191610102000000,SW 426,Residential,26320,88098,0,114418
191610102100000,SW 426,Residential,26320,58957,0,85277
191610102200000,SW 426,Residential,26320,95448,0,121768
191610102300000,SW 426,Residential,26320,83200,0,109520
191610102400000,SW 426,Residential,26338,62035,0,88373
191610200100000,SW 426,Residential,25928,98919,0,124847
191610200200000,SW 426,Residential,25568,100765,0,126333
191610200300000,SW 426,Residential,25568,57331,0,82899
191610200400000,SW 426,Residential,25568,101894,0,127462
191610200500000,SW 426,Residential,25568,80883,0,106451
191610200600000,SW 426,Residential,25960,109506,0,135466
191610200700000,SW 426,Residential,20880,99695,0,120575
191610200800000,SW 426,Residential,20880,105924,0,126804
191610200900000,SW 426,Residential,20880,115963,0,136843
191610201000000,SW 426,Residential,22100,114352,0,136452
191610201100000,SW 426,Residential,18933,103546,0,122479
191610201200000,SW 426,Residential,23073,110662,0,133735
191610201300000,SW 426,Residential,21763,114468,0,136231
191610201400000,SW 426,Residential,19427,105005,0,124432
191610201500000,SW 426,Residential,19015,105537,0,124552
191610201600000,SW 426,Residential,20877,96466,0,117343
191610201700000,SW 426,Residential,20640,100236,0,120876
191610201800000,SW 426,Residential,20400,104560,0,124960
191610201900000,SW 426,Residential,20400,95423,0,115823
191610202000000,SW 426,Residential,21632,119069,0,140701
191610202100000,SW 426,Residential,22880,98617,0,121497
191610202200000,SW 426,Residential,22880,125454,0,148334
191610202300000,SW 426,Residential,22880,111075,0,133955
191610202400000,SW 426,Residential,22811,129682,0,152493
191610202500000,SW 426,Residential,29073,87009,0,116082
191610202600000,SW 426,Residential,28322,110771,0,139093
191610202700000,SW 426,Residential,27711,98832,0,126543
191610202800000,SW 426,Residential,30558,81246,0,111804
191610202900000,SW 426,Residential,28079,64057,0,92136
191610203000000,SW 426,Residential,29667,66185,0,95852
191610203100000,SW 426,Residential,30138,69757,0,99895
191610203200000,Empty,Exempt,0,0,0,0
191610203300000,SW 426,Residential,62800,84203,0,147003
191610203701000,CONDO 501,Residential,14000,77550,0,91550
191610203701001,CONDO 501,Residential,14000,77550,0,91550
191610203701002,CONDO 501,Residential,14000,77550,0,91550
191610203701003,CONDO 501,Residential,14000,77550,0,91550
191610203701004,CONDO 501,Residential,14000,77550,0,91550
191610203701005,CONDO 501,Residential,14000,77550,0,91550
191610203701006,CONDO 501,Residential,14000,77550,0,91550
191610203701007,CONDO 501,Residential,14000,77550,0,91550
191610300100000,SW 426,Residential,27565,82546,0,110111
191610300200000,SW 426,Residential,27160,76870,0,104030
191610300300000,SW 426,Residential,27160,94840,0,122000
191610300400000,SW 426,Residential,26755,107348,0,134103
191610300500000,SW 426,Residential,28780,56220,0,85000
191610300600000,SW 426,Residential,28224,36296,0,64520
191610300700000,SW 426,Residential,28224,71026,0,99250
191610300800000,SW 426,Residential,28224,80456,0,108680
191610300900000,SW 426,Residential,27360,68236,0,95596
191610301000000,SW 426,Residential,29767,78013,0,107780
191610301100000,SW 426,Residential,28498,78954,0,107452
191610301200000,SW 426,Residential,26040,78511,0,104551
191610301300000,SW 426,Residential,33405,92281,0,125686
191610301400000,SW 426,Residential,25768,108174,0,133942
191610301500000,SW 426,Residential,21432,100185,0,121617
191610301600000,SW 426,Residential,21560,97528,0,119088
191610301700000,SW 426,Residential,21560,100758,0,122318
191610301800000,SW 426,Residential,21560,95888,0,117448
191610301900000,SW 426,Residential,21560,99149,0,120709
191610302000000,SW 426,Residential,21560,133063,0,154623
191610302100000,SW 426,Residential,1045,0,0,1045
191610400100000,SW 426,Residential,28030,77726,0,105756
191610400200000,SW 426,Residential,27160,103656,0,130816
191610400300000,SW 426,Residential,27160,87357,0,114517
191610400400000,SW 426,Residential,28380,86388,0,114768
191610400500000,SW 426,Residential,27101,101097,0,128198
191610400600000,SW 426,Residential,28000,64075,0,92075
191610400700000,SW 426,Residential,28000,60451,0,88451
191610400800000,SW 426,Residential,28000,65974,0,93974
191610400900000,SW 426,Residential,28547,65122,0,93669
191610401000000,SW 426,Residential,32521,51205,0,83726
191610401100000,SW 426,Residential,18200,0,0,18200
191610401200000,SW 426,Residential,18200,79630,0,97830
191610401300000,SW 426,Residential,28000,71806,0,99806
191610401400000,SW 426,Residential,28421,100462,0,128883
191610500100000,SW 426,Residential,27463,70421,0,97884
191610500200000,SW 426,Residential,27463,120647,0,148110
191610500300000,SW 426,Residential,27463,78955,0,106418
191610500400000,SW 426,Residential,27463,65082,0,92545
191610500500000,SW 426,Residential,27463,99353,0,126816
191610500600000,SW 426,Residential,27463,72057,0,99520
191610500700000,SW 426,Residential,27463,62783,0,90246
191610500800000,SW 426,Residential,28274,77909,0,106183
191610500900000,SW 426,Residential,27261,54244,0,81505
191610501000000,SW 426,Residential,28560,75935,0,104495
191610501100000,SW 426,Residential,25596,62552,0,88148
191610501200000,SW 426,Residential,25740,78205,0,103945
191610501300000,SW 426,Residential,26484,75909,0,102393
191610501500000,SW 426,Residential,25717,109010,0,134727
191610501600000,SW 426,Residential,24201,109010,0,133211
191610501700000,SW 426,Residential,26989,109010,0,135999
191610501800000,SW 426,Residential,24639,106283,0,130922
191610501900000,SW 426,Residential,21474,106283,0,127757
191610502000000,SW 426,Residential,27232,109010,0,136242
191610502100000,SW 426,Residential,27540,150410,0,177950
191610502200000,SW 426,Residential,26772,150410,0,177182
191610502300000,SW 426,Residential,24555,109205,0,133760
191610502400000,SW 426,Residential,26791,150410,0,177201
191610502500000,SW 426,Residential,23490,111566,0,135056
191610502600000,SW 426,Residential,27622,111566,0,139188
191610502700000,SW 426,Residential,26655,111566,0,138221
191610502800000,SW 426,Residential,23607,111566,0,135173
191610600100000,SW 426,Residential,25550,82320,0,107870
191610600200000,SW 426,Residential,25568,62223,0,87791
191610600300000,SW 426,Residential,25568,75937,0,101505
191610600400000,SW 426,Residential,25800,111566,0,137366
191610600500000,Empty,Exempt,0,0,0,0
191612600100000,SW 426,Residential,29286,64346,0,93632
191612600200000,SW 426,Residential,29486,72978,0,102464
191612600300000,SW 426,Residential,29486,49641,0,79127
191612600400000,SW 426,Residential,29486,74812,0,104298
191612600500000,SW 426,Residential,29486,68829,0,98315
191612600600000,SW 426,Residential,29486,93768,0,123254
191612600700000,SW 426,Residential,29486,76772,0,106258
191612600800000,SW 426,Residential,27816,80201,0,108017
191612600900000,SW 426,Residential,26255,125649,0,151904
191612700100000,SW 426,Residential,29750,58468,0,88218
191612700200000,SW 426,Residential,29484,64282,0,93766
191612700300000,SW 426,Residential,29484,80276,0,109760
191612700400000,SW 426,Residential,29484,77489,0,106973
191612700500000,SW 426,Residential,29484,94879,0,124363
191612700600000,SW 426,Residential,29484,81723,0,111207
191612700700000,SW 426,Residential,29484,71601,0,101085
191612700800000,SW 426,Residential,29484,61607,0,91091
191612700900000,SW 426,Residential,29393,75162,0,104555
191612701000000,SW 426,Residential,29750,82908,0,112658
191612701100000,Empty,Exempt,0,0,0,0
191612701200000,Empty,Exempt,0,0,0,0
191612701300000,SW 426,Residential,29750,117384,0,147134
191612701400000,SW 426,Residential,29750,65980,0,95730
191612701500000,SW 426,Residential,29750,67922,0,97672
191612800100000,SW 426,Residential,29750,65310,0,95060
191612800200000,SW 426,Residential,29750,65446,0,95196
191612800300000,SW 426,Residential,29750,62623,0,92373
191612800400000,SW 426,Residential,29750,67909,0,97659
191612800500000,SW 426,Residential,29750,79934,0,109684
191612800600000,SW 426,Residential,29750,91180,0,120930
191612800700000,SW 426,Residential,34020,74928,0,108948
191612800800000,SW 426,Residential,30498,68463,0,98961
191612800900000,SW 426,Residential,29652,99050,0,128702
191612801000000,SW 426,Residential,29750,67362,0,97112
191612801100000,SW 426,Residential,29750,88994,0,118744
191612801200000,SW 426,Residential,29750,69487,0,99237
191612801300000,SW 426,Residential,29750,69085,0,98835
191612900100000,SW 426,Residential,29750,83648,0,113398
191612900200000,SW 426,Residential,29750,69041,0,98791
191612900300000,SW 426,Residential,29750,71495,0,101245
191612900400000,SW 426,Residential,29750,60946,0,90696
191612900500000,SW 426,Residential,29750,67290,0,97040
191612900600000,SW 426,Residential,29750,113532,0,143282
191612900700000,SW 426,Residential,29750,72566,0,102316
191612900800000,SW 426,Residential,29750,84898,0,114648
191612900900000,SW 426,Residential,29750,74642,0,104392
191612901000000,SW 426,Residential,29750,127548,0,157298
191612901100000,SW 426,Residential,29750,91728,0,121478
191613000100000,SW 426,Residential,30879,70518,0,101397
191613000200000,SW 426,Residential,29452,76495,0,105947
191613000300000,SW 426,Residential,1725,0,0,1725
191613000400000,SW 426,Residential,1725,0,0,1725
191613000500000,SW 426,Residential,30940,96439,0,127379
191613000600000,SW 426,Residential,29750,79339,0,109089
191613000700000,SW 426,Residential,29750,71438,0,101188
191613000800000,SW 426,Residential,29452,67290,0,96742
191613000900000,SW 426,Residential,1725,0,0,1725
191613001000000,SW 426,Residential,29452,73574,0,103026
191613001100000,SW 426,Residential,30931,97960,0,128891
191613100100000,SW 426,Residential,29018,85800,0,114818
191613100200000,SW 426,Residential,29694,70067,0,99761
191613100300000,SW 426,Residential,31299,102662,0,133961
191613100400000,SW 426,Residential,30047,82966,0,113013
191613100500000,SW 426,Residential,29750,80431,0,110181
191613100600000,SW 426,Residential,29750,79364,0,109114
191613100700000,SW 426,Residential,29750,95635,0,125385
191613100800000,SW 426,Residential,18702,86966,0,105668
191613100900000,SW 426,Residential,19600,91064,0,110664
191613101000000,SW 426,Residential,30021,84373,0,114394
191613101100000,SW 426,Residential,29750,82303,0,112053
191613101200000,SW 426,Residential,29750,80698,0,110448
191613101300000,SW 426,Residential,29750,80401,0,110151
191613200100000,SW 426,Residential,29750,69683,0,99433
191613200200000,SW 426,Residential,29750,59578,0,89328
191613200300000,SW 426,Residential,29750,75925,0,105675
191613200400000,SW 426,Residential,29750,79974,0,109724
191613200500000,SW 426,Residential,29750,70638,0,100388
191613200600000,SW 426,Residential,29750,73588,0,103338
191613200700000,SW 426,Residential,29750,77249,0,106999
191613200800000,SW 426,Residential,29909,85592,0,115501
191613200900000,SW 426,Residential,29550,80522,0,110072
191613201000000,SW 426,Residential,29750,87694,0,117444
191613201100000,SW 426,Residential,29750,90815,0,120565
191613201200000,SW 426,Residential,29750,74863,0,104613
191613201300000,SW 426,Residential,29750,74679,0,104429
191613300100000,SW 426,Residential,30399,75894,0,106293
191613300200000,SW 426,Residential,1850,0,0,1850
191613300300000,SW 426,Residential,1830,0,0,1830
191613300400000,SW 426,Residential,30099,71597,0,101696
191613300500000,SW 426,Residential,29812,94265,0,124077
191613300600000,SW 426,Residential,29812,83672,0,113484
191615200100000,SW 422,Residential,44200,161374,0,205574
191615200200000,SW 422,Exempt,0,0,0,0
191615200300000,SW 422,Residential,37500,124805,0,162305
191615200400000,SW 422,Residential,37525,132815,0,170340
191615200500000,SW 422,Residential,36172,125187,0,161359
191615200600000,SW 422,Residential,33856,142263,0,176119
191615200700000,SW 422,Residential,31725,117395,0,149120
191615200800000,SW 422,Residential,28200,114106,0,142306
191615200900000,SW 422,Residential,37200,120538,0,157738
191615201000000,SW 422,Residential,36800,124153,0,160953
191615201100000,SW 422,Residential,2928,0,0,2928
191615201200000,SW 422,Residential,3102,0,0,3102
191615201300000,SW 422,Residential,3161,0,0,3161
191615201400000,SW 422,Residential,29450,110708,0,140158
191615201500000,SW 422,Residential,31280,109961,0,141241
191615300100000,SW 422,Residential,33534,125961,0,159495
191615300200000,SW 422,Residential,28520,135945,0,164465
191615300300000,SW 422,Residential,28520,126300,0,154820
191615300400000,SW 422,Residential,28520,142855,0,171375
191615300500000,SW 422,Residential,28520,123790,0,152310
191615300600000,SW 422,Residential,28520,132585,0,161105
191615300700000,SW 422,Residential,28520,159191,0,187711
191615300800000,SW 422,Residential,28520,152530,0,181050
191615300900000,SW 422,Residential,28520,118228,0,146748
191615301000000,SW 422,Residential,36800,127571,0,164371
191615301100000,SW 422,Residential,3632,0,0,3632
191615301200000,SW 422,Residential,2778,0,0,2778
191615301300000,SW 422,Residential,2778,0,0,2778
191615301400000,SW 422,Residential,2778,0,0,2778
191615301500000,SW 422,Residential,2778,0,0,2778
191615301600000,SW 422,Residential,2778,0,0,2778
191615301700000,SW 422,Residential,2778,0,0,2778
191615301800000,SW 422,Residential,2778,0,0,2778
191615301900000,SW 422,Residential,28520,90531,0,119051
191615400100000,SW 422,Residential,8850,0,0,8850
191615400200000,SW 422,Residential,29900,121480,0,151380
191615400300000,SW 422,Residential,37260,140916,0,178176
191615400400000,SW 422,Residential,28520,129068,0,157588
191615400500000,SW 422,Residential,28520,129065,0,157585
191615400600000,SW 422,Residential,28520,120774,0,149294
191615400700000,SW 422,Residential,28520,134997,0,163517
191615400800000,SW 422,Residential,28520,129313,0,157833
191615400900000,SW 422,Residential,28520,109189,0,137709
191615401000000,SW 422,Residential,28520,125485,0,154005
191615401100000,SW 422,Residential,28520,124808,0,153328
191615401200000,SW 422,Residential,34960,126410,0,161370
191615401300000,SW 422,Residential,38885,130773,0,169658
191615401400000,SW 422,Residential,30030,132920,0,162950
191615401500000,SW 422,Residential,40341,0,0,40341
191615401600000,SW 422,Residential,37400,158437,0,195837
191615401700000,SW 422,Residential,35437,130900,0,166337
191615401800000,SW 422,Residential,29467,114106,0,143573
191615401900000,SW 422,Residential,30080,143170,0,173250
191615402000000,SW 422,Residential,29760,119067,0,148827
191615402100000,SW 422,Residential,29440,133393,0,162833
191615402200000,SW 422,Residential,29440,122410,0,151850
191615500100000,SW 422,Residential,36480,111999,0,148479
191615500200000,SW 422,Residential,30070,72712,0,102782
191615500300000,SW 422,Residential,3242,0,0,3242
191615500400000,SW 422,Residential,3006,0,0,3006
191615500500000,SW 422,Residential,29140,10290,0,39430
191615500600000,SW 422,Residential,35340,121966,0,157306
191615500700000,SW 422,Exempt,0,0,0,0
191615500800000,SW 422,Residential,231750,0,0,231750
191615600100000,SW 422,Residential,37306,155585,0,192891
191615600200000,SW 422,Residential,2778,0,0,2778
191615600300000,SW 422,Residential,28520,148861,0,177381
191615600400000,SW 422,Residential,28520,133685,0,162205
191615600500000,SW 422,Residential,28520,137763,0,166283
191615600600000,SW 422,Residential,28520,137129,0,165649
191615600700000,SW 422,Residential,28520,133274,0,161794
191615600800000,SW 422,Residential,28520,141865,0,170385
191615600900000,SW 422,Residential,28520,124601,0,153121
191617600100000,SW 426,Residential,30100,93242,0,123342
191617600200000,APTS SW,Residential,78300,1178481,0,1256781
191617600300000,SW 426,Residential,35505,85770,0,121275
191617600500000,SW 426,Residential,28078,68895,0,96973
191617600600000,SW 426,Residential,27463,62465,0,89928
191617600900000,APTS SW,Commercial,29530,0,204193,233723
191617601000000,APTS SW,Commercial,27303,0,204564,231867
191617601201000,CONDO 500,Residential,1,0,0,1
191617601201001,CONDO 500,Residential,3750,35438,0,39188
191617601201002,CONDO 500,Residential,3750,36647,0,40397
191617601201003,CONDO 500,Residential,3750,36061,0,39811
191617601201004,CONDO 500,Residential,3750,36647,0,40397
191617601201005,CONDO 500,Residential,3750,36647,0,40397
191617601201006,CONDO 500,Residential,3750,36647,0,40397
191617601201007,CONDO 500,Residential,3750,35438,0,39188
191617601201008,CONDO 500,Residential,3750,36647,0,40397
191617601201009,CONDO 500,Residential,3750,36647,0,40397
191617601201010,CONDO 500,Residential,3750,36647,0,40397
191617601201011,CONDO 500,Residential,3750,35438,0,39188
191617601201012,CONDO 500,Residential,3750,36647,0,40397
191617601201013,CONDO 500,Residential,3750,36647,0,40397
191617601201014,CONDO 500,Residential,3750,35438,0,39188
191617601201015,CONDO 500,Residential,3750,36647,0,40397
191617601201016,CONDO 500,Residential,3750,36061,0,39811
191617601201017,CONDO 500,Residential,3750,36647,0,40397
191617601201018,CONDO 500,Residential,3750,36647,0,40397
191617601201019,CONDO 500,Residential,3750,36647,0,40397
191617601201020,CONDO 500,Residential,3750,35438,0,39188
191617601201021,CONDO 500,Residential,3750,36647,0,40397
191617601201022,CONDO 500,Residential,3750,36647,0,40397
191617601201023,CONDO 500,Residential,3750,36647,0,40397
191617601201024,CONDO 500,Residential,3750,35438,0,39188
191617601201025,CONDO 500,Residential,3750,35438,0,39188
191617601201026,CONDO 500,Residential,3750,36647,0,40397
191617601201027,CONDO 500,Residential,3750,36061,0,39811
191617601201028,CONDO 500,Residential,3750,36647,0,40397
191617601201029,CONDO 500,Residential,3750,36647,0,40397
191617601201030,CONDO 500,Residential,3750,36647,0,40397
191617601201031,CONDO 500,Residential,3750,35438,0,39188
191617601201032,CONDO 500,Residential,3750,36647,0,40397
191617601201033,CONDO 500,Residential,3750,36647,0,40397
191617601201034,CONDO 500,Residential,3750,36647,0,40397
191617601201035,CONDO 500,Residential,3750,35438,0,39188
191617601201036,CONDO 500,Residential,3750,36647,0,40397
191617601201037,CONDO 500,Residential,3750,36647,0,40397
191617601201038,CONDO 500,Residential,3750,35438,0,39188
191617601201039,CONDO 500,Residential,3750,36647,0,40397
191617601201040,CONDO 500,Residential,3750,36061,0,39811
191617601201041,CONDO 500,Residential,3750,36647,0,40397
191617601201042,CONDO 500,Residential,3750,36647,0,40397
191617601201043,CONDO 500,Residential,3750,36647,0,40397
191617601201044,CONDO 500,Residential,3750,35438,0,39188
191617601201045,CONDO 500,Residential,3750,36647,0,40397
191617601201046,CONDO 500,Residential,3750,36647,0,40397
191617601201047,CONDO 500,Residential,3750,36647,0,40397
191617601201048,CONDO 500,Residential,3750,35438,0,39188
191617601201049,CONDO 500,Residential,3750,35438,0,39188
191617601201050,CONDO 500,Residential,3750,36647,0,40397
191617601201051,CONDO 500,Residential,3750,36061,0,39811
191617601201052,CONDO 500,Residential,3750,36647,0,40397
191617601201053,CONDO 500,Residential,3750,36647,0,40397
191617601201054,CONDO 500,Residential,3750,36647,0,40397
191617601201055,CONDO 500,Residential,3750,35438,0,39188
191617601201056,CONDO 500,Residential,3750,36647,0,40397
191617601201057,CONDO 500,Residential,3750,36647,0,40397
191617601201058,CONDO 500,Residential,3750,36647,0,40397
191617601201059,CONDO 500,Residential,3750,35438,0,39188
191617601201060,CONDO 500,Residential,3750,36647,0,40397
191617601201061,CONDO 500,Residential,3750,36647,0,40397
191617601201062,CONDO 500,Residential,3750,35438,0,39188
191617601201063,CONDO 500,Residential,3750,36647,0,40397
191617601201064,CONDO 500,Residential,3750,36061,0,39811
191617601201065,CONDO 500,Residential,3750,36647,0,40397
191617601201066,CONDO 500,Residential,3750,36647,0,40397
191617601201067,CONDO 500,Residential,3750,36647,0,40397
191617601201068,CONDO 500,Residential,3750,35438,0,39188
191617601201069,CONDO 500,Residential,3750,36647,0,40397
191617601201070,CONDO 500,Residential,3750,36647,0,40397
191617601201071,CONDO 500,Residential,3750,36647,0,40397
191617601201072,CONDO 500,Residential,3750,35438,0,39188
191617601201073,CONDO 500,Residential,3750,35438,0,39188
191617601201074,CONDO 500,Residential,3750,36647,0,40397
191617601201075,CONDO 500,Residential,3750,36061,0,39811
191617601201076,CONDO 500,Residential,3750,36647,0,40397
191617601201077,CONDO 500,Residential,3750,36647,0,40397
191617601201078,CONDO 500,Residential,3750,36647,0,40397
191617601201079,CONDO 500,Residential,3750,35438,0,39188
191617601201080,CONDO 500,Residential,3750,36647,0,40397
191617601201081,CONDO 500,Residential,3750,36647,0,40397
191617601201082,CONDO 500,Residential,3750,36647,0,40397
191617601201083,CONDO 500,Residential,3750,35438,0,39188
191617601201084,CONDO 500,Residential,3750,36647,0,40397
191617601201085,CONDO 500,Residential,3750,36647,0,40397
191617601201086,CONDO 500,Residential,3750,35438,0,39188
191617601201087,CONDO 500,Residential,3750,36647,0,40397
191617601201088,CONDO 500,Residential,3750,36061,0,39811
191617601201089,CONDO 500,Residential,3750,36647,0,40397
191617601201090,CONDO 500,Residential,3750,36647,0,40397
191617601201091,CONDO 500,Residential,3750,36647,0,40397
191617601201092,CONDO 500,Residential,3750,35438,0,39188
191617601201093,CONDO 500,Residential,3750,36647,0,40397
191617601201094,CONDO 500,Residential,3750,36647,0,40397
191617601201095,CONDO 500,Residential,3750,36647,0,40397
191617601201096,CONDO 500,Residential,3750,35438,0,39188
191617601201097,CONDO 500,Residential,3750,35438,0,39188
191617601201098,CONDO 500,Residential,3750,36647,0,40397
191617601201099,CONDO 500,Residential,3750,36061,0,39811
191617601201100,CONDO 500,Residential,3750,36647,0,40397
191617601201101,CONDO 500,Residential,3750,36647,0,40397
191617601201102,CONDO 500,Residential,3750,36647,0,40397
191617601201103,CONDO 500,Residential,3750,35438,0,39188
191617601201104,CONDO 500,Residential,3750,36647,0,40397
191617601201105,CONDO 500,Residential,3750,36647,0,40397
191617601201106,CONDO 500,Residential,3750,36647,0,40397
191617601201107,CONDO 500,Residential,3750,35438,0,39188
191617601201108,CONDO 500,Residential,3750,36647,0,40397
191617601201109,CONDO 500,Residential,3750,36647,0,40397
191617601201110,CONDO 500,Residential,3750,35438,0,39188
191617601201111,CONDO 500,Residential,3750,36647,0,40397
191617601201112,CONDO 500,Residential,3750,36061,0,39811
191617601201113,CONDO 500,Residential,3750,36647,0,40397
191617601201114,CONDO 500,Residential,3750,36647,0,40397
191617601201115,CONDO 500,Residential,3750,36647,0,40397
191617601201116,CONDO 500,Residential,3750,35438,0,39188
191617601201117,CONDO 500,Residential,3750,36647,0,40397
191617601201118,CONDO 500,Residential,3750,36647,0,40397
191617601201119,CONDO 500,Residential,3750,36647,0,40397
191617601201120,CONDO 500,Residential,3750,35438,0,39188
191617601201121,CONDO 500,Residential,3750,35438,0,39188
191617601201122,CONDO 500,Residential,3750,36647,0,40397
191617601201123,CONDO 500,Residential,3750,36061,0,39811
191617601201124,CONDO 500,Residential,3750,36647,0,40397
191617601201125,CONDO 500,Residential,3750,36647,0,40397
191617601201126,CONDO 500,Residential,3750,36647,0,40397
191617601201127,CONDO 500,Residential,3750,35438,0,39188
191617601201128,CONDO 500,Residential,3750,36647,0,40397
191617601201129,CONDO 500,Residential,3750,36647,0,40397
191617601201130,CONDO 500,Residential,3750,36647,0,40397
191617601201131,CONDO 500,Residential,3750,35438,0,39188
191617601201132,CONDO 500,Residential,3750,36647,0,40397
191617601201133,CONDO 500,Residential,3750,36647,0,40397
191617601201134,CONDO 500,Residential,3750,35438,0,39188
191617601201135,CONDO 500,Residential,3750,36647,0,40397
191617601201136,CONDO 500,Residential,3750,36061,0,39811
191617601201137,CONDO 500,Residential,3750,36647,0,40397
191617601201138,CONDO 500,Residential,3750,36647,0,40397
191617601201139,CONDO 500,Residential,3750,36647,0,40397
191617601201140,CONDO 500,Residential,3750,35438,0,39188
191617601201141,CONDO 500,Residential,3750,36647,0,40397
191617601201142,CONDO 500,Residential,3750,36647,0,40397
191617601201143,CONDO 500,Residential,3750,36647,0,40397
191617601201144,CONDO 500,Residential,3750,35438,0,39188
191617601301000,CONDO 500,Residential,3750,46486,0,50236
191617601301001,CONDO 500,Residential,3750,46486,0,50236
191617601301002,CONDO 500,Residential,3750,46486,0,50236
191617601301003,CONDO 500,Residential,3750,46486,0,50236
191617601301004,CONDO 500,Residential,3750,27626,0,31376
191617601301005,CONDO 500,Residential,3750,46486,0,50236
191617601301006,CONDO 500,Residential,3750,46486,0,50236
191617601301007,CONDO 500,Residential,3750,46486,0,50236
191617601301008,CONDO 500,Residential,3750,46486,0,50236
191617601301009,CONDO 500,Residential,3750,46486,0,50236
191617601301010,CONDO 500,Residential,3750,46486,0,50236
191617601301011,CONDO 500,Residential,3750,46486,0,50236
191617601301012,CONDO 500,Residential,3750,27626,0,31376
191617601301013,CONDO 500,Residential,3750,46486,0,50236
191617601301014,CONDO 500,Residential,3750,46486,0,50236
191617601301015,CONDO 500,Residential,3750,46486,0,50236
191617601301016,CONDO 500,Residential,3750,47567,0,51317
191617601301017,CONDO 500,Residential,3750,47567,0,51317
191617601301018,CONDO 500,Residential,3750,47567,0,51317
191617601301019,CONDO 500,Residential,3750,47567,0,51317
191617601301020,CONDO 500,Residential,3750,28267,0,32017
191617601301021,CONDO 500,Residential,3750,47567,0,51317
191617601301022,CONDO 500,Residential,3750,47567,0,51317
191617601301023,CONDO 500,Residential,3750,47567,0,51317
191617601301024,CONDO 500,Residential,3750,28267,0,32017
191617601301025,CONDO 500,Residential,3750,47567,0,51317
191617601301026,CONDO 500,Residential,3750,47567,0,51317
191617601301027,CONDO 500,Residential,3750,47567,0,51317
191617601301028,CONDO 500,Residential,3750,47567,0,51317
191617601301029,CONDO 500,Residential,3750,47567,0,51317
191617601301030,CONDO 500,Residential,3750,47567,0,51317
191617601301031,CONDO 500,Residential,3750,47567,0,51317
191617700100000,E-84 EDU EXPMT LAND,Exempt,86521,0,0,86521
191617700201000,CONDO 500,Residential,8000,76900,0,84900
191617700201001,CONDO 500,Residential,8000,76900,0,84900
191617700201002,CONDO 500,Residential,8000,76900,0,84900
191617700201003,CONDO 500,Residential,8000,77355,0,85355
191617700201004,CONDO 500,Residential,8000,77355,0,85355
191617700201005,CONDO 500,Residential,8000,77355,0,85355
191617700201006,CONDO 500,Residential,8000,77020,0,85020
191617700201007,CONDO 500,Residential,8000,77020,0,85020
191617700201008,CONDO 500,Residential,8000,77020,0,85020
191617700201009,CONDO 500,Residential,8000,77355,0,85355
191617700201010,CONDO 500,Residential,8000,77355,0,85355
191617700201011,CONDO 500,Residential,8000,77355,0,85355
191617700201012,CONDO 500,Residential,8000,76900,0,84900
191617700201013,CONDO 500,Residential,8000,76900,0,84900
191617700201014,CONDO 500,Residential,8000,76900,0,84900
191617700201015,CONDO 500,Residential,8000,77355,0,85355
191617700201016,CONDO 500,Residential,8000,77355,0,85355
191617700201017,CONDO 500,Residential,8000,77355,0,85355
191617700201018,CONDO 500,Residential,8000,76900,0,84900
191617700201019,CONDO 500,Residential,8000,76900,0,84900
191617700201020,CONDO 500,Residential,8000,76900,0,84900
191617700201021,CONDO 500,Residential,8000,77355,0,85355
191617700201022,CONDO 500,Residential,8000,77355,0,85355
191617700201023,CONDO 500,Residential,8000,77355,0,85355
191617700301017,CONDO 500,Residential,7500,84406,0,91906
191617700301018,CONDO 500,Residential,4500,59740,0,64240
191617700301019,CONDO 500,Residential,4500,59456,0,63956
191617700301020,CONDO 500,Residential,4500,60150,0,64650
191617700301021,CONDO 500,Residential,4500,60150,0,64650
191617700301022,CONDO 500,Residential,4500,59087,0,63587
191617700301023,CONDO 500,Residential,4500,60150,0,64650
191617700301024,CONDO 500,Residential,4500,59456,0,63956
191617700301025,CONDO 500,Residential,4500,58911,0,63411
191617700301026,CONDO 500,Residential,4500,60150,0,64650
191617700301027,CONDO 500,Residential,4500,60150,0,64650
191617700301028,CONDO 500,Residential,4500,60150,0,64650
191617700301029,CONDO 500,Residential,4500,59087,0,63587
191617700301030,CONDO 500,Residential,0,72151,0,72151
191617700500000,COMM SW,Commercial,122580,0,0,122580
191617700601000,CONDO 500,Residential,7500,81882,0,89382
191617700601001,CONDO 500,Residential,7500,83145,0,90645
191617700601002,CONDO 500,Residential,7500,83145,0,90645
191617700601003,CONDO 500,Residential,4500,57450,0,61950
191617700601004,CONDO 500,Residential,4500,61183,0,65683
191617700601005,CONDO 500,Residential,4500,60987,0,65487
191617700601006,CONDO 500,Residential,4500,60987,0,65487
191617700601007,CONDO 500,Residential,4500,62051,0,66551
191617700601008,CONDO 500,Residential,4500,61704,0,66204
191617700601009,CONDO 500,Residential,4500,58255,0,62755
191617700601010,CONDO 500,Residential,4500,62241,0,66741
191617700601011,CONDO 500,Residential,4500,58317,0,62817
191617700601012,CONDO 500,Residential,4500,61506,0,66006
191617700601013,CONDO 500,Residential,4500,59381,0,63881
191617700601014,CONDO 500,Residential,4500,61506,0,66006
191617700601015,CONDO 500,Residential,7500,80680,0,88180
191617700601016,CONDO 500,Residential,7500,83862,0,91362
191617700700000,COMM SW,Commercial,14850,0,0,14850
191617701401000,CONDO 500,Residential,3750,34543,0,38293
191617701401001,CONDO 500,Residential,3750,34543,0,38293
191617701401002,CONDO 500,Residential,3750,34543,0,38293
191617701401003,CONDO 500,Residential,3750,34543,0,38293
191617701401004,CONDO 500,Residential,3750,34543,0,38293
191617701401005,CONDO 500,Residential,3750,34543,0,38293
191617701401006,CONDO 500,Residential,3750,34543,0,38293
191617701401007,CONDO 500,Residential,3750,34543,0,38293
191617701401008,CONDO 500,Residential,3750,34543,0,38293
191617701401009,CONDO 500,Residential,3750,34543,0,38293
191617701401010,CONDO 500,Residential,3750,34543,0,38293
191617701401011,CONDO 500,Residential,3750,34543,0,38293
191617701401012,CONDO 500,Residential,3750,34543,0,38293
191617701401013,CONDO 500,Residential,3750,34543,0,38293
191617701401014,CONDO 500,Residential,3750,34543,0,38293
191617701401015,CONDO 500,Residential,3750,34543,0,38293
191617701401016,CONDO 500,Residential,3750,34543,0,38293
191617701401017,CONDO 500,Residential,3750,34543,0,38293
191617701401018,CONDO 500,Residential,3750,34543,0,38293
191617701401019,CONDO 500,Residential,3750,34543,0,38293
191617701401020,CONDO 500,Residential,3750,34543,0,38293
191617701401021,CONDO 500,Residential,3750,34543,0,38293
191617701401022,CONDO 500,Residential,3750,34543,0,38293
191617701401023,CONDO 500,Residential,3750,34543,0,38293
191617701401024,CONDO 500,Residential,3750,34543,0,38293
191617701401025,CONDO 500,Residential,3750,34543,0,38293
191617701401026,CONDO 500,Residential,3750,34543,0,38293
191617701401027,CONDO 500,Residential,3750,34543,0,38293
191617701401028,CONDO 500,Residential,3750,34543,0,38293
191617701401029,CONDO 500,Residential,3750,34543,0,38293
191617701401030,CONDO 500,Residential,3750,34543,0,38293
191617701401031,CONDO 500,Residential,3750,34543,0,38293
191617701401032,CONDO 500,Residential,3750,37022,0,40772
191617701401033,CONDO 500,Residential,3750,38211,0,41961
191617701401034,CONDO 500,Residential,3750,37022,0,40772
191617701401035,CONDO 500,Residential,3750,38211,0,41961
191617701401036,CONDO 500,Residential,3750,37022,0,40772
191617701401037,CONDO 500,Residential,3750,37022,0,40772
191617701401038,CONDO 500,Residential,3750,37022,0,40772
191617701401039,CONDO 500,Residential,3750,38211,0,41961
191617701401040,CONDO 500,Residential,3750,37022,0,40772
191617701401041,CONDO 500,Residential,3750,38211,0,41961
191617701401042,CONDO 500,Residential,3750,37022,0,40772
191617701401043,CONDO 500,Residential,3750,37022,0,40772
191617701501000,CONDO 500,Residential,3750,34543,0,38293
191617701501001,CONDO 500,Residential,3750,34543,0,38293
191617701501002,CONDO 500,Residential,3750,34543,0,38293
191617701501003,CONDO 500,Residential,3750,34543,0,38293
191617701501004,CONDO 500,Residential,3750,34543,0,38293
191617701501005,CONDO 500,Residential,3750,34543,0,38293
191617701501006,CONDO 500,Residential,3750,34543,0,38293
191617701501007,CONDO 500,Residential,3750,34543,0,38293
191617701501008,CONDO 500,Residential,3750,34543,0,38293
191617701501009,CONDO 500,Residential,3750,34543,0,38293
191617701501010,CONDO 500,Residential,3750,34543,0,38293
191617701501011,CONDO 500,Residential,3750,34543,0,38293
191617701501012,CONDO 500,Residential,3750,34543,0,38293
191617701501013,CONDO 500,Residential,3750,34543,0,38293
191617701501014,CONDO 500,Residential,3750,34543,0,38293
191617701501015,CONDO 500,Residential,3750,34543,0,38293
191617701501016,CONDO 500,Residential,3750,34543,0,38293
191617701501017,CONDO 500,Residential,3750,34543,0,38293
191617701501018,CONDO 500,Residential,3750,34543,0,38293
191617701501019,CONDO 500,Residential,3750,34543,0,38293
191617701501020,CONDO 500,Residential,3750,34543,0,38293
191617701501021,CONDO 500,Residential,3750,34543,0,38293
191617701501022,CONDO 500,Residential,3750,34543,0,38293
191617701501023,CONDO 500,Residential,3750,34543,0,38293
191617701501024,CONDO 500,Residential,3750,34543,0,38293
191617701501025,CONDO 500,Residential,3750,34543,0,38293
191617701501026,CONDO 500,Residential,3750,34543,0,38293
191617701501027,CONDO 500,Residential,3750,34543,0,38293
191617701501028,CONDO 500,Residential,3750,34543,0,38293
191617701501029,CONDO 500,Residential,3750,34543,0,38293
191617701501030,CONDO 500,Residential,3750,34543,0,38293
191617701501031,CONDO 500,Residential,3750,34543,0,38293
191617701501032,CONDO 500,Residential,3750,37022,0,40772
191617701501033,CONDO 500,Residential,3750,38211,0,41961
191617701501034,CONDO 500,Residential,3750,37022,0,40772
191617701501035,CONDO 500,Residential,3750,38211,0,41961
191617701501036,CONDO 500,Residential,3750,37022,0,40772
191617701501037,CONDO 500,Residential,3750,37022,0,40772
191617701501038,CONDO 500,Residential,3750,37022,0,40772
191617701501039,CONDO 500,Residential,3750,38211,0,41961
191617701501040,CONDO 500,Residential,3750,37022,0,40772
191617701501041,CONDO 500,Residential,3750,38211,0,41961
191617701501042,CONDO 500,Residential,3750,37022,0,40772
191617701501043,CONDO 500,Residential,3750,37022,0,40772
191617701601000,CONDO 500,Residential,3750,37022,0,40772
191617701601001,CONDO 500,Residential,3750,38211,0,41961
191617701601002,CONDO 500,Residential,3750,37022,0,40772
191617701601003,CONDO 500,Residential,3750,38211,0,41961
191617701601004,CONDO 500,Residential,3750,37022,0,40772
191617701601005,CONDO 500,Residential,3750,37022,0,40772
191617701601006,CONDO 500,Residential,3750,37022,0,40772
191617701601007,CONDO 500,Residential,3750,38211,0,41961
191617701601008,CONDO 500,Residential,3750,37022,0,40772
191617701601009,CONDO 500,Residential,3750,38211,0,41961
191617701601010,CONDO 500,Residential,3750,37022,0,40772
191617701601011,CONDO 500,Residential,3750,37022,0,40772
191617701601012,CONDO 500,Residential,3750,34543,0,38293
191617701601013,CONDO 500,Residential,3750,34543,0,38293
191617701601014,CONDO 500,Residential,3750,34543,0,38293
191617701601015,CONDO 500,Residential,3750,34543,0,38293
191617701601016,CONDO 500,Residential,3750,34543,0,38293
191617701601017,CONDO 500,Residential,3750,34543,0,38293
191617701601018,CONDO 500,Residential,3750,34543,0,38293
191617701601019,CONDO 500,Residential,3750,34543,0,38293
191617701601020,CONDO 500,Residential,3750,34543,0,38293
191617701601021,CONDO 500,Residential,3750,34543,0,38293
191617701601022,CONDO 500,Residential,3750,34543,0,38293
191617701601023,CONDO 500,Residential,3750,34543,0,38293
191617701601024,CONDO 500,Residential,3750,37022,0,40772
191617701601025,CONDO 500,Residential,3750,38211,0,41961
191617701601026,CONDO 500,Residential,3750,37022,0,40772
191617701601027,CONDO 500,Residential,3750,38211,0,41961
191617701601028,CONDO 500,Residential,3750,37022,0,40772
191617701601029,CONDO 500,Residential,3750,37022,0,40772
191617701601030,CONDO 500,Residential,3750,37022,0,40772
191617701601031,CONDO 500,Residential,3750,38211,0,41961
191617701601032,CONDO 500,Residential,3750,37022,0,40772
191617701601033,CONDO 500,Residential,3750,38211,0,41961
191617701601034,CONDO 500,Residential,3750,37022,0,40772
191617701601035,CONDO 500,Residential,3750,37022,0,40772
191617701601036,CONDO 500,Residential,3750,34543,0,38293
191617701601037,CONDO 500,Residential,3750,34543,0,38293
191617701601038,CONDO 500,Residential,3750,34543,0,38293
191617701601039,CONDO 500,Residential,3750,34543,0,38293
191617701601040,CONDO 500,Residential,3750,34543,0,38293
191617701601041,CONDO 500,Residential,3750,34543,0,38293
191617701601042,CONDO 500,Residential,3750,34543,0,38293
191617701601043,CONDO 500,Residential,3750,34543,0,38293
191617701701000,CONDO 500,Residential,3750,34543,0,38293
191617701701001,CONDO 500,Residential,3750,34543,0,38293
191617701701002,CONDO 500,Residential,3750,34543,0,38293
191617701701003,CONDO 500,Residential,3750,34543,0,38293
191617701701004,CONDO 500,Residential,3750,34543,0,38293
191617701701005,CONDO 500,Residential,3750,34543,0,38293
191617701701006,CONDO 500,Residential,3750,34543,0,38293
191617701701007,CONDO 500,Residential,3750,34543,0,38293
191617701701008,CONDO 500,Residential,3750,37022,0,40772
191617701701009,CONDO 500,Residential,3750,38211,0,41961
191617701701010,CONDO 500,Residential,3750,37022,0,40772
191617701701011,CONDO 500,Residential,3750,38211,0,41961
191617701701012,CONDO 500,Residential,3750,37022,0,40772
191617701701013,CONDO 500,Residential,3750,37022,0,40772
191617701701014,CONDO 500,Residential,3750,37022,0,40772
191617701701015,CONDO 500,Residential,3750,38211,0,41961
191617701701016,CONDO 500,Residential,3750,37022,0,40772
191617701701017,CONDO 500,Residential,3750,38211,0,41961
191617701701018,CONDO 500,Residential,3750,37022,0,40772
191617701701019,CONDO 500,Residential,3750,37022,0,40772
191617701701020,CONDO 500,Residential,3750,34543,0,38293
191617701701021,CONDO 500,Residential,3750,34543,0,38293
191617701701022,CONDO 500,Residential,3750,34543,0,38293
191617701701023,CONDO 500,Residential,3750,34543,0,38293
191617701701024,CONDO 500,Residential,3750,34543,0,38293
191617701701025,CONDO 500,Residential,3750,34543,0,38293
191617701701026,CONDO 500,Residential,3750,34543,0,38293
191617701701027,CONDO 500,Residential,3750,34543,0,38293
191617701701028,CONDO 500,Residential,3750,34543,0,38293
191617701701029,CONDO 500,Residential,3750,34543,0,38293
191617701701030,CONDO 500,Residential,3750,34543,0,38293
191617701701031,CONDO 500,Residential,3750,34543,0,38293
191617701801000,CONDO 500,Residential,3750,34543,0,38293
191617701801001,CONDO 500,Residential,3750,34543,0,38293
191617701801002,CONDO 500,Residential,3750,34543,0,38293
191617701801003,CONDO 500,Residential,3750,34543,0,38293
191617701801004,CONDO 500,Residential,3750,34543,0,38293
191617701801005,CONDO 500,Residential,3750,34543,0,38293
191617701801006,CONDO 500,Residential,3750,34543,0,38293
191617701801007,CONDO 500,Residential,3750,34543,0,38293
191617701801008,CONDO 500,Residential,3750,34543,0,38293
191617701801009,CONDO 500,Residential,3750,34543,0,38293
191617701801010,CONDO 500,Residential,3750,34543,0,38293
191617701801011,CONDO 500,Residential,3750,34543,0,38293
191617701801012,CONDO 500,Residential,3750,34543,0,38293
191617701801013,CONDO 500,Residential,3750,34543,0,38293
191617701801014,CONDO 500,Residential,3750,34543,0,38293
191617701801015,CONDO 500,Residential,3750,34543,0,38293
191617701801016,CONDO 500,Residential,3750,34543,0,38293
191617701801017,CONDO 500,Residential,3750,34543,0,38293
191617701801018,CONDO 500,Residential,3750,34543,0,38293
191617701801019,CONDO 500,Residential,3750,34543,0,38293
191617701801020,CONDO 500,Residential,3750,37022,0,40772
191617701801021,CONDO 500,Residential,3750,38211,0,41961
191617701801022,CONDO 500,Residential,3750,37022,0,40772
191617701801023,CONDO 500,Residential,3750,38211,0,41961
191617701801024,CONDO 500,Residential,3750,37022,0,40772
191617701801025,CONDO 500,Residential,3750,37022,0,40772
191617701801026,CONDO 500,Residential,3750,37022,0,40772
191617701801027,CONDO 500,Residential,3750,38211,0,41961
191617701801028,CONDO 500,Residential,3750,37022,0,40772
191617701801029,CONDO 500,Residential,3750,38211,0,41961
191617701801030,CONDO 500,Residential,3750,37022,0,40772
191617701801031,CONDO 500,Residential,3750,37022,0,40772
191620100100000,Empty,Exempt,0,0,0,0
191620100200000,Empty,Exempt,0,0,0,0
191622600100000,SW 425,Residential,203400,0,0,203400
191622600200000,SW 425,Residential,103200,0,0,103200
191622600300000,COMM SW,Commercial,283770,0,435698,719468
191622600400000,SW 425,Ag Dwelling,19007,61914,2632,83553
191622600500000,COMM SW,Commercial,257994,0,1064170,1322164
191625100200000,COMM SW,Commercial,143370,0,395653,539023
191625100202000,COMM SW,Commercial,0,0,64959,64959
191625100300000,COMM SW,Commercial,169290,0,472742,642032
191625100400000,COMM SW,Commercial,169997,0,261302,431299
191625100500000,COMM SW,Commercial,276264,0,1409779,1686043
191625100800000,COMM SW,Commercial,373334,0,2006100,2379434
191625200100000,INDUSTRIAL,Industrial,118260,0,464557,582817
191625200200000,E-70 CHARITY OTHER,Exempt,269460,0,622780,892240
191625200300000,COMM SW,Commercial,90914,0,382902,473816
191625200400000,COMM SW,Commercial,70000,0,399822,469822
191627600100000,SW 426,Residential,326350,182251,0,508601
191630100100000,SW 422,Ag Land,43019,0,0,43019
191632600100000,SW 425,Ag Land,34138,0,0,34138
191632600200000,COMM SW,Commercial,111780,0,72206,183986
191632600300000,SW 425,Residential,35329,114665,0,149994
191635100100000,SW 425,Ag Dwelling,41099,129940,5066,176105
191637600100000,SW 422,Ag Dwelling,50569,78700,3590,132859
191640100400000,Empty,Exempt,0,0,0,0
191640100402000,COMM SW,Commercial,0,0,45451,45451
191640100500000,Empty,Exempt,0,0,0,0
191640100600000,SW 433,Residential,40680,210152,0,250832
191640100700000,SW 433,Residential,41512,174539,0,216051
191640100800000,SW 433,Residential,41908,220549,0,262457
191640100900000,SW 433,Residential,40660,0,0,40660
191640101000000,SW 433,Residential,41420,248501,0,289921
191640101100000,SW 433,Residential,39686,25066,0,64752
191640101200000,SW 433,Residential,44184,213083,0,257267
191640101300000,SW 433,Residential,42750,248362,0,291112
191640101400000,SW 433,Residential,33561,222352,0,255913
191640101500000,SW 433,Residential,38610,232783,0,271393
191640101600000,SW 433,Residential,38934,248469,0,287403
191640101700000,SW 433,Residential,35848,176386,0,212234
191640101800000,SW 433,Residential,40800,227725,0,268525
191640101900000,SW 433,Residential,39200,261350,0,300550
191640102000000,SW 433,Residential,40420,203811,0,244231
191640102300000,SW 433,Residential,42400,226444,0,268844
191640102400000,SW 433,Residential,5281,0,0,5281
191640102500000,SW 433,Residential,6214,0,0,6214
191640102600000,SW 433,Residential,7886,0,0,7886
191640102700000,SW 433,Residential,11268,0,0,11268
191640102800000,SW 433,Residential,10607,0,0,10607
191640102900000,SW 433,Residential,10185,0,0,10185
191640103000000,SW 433,Residential,35897,232743,0,268640
191640103100000,SW 433,Residential,6093,0,0,6093
191640103200000,SW 433,Residential,6225,0,0,6225
191640103300000,SW 433,Residential,6038,0,0,6038
191640103400000,SW 433,Residential,8753,0,0,8753
191640103500000,SW 433,Residential,10008,0,0,10008
191640103600000,SW 433,Residential,4739,0,0,4739
191640200100000,SW 433,Residential,41400,151969,0,193369
191640200200000,SW 433,Residential,41400,188675,0,230075
191640200300000,SW 433,Residential,35880,161990,0,197870
191640200400000,SW 433,Residential,41400,198169,0,239569
191640200500000,SW 433,Residential,41400,185776,0,227176
191640200600000,SW 433,Residential,35880,180178,0,216058
191640200700000,SW 433,Residential,35880,191072,0,226952
191640200800000,SW 433,Residential,35880,164451,0,200331
191640200900000,SW 433,Residential,35880,161478,0,197358
191640201000000,SW 433,Residential,35880,170088,0,205968
191640201100000,SW 433,Residential,35880,143751,0,179631
191640300100000,SW 433,Residential,44892,224336,0,269228
191640300200000,SW 433,Residential,41715,215731,0,257446
191640300300000,SW 433,Residential,41040,202031,0,243071
191640300400000,SW 433,Residential,41760,246795,0,288555
191640300500000,SW 433,Residential,42120,213024,0,255144
191640300600000,SW 433,Residential,42840,210856,0,253696
191640300700000,SW 433,Residential,43200,210211,0,253411
191640300800000,SW 433,Residential,55080,224022,0,279102
191640300900000,SW 433,Residential,59740,242626,0,302366
191640301000000,SW 433,Residential,47952,0,0,47952
191640301100000,SW 433,Residential,49248,0,0,49248
191640301200000,SW 433,Residential,49932,0,0,49932
191640301300000,SW 433,Residential,54756,0,0,54756
191640301400000,SW 433,Residential,55224,230776,0,286000
191640301500000,SW 433,Residential,56160,201145,0,257305
191640301600000,SW 433,Residential,45677,0,0,45677
191640301700000,SW 433,Residential,56160,0,0,56160
191640301800000,SW 433,Residential,52896,259210,0,312106
191640301900000,SW 433,Residential,59400,0,0,59400
191640400100000,SW 433,Residential,32595,0,0,32595
191640400200000,SW 433,Residential,36364,0,0,36364
191640400300000,SW 433,Residential,35574,0,0,35574
191640400400000,SW 433,Residential,54612,167602,0,222214
191640400500000,SW 433,Residential,58968,171334,0,230302
191640400600000,SW 433,Residential,54756,198927,0,253683
191640400700000,SW 433,Residential,55598,198858,0,254456
191640400800000,SW 433,Residential,36288,0,0,36288
191640400900000,SW 433,Residential,34870,0,0,34870
191640401000000,SW 433,Residential,35414,0,0,35414
191640401100000,SW 433,Residential,34020,0,0,34020
191640401200000,SW 433,Residential,32130,0,0,32130
191640401300000,SW 433,Residential,32760,0,0,32760
191642600100000,SW 422,Ag Land,55706,0,0,55706
191645100100000,SW 422,Ag Dwelling,52810,62384,2873,118067
191647600200000,Empty,Exempt,0,0,0,0
191647600300000,SW 422,Residential,41170,6341,0,47511
191647600400000,SW 422,Residential,23160,107569,0,130729
191647600500000,SW 433,Residential,30441,171958,0,202399
191647600600000,SW 433,Residential,29440,156262,0,185702
191647600700000,SW 433,Residential,29900,144376,0,174276
191647600800000,SW 433,Residential,29900,186260,0,216160
191647600900000,SW 433,Residential,29900,184811,0,214711
191647601000000,SW 433,Residential,27784,159161,0,186945
191647601100000,SW 433,Residential,31761,133773,0,165534
191647601200000,SW 433,Residential,37255,164346,0,201601
191647601300000,SW 433,Residential,35252,190964,0,226216
191647601400000,SW 433,Residential,34523,130608,0,165131
191647601500000,SW 433,Residential,35529,105424,0,140953
191647601600000,SW 433,Residential,30346,123579,0,153925
191647601700000,SW 433,Residential,31493,126807,0,158300
191647601800000,SW 433,Residential,31525,193458,0,224983
191647601900000,SW 433,Residential,31472,0,0,31472
191647602000000,SW 433,Residential,39369,216584,0,255953
191647602100000,SW 433,Residential,39251,240101,0,279352
191647602200000,SW 433,Residential,43435,252384,0,295819
191647602300000,SW 433,Residential,40600,183403,0,224003
191647602400000,SW 433,Residential,40680,247512,0,288192
191647602500000,SW 433,Residential,42265,240391,0,282656
191647602600000,SW 433,Residential,39432,208593,0,248025
191647602700000,SW 433,Residential,35700,172697,0,208397
191647602800000,SW 433,Residential,42653,237673,0,280326
191647602900000,SW 433,Residential,43635,198077,0,241712
191647603000000,SW 433,Residential,38400,200762,0,239162
191647603100000,SW 433,Residential,36874,161675,0,198549
191647603200000,SW 433,Residential,36079,144739,0,180818
191647603300000,SW 433,Residential,47000,0,0,47000
191647603400000,SW 433,Residential,40818,0,0,40818
191647603500000,SW 433,Residential,58104,199071,0,257175
191647603600000,SW 433,Residential,33264,0,0,33264
191647700100000,SW 433,Residential,37450,204952,0,242402
191647700200000,SW 433,Residential,38119,207393,0,245512
191647700300000,Empty,Exempt,0,0,0,0
191647700400000,SW 433,Residential,38520,212591,0,251111
191647700500000,SW 433,Residential,35425,193795,0,229220
191647700600000,SW 433,Residential,36075,166940,0,203015
191647700700000,SW 433,Residential,34580,143227,0,177807
191647700800000,SW 433,Residential,37039,172227,0,209266
191647700900000,SW 433,Residential,37952,140604,0,178556
191647701000000,SW 433,Residential,42560,185978,0,228538
191647701100000,SW 433,Residential,38405,188143,0,226548
191647701200000,SW 433,Residential,31525,189589,0,221114
191647701300000,SW 433,Residential,31525,160848,0,192373
191647701400000,SW 433,Residential,37448,134454,0,171902
191647701500000,SW 433,Residential,35880,146328,0,182208
191647701600000,SW 433,Residential,35880,160370,0,196250
191647701700000,SW 433,Residential,35880,145892,0,181772
191647701800000,SW 433,Residential,37440,194782,0,232222
191647701900000,SW 433,Residential,35490,184655,0,220145
191647702000000,SW 433,Residential,39620,232246,0,271866
191647702100000,SW 433,Residential,39765,220502,0,260267
191647702200000,SW 433,Residential,42924,230263,0,273187
191647702300000,SW 433,Residential,38590,198836,0,237426
191647702400000,SW 433,Residential,39330,153242,0,192572
191647702500000,SW 433,Residential,40320,203938,0,244258
191647702600000,SW 433,Residential,40320,211242,0,251562
191647702700000,SW 433,Residential,41325,189143,0,230468
191647702800000,SW 433,Residential,40890,107860,0,148750
191647702900000,SW 433,Residential,38516,155013,0,193529
191647800100000,SW 433,Residential,35880,145260,0,181140
191647800200000,SW 433,Residential,35880,170218,0,206098
191647800300000,SW 433,Residential,35880,136855,0,172735
191647800400000,SW 433,Residential,35880,163377,0,199257
191647800500000,SW 433,Residential,35880,160788,0,196668
191647800600000,SW 433,Residential,35880,127286,0,163166
191647800700000,SW 433,Residential,35880,165417,0,201297
191710100100000,INDUSTRIAL,Industrial,87000,0,0,87000
191710100300000,COMM SW,Commercial,127170,0,578562,705732
191710100400000,COMM SW,Commercial,44550,0,168678,213228
191710100500000,COMM SW,Commercial,38880,0,190608,229488
191710200100000,COMM SW,Commercial,51030,0,126310,177340
191710200200000,SW 418,Residential,54600,86252,0,140852
191710200300000,COMM SW,Commercial,148338,0,49439,197777
191710200700000,INDUSTRIAL,Industrial,94087,0,0,94087
191710200800000,COMM SW,Commercial,119000,0,553460,672460
191710201200000,INDUSTRIAL,Industrial,49050,0,0,49050
191710201300000,INDUSTRIAL,Industrial,46950,0,0,46950
191710201401000,COMM SW,Commercial,159952,0,1200036,1359988
191710201401001,COMM SW,Commercial,93501,0,560364,653865
191710201500000,COMM SW,Commercial,119000,0,631000,750000
191710201700000,COMM SW,Commercial,47709,0,214177,261886
191710201800000,COMM SW,Commercial,48320,0,226774,275094
191710202000000,INDUSTRIAL,Industrial,232400,0,433381,665781
191710202100000,INDUSTRIAL,Industrial,104025,0,0,104025
191710202200000,COMM SW,Commercial,91773,0,538457,630230
191712600100000,COMM SW,Commercial,26098,0,159094,185192
191712600200000,SW 418,Residential,67500,101440,0,168940
191712600300000,COMM SW,Commercial,36855,0,190581,227436
191712600400000,Empty,Exempt,0,0,0,0
191712600500000,COMM SW,Commercial,169938,0,313552,483490
191712600600000,COMM SW,Commercial,262818,0,323281,586099
191712600700000,INDUSTRIAL,Industrial,264650,0,1370178,1634828
191712600800000,COMM SW,Commercial,224100,0,556670,780770
191712600900000,Empty,Other,0,0,0,0
191712700100000,COMM SW,Commercial,204012,0,1236538,1440550
191712700200000,COMM SW,Commercial,113400,0,401190,514590
191712700300000,COMM SW,Commercial,61236,0,35887,97123
191712700400000,COMM SW,Commercial,94770,0,0,94770
191712700500000,COMM SW,Commercial,146610,0,304660,451270
191715100100000,INDUSTRIAL,Industrial,231890,0,159030,390920
191715200100000,COMM SW,Commercial,124447,0,0,124447
191715200200000,COMM SW,Commercial,202716,0,67076,269792
191715200300000,COMM SW,Commercial,100440,0,280719,381159
191715200400000,COMM SW,Commercial,166536,0,179788,346324
191715300100000,COMM SW,Commercial,218106,0,648646,866752
191715300200000,COMM SW,Commercial,13381,0,9720,23101
191715300300000,COMM SW,Commercial,80676,0,66437,147113
191715400100000,COMM SW,Commercial,217620,0,630687,848307
191717600100000,COMM SW,Commercial,153446,0,318903,472349
191717600200000,COMM SW,Commercial,167292,0,364867,532159
191717600300000,COMM SW,Commercial,57996,0,0,57996
191717600400000,INDUSTRIAL,Industrial,195040,0,1780746,1975786
191717600500000,COMM SW,Commercial,48843,0,115668,164511
191717600600000,COMM SW,Commercial,58482,0,180653,239135
191717600700000,COMM SW,Commercial,21074,0,81521,102595
191717600800000,COMM SW,Commercial,36855,0,116972,153827
191717600900000,COMM SW,Commercial,57894,0,83270,141164
191717601000000,COMM SW,Commercial,48608,0,0,48608
191717601002000,COMM SW,Commercial,0,0,11351,11351
191717700100000,COMM SW,Commercial,186840,0,243945,430785
191717700200000,COMM SW,Commercial,68283,0,117580,185863
191717700300000,COMM SW,Commercial,62775,0,200925,263700
191717700400000,COMM SW,Commercial,60750,0,46044,106794
191717700500000,COMM SW,Commercial,237924,0,620711,858635
191717700600000,COMM SW,Commercial,49014,0,119069,168083
191717700700000,COMM SW,Commercial,170640,0,204360,375000
191717800100000,INDUSTRIAL,Industrial,91500,0,206279,297779
191717800200000,COMM SW,Commercial,231552,0,1347179,1578731
191717800400000,COMM SW,Commercial,71204,0,140087,211291
191717800500000,COMM SW,Commercial,135270,0,189730,325000
191722600100000,SW 418,Ag Land,28292,0,0,28292
191725100100000,SW 418,Ag Land,34444,0,0,34444
191727600100000,INDUSTRIAL,Industrial,2437775,0,31759738,34197513
191732600100000,SW 418,Ag Land,35859,0,0,35859
191735100100000,SW 418,Ag Land,33447,0,0,33447
191737600100000,INDUSTRIAL,Industrial,286030,0,43953,329983
191737600200000,COMM SW,Commercial,212922,0,1656522,1869444
191737600300000,COMM SW,Commercial,133650,0,0,133650
191737700100000,INDUSTRIAL,Industrial,346400,0,5243974,5590374
191740100100000,SW 418,Ag Dwelling,49621,104221,4568,158410
191742600100000,SW 418,Ag Land,45613,0,0,45613
191745100100000,SW 418,Ag Land,54662,0,0,54662
191747600100000,SW 418,Ag Land,44320,0,0,44320
191810100100000,SW 418,Ag Dwelling,42242,81601,7578,131421
191812600100000,INDUSTRIAL,Industrial,399210,0,278851,678061
191815100100000,SW 418,Ag Land,53582,0,0,53582
191817600100000,SW 418,Ag Land,52471,0,0,52471
191820100100000,COMM SW,Commercial,369897,0,292330,662227
191820100200000,SW 418,Residential,82375,87940,0,170315
191822600100000,SW 418,Ag Land,49713,0,0,49713
191825100100000,SW 418,Ag Land,51699,0,546,52245
191825100200000,SW 418,Residential,95100,133863,0,228963
191827600100000,SW 418,Ag Land,50852,0,0,50852
191830100100000,SW 418,Ag Land,50535,0,0,50535
191832600100000,SW 418,Ag Land,52808,0,0,52808
191835100100000,SW 418,Ag Land,52041,0,0,52041
191837600100000,SW 418,Ag Dwelling,52822,58323,1998,113143
191840100100000,SW 418,Ag Land,53870,0,0,53870
191842600100000,SW 418,Ag Land,53667,0,0,53667
191845100100000,SW 418,Ag Land,52824,0,0,52824
191847600100000,SW 418,Ag Land,50345,0,0,50345
191847600200000,SW 418,Residential,49128,0,0,49128
191910100100000,COMM SW,Commercial,913086,0,21901024,22814110
191917600100000,Empty,Exempt,0,0,0,0
191920100100000,Empty,Exempt,0,0,0,0
192010100100000,SW 418,Ag Dwelling,52641,123171,2863,178675
192012600100000,SW 418,Ag Land,52815,0,0,52815
192015100100000,SW 422,Ag Land,54008,0,0,54008
192017600100000,COMM SW,Commercial,842346,0,3083120,3925466
192020100100000,INDUSTRIAL,Industrial,571550,0,4965941,5537491
192020100200000,COMM SW,Commercial,233010,0,288926,521936
192020100300000,SW 418,Ag Land,8425,0,0,8425
192022600100000,Empty,Exempt,0,0,0,0
192022600200000,SW 418,Ag Land,24823,0,0,24823
192025100100000,SW 418,Ag Dwelling,47297,101141,2087,150525
192027600100000,SW 418,Ag Land,53967,0,0,53967
192030100200000,SW 418,Exempt,0,0,0,0
192032600100000,Empty,Exempt,0,0,0,0
192037600200000,SW 418,Exempt,0,0,0,0
192037600300000,SW 418,Exempt,0,0,0,0
192040100100000,SW 418,Ag Land,54678,0,7769,62447
192040100102000,COMM SW,Commercial,0,0,11058,11058
192042600100000,SW 418,Ag Land,53811,0,0,53811
192045100100000,SW 418,Ag Land,43732,0,0,43732
192045200100000,SW 418,Ag Land,19805,0,0,19805
192047600100000,COMM SW,Commercial,321705,0,0,321705
192047600200000,COMM SW,Commercial,847,0,0,847
192047600300000,COMM SW,Commercial,263520,0,12163,275683
192047600400000,COMM SW,Commercial,248400,0,551600,800000
192047700100000,COMM SW,Commercial,464400,0,1154417,1618817
192047800100000,COMM SW,Commercial,321840,0,0,321840
192047800200000,COMM SW,Commercial,446580,0,1353420,1800000
192110100100000,Empty,Exempt,0,0,0,0
192112600100000,Empty,Exempt,0,0,0,0
192115100100000,Empty,Exempt,0,0,0,0
192117600100000,Empty,Exempt,0,0,0,0
192117600200000,Empty,Exempt,0,0,0,0
192122600100000,SW 418,Ag Land,37624,0,0,37624
192125100100000,SW 418,Ag Dwelling,45729,77274,3891,126894
192125100102000,COMM SW,Commercial,0,0,46907,46907
192130100100000,SW 422,Ag Land,46445,0,0,46445
192132600100000,COMM SW,Commercial,430650,0,0,430650
192132600200000,SW 422,Ag Land,22413,0,0,22413
192135100100000,SW 422,Ag Land,20794,0,0,20794
192135100200000,SW 422,Ag Land,1500,0,0,1500
192135100400000,COMM SW,Commercial,448362,0,0,448362
192135100500000,COMM SW,Commercial,293760,0,644636,938396
192135100600000,COMM SW,Commercial,252720,0,0,252720
192135100700000,COMM SW,Commercial,253182,0,0,253182
192137600100000,SW 422,Ag Land,33306,0,0,33306
192140100100000,SW 418,Ag Land,26336,0,0,26336
192140100200000,SW 422,Residential,21162,115906,0,137068
192140100300000,SW 422,Residential,21162,114393,0,135555
192140100400000,SW 422,Residential,21038,114258,0,135296
192140100500000,SW 422,Residential,21038,114258,0,135296
192140100600000,SW 422,Residential,21038,114258,0,135296
192140100700000,SW 422,Residential,21038,113054,0,134092
192140100800000,SW 422,Residential,21038,114258,0,135296
192140100900000,SW 422,Residential,21038,113054,0,134092
192140101000000,SW 422,Residential,23549,114258,0,137807
192140101100000,SW 422,Residential,22938,114258,0,137196
192140101200000,SW 422,Residential,23609,122375,0,145984
192140101300000,SW 422,Residential,27625,122375,0,150000
192140101400000,SW 422,Residential,28987,137230,0,166217
192140101500000,SW 422,Residential,24709,146485,0,171194
192140101600000,SW 422,Residential,23241,122095,0,145336
192140101700000,SW 422,Residential,24442,136295,0,160737
192140101800000,SW 422,Residential,24194,0,0,24194
192140101900000,SW 422,Residential,24194,0,0,24194
192140102000000,SW 422,Residential,24194,131534,0,155728
192140102100000,SW 422,Residential,24194,126616,0,150810
192140102200000,SW 422,Residential,23760,121695,0,145455
192140102300000,SW 422,Residential,23890,123364,0,147254
192140102400000,SW 422,Residential,7013,0,0,7013
192140102500000,SW 422,Residential,54510,138214,0,192724
192140102600000,SW 422,Residential,31040,134695,0,165735
192140102700000,SW 422,Residential,29700,146768,0,176468
192140102800000,SW 422,Residential,29700,140845,0,170545
192140102900000,SW 422,Residential,29700,135583,0,165283
192140103000000,SW 422,Residential,29700,163127,0,192827
192140103100000,SW 422,Residential,35084,152520,0,187604
192140103200000,SW 422,Residential,35868,152885,0,188753
192140103300000,SW 422,Residential,32044,185929,0,217973
192140103400000,SW 422,Residential,32908,180572,0,213480
192140103500000,SW 422,Residential,40320,148566,0,188886
192140103600000,SW 422,Residential,35360,140376,0,175736
192140103700000,SW 422,Residential,32100,134402,0,166502
192140103800000,SW 422,Residential,44734,125528,0,170262
192140103900000,SW 422,Residential,41412,91846,0,133258
192140104000000,SW 422,Residential,41024,144572,0,185596
192140104100000,SW 422,Residential,387,0,0,387
192140104200000,SW 422,Residential,44248,138010,0,182258
192140104300000,SW 422,Residential,36828,133425,0,170253
192140104400000,SW 422,Residential,36330,139650,0,175980
192140104500000,SW 422,Residential,30400,88782,0,119182
192140104600000,SW 422,Exempt,0,0,0,0
192140200100000,SW 422,Residential,40372,137040,0,177412
192140200200000,SW 422,Residential,31153,148230,0,179383
192140200300000,SW 422,Residential,32670,156962,0,189632
192140200400000,SW 422,Residential,147,0,0,147
192140200500000,SW 422,Residential,32670,136110,0,168780
192140200600000,SW 422,Residential,25881,114564,0,140445
192140200700000,SW 422,Residential,32472,75718,0,108190
192140200800000,SW 422,Residential,111,0,0,111
192140200900000,SW 422,Residential,111,0,0,111
192140201000000,SW 422,Residential,111,0,0,111
192140201100000,SW 422,Residential,32472,170020,0,202492
192140201200000,SW 422,Residential,36347,140883,0,177230
192140201300000,SW 422,Residential,32670,141955,0,174625
192140201400000,SW 422,Residential,32670,137415,0,170085
192140201500000,SW 422,Residential,32670,148063,0,180733
192140201600000,SW 422,Residential,38731,137457,0,176188
192142600100000,SW 422,Ag Land,55046,0,0,55046
192145100200000,SW 422,Ag Land,6159,0,0,6159
192145100300000,COMM SW,Commercial,201744,0,820714,1022458
192145100400000,SW 422,Ag Land,6949,0,0,6949
192145200100000,COMM SW,Commercial,221508,0,3740720,3962228
192145200200000,SW 422,Ag Land,19398,0,0,19398
192145200300000,SW 422,Ag Land,3620,0,0,3620
192147600200000,SW 418,Ag Land,2964,0,0,2964
192147600300000,SW 418,Ag Land,47272,0,0,47272
192222600300000,Empty,Exempt,0,0,0,0
192225100300000,E-20 SCHOOLS,Exempt,0,0,0,0
192820100100000,COMM SW,Commercial,608850,0,0,608850
192820100200000,COMM SW,Commercial,520560,0,8609440,9130000
192822600100000,COMM SW,Commercial,316440,0,0,316440
192822600200000,COMM SW,Commercial,308629,0,436659,745288
192822600300000,COMM SW,Commercial,248400,0,0,248400
192822600500000,COMM SW,Commercial,317358,0,497556,814914
192822600700000,COMM SW,Commercial,260642,0,591772,852414
192822600800000,COMM SW,Commercial,111222,0,200720,311942
192825100100000,SW 422,Ag Land,13177,0,0,13177
192825100200000,COMM SW,Commercial,381240,0,3739767,4121007
192825100300000,SW 422,Ag Land,21112,0,0,21112
192825100302000,COMM SW,Commercial,0,0,100554,100554
192832600100000,SW 418,Ag Land,51912,0,0,51912
192835100100000,SW 418,Ag Land,49880,0,627,50507
192910100100000,COMM SW,Commercial,420255,0,0,420255
192910100200000,COMM SW,Commercial,475200,0,1191027,1666227
192910200100000,COMM SW,Commercial,357912,0,1366902,1724814
192910200200000,COMM SW,Commercial,213570,0,1139688,1353258
192910200201000,COMM SW,Commercial,38745,0,270310,309055
192910200300000,COMM SW,Commercial,277560,0,1335325,1612885
192910300100000,COMM SW,Commercial,157680,0,0,157680
192910300200000,COMM SW,Commercial,219780,0,463632,683412
192910300300000,COMM SW,Commercial,129600,0,773511,903111
192912600300000,SW 418,Residential,41039,109908,0,150947
192912600400000,SW 418,Residential,32436,128831,0,161267
192912600500000,SW 418,Residential,24000,106325,0,130325
192912600600000,SW 418,Residential,24000,82882,0,106882
192912600700000,SW 418,Residential,26448,92480,0,118928
192912600800000,SW 418,Residential,28356,85772,0,114128
192912600900000,SW 418,Residential,27576,136851,0,164427
192912601000000,SW 418,Ag Land,372,0,0,372
192912601100000,SW 418,Residential,37122,134787,0,171909
192912601200000,SW 418,Ag Land,17271,0,10930,28201
192912601400000,COMM SW,Commercial,261900,0,854734,1116634
192912601600000,COMM SW,Commercial,30780,0,0,30780
192912601700000,SW 418,Ag Land,24514,0,0,24514
192915100200000,COMM SW,Commercial,410400,0,2263312,2673712
192915100300000,SW 418,Ag Land,47698,0,0,47698
192917600100000,SW 418,Ag Land,36515,0,0,36515
192917600200000,SW 418,Residential,101500,159828,0,261328
192917600300000,SW 418,Residential,1045,0,0,1045
192917600400000,Empty,Other,0,0,0,0
192917700100000,COMM SW,Commercial,313686,0,1744291,2057977
192917700200000,SW 416,Ag Land,4286,0,0,4286
192920100100000,SW 418,Ag Land,927,0,0,927
192920100200000,SW 418,Ag Land,2915,0,5703,8618
192920100300000,SW 418,Ag Land,20451,0,0,20451
192920100400000,Empty,Exempt,0,0,0,0
192920100500000,SW 418,Residential,52300,130078,0,182378
192920100600000,SW 418,Residential,51150,98418,0,149568
192922600100000,SW 418,Residential,760,0,0,760
192922600300000,SW 418,Residential,31120,107382,0,138502
192922600500000,SW 418,Residential,30943,118594,0,149537
192922600600000,SW 418,Residential,30943,173539,0,204482
192922600700000,SW 418,Residential,33263,98314,0,131577
192922600800000,COMM SW,Commercial,159021,0,0,159021
192922600900000,COMM SW,Commercial,170316,0,0,170316
192922601000000,COMM SW,Commercial,37703,0,27431,65134
192922601200000,SW 418,Residential,29122,80310,0,109432
192922601300000,SW 418,Residential,30765,91081,0,121846
192922601400000,SW 418,Residential,760,0,0,760
192922601500000,COMM SW,Commercial,97902,0,316936,414838
192922601600000,COMM SW,Commercial,113724,0,0,113724
192922601800000,COMM SW,Commercial,204660,0,791765,996425
192922601900000,COMM SW,Commercial,171191,0,18865,190056
192922700100000,SW 418,Residential,760,0,0,760
192922700200000,SW 418,Residential,760,0,0,760
192922700300000,SW 418,Residential,32185,112617,0,144802
192922700400000,SW 418,Residential,35520,98678,0,134198
192922700500000,SW 418,Residential,35017,94426,0,129443
192922700600000,SW 418,Residential,36097,122596,0,158693
192922700700000,SW 418,Residential,35520,121166,0,156686
192922700800000,SW 418,Residential,30765,90496,0,121261
192922800100000,COMM SW,Commercial,140810,0,0,140810
192922800102000,COMM SW,Commercial,0,0,32435,32435
192922800200000,COMM SW,Commercial,14742,0,0,14742
192922800300000,SW 418,Residential,14875,48594,0,63469
192940100100000,SW 418,Residential,62700,120431,0,183131
192940100200000,SW 418,Ag Land,53093,0,0,53093
192942600100000,SW 418,Ag Land,58908,0,0,58908
192947600100000,COMM SW,Commercial,232200,0,517841,750041
192947600300000,INDUSTRIAL,Industrial,354672,0,1777719,2132391
192947600400000,COMM SW,Commercial,234922,0,0,234922
192947600500000,COMM SW,Commercial,236520,0,0,236520
192947700100000,COMM SW,Commercial,230634,0,314379,545013
193010100100000,Empty,Exempt,0,0,0,0
193020100100000,COMM SW,Commercial,275184,0,1830,277014
193020100200000,COMM SW,Commercial,402840,0,1223667,1626507
193020100300000,COMM SW,Commercial,52164,0,300628,352792
193020100400000,COMM SW,Commercial,99765,0,178132,277897
193020100500000,Empty,Exempt,0,0,0,0
193037600100000,Empty,Exempt,0,0,0,0
193047600100000,E-05 STATE,Exempt,0,0,0,0
193110100100000,Empty,Exempt,0,0,0,0
193222600100000,Empty,Exempt,0,0,0,0
193240100200000,SW 418,Ag Dwelling,6892,180718,8057,195667
193242600200000,SW 418,Ag Land,106834,0,0,106834
193322600700000,COMM SW,Commercial,4612,0,0,4612
193322600800000,COMM SW,Commercial,338310,0,3495383,3833693
193325100300000,COMM SW,Commercial,393925,0,3761467,4155392
193325100600000,SW 422,Ag Land,14704,0,0,14704
193325100700000,SW 422,Ag Land,4249,0,0,4249
193325100800000,SW 422,Ag Land,12474,0,0,12474
193325100900000,SW 422,Ag Land,13176,0,0,13176
193325101100000,COMM SW,Commercial,7180,0,0,7180
193332600100000,SW 422,Ag Land,45025,0,0,45025
193335100100000,SW 418,Ag Land,63102,0,0,63102
193335100200000,SW 418,Residential,38400,98817,0,137217
193335100300000,SW 418,Residential,33600,89756,0,123356
193335100400000,SW 418,Residential,61850,78192,0,140042
200110100200000,COMM SW,Commercial,1688688,0,8300663,9989351
200110100300000,COMM SW,Commercial,298728,0,496272,795000
200110100400000,COMM SW,Commercial,747576,0,1880106,2627682
200110100500000,COMM SW,Commercial,361800,0,618581,980381
200110100700000,COMM SW,Commercial,319788,0,236076,555864
200110100900000,COMM SW,Commercial,298080,0,569035,867115
200110101000000,COMM SW,Commercial,297432,0,268506,565938
200110300100000,COMM SW,Commercial,1296,0,0,1296
200112600200000,COMM SW,Commercial,537300,0,1137554,1674854
200112600500000,COMM SW,Commercial,705991,0,599632,1305623
200112600601000,CONDO 500,Residential,5000,74157,0,79157
200112600601001,CONDO 500,Residential,5000,74157,0,79157
200112600601002,CONDO 500,Residential,5000,74157,0,79157
200112600601003,CONDO 500,Residential,5000,74157,0,79157
200112600601004,CONDO 500,Residential,5000,75185,0,80185
200112600601005,CONDO 500,Residential,5000,75185,0,80185
200112600601006,CONDO 500,Residential,5000,75185,0,80185
200112600601007,CONDO 500,Residential,5000,75185,0,80185
200112600601008,CONDO 500,Residential,5000,75185,0,80185
200112600601009,CONDO 500,Residential,5000,75185,0,80185
200112600601010,CONDO 500,Residential,5000,75185,0,80185
200112600601011,CONDO 500,Residential,5000,75185,0,80185
200112600701000,CONDO 500,Residential,5000,74157,0,79157
200112600701001,CONDO 500,Residential,5000,74157,0,79157
200112600701002,CONDO 500,Residential,5000,74157,0,79157
200112600701003,CONDO 500,Residential,5000,74157,0,79157
200112600701004,CONDO 500,Residential,5000,75185,0,80185
200112600701005,CONDO 500,Residential,5000,75185,0,80185
200112600701006,CONDO 500,Residential,5000,75185,0,80185
200112600701007,CONDO 500,Residential,5000,75185,0,80185
200112600701008,CONDO 500,Residential,5000,75185,0,80185
200112600701009,CONDO 500,Residential,5000,75185,0,80185
200112600701010,CONDO 500,Residential,5000,75185,0,80185
200112600701011,CONDO 500,Residential,5000,75185,0,80185
200112600801000,CONDO 500,Residential,5000,74157,0,79157
200112600801001,CONDO 500,Residential,5000,74157,0,79157
200112600801002,CONDO 500,Residential,5000,74157,0,79157
200112600801003,CONDO 500,Residential,5000,74157,0,79157
200112600801004,CONDO 500,Residential,5000,75185,0,80185
200112600801005,CONDO 500,Residential,5000,75185,0,80185
200112600801006,CONDO 500,Residential,5000,75185,0,80185
200112600801007,CONDO 500,Residential,5000,75185,0,80185
200112600801008,CONDO 500,Residential,5000,75185,0,80185
200112600801009,CONDO 500,Residential,5000,75185,0,80185
200112600801010,CONDO 500,Residential,5000,75185,0,80185
200112600801011,CONDO 500,Residential,5000,75185,0,80185
200112600901000,CONDO 500,Residential,5000,74157,0,79157
200112600901001,CONDO 500,Residential,5000,74157,0,79157
200112600901002,CONDO 500,Residential,5000,74157,0,79157
200112600901003,CONDO 500,Residential,5000,74157,0,79157
200112600901004,CONDO 500,Residential,5000,75185,0,80185
200112600901005,CONDO 500,Residential,5000,75185,0,80185
200112600901006,CONDO 500,Residential,5000,75185,0,80185
200112600901007,CONDO 500,Residential,5000,75185,0,80185
200112600901008,CONDO 500,Residential,5000,75185,0,80185
200112600901009,CONDO 500,Residential,5000,75185,0,80185
200112600901010,CONDO 500,Residential,5000,75185,0,80185
200112600901011,CONDO 500,Residential,5000,75185,0,80185
200112601001000,CONDO 500,Residential,5000,74157,0,79157
200112601001001,CONDO 500,Residential,5000,74157,0,79157
200112601001002,CONDO 500,Residential,5000,74157,0,79157
200112601001003,CONDO 500,Residential,5000,74157,0,79157
200112601001004,CONDO 500,Residential,5000,75185,0,80185
200112601001005,CONDO 500,Residential,5000,75185,0,80185
200112601001006,CONDO 500,Residential,5000,75185,0,80185
200112601001007,CONDO 500,Residential,5000,75185,0,80185
200112601001008,CONDO 500,Residential,5000,75185,0,80185
200112601001009,CONDO 500,Residential,5000,75185,0,80185
200112601001010,CONDO 500,Residential,5000,75185,0,80185
200112601001011,CONDO 500,Residential,5000,75185,0,80185
200112601101000,CONDO 500,Residential,5000,0,0,5000
200112601101001,CONDO 500,Residential,5000,0,0,5000
200112601101002,CONDO 500,Residential,5000,0,0,5000
200112601101003,CONDO 500,Residential,5000,0,0,5000
200112601101004,CONDO 500,Residential,5000,0,0,5000
200112601101005,CONDO 500,Residential,5000,0,0,5000
200112601101006,CONDO 500,Residential,5000,0,0,5000
200112601101007,CONDO 500,Residential,5000,0,0,5000
200112601101008,CONDO 500,Residential,5000,0,0,5000
200112601101009,CONDO 500,Residential,5000,0,0,5000
200112601101010,CONDO 500,Residential,5000,0,0,5000
200112601101011,CONDO 500,Residential,5000,0,0,5000
200112601201000,CONDO 500,Residential,5000,0,0,5000
200112601201001,CONDO 500,Residential,5000,0,0,5000
200112601201002,CONDO 500,Residential,5000,0,0,5000
200112601201003,CONDO 500,Residential,5000,0,0,5000
200112601201004,CONDO 500,Residential,5000,0,0,5000
200112601201005,CONDO 500,Residential,5000,0,0,5000
200112601201006,CONDO 500,Residential,5000,0,0,5000
200112601201007,CONDO 500,Residential,5000,0,0,5000
200112601201008,CONDO 500,Residential,5000,0,0,5000
200112601201009,CONDO 500,Residential,5000,0,0,5000
200112601201010,CONDO 500,Residential,5000,0,0,5000
200112601201011,CONDO 500,Residential,5000,0,0,5000
200112601301000,CONDO 500,Residential,5000,74157,0,79157
200112601301001,CONDO 500,Residential,5000,74157,0,79157
200112601301002,CONDO 500,Residential,5000,74157,0,79157
200112601301003,CONDO 500,Residential,5000,74157,0,79157
200112601301004,CONDO 500,Residential,5000,75185,0,80185
200112601301005,CONDO 500,Residential,5000,75185,0,80185
200112601301006,CONDO 500,Residential,5000,75185,0,80185
200112601301007,CONDO 500,Residential,5000,75185,0,80185
200112601301008,CONDO 500,Residential,5000,75185,0,80185
200112601301009,CONDO 500,Residential,5000,75185,0,80185
200112601301010,CONDO 500,Residential,5000,75185,0,80185
200112601301011,CONDO 500,Residential,5000,75185,0,80185
200112601401000,CONDO 500,Residential,5000,74157,0,79157
200112601401001,CONDO 500,Residential,5000,74157,0,79157
200112601401002,CONDO 500,Residential,5000,74157,0,79157
200112601401003,CONDO 500,Residential,5000,74157,0,79157
200112601401004,CONDO 500,Residential,5000,75185,0,80185
200112601401005,CONDO 500,Residential,5000,75185,0,80185
200112601401006,CONDO 500,Residential,5000,75185,0,80185
200112601401007,CONDO 500,Residential,5000,75185,0,80185
200112601401008,CONDO 500,Residential,5000,75185,0,80185
200112601401009,CONDO 500,Residential,5000,75185,0,80185
200112601401010,CONDO 500,Residential,5000,75185,0,80185
200112601401011,CONDO 500,Residential,5000,75185,0,80185
200112601501000,CONDO 500,Residential,5000,74157,0,79157
200112601501001,CONDO 500,Residential,5000,74157,0,79157
200112601501002,CONDO 500,Residential,5000,74157,0,79157
200112601501003,CONDO 500,Residential,5000,74157,0,79157
200112601501004,CONDO 500,Residential,5000,75185,0,80185
200112601501005,CONDO 500,Residential,5000,75185,0,80185
200112601501006,CONDO 500,Residential,5000,75185,0,80185
200112601501007,CONDO 500,Residential,5000,75185,0,80185
200112601501008,CONDO 500,Residential,5000,75185,0,80185
200112601501009,CONDO 500,Residential,5000,75185,0,80185
200112601501010,CONDO 500,Residential,5000,75185,0,80185
200112601501011,CONDO 500,Residential,5000,75185,0,80185
200112601801000,CONDO 500,Residential,5000,84427,0,89427
200112601801001,CONDO 500,Residential,5000,84427,0,89427
200112601801002,CONDO 500,Residential,5000,84427,0,89427
200112601801003,CONDO 500,Residential,5000,84427,0,89427
200112601801004,CONDO 500,Residential,5000,85520,0,90520
200112601801005,CONDO 500,Residential,5000,85520,0,90520
200112601801006,CONDO 500,Residential,5000,81280,0,86280
200112601801007,CONDO 500,Residential,5000,81280,0,86280
200112601801008,CONDO 500,Residential,5000,85520,0,90520
200112601801009,CONDO 500,Residential,5000,85520,0,90520
200112601801010,CONDO 500,Residential,5000,85520,0,90520
200112601801011,CONDO 500,Residential,5000,85520,0,90520
200112601901000,CONDO 500,Residential,5000,84427,0,89427
200112601901001,CONDO 500,Residential,5000,84427,0,89427
200112601901002,CONDO 500,Residential,5000,81552,0,86552
200112601901003,CONDO 500,Residential,5000,84427,0,89427
200112601901004,CONDO 500,Residential,5000,85520,0,90520
200112601901005,CONDO 500,Residential,5000,85520,0,90520
200112601901006,CONDO 500,Residential,5000,85520,0,90520
200112601901007,CONDO 500,Residential,5000,85520,0,90520
200112601901008,CONDO 500,Residential,5000,85520,0,90520
200112601901009,CONDO 500,Residential,5000,85520,0,90520
200112601901010,CONDO 500,Residential,5000,85520,0,90520
200112601901011,CONDO 500,Residential,5000,85520,0,90520
200112602001000,CONDO 500,Residential,5000,81552,0,86552
200112602001001,CONDO 500,Residential,5000,81552,0,86552
200112602001002,CONDO 500,Residential,5000,81552,0,86552
200112602001003,CONDO 500,Residential,5000,81552,0,86552
200112602001004,CONDO 500,Residential,5000,82645,0,87645
200112602001005,CONDO 500,Residential,5000,82645,0,87645
200112602001006,CONDO 500,Residential,5000,82645,0,87645
200112602001007,CONDO 500,Residential,5000,82645,0,87645
200112602001008,CONDO 500,Residential,5000,82645,0,87645
200112602001009,CONDO 500,Residential,5000,82645,0,87645
200112602001010,CONDO 500,Residential,5000,82645,0,87645
200112602001011,CONDO 500,Residential,5000,82645,0,87645
200112602100000,CONDO 500,Residential,43200,0,0,43200
200112700301000,CONDO 501,Residential,12000,114828,0,126828
200112700301001,CONDO 501,Residential,12000,123163,0,135163
200112700301002,CONDO 505,Residential,12000,115634,0,127634
200112700301003,CONDO 505,Residential,12000,114828,0,126828
200112700301004,CONDO 505,Residential,12000,117005,0,129005
200112700301005,CONDO 505,Residential,12000,147024,0,159024
200112700301006,CONDO 505,Residential,12000,88823,0,100823
200112700301007,CONDO 505,Residential,12000,114096,0,126096
200112700301008,CONDO 501,Residential,12000,117408,0,129408
200112700301009,CONDO 501,Residential,12000,95566,0,107566
200112700301010,CONDO 501,Residential,12000,87597,0,99597
200112700600000,COMM SW,Commercial,985068,0,0,985068
200112700700000,CONDO 501,Residential,264000,63000,0,327000
200115100100000,SW 407,Ag Land,6317,0,0,6317
200115100200000,SW 431,Residential,25760,185940,0,211700
200115100300000,SW 431,Residential,25760,161675,0,187435
200115100500000,SW 431,Residential,25760,223549,0,249309
200115100600000,SW 431,Residential,25760,184492,0,210252
200115100700000,SW 431,Residential,25760,176649,0,202409
200115100800000,SW 431,Residential,25760,170484,0,196244
200115100900000,SW 431,Residential,25760,153448,0,179208
200115101000000,SW 431,Residential,25916,159079,0,184995
200115101100000,SW 431,Residential,25760,146680,0,172440
200115101200000,SW 407,Residential,25760,159024,0,184784
200115101300000,SW 407,Residential,162,0,0,162
200115101401000,CONDO 501,Residential,12000,141881,0,153881
200115101401001,CONDO 501,Residential,12000,121321,0,133321
200115101501000,CONDO 501,Residential,12000,124842,0,136842
200115101501001,CONDO 501,Residential,12000,124807,0,136807
200115101601000,CONDO 501,Residential,12000,135749,0,147749
200115101601001,CONDO 501,Residential,12000,114591,0,126591
200115101701000,CONDO 501,Residential,12000,127871,0,139871
200115101701001,CONDO 501,Residential,12000,114828,0,126828
200115200300000,SW 431,Residential,31501,170561,0,202062
200115200400000,SW 431,Residential,29440,120410,0,149850
200115200500000,SW 431,Residential,29440,199937,0,229377
200115200600000,SW 431,Residential,29440,172294,0,201734
200115200700000,SW 431,Residential,31501,216283,0,247784
200115200900000,SW 431,Residential,30415,176389,0,206804
200115201000000,SW 431,Residential,29440,180988,0,210428
200115201100000,SW 431,Residential,29440,162443,0,191883
200115201200000,SW 431,Residential,29440,162209,0,191649
200115201300000,SW 431,Residential,31560,152029,0,183589
200115300100000,SW 431,Residential,28177,160194,0,188371
200115300200000,SW 431,Residential,29440,169069,0,198509
200115300300000,SW 431,Residential,29440,160203,0,189643
200115300400000,SW 431,Residential,29440,157322,0,186762
200115300500000,SW 431,Residential,29744,169421,0,199165
200115400100000,SW 431,Residential,25760,170213,0,195973
200115400200000,SW 431,Residential,25760,169482,0,195242
200115400300000,SW 431,Residential,25760,158378,0,184138
200115400400000,SW 431,Residential,25513,150947,0,176460
200115400500000,SW 431,Residential,25760,136821,0,162581
200115400600000,SW 431,Residential,29440,172143,0,201583
200115500100000,SW 431,Residential,31190,168163,0,199353
200115500200000,SW 431,Residential,30720,155995,0,186715
200115500300000,SW 431,Residential,30720,154860,0,185580
200115500400000,SW 431,Residential,30720,157296,0,188016
200115500500000,SW 431,Residential,30396,168889,0,199285
200115500600000,SW 407,Residential,216,0,0,216
200115500700000,SW 407,Residential,27136,158947,0,186083
200115500800000,SW 407,Residential,170,0,0,170
200115500900000,SW 407,Residential,27648,193002,0,220650
200115501000000,SW 407,Residential,29952,177638,0,207590
200115600100000,SW 431,Residential,29440,146874,0,176314
200115600200000,SW 431,Residential,26126,143711,0,169837
200115600300000,SW 407,Residential,30080,42081,0,72161
200115600400000,SW 407,Residential,35520,166626,0,202146
200115600500000,SW 407,Residential,38332,188050,0,226382
200115600600000,SW 407,Residential,247,0,0,247
200115600700000,SW 407,Residential,201,0,0,201
200115600800000,SW 407,Residential,185,0,0,185
200115600900000,SW 407,Residential,28116,178631,0,206747
200115601000000,SW 407,Residential,28400,186547,0,214947
200115601100000,SW 407,Residential,28400,200015,0,228415
200115601200000,SW 407,Residential,28400,186409,0,214809
200115601300000,SW 407,Residential,30000,201785,0,231785
200115601401000,CONDO 501,Residential,12000,136488,0,148488
200115601401001,CONDO 501,Residential,12000,124036,0,136036
200115601401002,CONDO 501,Residential,12000,128915,0,140915
200115601401003,CONDO 501,Residential,12000,139958,0,151958
200115601401004,CONDO 501,Residential,12000,127993,0,139993
200115601401005,CONDO 501,Residential,12000,141034,0,153034
200115601401006,CONDO 501,Residential,12000,126565,0,138565
200115601401007,CONDO 501,Residential,12000,133952,0,145952
200115601401008,CONDO 501,Residential,12000,114711,0,126711
200115601401009,CONDO 501,Residential,12000,114966,0,126966
200115601401010,CONDO 501,Residential,12000,127412,0,139412
200115601401011,CONDO 501,Residential,12000,116537,0,128537
200115601401012,CONDO 501,Residential,12000,126699,0,138699
200115601401013,CONDO 501,Residential,12000,120177,0,132177
200115601401014,CONDO 501,Residential,12000,127668,0,139668
200115601500000,Empty,Exempt,0,0,0,0
200115700101000,CONDO 501,Residential,12000,85765,0,97765
200115700101001,CONDO 501,Residential,12000,81201,0,93201
200115700101002,CONDO 501,Residential,12000,81144,0,93144
200115700101003,CONDO 501,Residential,12000,78897,0,90897
200115700101004,CONDO 501,Residential,12000,84334,0,96334
200115700101005,CONDO 501,Residential,12000,81727,0,93727
200115700101006,CONDO 501,Residential,12000,86621,0,98621
200115700101007,CONDO 501,Residential,12000,81201,0,93201
200115700101008,CONDO 501,Residential,12000,78897,0,90897
200115700101009,CONDO 501,Residential,12000,78897,0,90897
200115700101010,CONDO 501,Residential,12000,78897,0,90897
200115700101011,CONDO 501,Residential,12000,83942,0,95942
200115700101012,CONDO 501,Residential,12000,84786,0,96786
200115700101013,CONDO 501,Residential,12000,78897,0,90897
200115700101014,CONDO 501,Residential,12000,78897,0,90897
200115700101015,CONDO 501,Residential,12000,79400,0,91400
200115700101016,CONDO 501,Residential,12000,78897,0,90897
200115700101017,CONDO 501,Residential,12000,84211,0,96211
200115700101018,CONDO 501,Residential,12000,114711,0,126711
200115700101019,CONDO 501,Residential,12000,132761,0,144761
200115700101020,CONDO 501,Residential,12000,124851,0,136851
200115700200000,Empty,Exempt,0,0,0,0
200115800201000,CONDO 501,Residential,12000,132039,0,144039
200115800201001,CONDO 501,Residential,12000,130632,0,142632
200115800301000,CONDO 501,Residential,12000,127467,0,139467
200115800301001,CONDO 501,Residential,12000,132492,0,144492
200115800401000,CONDO 501,Residential,12000,141570,0,153570
200115800401001,CONDO 501,Residential,12000,114657,0,126657
200115800601000,CONDO 501,Residential,12000,117463,0,129463
200115800601001,CONDO 501,Residential,12000,127463,0,139463
200115800601002,CONDO 501,Residential,12000,117463,0,129463
200115800601003,CONDO 501,Residential,12000,118192,0,130192
200115800601004,CONDO 501,Residential,12000,130079,0,142079
200115800601005,CONDO 501,Residential,12000,117744,0,129744
200115800601006,CONDO 501,Residential,12000,134354,0,146354
200115800601007,CONDO 501,Residential,12000,127189,0,139189
200115800601008,CONDO 501,Residential,12000,117233,0,129233
200115800701000,CONDO 501,Residential,12000,140380,0,152380
200115800701001,CONDO 501,Residential,12000,146587,0,158587
200115900201000,CONDO 501,Residential,12000,118741,0,130741
200115900201001,CONDO 501,Residential,12000,121435,0,133435
200115900201002,CONDO 501,Residential,12000,118621,0,130621
200115900201003,CONDO 501,Residential,12000,106012,0,118012
200115900201004,CONDO 501,Residential,12000,104087,0,116087
200115900201005,CONDO 501,Residential,12000,116110,0,128110
200115900201006,CONDO 501,Residential,12000,115151,0,127151
200115900201007,CONDO 501,Residential,12000,124168,0,136168
200115900201008,CONDO 501,Residential,12000,117911,0,129911
200117600200000,COMM SW,Commercial,1326321,0,6754717,8081038
200117600300000,COMM SW,Commercial,589680,0,991848,1581528
200117700100000,E-40 CHURCHES,Exempt,882684,0,317570,1200254
200117700200000,SW 431,Residential,26320,182142,0,208462
200117700300000,SW 431,Residential,30357,209616,0,239973
200117700400000,SW 431,Residential,31262,155369,0,186631
200117700500000,SW 431,Residential,29965,151330,0,181295
200117700600000,SW 431,Residential,29660,138861,0,168521
200117700700000,SW 431,Residential,30660,154604,0,185264
200117800100000,SW 431,Residential,29376,140286,0,169662
200117800200000,SW 431,Residential,30109,132455,0,162564
200117800300000,SW 431,Residential,30410,156865,0,187275
200117800400000,SW 431,Residential,29664,227803,0,257467
200117800500000,SW 431,Residential,30940,213627,0,244567
200117800600000,SW 431,Residential,27300,196999,0,224299
200117800700000,SW 431,Residential,27843,149162,0,177005
200117800800000,SW 431,Residential,30520,165994,0,196514
200117800900000,SW 431,Residential,29648,163744,0,193392
200117801000000,SW 431,Residential,40619,221607,0,262226
200117801100000,SW 431,Residential,31172,165293,0,196465
200117900100000,SW 431,Residential,36213,174559,0,210772
200117900200000,SW 431,Residential,27900,155440,0,183340
200117900300000,SW 431,Residential,27600,180794,0,208394
200117900400000,SW 431,Residential,27600,142069,0,169669
200117900500000,SW 431,Residential,28277,151431,0,179708
200118000100000,SW 431,Residential,31552,170639,0,202191
200118000200000,SW 431,Residential,30172,203616,0,233788
200118000300000,SW 431,Residential,28831,162937,0,191768
200118000400000,SW 431,Residential,28359,179278,0,207637
200118000500000,SW 431,Residential,27979,178517,0,206496
200118000600000,SW 431,Residential,25760,161948,0,187708
200118000700000,SW 431,Residential,25760,145335,0,171095
200118100100000,SW 431,Residential,25760,174194,0,199954
200118100200000,SW 431,Residential,25760,133322,0,159082
200120100200000,SW 407,Ag Land,34224,0,0,34224
200120100300000,CONDO 501,Residential,48000,18000,0,66000
200120100400000,CONDO 500,Residential,48000,94277,0,142277
200120100500000,CONDO 500,Residential,48000,0,0,48000
200120100801000,CONDO 501,Residential,12000,82288,0,94288
200120100801001,CONDO 501,Residential,12000,81922,0,93922
200120100801002,CONDO 501,Residential,12000,79425,0,91425
200120100801003,CONDO 501,Residential,12000,82288,0,94288
200120100801004,CONDO 501,Residential,12000,82288,0,94288
200120100801005,CONDO 501,Residential,12000,79425,0,91425
200120100801006,CONDO 501,Residential,12000,79425,0,91425
200120100801007,CONDO 505,Residential,12000,82288,0,94288
200120100801008,CONDO 501,Residential,12000,82288,0,94288
200120100801009,CONDO 501,Residential,12000,79425,0,91425
200120100801010,CONDO 501,Residential,12000,79425,0,91425
200120100801011,CONDO 501,Residential,12000,82288,0,94288
200120100801012,CONDO 501,Residential,12000,82288,0,94288
200120100801013,CONDO 501,Residential,12000,79425,0,91425
200120100801014,CONDO 501,Residential,12000,79425,0,91425
200120100801015,CONDO 501,Residential,12000,82288,0,94288
200120200100000,CONDO 500,Residential,48000,0,0,48000
200120200200000,CONDO 500,Residential,20240,0,0,20240
200120200300000,CONDO 500,Residential,48000,0,0,48000
200120200400000,CONDO 500,Residential,48000,0,0,48000
200122700200000,SW 407,Ag Land,5172,0,0,5172
200132600100000,SW 418,Ag Land,42117,0,0,42117
200132600200000,SW 422,Residential,53950,189151,0,243101
200132600300000,SW 418,Residential,102000,289793,0,391793
200140100500000,COMM SW,Commercial,316872,0,0,316872
200140100501000,CONDO 501,Residential,12000,87769,0,99769
200140100501001,CONDO 501,Residential,12000,79400,0,91400
200140100501002,CONDO 501,Residential,12000,79400,0,91400
200140100501003,CONDO 501,Residential,12000,87083,0,99083
200140100501004,CONDO 501,Residential,12000,79400,0,91400
200140100501005,CONDO 501,Residential,12000,82262,0,94262
200140100501006,CONDO 501,Residential,12000,87157,0,99157
200140100501007,CONDO 501,Residential,12000,81201,0,93201
200140100501008,CONDO 501,Residential,12000,79400,0,91400
200140100501009,CONDO 501,Residential,12000,82262,0,94262
200140100501010,CONDO 501,Residential,12000,90069,0,102069
200140100501011,CONDO 501,Residential,12000,82219,0,94219
200140100501012,CONDO 501,Residential,12000,82219,0,94219
200140100501013,CONDO 501,Residential,12000,86752,0,98752
200140100501014,CONDO 501,Residential,12000,86752,0,98752
200140100501015,CONDO 501,Residential,12000,85255,0,97255
200140100501016,CONDO 501,Residential,12000,84710,0,96710
200140100501017,CONDO 501,Residential,12000,79504,0,91504
200140100501018,CONDO 501,Residential,12000,81705,0,93705
200140100501019,CONDO 501,Residential,12000,79400,0,91400
200140100501020,CONDO 501,Residential,12000,84010,0,96010
200140100501021,CONDO 501,Residential,12000,84710,0,96710
200140100501022,CONDO 501,Residential,12000,86766,0,98766
200140100501023,CONDO 501,Residential,12000,79400,0,91400
200140100501024,CONDO 501,Residential,12000,79400,0,91400
200140100501025,CONDO 501,Residential,12000,85321,0,97321
200140100600000,COMM SW,Commercial,273024,0,0,273024
200140200101000,CONDO 501,Residential,12000,116388,0,128388
200140200101001,CONDO 501,Residential,12000,118978,0,130978
200140200101002,CONDO 501,Residential,12000,122554,0,134554
200140200101003,CONDO 501,Residential,12000,120677,0,132677
200140200101004,CONDO 501,Residential,12000,138382,0,150382
200140200101005,CONDO 501,Residential,12000,126511,0,138511
200140200101006,CONDO 501,Residential,12000,126255,0,138255
200140200101007,CONDO 501,Residential,12000,122881,0,134881
200140200101008,CONDO 501,Residential,12000,143889,0,155889
200140200101009,CONDO 501,Residential,12000,133120,0,145120
200140200101010,CONDO 501,Residential,12000,127356,0,139356
200140200101011,CONDO 501,Residential,12000,126143,0,138143
200140200101012,CONDO 501,Residential,12000,121252,0,133252
200140200101013,CONDO 501,Residential,12000,125454,0,137454
200140200101014,CONDO 501,Residential,12000,127906,0,139906
200140200101015,CONDO 501,Residential,12000,141219,0,153219
200140200201004,CONDO 501,Residential,12000,141947,0,153947
200140200201005,CONDO 501,Residential,12000,119323,0,131323
200140200201006,CONDO 501,Residential,12000,119317,0,131317
200140200201007,CONDO 501,Residential,12000,123079,0,135079
200140200201008,CONDO 501,Residential,12000,121967,0,133967
200140200201009,CONDO 501,Residential,12000,132660,0,144660
200140200201010,CONDO 501,Residential,12000,91990,0,103990
200140200201011,CONDO 501,Residential,12000,88619,0,100619
200140200201012,CONDO 501,Residential,12000,80438,0,92438
200140200201013,CONDO 501,Residential,12000,89604,0,101604
200140200201014,CONDO 501,Residential,12000,124317,0,136317
200140200201015,CONDO 501,Residential,12000,144284,0,156284
200140200301000,CONDO 501,Residential,12000,120197,0,132197
200140200301001,CONDO 501,Residential,12000,120197,0,132197
200140200301002,CONDO 501,Residential,12000,118411,0,130411
200140200301003,CONDO 501,Residential,12000,118411,0,130411
200140200301004,CONDO 501,Residential,12000,120823,0,132823
200140200301005,CONDO 501,Residential,12000,109478,0,121478
200140200301006,CONDO 501,Residential,12000,109478,0,121478
200140200301007,CONDO 501,Residential,12000,120823,0,132823
200142600201000,CONDO 501,Residential,12000,118682,0,130682
200142600201001,CONDO 501,Residential,12000,106780,0,118780
200142600201002,CONDO 501,Residential,12000,105917,0,117917
200142600201003,CONDO 501,Residential,12000,119852,0,131852
200142600201004,CONDO 501,Residential,12000,125192,0,137192
200142600201005,CONDO 501,Residential,12000,125479,0,137479
200142600201006,CONDO 501,Residential,12000,127397,0,139397
200142600201007,CONDO 501,Residential,12000,123851,0,135851
200142600201008,CONDO 501,Residential,12000,144980,0,156980
200142600201009,CONDO 501,Residential,12000,140699,0,152699
200142800101000,CONDO 501,Residential,12000,81972,0,93972
200142800101001,CONDO 501,Residential,12000,80901,0,92901
200142800101002,CONDO 501,Residential,12000,79127,0,91127
200142800101003,CONDO 501,Residential,12000,79127,0,91127
200142800101004,CONDO 501,Residential,12000,81432,0,93432
200142800101005,CONDO 501,Residential,12000,86255,0,98255
200142800101006,CONDO 501,Residential,12000,89742,0,101742
200142800101007,CONDO 501,Residential,12000,86732,0,98732
200142800101008,CONDO 501,Residential,12000,81432,0,93432
200142800101009,CONDO 501,Residential,12000,79127,0,91127
200142800101010,CONDO 501,Residential,12000,79127,0,91127
200142800101011,CONDO 501,Residential,12000,81972,0,93972
200142800101012,CONDO 501,Residential,12000,87479,0,99479
200142800101013,CONDO 501,Residential,12000,78597,0,90597
200142800101014,CONDO 501,Residential,12000,84313,0,96313
200142800101015,CONDO 501,Residential,12000,81432,0,93432
200142800101016,CONDO 501,Residential,12000,79127,0,91127
200142800101017,CONDO 501,Residential,12000,83124,0,95124
200142800101018,CONDO 501,Residential,12000,81727,0,93727
200142800101019,CONDO 501,Residential,12000,85811,0,97811
200142800101020,CONDO 501,Residential,12000,78897,0,90897
200142800101021,CONDO 501,Residential,12000,86621,0,98621
200142900101000,CONDO 501,Residential,12000,125203,0,137203
200142900101001,CONDO 501,Residential,12000,107751,0,119751
200142900101002,CONDO 501,Residential,12000,106575,0,118575
200142900101003,CONDO 501,Residential,12000,124934,0,136934
200142900101004,CONDO 501,Residential,12000,126597,0,138597
200142900101005,CONDO 501,Residential,12000,125526,0,137526
200142900101006,CONDO 501,Residential,12000,116056,0,128056
200142900101007,CONDO 501,Residential,12000,113966,0,125966
200142900101008,CONDO 501,Residential,12000,126108,0,138108
200142900101009,CONDO 501,Residential,12000,136919,0,148919
200142900101010,CONDO 501,Residential,12000,131986,0,143986
200142900101011,CONDO 501,Residential,12000,127169,0,139169
200142900101012,CONDO 501,Residential,12000,121537,0,133537
200142900101013,CONDO 501,Residential,12000,109478,0,121478
200142900101014,CONDO 501,Residential,12000,130940,0,142940
200142900201000,CONDO 501,Residential,12000,119517,0,131517
200142900201001,CONDO 501,Residential,12000,105042,0,117042
200142900201002,CONDO 501,Residential,12000,113719,0,125719
200142900201003,CONDO 501,Residential,12000,127533,0,139533
200142900300000,Empty,Exempt,0,0,0,0
200145100300000,Empty,Commercial,507600,0,5716032,6223632
200145100500000,COMM SW,Commercial,448146,0,4805081,5253227
200145200100000,COMM SW,Commercial,243540,0,802049,1045589
200145200200000,COMM SW,Commercial,160650,0,184186,344836
200147600100000,COMM SW,Commercial,244853,0,0,244853
200210100200000,SW 407,Ag Land,30912,0,0,30912
200212600300000,SW 407,Residential,30143,156238,0,186381
200212600400000,SW 407,Residential,27448,151329,0,178777
200212600500000,SW 407,Residential,27448,157321,0,184769
200212600600000,SW 407,Residential,27448,155185,0,182633
200212600700000,SW 407,Residential,27448,173720,0,201168
200212600800000,SW 407,Residential,27448,154550,0,181998
200212600900000,SW 407,Residential,27448,163113,0,190561
200212601000000,SW 407,Residential,27448,158051,0,185499
200212601100000,SW 407,Residential,27448,152660,0,180108
200212601200000,SW 407,Residential,27448,172231,0,199679
200212601300000,SW 407,Residential,27448,198603,0,226051
200212601400000,SW 407,Residential,27448,161091,0,188539
200212601500000,SW 407,Residential,161,0,0,161
200212601600000,SW 407,Residential,161,0,0,161
200212601700000,SW 407,Residential,27448,153114,0,180562
200212601800000,SW 407,Residential,27740,161713,0,189453
200212601900000,SW 407,Residential,7655,0,0,7655
200212700100000,SW 407,Residential,30102,182861,0,212963
200212700200000,SW 407,Residential,26496,155454,0,181950
200212700300000,SW 407,Residential,26496,158518,0,185014
200212700400000,SW 407,Residential,26496,158801,0,185297
200212700500000,SW 407,Residential,26496,155212,0,181708
200212700600000,SW 407,Residential,26496,159079,0,185575
200212700700000,SW 407,Residential,29440,157935,0,187375
200212700800000,SW 407,Residential,27600,159572,0,187172
200212700900000,SW 407,Residential,27600,119839,0,147439
200212701000000,SW 407,Residential,27600,183926,0,211526
200212701100000,SW 407,Residential,27232,146819,0,174051
200212701200000,SW 407,Residential,161,0,0,161
200212701300000,SW 407,Residential,161,0,0,161
200212701400000,SW 407,Residential,161,0,0,161
200212701500000,SW 407,Residential,161,0,0,161
200212701600000,SW 407,Residential,27824,157121,0,184945
200212701700000,SW 407,Residential,7934,0,0,7934
200215100100000,SW 432,Ag Land,26467,0,0,26467
200220100100000,SW 407,Ag Land,23945,0,0,23945
200220200301000,CONDO 500,Residential,6500,34905,0,41405
200220200301001,CONDO 500,Residential,6500,34905,0,41405
200220200301002,CONDO 500,Residential,6500,34905,0,41405
200220200301003,CONDO 500,Residential,6500,34905,0,41405
200220200301004,CONDO 500,Residential,6500,34905,0,41405
200220200301005,CONDO 500,Residential,6500,34905,0,41405
200220200301006,CONDO 500,Residential,6500,34905,0,41405
200220200301007,CONDO 500,Residential,6500,34905,0,41405
200220200301008,CONDO 500,Residential,6500,34905,0,41405
200220200301009,CONDO 500,Residential,6500,34905,0,41405
200220200301010,CONDO 500,Residential,6500,34905,0,41405
200220200301011,CONDO 500,Residential,6500,47514,0,54014
200220200301012,CONDO 500,Residential,6500,34905,0,41405
200220200301013,CONDO 500,Residential,6500,34905,0,41405
200220200301014,CONDO 500,Residential,6500,34905,0,41405
200220200301015,CONDO 500,Residential,6500,34905,0,41405
200220200301016,CONDO 500,Residential,6500,34874,0,41374
200220200301017,CONDO 500,Residential,6500,34874,0,41374
200220200301018,CONDO 500,Residential,6500,34874,0,41374
200220200301019,CONDO 500,Residential,6500,34874,0,41374
200220200301020,CONDO 500,Residential,6500,34874,0,41374
200220200301021,CONDO 500,Residential,6500,34874,0,41374
200220200301022,CONDO 500,Residential,6500,34874,0,41374
200220200301023,CONDO 500,Residential,6500,34874,0,41374
200220200301024,CONDO 500,Residential,6500,34874,0,41374
200220200301025,CONDO 500,Residential,6500,34874,0,41374
200220200301026,CONDO 500,Residential,6500,47483,0,53983
200220200301027,CONDO 500,Residential,6500,34874,0,41374
200220200301028,CONDO 500,Residential,6500,34874,0,41374
200220200301029,CONDO 500,Residential,6500,34874,0,41374
200220200301030,CONDO 500,Residential,6500,34874,0,41374
200220200301031,CONDO 500,Residential,6500,34874,0,41374
200220200301032,CONDO 500,Residential,6500,34874,0,41374
200220200301033,CONDO 500,Residential,6500,34874,0,41374
200220200301034,CONDO 500,Residential,6500,34874,0,41374
200220200301035,CONDO 500,Residential,6500,34874,0,41374
200220200301036,CONDO 500,Residential,6500,34874,0,41374
200220200301037,CONDO 500,Residential,6500,34874,0,41374
200220200301038,CONDO 500,Residential,6500,34874,0,41374
200220200301039,CONDO 500,Residential,6500,34874,0,41374
200220200301040,CONDO 500,Residential,6500,34874,0,41374
200220200301041,CONDO 500,Residential,6500,47483,0,53983
200220200301042,CONDO 500,Residential,6500,34874,0,41374
200220200301043,CONDO 500,Residential,6500,34874,0,41374
200220200301044,CONDO 500,Residential,6500,34874,0,41374
200220200301045,CONDO 500,Residential,6500,34874,0,41374
200220200301046,CONDO 500,Residential,6500,34874,0,41374
200220200301047,CONDO 500,Residential,6500,34874,0,41374
200220200301048,CONDO 500,Residential,6500,34874,0,41374
200220200301049,CONDO 500,Residential,6500,34874,0,41374
200220200301050,CONDO 500,Residential,6500,34874,0,41374
200220200301051,CONDO 500,Residential,6500,34874,0,41374
200220200301052,CONDO 500,Residential,6500,34874,0,41374
200220200301053,CONDO 500,Residential,6500,34874,0,41374
200220200301054,CONDO 500,Residential,6500,34874,0,41374
200220200301055,CONDO 500,Residential,6500,34874,0,41374
200220200301056,CONDO 500,Residential,6500,47483,0,53983
200220200301057,CONDO 500,Residential,6500,34874,0,41374
200220200301058,CONDO 500,Residential,6500,34874,0,41374
200220200301059,CONDO 500,Residential,6500,34874,0,41374
200220200301060,CONDO 500,Residential,6500,34874,0,41374
200220200301061,CONDO 500,Residential,6500,34874,0,41374
200220200301062,CONDO 500,Residential,6500,34874,0,41374
200220200301063,CONDO 500,Residential,6500,34874,0,41374
200220200301064,CONDO 500,Residential,6500,34874,0,41374
200220200301065,CONDO 500,Residential,6500,34874,0,41374
200220200301066,CONDO 500,Residential,6500,34874,0,41374
200220200301067,CONDO 500,Residential,6500,34874,0,41374
200220200301068,CONDO 500,Residential,6500,34874,0,41374
200220200301069,CONDO 500,Residential,6500,34874,0,41374
200220200301070,CONDO 500,Residential,6500,34874,0,41374
200220200301071,CONDO 500,Residential,6500,47483,0,53983
200220200301072,CONDO 500,Residential,6500,34874,0,41374
200220200301073,CONDO 500,Residential,6500,34874,0,41374
200220200301074,CONDO 500,Residential,6500,34874,0,41374
200220200301075,CONDO 500,Residential,6500,31836,0,38336
200220200301076,CONDO 500,Residential,6500,31836,0,38336
200220200301077,CONDO 500,Residential,6500,31836,0,38336
200220200301078,CONDO 500,Residential,6500,31836,0,38336
200220200301079,CONDO 500,Residential,6500,31836,0,38336
200220200301080,CONDO 500,Residential,6500,31836,0,38336
200220200301081,CONDO 500,Residential,6500,31836,0,38336
200220200301082,CONDO 500,Residential,6500,31836,0,38336
200220200301083,CONDO 500,Residential,6500,31836,0,38336
200220200301084,CONDO 500,Residential,6500,31836,0,38336
200220200301085,CONDO 500,Residential,6500,31836,0,38336
200220200301086,CONDO 500,Residential,6500,44445,0,50945
200220200301087,CONDO 500,Residential,6500,31836,0,38336
200220200301088,CONDO 500,Residential,6500,31836,0,38336
200220200301089,CONDO 500,Residential,6500,31836,0,38336
200220200301090,CONDO 500,Residential,6500,31836,0,38336
200220200301091,CONDO 500,Residential,6500,31836,0,38336
200220200301092,CONDO 500,Residential,6500,31836,0,38336
200220200301093,CONDO 500,Residential,6500,31836,0,38336
200220200301094,CONDO 500,Residential,6500,31836,0,38336
200220200301095,CONDO 500,Residential,6500,31836,0,38336
200220200301096,CONDO 500,Residential,6500,31836,0,38336
200220200301097,CONDO 500,Residential,6500,31836,0,38336
200220200301098,CONDO 500,Residential,6500,31836,0,38336
200220200301099,CONDO 500,Residential,6500,31836,0,38336
200220200301100,CONDO 500,Residential,6500,31836,0,38336
200220200301101,CONDO 500,Residential,6500,44445,0,50945
200220200301102,CONDO 500,Residential,6500,31836,0,38336
200220200301103,CONDO 500,Residential,6500,31836,0,38336
200220200301104,CONDO 500,Residential,6500,31836,0,38336
200220200301105,CONDO 500,Residential,6500,31836,0,38336
200220200301106,CONDO 500,Residential,6500,31836,0,38336
200220200301107,CONDO 500,Residential,6500,31836,0,38336
200220200301108,CONDO 500,Residential,6500,31836,0,38336
200220200301109,CONDO 500,Residential,6500,31836,0,38336
200220200301110,CONDO 500,Residential,6500,31836,0,38336
200220200301111,CONDO 500,Residential,6500,31836,0,38336
200220200301112,CONDO 500,Residential,6500,31836,0,38336
200220200301113,CONDO 500,Residential,6500,31836,0,38336
200220200301114,CONDO 500,Residential,6500,31836,0,38336
200220200301115,CONDO 500,Residential,6500,31836,0,38336
200220200301116,CONDO 500,Residential,6500,44445,0,50945
200220200301117,CONDO 500,Residential,6500,31836,0,38336
200220200301118,CONDO 500,Residential,6500,31836,0,38336
200220200301119,CONDO 500,Residential,6500,31836,0,38336
200220200301120,CONDO 500,Residential,6500,31836,0,38336
200220200301121,CONDO 500,Residential,6500,31836,0,38336
200220200301122,CONDO 500,Residential,6500,31836,0,38336
200220200301123,CONDO 500,Residential,6500,31836,0,38336
200220200301124,CONDO 500,Residential,6500,31836,0,38336
200220200301125,CONDO 500,Residential,6500,31836,0,38336
200220200301126,CONDO 500,Residential,6500,31836,0,38336
200220200301127,CONDO 500,Residential,6500,31836,0,38336
200220200301128,CONDO 500,Residential,6500,31836,0,38336
200220200301129,CONDO 500,Residential,6500,31836,0,38336
200220200301130,CONDO 500,Residential,6500,31836,0,38336
200220200301131,CONDO 500,Residential,6500,44445,0,50945
200220200301132,CONDO 500,Residential,6500,31836,0,38336
200220200301133,CONDO 500,Residential,6500,31836,0,38336
200220200301134,CONDO 500,Residential,6500,31836,0,38336
200220200301135,CONDO 500,Residential,6500,31836,0,38336
200220200301136,CONDO 500,Residential,6500,31836,0,38336
200220200301137,CONDO 500,Residential,6500,31836,0,38336
200220200301138,CONDO 500,Residential,6500,31836,0,38336
200220200301139,CONDO 500,Residential,6500,31836,0,38336
200220200301140,CONDO 500,Residential,6500,31836,0,38336
200220200301141,CONDO 500,Residential,6500,31836,0,38336
200220200301142,CONDO 500,Residential,6500,31836,0,38336
200220200301143,CONDO 500,Residential,6500,31836,0,38336
200220200301144,CONDO 500,Residential,6500,31836,0,38336
200220200301145,CONDO 500,Residential,6500,31836,0,38336
200220200301146,CONDO 500,Residential,6500,44445,0,50945
200220200301147,CONDO 500,Residential,6500,31836,0,38336
200220200301148,CONDO 500,Residential,6500,31836,0,38336
200220200301149,CONDO 500,Residential,6500,31836,0,38336
200220200301150,CONDO 500,Residential,6500,31836,0,38336
200220200301151,CONDO 500,Residential,6500,31836,0,38336
200220200301152,CONDO 500,Residential,6500,31836,0,38336
200220200301153,CONDO 500,Residential,6500,31836,0,38336
200220200301154,CONDO 500,Residential,6500,31836,0,38336
200220200301155,CONDO 500,Residential,6500,31836,0,38336
200220200301156,CONDO 500,Residential,6500,31836,0,38336
200220200301157,CONDO 500,Residential,6500,31836,0,38336
200220200301158,CONDO 500,Residential,6500,31836,0,38336
200220200301159,CONDO 500,Residential,6500,31836,0,38336
200220200301160,CONDO 500,Residential,6500,31836,0,38336
200220200301161,CONDO 500,Residential,6500,44445,0,50945
200220200301162,CONDO 500,Residential,6500,31836,0,38336
200220200301163,CONDO 500,Residential,6500,31836,0,38336
200220200301164,CONDO 500,Residential,6500,31836,0,38336
200220200301165,CONDO 500,Residential,6500,31836,0,38336
200220200301166,CONDO 500,Residential,6500,31836,0,38336
200220200301167,CONDO 500,Residential,6500,31836,0,38336
200220200301168,CONDO 500,Residential,6500,31836,0,38336
200220200301169,CONDO 500,Residential,6500,31836,0,38336
200220200301170,CONDO 500,Residential,6500,31836,0,38336
200220200301171,CONDO 500,Residential,6500,31836,0,38336
200220200301172,CONDO 500,Residential,6500,31836,0,38336
200220200301173,CONDO 500,Residential,6500,31836,0,38336
200220200301174,CONDO 500,Residential,6500,31836,0,38336
200220200301175,CONDO 500,Residential,6500,31836,0,38336
200220200301176,CONDO 500,Residential,6500,44445,0,50945
200220200301177,CONDO 500,Residential,6500,31836,0,38336
200220200301178,CONDO 500,Residential,6500,31836,0,38336
200220200301179,CONDO 500,Residential,6500,31836,0,38336
200220200301180,CONDO 500,Residential,6500,31836,0,38336
200220200301181,CONDO 500,Residential,6500,31836,0,38336
200220200301182,CONDO 500,Residential,6500,31836,0,38336
200220200301183,CONDO 500,Residential,6500,31836,0,38336
200220200301184,CONDO 500,Residential,6500,31836,0,38336
200220200301185,CONDO 500,Residential,6500,31836,0,38336
200220200301186,CONDO 500,Residential,6500,31836,0,38336
200220200301187,CONDO 500,Residential,6500,31836,0,38336
200220200301188,CONDO 500,Residential,6500,31836,0,38336
200220200301189,CONDO 500,Residential,6500,31836,0,38336
200220200301190,CONDO 500,Residential,6500,31836,0,38336
200220200301191,CONDO 500,Residential,6500,44445,0,50945
200220200301192,CONDO 500,Residential,6500,31836,0,38336
200220200301193,CONDO 500,Residential,6500,31836,0,38336
200220200301194,CONDO 500,Residential,6500,31836,0,38336
200220200301195,CONDO 500,Residential,6500,31836,0,38336
200220200301196,CONDO 500,Residential,6500,31836,0,38336
200220200301197,CONDO 500,Residential,6500,31836,0,38336
200220200301198,CONDO 500,Residential,6500,31836,0,38336
200220200301199,CONDO 500,Residential,6500,31836,0,38336
200220200301200,CONDO 500,Residential,6500,31836,0,38336
200220200301201,CONDO 500,Residential,6500,31836,0,38336
200220200301202,CONDO 500,Residential,6500,31836,0,38336
200220200301203,CONDO 500,Residential,6500,31836,0,38336
200220200301204,CONDO 500,Residential,6500,31836,0,38336
200220200301205,CONDO 500,Residential,6500,31836,0,38336
200220200301206,CONDO 500,Residential,6500,44445,0,50945
200220200301207,CONDO 500,Residential,6500,31836,0,38336
200220200301208,CONDO 500,Residential,6500,31836,0,38336
200220200301209,CONDO 500,Residential,6500,31836,0,38336
200220200301210,CONDO 500,Residential,6500,31836,0,38336
200220200301211,CONDO 500,Residential,6500,31836,0,38336
200220200301212,CONDO 500,Residential,6500,31836,0,38336
200220200301213,CONDO 500,Residential,6500,31836,0,38336
200220200301214,CONDO 500,Residential,6500,31836,0,38336
200220200301215,CONDO 500,Residential,6500,31836,0,38336
200220200301216,CONDO 500,Residential,6500,31836,0,38336
200220200301217,CONDO 500,Residential,6500,31836,0,38336
200220200301218,CONDO 500,Residential,6500,31836,0,38336
200220200301219,CONDO 500,Residential,6500,31836,0,38336
200220200301220,CONDO 500,Residential,6500,31836,0,38336
200220200301221,CONDO 500,Residential,6500,44445,0,50945
200220200301222,CONDO 500,Residential,6500,31836,0,38336
200220200301223,CONDO 500,Residential,6500,31836,0,38336
200220200301224,CONDO 500,Residential,6500,31836,0,38336
200220200301225,CONDO 500,Residential,6500,31836,0,38336
200220200301226,CONDO 500,Residential,6500,31836,0,38336
200220200301227,CONDO 500,Residential,6500,31836,0,38336
200220200301228,CONDO 500,Residential,6500,31836,0,38336
200220200301229,CONDO 500,Residential,6500,31836,0,38336
200220200301230,CONDO 500,Residential,6500,31836,0,38336
200220200301231,CONDO 500,Residential,6500,31836,0,38336
200220200301232,CONDO 500,Residential,6500,31836,0,38336
200220200301233,CONDO 500,Residential,6500,31836,0,38336
200220200301234,CONDO 500,Residential,6500,31836,0,38336
200220200301235,CONDO 500,Residential,6500,31836,0,38336
200220200301236,CONDO 500,Residential,6500,44445,0,50945
200220200301237,CONDO 500,Residential,6500,31836,0,38336
200220200301238,CONDO 500,Residential,6500,31836,0,38336
200220200301239,CONDO 500,Residential,6500,31836,0,38336
200222600100000,SW 407,Residential,44280,0,0,44280
200222600200000,SW 407,Residential,1300,0,0,1300
200222700201000,CONDO 501,Residential,6500,52181,0,58681
200222700201001,CONDO 501,Residential,6500,52181,0,58681
200222700201002,CONDO 501,Residential,6500,52181,0,58681
200222700201003,CONDO 501,Residential,6500,52181,0,58681
200222700201004,CONDO 501,Residential,6500,55062,0,61562
200222700201005,CONDO 501,Residential,6500,55763,0,62263
200222700201006,CONDO 501,Residential,6500,55763,0,62263
200222700201007,CONDO 501,Residential,6500,55763,0,62263
200222700201008,CONDO 501,Residential,6500,55062,0,61562
200222700201009,CONDO 501,Residential,6500,55763,0,62263
200222700201010,CONDO 501,Residential,6500,55763,0,62263
200222700201011,CONDO 501,Residential,6500,55763,0,62263
200222700201012,CONDO 501,Residential,6500,55062,0,61562
200222700201013,CONDO 501,Residential,6500,55763,0,62263
200222700201014,CONDO 501,Residential,6500,55763,0,62263
200222700201015,CONDO 501,Residential,6500,55763,0,62263
200222700201016,CONDO 501,Residential,6500,55062,0,61562
200222700201017,CONDO 501,Residential,6500,55763,0,62263
200222700201018,CONDO 501,Residential,6500,55763,0,62263
200222700201019,CONDO 501,Residential,6500,55763,0,62263
200222700201020,CONDO 501,Residential,6500,55062,0,61562
200222700201021,CONDO 501,Residential,6500,55763,0,62263
200222700201022,CONDO 501,Residential,6500,55763,0,62263
200222700201023,CONDO 501,Residential,6500,55763,0,62263
200222700201024,CONDO 501,Residential,6500,55062,0,61562
200222700201025,CONDO 501,Residential,6500,55763,0,62263
200222700201026,CONDO 501,Residential,6500,55763,0,62263
200222700201027,CONDO 501,Residential,6500,55763,0,62263
200222700201028,CONDO 501,Residential,6500,55062,0,61562
200222700201029,CONDO 501,Residential,6500,55763,0,62263
200222700201030,CONDO 501,Residential,6500,55763,0,62263
200222700201031,CONDO 501,Residential,6500,55763,0,62263
200222700201032,CONDO 501,Residential,6500,55062,0,61562
200222700201033,CONDO 501,Residential,6500,55763,0,62263
200222700201034,CONDO 501,Residential,6500,55763,0,62263
200222700201035,CONDO 501,Residential,6500,55763,0,62263
200222700201036,CONDO 501,Residential,6500,55062,0,61562
200222700201037,CONDO 501,Residential,6500,55763,0,62263
200222700201038,CONDO 501,Residential,6500,55763,0,62263
200222700201039,CONDO 501,Residential,6500,55763,0,62263
200222700201040,CONDO 501,Residential,6500,55062,0,61562
200222700201041,CONDO 501,Residential,6500,55763,0,62263
200222700201042,CONDO 501,Residential,6500,55763,0,62263
200222700201043,CONDO 501,Residential,6500,55763,0,62263
200222700201044,CONDO 501,Residential,6500,52181,0,58681
200222700201045,CONDO 501,Residential,6500,52181,0,58681
200222700201046,CONDO 501,Residential,6500,52181,0,58681
200222700201047,CONDO 501,Residential,6500,52181,0,58681
200222700201048,CONDO 501,Residential,6500,52181,0,58681
200222700201049,CONDO 501,Residential,6500,52181,0,58681
200222700201050,CONDO 501,Residential,6500,52181,0,58681
200222700201051,CONDO 501,Residential,6500,52181,0,58681
200222700201052,CONDO 501,Residential,6500,52181,0,58681
200222700201053,CONDO 501,Residential,6500,52181,0,58681
200222700201054,CONDO 501,Residential,6500,52181,0,58681
200222700201055,CONDO 501,Residential,6500,52181,0,58681
200222700201056,CONDO 501,Residential,6500,52181,0,58681
200222700201057,CONDO 501,Residential,6500,52181,0,58681
200222700201058,CONDO 501,Residential,6500,52181,0,58681
200222700201059,CONDO 501,Residential,6500,52181,0,58681
200222700201060,CONDO 501,Residential,6500,52181,0,58681
200222700201061,CONDO 501,Residential,6500,52181,0,58681
200222700201062,CONDO 501,Residential,6500,52181,0,58681
200222700201063,CONDO 501,Residential,6500,52181,0,58681
200222700201064,CONDO 501,Residential,6500,52181,0,58681
200222700201065,CONDO 501,Residential,6500,52181,0,58681
200222700201066,CONDO 501,Residential,6500,52181,0,58681
200222700201067,CONDO 501,Residential,6500,52181,0,58681
200222700201068,CONDO 501,Residential,6500,55062,0,61562
200222700201069,CONDO 501,Residential,6500,55763,0,62263
200222700201070,CONDO 501,Residential,6500,55763,0,62263
200222700201071,CONDO 501,Residential,6500,55763,0,62263
200222700201072,CONDO 501,Residential,6500,55062,0,61562
200222700201073,CONDO 501,Residential,6500,55763,0,62263
200222700201074,CONDO 501,Residential,6500,55763,0,62263
200222700201075,CONDO 501,Residential,6500,55763,0,62263
200222700201076,CONDO 501,Residential,6500,55062,0,61562
200222700201077,CONDO 501,Residential,6500,55763,0,62263
200222700201078,CONDO 501,Residential,6500,55763,0,62263
200222700201079,CONDO 501,Residential,6500,55763,0,62263
200222700201080,CONDO 501,Residential,6500,55062,0,61562
200222700201081,CONDO 501,Residential,6500,55763,0,62263
200222700201082,CONDO 501,Residential,6500,55763,0,62263
200222700201083,CONDO 501,Residential,6500,55763,0,62263
200222700201084,CONDO 501,Residential,6500,55062,0,61562
200222700201085,CONDO 501,Residential,6500,55763,0,62263
200222700201086,CONDO 501,Residential,6500,55763,0,62263
200222700201087,CONDO 501,Residential,6500,55763,0,62263
200225100200000,SW 422,Residential,73200,108334,0,181534
200225100300000,SW 422,Residential,93000,138654,0,231654
200225100400000,SW 422,Residential,62350,116897,0,179247
200225100601000,CONDO 501,Residential,15000,114043,0,129043
200225100601001,CONDO 501,Residential,15000,120738,0,135738
200225100601002,CONDO 501,Residential,15000,121749,0,136749
200225100601003,CONDO 501,Residential,15000,110911,0,125911
200225100601004,CONDO 501,Residential,15000,117282,0,132282
200225100601005,CONDO 501,Residential,15000,110582,0,125582
200225100601006,CONDO 501,Residential,15000,111284,0,126284
200225100601007,CONDO 501,Residential,15000,131354,0,146354
200225100601008,CONDO 501,Residential,15000,128777,0,143777
200225100601009,CONDO 501,Residential,15000,113809,0,128809
200225100601010,CONDO 501,Residential,15000,113924,0,128924
200225100601011,CONDO 501,Residential,15000,121453,0,136453
200225100601012,CONDO 501,Residential,15000,125635,0,140635
200225100601013,CONDO 501,Residential,15000,133244,0,148244
200225100601014,CONDO 501,Residential,15000,119788,0,134788
200225100601015,CONDO 501,Residential,15000,119985,0,134985
200225100601016,CONDO 501,Residential,15000,111569,0,126569
200225100601017,CONDO 501,Residential,15000,117382,0,132382
200225100601018,CONDO 501,Residential,15000,114444,0,129444
200225100601019,CONDO 501,Residential,15000,122579,0,137579
200225100601020,CONDO 501,Residential,15000,135163,0,150163
200225100601021,CONDO 501,Residential,15000,125293,0,140293
200225100601022,CONDO 501,Residential,15000,113792,0,128792
200225100601023,CONDO 501,Residential,15000,119497,0,134497
200225100601024,CONDO 501,Residential,15000,135016,0,150016
200225100601025,CONDO 501,Residential,15000,118443,0,133443
200225100601026,CONDO 501,Residential,15000,118443,0,133443
200225100601027,CONDO 501,Residential,15000,110604,0,125604
200225100601028,CONDO 501,Residential,15000,124593,0,139593
200225100601029,CONDO 501,Residential,15000,118000,0,133000
200225100601030,CONDO 501,Residential,15000,108014,0,123014
200225100601031,CONDO 501,Residential,15000,123371,0,138371
200225100601032,CONDO 501,Residential,15000,120055,0,135055
200225100601033,CONDO 501,Residential,15000,115088,0,130088
200225100601034,CONDO 501,Residential,15000,113841,0,128841
200225100601035,CONDO 501,Residential,15000,116946,0,131946
200225100601036,CONDO 501,Residential,15000,110619,0,125619
200225100601037,CONDO 501,Residential,15000,115808,0,130808
200225100601038,CONDO 501,Residential,15000,117903,0,132903
200225100601039,CONDO 501,Residential,15000,116227,0,131227
200225100601040,CONDO 501,Residential,15000,105042,0,120042
200225100601041,CONDO 501,Residential,15000,121591,0,136591
200225100601042,CONDO 501,Residential,15000,109325,0,124325
200225100601043,CONDO 501,Residential,15000,136654,0,151654
200225100601044,CONDO 501,Residential,15000,108084,0,123084
200225100601045,CONDO 501,Residential,15000,105420,0,120420
200225100601046,CONDO 501,Residential,15000,116184,0,131184
200225100601047,CONDO 501,Residential,15000,118852,0,133852
200225100601048,CONDO 501,Residential,15000,106768,0,121768
200225100700000,SW 407,Residential,11587,0,0,11587
200225100800000,SW 407,Residential,17848,0,0,17848
200225100801000,CONDO 501,Residential,15000,91978,0,106978
200225100801001,CONDO 501,Residential,15000,90241,0,105241
200225100801002,CONDO 501,Residential,15000,90241,0,105241
200225100801003,CONDO 501,Residential,15000,91978,0,106978
200225100801004,CONDO 501,Residential,15000,98795,0,113795
200225100801005,CONDO 501,Residential,15000,98564,0,113564
200225100801006,CONDO 501,Residential,15000,98564,0,113564
200225100801007,CONDO 501,Residential,15000,98527,0,113527
200225100801008,CONDO 501,Residential,15000,120280,0,135280
200225100801009,CONDO 501,Residential,15000,109030,0,124030
200225100801010,CONDO 501,Residential,15000,107863,0,122863
200225100801011,CONDO 501,Residential,15000,120280,0,135280
200225100801012,CONDO 501,Residential,15000,126792,0,141792
200225100801013,CONDO 501,Residential,15000,97397,0,112397
200225100801014,CONDO 501,Residential,15000,107507,0,122507
200225100801015,CONDO 501,Residential,15000,137423,0,152423
200225100801016,CONDO 501,Residential,15000,96817,0,111817
200225100801017,CONDO 501,Residential,15000,94512,0,109512
200225100801018,CONDO 501,Residential,15000,94781,0,109781
200225100801019,CONDO 501,Residential,15000,94512,0,109512
200225100801020,CONDO 501,Residential,15000,120800,0,135800
200225100801021,CONDO 501,Residential,15000,94014,0,109014
200225100801022,CONDO 501,Residential,15000,94014,0,109014
200225100801023,CONDO 501,Residential,15000,133284,0,148284
200225100801024,CONDO 501,Residential,15000,117797,0,132797
200225100801025,CONDO 501,Residential,15000,133831,0,148831
200225100801026,CONDO 501,Residential,15000,113062,0,128062
200225100801027,CONDO 501,Residential,15000,99604,0,114604
200225100801028,CONDO 501,Residential,15000,105653,0,120653
200225100801029,CONDO 501,Residential,15000,100020,0,115020
200225100801030,CONDO 501,Residential,15000,96942,0,111942
200225100801031,CONDO 501,Residential,15000,96942,0,111942
200225100801032,CONDO 501,Residential,15000,96942,0,111942
200225100801033,CONDO 501,Residential,15000,96942,0,111942
200225100801034,CONDO 501,Residential,15000,117547,0,132547
200225100801035,CONDO 501,Residential,15000,95052,0,110052
200225100801036,CONDO 501,Residential,15000,116056,0,131056
200225100801037,CONDO 501,Residential,15000,121337,0,136337
200225100801038,CONDO 501,Residential,15000,123758,0,138758
200225100801039,CONDO 501,Residential,15000,117011,0,132011
200225100801040,CONDO 501,Residential,15000,93954,0,108954
200225100801041,CONDO 501,Residential,15000,0,0,15000
200225100801042,CONDO 501,Residential,15000,117280,0,132280
200225100801043,CONDO 501,Residential,15000,119863,0,134863
200225100801044,CONDO 501,Residential,15000,117512,0,132512
200225100801045,CONDO 501,Residential,15000,129064,0,144064
200225100801046,CONDO 501,Residential,15000,98691,0,113691
200225100801047,CONDO 501,Residential,15000,101451,0,116451
200225100801048,CONDO 501,Residential,15000,66586,0,81586
200225100801049,CONDO 501,Residential,15000,98422,0,113422
200225100801050,CONDO 501,Residential,15000,64549,0,79549
200225100801051,CONDO 501,Residential,15000,64549,0,79549
200225100801052,CONDO 501,Residential,15000,64549,0,79549
200225100801053,CONDO 501,Residential,15000,85995,0,100995
200225100801054,CONDO 501,Residential,15000,134783,0,149783
200225100801055,CONDO 501,Residential,15000,76241,0,91241
200225100801056,CONDO 501,Residential,15000,74794,0,89794
200225100801057,CONDO 501,Residential,15000,123274,0,138274
200225100801058,CONDO 501,Residential,15000,120746,0,135746
200225100801059,CONDO 501,Residential,15000,84070,0,99070
200225100801060,CONDO 501,Residential,15000,119317,0,134317
200225100801061,CONDO 501,Residential,15000,124219,0,139219
200225100801062,CONDO 501,Residential,15000,80978,0,95978
200225100801063,CONDO 501,Residential,15000,115087,0,130087
200225100801064,CONDO 501,Residential,15000,72469,0,87469
200225100801065,CONDO 501,Residential,15000,68127,0,83127
200225100801066,CONDO 501,Residential,15000,130731,0,145731
200225100801067,CONDO 501,Residential,15000,118036,0,133036
200225100801068,CONDO 501,Residential,15000,79961,0,94961
200225100801069,CONDO 501,Residential,15000,127585,0,142585
200227600400000,SW 407,Residential,12500,0,0,12500
200227600500000,SW 407,Residential,83600,0,0,83600
200227700301000,CONDO 501,Residential,15000,117026,0,132026
200227700301001,CONDO 501,Residential,15000,156728,0,171728
200227700301002,CONDO 501,Residential,15000,124644,0,139644
200227700301003,CONDO 501,Residential,15000,112423,0,127423
200227700301004,CONDO 501,Residential,15000,118226,0,133226
200227700301005,CONDO 501,Residential,15000,118226,0,133226
200227700301006,CONDO 501,Residential,15000,107647,0,122647
200227700301007,CONDO 501,Residential,15000,123022,0,138022
200227700301008,CONDO 501,Residential,15000,139611,0,154611
200227700301009,CONDO 501,Residential,15000,115841,0,130841
200227700301010,CONDO 501,Residential,15000,142799,0,157799
200227700301011,CONDO 501,Residential,15000,134829,0,149829
200227700301012,CONDO 501,Residential,15000,134342,0,149342
200227700301013,CONDO 501,Residential,15000,122280,0,137280
200227700301014,CONDO 501,Residential,15000,119440,0,134440
200227700301015,CONDO 501,Residential,15000,109767,0,124767
200227700301016,CONDO 501,Residential,15000,109883,0,124883
200227700301017,CONDO 501,Residential,15000,120951,0,135951
200227700301018,CONDO 501,Residential,15000,122894,0,137894
200227700301019,CONDO 501,Residential,15000,104680,0,119680
200227700301020,CONDO 501,Residential,15000,123106,0,138106
200227700301021,CONDO 501,Residential,15000,121992,0,136992
200227700301022,CONDO 501,Residential,15000,136580,0,151580
200227700301023,CONDO 501,Residential,15000,112553,0,127553
200227700301024,CONDO 501,Residential,15000,120900,0,135900
200227700301025,CONDO 501,Residential,15000,110809,0,125809
200227700301026,CONDO 501,Residential,15000,111677,0,126677
200227700301027,CONDO 501,Residential,15000,138616,0,153616
200227700301028,CONDO 501,Residential,15000,111677,0,126677
200227700301029,CONDO 501,Residential,15000,113924,0,128924
200227700301030,CONDO 501,Residential,15000,134217,0,149217
200227700301031,CONDO 501,Residential,15000,126765,0,141765
200227700301032,CONDO 501,Residential,15000,133541,0,148541
200227700301033,CONDO 501,Residential,15000,129133,0,144133
200227700301034,CONDO 501,Residential,15000,116890,0,131890
200227700301035,CONDO 501,Residential,15000,109590,0,124590
200227700301036,CONDO 501,Residential,15000,120234,0,135234
200227700301037,CONDO 501,Residential,15000,122257,0,137257
200227700301038,CONDO 501,Residential,15000,116286,0,131286
200227700301039,CONDO 501,Residential,15000,105991,0,120991
200227700301040,CONDO 501,Residential,15000,124999,0,139999
200227700301041,CONDO 501,Residential,15000,118621,0,133621
200227700301042,CONDO 501,Residential,15000,105506,0,120506
200227700301043,CONDO 501,Residential,15000,107000,0,122000
200227700301044,CONDO 501,Residential,15000,120234,0,135234
200227700301045,CONDO 501,Residential,15000,120234,0,135234
200227700301046,CONDO 501,Residential,15000,107583,0,122583
200227700301047,CONDO 501,Residential,15000,106909,0,121909
200227700301048,CONDO 501,Residential,15000,119943,0,134943
200227700301049,CONDO 501,Residential,15000,120115,0,135115
200227700301050,CONDO 501,Residential,15000,107486,0,122486
200227700301051,CONDO 501,Residential,15000,107486,0,122486
200227700301052,CONDO 501,Residential,15000,120234,0,135234
200227700301053,CONDO 501,Residential,15000,122824,0,137824
200227700301054,CONDO 501,Residential,15000,106989,0,121989
200227700301055,CONDO 501,Residential,15000,109794,0,124794
200227700301056,CONDO 501,Residential,15000,120234,0,135234
200227700301057,CONDO 501,Residential,15000,122176,0,137176
200227700301058,CONDO 501,Residential,15000,107475,0,122475
200227700301059,CONDO 501,Residential,15000,107647,0,122647
200227700301060,CONDO 501,Residential,15000,116861,0,131861
200227700301061,CONDO 501,Residential,15000,123965,0,138965
200227700301062,CONDO 501,Residential,15000,109104,0,124104
200227700301063,CONDO 501,Residential,15000,140613,0,155613
200227700301064,CONDO 501,Residential,15000,154133,0,169133
200227700301065,CONDO 501,Residential,15000,113924,0,128924
200227700301066,CONDO 501,Residential,15000,113833,0,128833
200227700301067,CONDO 501,Residential,15000,121555,0,136555
200227700301068,CONDO 501,Residential,15000,118494,0,133494
200227700301069,CONDO 501,Residential,15000,111677,0,126677
200227700301070,CONDO 501,Residential,15000,117407,0,132407
200227700301071,CONDO 501,Residential,15000,137080,0,152080
200227700301072,CONDO 501,Residential,15000,109590,0,124590
200227700301073,CONDO 501,Residential,15000,118226,0,133226
200227700301074,CONDO 501,Residential,15000,122216,0,137216
200227700301075,CONDO 501,Residential,15000,107081,0,122081
200227700301076,CONDO 501,Residential,15000,112262,0,127262
200227700301077,CONDO 501,Residential,15000,111227,0,126227
200227700301078,CONDO 501,Residential,15000,120648,0,135648
200227700301079,CONDO 501,Residential,15000,109153,0,124153
200227700301080,CONDO 501,Residential,15000,105248,0,120248
200227800100000,SW 432,Residential,85200,226583,0,311783
200230200100000,SW 432,Residential,55800,78003,0,133803
200232800100000,SW 432,Residential,9440,0,0,9440
200232800200000,SW 432,Residential,38760,157799,0,196559
200232800300000,SW 432,Residential,39375,180277,0,219652
200232800400000,SW 432,Residential,36860,156027,0,192887
200232800500000,SW 432,Residential,32430,153528,0,185958
200232800600000,SW 432,Residential,31825,154390,0,186215
200232800700000,SW 432,Residential,33165,154053,0,187218
200232800800000,SW 432,Residential,35640,154437,0,190077
200232800900000,SW 432,Residential,44583,166945,0,211528
200232801000000,SW 432,Residential,42400,196225,0,238625
200232801100000,SW 432,Residential,35000,165434,0,200434
200232801200000,SW 432,Residential,35000,167968,0,202968
200232801300000,SW 432,Residential,31200,149370,0,180570
200232801400000,SW 432,Residential,36015,151336,0,187351
200232801500000,SW 432,Residential,40950,195328,0,236278
200232801600000,SW 432,Residential,51603,191672,0,243275
200232801700000,SW 432,Residential,41382,179139,0,220521
200232801800000,SW 432,Residential,35845,0,0,35845
200232801900000,SW 432,Residential,35845,200514,0,236359
200232802000000,SW 432,Residential,35845,0,0,35845
200232802100000,SW 432,Residential,44640,178948,0,223588
200232802200000,SW 432,Residential,48213,0,0,48213
200232802300000,SW 432,Residential,42952,173445,0,216397
200232802400000,SW 432,Residential,42157,175343,0,217500
200232900100000,SW 432,Residential,35000,157927,0,192927
200232900200000,SW 432,Residential,43600,187890,0,231490
200232900300000,SW 432,Residential,33600,0,0,33600
200232900400000,SW 432,Residential,31167,138405,0,169572
200232900500000,SW 432,Residential,31960,138197,0,170157
200232900600000,SW 432,Residential,30680,0,0,30680
200232900700000,SW 432,Residential,33800,0,0,33800
200232900800000,SW 432,Residential,40400,245911,0,286311
200232900900000,SW 432,Residential,34300,0,0,34300
200240100200000,Empty,Ag Land,35560,0,0,35560
200245100100000,SW 422,Ag Dwelling,31868,85007,1375,118250
200247600100000,SW 422,Residential,37967,144886,0,182853
200247600200000,SW 422,Residential,38232,112776,0,151008
200247600300000,SW 422,Residential,38232,92359,0,130591
200247600400000,SW 422,Residential,38232,99141,0,137373
200247600500000,SW 422,Residential,38232,137749,0,175981
200247600600000,SW 422,Residential,38232,86634,0,124866
200247600700000,SW 422,Residential,46463,138038,0,184501
200247600800000,SW 422,Residential,39825,116719,0,156544
200247600900000,SW 422,Residential,34515,78781,0,113296
200247601000000,SW 422,Residential,78273,9878,0,88151
200247601100000,SW 422,Residential,46058,130343,0,176401
200247601300000,SW 422,Ag Land,7329,0,0,7329
200247601400000,SW 422,Ag Land,20843,0,0,20843
200247601500000,SW 422,Residential,82010,88772,0,170782
200310100200000,SW 432,Residential,28900,285192,0,314092
200310100300000,SW 432,Residential,29131,198838,0,227969
200310100400000,SW 432,Residential,29189,224906,0,254095
200310100500000,SW 432,Residential,26785,201956,0,228741
200310100600000,SW 432,Residential,27907,170306,0,198213
200310100700000,SW 432,Residential,27791,199052,0,226843
200310100800000,SW 432,Residential,28635,217624,0,246259
200310100900000,SW 432,Residential,31282,203563,0,234845
200310101000000,SW 432,Residential,30361,0,0,30361
200310101100000,SW 432,Residential,29146,153338,0,182484
200310101200000,SW 432,Residential,28035,208233,0,236268
200310101300000,SW 432,Residential,27795,184460,0,212255
200310101400000,SW 432,Residential,30520,175442,0,205962
200310101500000,SW 432,Residential,31666,0,0,31666
200310101600000,SW 432,Residential,31051,0,0,31051
200310101700000,SW 432,Residential,30240,0,0,30240
200310101800000,SW 432,Residential,30240,0,0,30240
200310101900000,SW 432,Residential,31179,0,0,31179
200310102000000,SW 432,Residential,30320,0,0,30320
200310102100000,SW 432,Residential,30400,0,0,30400
200310102200000,SW 432,Residential,495,0,0,495
200310200100000,SW 432,Residential,25200,176345,0,201545
200310200200000,SW 432,Residential,26775,194561,0,221336
200310300200000,SW 432,Residential,30210,177118,0,207328
200310300300000,SW 432,Residential,27608,201738,0,229346
200310300400000,SW 432,Residential,27548,201996,0,229544
200310300500000,SW 432,Residential,29786,180962,0,210748
200310300600000,SW 432,Residential,28560,162815,0,191375
200310300700000,SW 432,Residential,25059,156031,0,181090
200310300800000,SW 432,Residential,25200,165873,0,191073
200310300900000,SW 432,Residential,28860,0,0,28860
200310400100000,SW 432,Residential,27821,161384,0,189205
200310400200000,SW 432,Residential,27216,134088,0,161304
200310400300000,SW 432,Residential,25200,128272,0,153472
200310400400000,SW 432,Residential,25200,161523,0,186723
200310500100000,SW 432,Residential,28119,129267,0,157386
200310500200000,SW 432,Residential,28960,240085,0,269045
200310500300000,SW 432,Residential,29700,190890,0,220590
200310500400000,SW 432,Residential,29453,9108,0,38561
200310500500000,SW 432,Residential,28304,215636,0,243940
200310500600000,SW 432,Residential,47390,226029,0,273419
200310500700000,SW 432,Residential,29736,182211,0,211947
200310500800000,SW 432,Residential,31824,204702,0,236526
200310500900000,SW 432,Residential,29484,0,0,29484
200310501000000,SW 432,Residential,31824,240660,0,272484
200310501100000,SW 432,Residential,29484,201781,0,231265
200310501200000,SW 432,Residential,30372,0,0,30372
200310501300000,SW 432,Residential,32130,0,0,32130
200310501400000,SW 432,Residential,29760,0,0,29760
200310501500000,SW 432,Residential,30498,0,0,30498
200310501600000,SW 432,Residential,34237,0,0,34237
200310501700000,SW 432,Residential,30111,229443,0,259554
200310501800000,SW 432,Residential,25841,0,0,25841
200310501900000,SW 432,Residential,28580,0,0,28580
200310502000000,SW 432,Residential,31606,0,0,31606
200310502100000,SW 432,Residential,30078,0,0,30078
200310502200000,SW 432,Residential,31000,0,0,31000
200310502300000,SW 432,Residential,32195,0,0,32195
200310502400000,SW 432,Residential,27720,0,0,27720
200310502500000,SW 432,Residential,32320,272484,0,304804
200310502600000,SW 432,Residential,28280,0,0,28280
200310502700000,SW 432,Residential,31011,0,0,31011
200310502800000,SW 432,Residential,29589,232392,0,261981
200310502900000,SW 432,Residential,30572,182549,0,213121
200310503000000,SW 432,Residential,30527,238612,0,269139
200310503100000,SW 432,Residential,30240,187765,0,218005
200310503200000,SW 432,Residential,29400,0,0,29400
200310503300000,SW 432,Residential,30325,181146,0,211471
200310503400000,Empty,Other,0,0,0,0
200317600200000,SW 432,Residential,29158,221682,0,250840
200317600300000,SW 432,Residential,33640,257594,0,291234
200317600400000,SW 432,Residential,29746,238607,0,268353
200317600500000,SW 432,Residential,30576,0,0,30576
200317600600000,SW 432,Residential,28941,207244,0,236185
200317600700000,SW 432,Residential,28280,217363,0,245643
200317600800000,SW 432,Residential,27997,212751,0,240748
200317600900000,SW 432,Residential,29817,181761,0,211578
200317601100000,SW 432,Residential,25840,170969,0,196809
200317601200000,SW 432,Residential,25840,143175,0,169015
200317601300000,SW 432,Residential,25745,170970,0,196715
200317601400000,SW 432,Residential,27436,167172,0,194608
200317601500000,SW 432,Residential,24941,157423,0,182364
200317601600000,SW 432,Residential,31284,170657,0,201941
200317601700000,SW 432,Residential,28188,180393,0,208581
200317601800000,SW 432,Residential,26946,118054,0,145000
200317601900000,SW 432,Residential,26309,135608,0,161917
200317602000000,SW 432,Residential,25440,129196,0,154636
200317602100000,SW 432,Residential,25440,134395,0,159835
200317602200000,SW 432,Residential,25440,128643,0,154083
200317602300000,SW 432,Residential,25440,129854,0,155294
200317602400000,SW 432,Residential,28642,0,0,28642
200317602500000,SW 432,Residential,25440,142815,0,168255
200317602600000,SW 432,Residential,25440,126967,0,152407
200317602700000,SW 432,Residential,28166,193602,0,221768
200317602800000,SW 432,Residential,29158,144348,0,173506
200317602900000,SW 432,Residential,28698,152334,0,181032
200317603000000,SW 432,Residential,28559,140129,0,168688
200317603100000,SW 432,Residential,28792,140899,0,169691
200317603200000,SW 432,Residential,28405,177973,0,206378
200317603300000,SW 432,Residential,27846,145672,0,173518
200317700100000,SW 432,Residential,27216,158022,0,185238
200317700200000,SW 432,Residential,25200,159993,0,185193
200317700300000,SW 432,Residential,25200,149289,0,174489
200317700400000,SW 432,Residential,27216,137113,0,164329
200317700500000,SW 432,Residential,25200,141909,0,167109
200317700600000,SW 432,Residential,25200,141383,0,166583
200317700700000,SW 432,Residential,27216,158395,0,185611
200317700800000,SW 432,Residential,25200,144752,0,169952
200317700900000,SW 432,Residential,25200,126063,0,151263
200317701000000,SW 432,Residential,27216,161778,0,188994
200317701100000,SW 432,Residential,25200,140340,0,165540
200317701200000,SW 432,Residential,25200,141001,0,166201
200317701300000,SW 432,Residential,27216,119122,0,146338
200317701400000,SW 432,Residential,25200,147011,0,172211
200317701500000,SW 432,Residential,25200,149750,0,174950
200317701600000,SW 432,Residential,27543,166855,0,194398
200317800100000,SW 432,Residential,28240,139515,0,167755
200317800200000,SW 432,Residential,26993,164896,0,191889
200317800300000,SW 432,Residential,26723,143308,0,170031
200317800400000,SW 432,Residential,27931,151737,0,179668
200317800500000,SW 432,Residential,25816,184020,0,209836
200317800600000,SW 432,Residential,28464,126853,0,155317
200317800700000,SW 432,Residential,25680,130364,0,156044
200317800800000,SW 432,Residential,25680,118225,0,143905
200317800900000,SW 432,Residential,25680,125966,0,151646
200317801000000,SW 432,Residential,25680,115144,0,140824
200317801100000,SW 432,Residential,26311,137096,0,163407
200317801200000,SW 432,Residential,26418,140353,0,166771
200317801300000,SW 432,Residential,28665,125261,0,153926
200317801400000,SW 432,Residential,29160,177647,0,206807
200317801500000,SW 432,Residential,26366,167217,0,193583
200317801600000,SW 432,Residential,25680,154128,0,179808
200317801700000,SW 432,Residential,25680,139758,0,165438
200317900100000,SW 432,Residential,28143,153422,0,181565
200317900200000,SW 432,Residential,25445,125894,0,151339
200317900300000,SW 432,Residential,25445,152747,0,178192
200317900400000,SW 432,Residential,25445,131601,0,157046
200317900500000,SW 432,Residential,25445,148533,0,173978
200317900600000,SW 432,Residential,25445,135066,0,160511
200317900700000,SW 432,Residential,25445,155697,0,181142
200317900800000,SW 432,Residential,25445,148773,0,174218
200317900900000,SW 432,Residential,25445,142416,0,167861
200317901000000,SW 432,Residential,25445,128531,0,153976
200317901100000,SW 432,Residential,26721,160938,0,187659
200317901200000,SW 432,Residential,26730,158882,0,185612
200317901300000,SW 432,Residential,27000,142746,0,169746
200317901400000,SW 432,Residential,27252,156224,0,183476
200317901500000,SW 432,Residential,26957,201771,0,228728
200317901600000,SW 432,Residential,25200,137743,0,162943
200317901700000,SW 432,Residential,25890,126205,0,152095
200317901800000,SW 432,Residential,25661,131287,0,156948
200317901900000,SW 432,Residential,25661,151184,0,176845
200317902000000,SW 432,Residential,25661,165814,0,191475
200317902100000,SW 432,Residential,25661,183733,0,209394
200317902200000,SW 432,Residential,25661,157216,0,182877
200317902300000,SW 432,Residential,28685,173687,0,202372
200318000100000,SW 432,Residential,39424,145062,0,184486
200318000200000,SW 432,Residential,28560,149076,0,177636
200318000300000,SW 432,Residential,28560,136149,0,164709
200318000400000,SW 432,Residential,28560,114016,0,142576
200318000500000,SW 432,Residential,28560,131252,0,159812
200318000600000,SW 432,Residential,28560,141587,0,170147
200318000700000,SW 432,Residential,28560,121982,0,150542
200318000800000,SW 432,Residential,28911,148178,0,177089
200318100100000,SW 432,Residential,28053,149583,0,177636
200318100200000,SW 432,Residential,25536,180458,0,205994
200318100300000,SW 432,Residential,25536,141376,0,166912
200318100400000,SW 432,Residential,25536,158693,0,184229
200318100500000,SW 432,Residential,25536,139428,0,164964
200318100600000,SW 432,Residential,25536,152963,0,178499
200318100700000,SW 432,Residential,25536,132046,0,157582
200318100800000,SW 432,Residential,26941,175322,0,202263
200340100200000,SW 432,Residential,38053,167859,0,205912
200340100300000,SW 432,Residential,30600,163214,0,193814
200340100400000,SW 432,Residential,30600,160430,0,191030
200340100500000,SW 432,Residential,30600,162413,0,193013
200340100600000,SW 432,Residential,30600,129225,0,159825
200340100700000,SW 432,Residential,30600,189220,0,219820
200340100800000,SW 432,Residential,30600,150383,0,180983
200340100900000,SW 432,Residential,30600,188510,0,219110
200340101000000,SW 432,Residential,30600,156307,0,186907
200340101100000,SW 432,Residential,30600,167061,0,197661
200340101201000,CONDO 501,Residential,14000,148849,0,162849
200340101201001,CONDO 501,Residential,14000,159102,0,173102
200340101201002,CONDO 501,Residential,14000,147958,0,161958
200340101201003,CONDO 501,Residential,14000,160458,0,174458
200340101201004,CONDO 501,Residential,14000,166179,0,180179
200340101201005,CONDO 501,Residential,14000,163344,0,177344
200340101201006,CONDO 501,Residential,14000,185407,0,199407
200340101201007,CONDO 501,Residential,14000,178261,0,192261
200340101201008,CONDO 501,Residential,14000,177308,0,191308
200340101201009,CONDO 501,Residential,14000,161844,0,175844
200340101201010,CONDO 501,Residential,14000,172022,0,186022
200340101201011,CONDO 501,Residential,14000,150918,0,164918
200340101201012,CONDO 501,Residential,14000,174899,0,188899
200340101201013,CONDO 501,Residential,14000,175848,0,189848
200340101201014,CONDO 501,Residential,14000,177485,0,191485
200340101201015,CONDO 500,Residential,14000,171915,0,185915
200340101201016,CONDO 501,Residential,14000,138957,0,152957
200340101201017,CONDO 501,Residential,14000,138474,0,152474
200340101201018,CONDO 501,Residential,14000,170955,0,184955
200340101201019,CONDO 501,Residential,14000,154887,0,168887
200340101201020,CONDO 501,Residential,14000,133528,0,147528
200340101201021,CONDO 501,Residential,14000,146185,0,160185
200340101201022,CONDO 501,Residential,14000,159810,0,173810
200340101201023,CONDO 501,Residential,14000,159232,0,173232
200340101201024,CONDO 501,Residential,14000,158736,0,172736
200340101201025,CONDO 501,Residential,14000,129061,0,143061
200340101201026,CONDO 501,Residential,14000,131057,0,145057
200340101201027,CONDO 501,Residential,14000,159667,0,173667
200340101201028,CONDO 501,Residential,14000,163347,0,177347
200340101201029,CONDO 501,Residential,14000,150215,0,164215
200340101201030,CONDO 501,Residential,14000,140193,0,154193
200340101201031,CONDO 501,Residential,14000,149824,0,163824
200340101201032,CONDO 501,Residential,14000,159097,0,173097
200340101201033,CONDO 501,Residential,14000,171044,0,185044
200340101201034,CONDO 501,Residential,14000,175445,0,189445
200340101201035,CONDO 501,Residential,14000,153390,0,167390
200340101201036,CONDO 501,Residential,14000,171847,0,185847
200340101201037,CONDO 501,Residential,14000,130419,0,144419
200340101201038,CONDO 501,Residential,14000,129740,0,143740
200340101201039,CONDO 501,Residential,14000,163070,0,177070
200340101201040,CONDO 501,Residential,14000,154197,0,168197
200340101300000,SW 432,Residential,20,0,0,20
200340101500000,SW 432,Residential,6338,0,0,6338
200340101600000,SW 432,Residential,19035,0,0,19035
200340101901000,CONDO 501,Residential,11000,115181,0,126181
200340101901001,CONDO 501,Residential,11000,111313,0,122313
200340101901002,CONDO 501,Residential,11000,111313,0,122313
200340101901003,CONDO 501,Residential,11000,80627,0,91627
200340101901004,CONDO 501,Residential,11000,89585,0,100585
200340101901005,CONDO 501,Residential,11000,123681,0,134681
200340101901006,CONDO 501,Residential,11000,123555,0,134555
200340101901007,CONDO 501,Residential,11000,127979,0,138979
200340101901008,CONDO 501,Residential,11000,89585,0,100585
200340101901009,CONDO 501,Residential,11000,86577,0,97577
200340101901010,CONDO 501,Residential,11000,86577,0,97577
200340101901011,CONDO 501,Residential,11000,127979,0,138979
200340102000000,SW 432,Residential,224750,0,0,224750
200340200101000,CONDO 501,Residential,14000,153947,0,167947
200340200101001,CONDO 501,Residential,14000,165949,0,179949
200340200101002,CONDO 501,Residential,14000,146134,0,160134
200340200101003,CONDO 501,Residential,14000,162875,0,176875
200340200101004,CONDO 501,Residential,14000,162058,0,176058
200340200101005,CONDO 501,Residential,14000,167361,0,181361
200340200101006,CONDO 501,Residential,14000,153662,0,167662
200340200101007,CONDO 501,Residential,14000,144331,0,158331
200340200101008,CONDO 501,Residential,14000,156109,0,170109
200340200101009,CONDO 501,Residential,14000,166497,0,180497
200340200101010,CONDO 501,Residential,14000,138957,0,152957
200340200101011,CONDO 501,Residential,14000,157870,0,171870
200340200101012,CONDO 501,Residential,14000,159525,0,173525
200340200101013,CONDO 501,Residential,14000,140261,0,154261
200340200101014,CONDO 501,Residential,14000,166444,0,180444
200340200101015,CONDO 501,Residential,14000,166987,0,180987
200340200101016,CONDO 501,Residential,14000,153662,0,167662
200340200101017,CONDO 501,Residential,14000,160384,0,174384
200340200101018,CONDO 501,Residential,14000,163002,0,177002
200340200101019,CONDO 501,Residential,14000,163728,0,177728
200340200101020,CONDO 501,Residential,14000,152575,0,166575
200340200101021,CONDO 501,Residential,14000,149824,0,163824
200340200101022,CONDO 501,Residential,14000,148917,0,162917
200340200101023,CONDO 501,Residential,14000,154691,0,168691
200340200101024,CONDO 501,Residential,14000,149824,0,163824
200340200101025,CONDO 501,Residential,14000,158146,0,172146
200340200101026,CONDO 501,Residential,14000,163557,0,177557
200340200101027,CONDO 501,Residential,14000,159134,0,173134
200340200201000,CONDO 501,Residential,11000,118387,0,129387
200340200201001,CONDO 501,Residential,11000,110826,0,121826
200340200201002,CONDO 501,Residential,11000,101258,0,112258
200340200201003,CONDO 501,Residential,11000,119299,0,130299
200340200301000,CONDO 501,Residential,11000,124371,0,135371
200340200301001,CONDO 501,Residential,11000,101395,0,112395
200340200301002,CONDO 501,Residential,11000,101234,0,112234
200340200301003,CONDO 501,Residential,11000,119036,0,130036
200340200401000,CONDO 501,Residential,11000,118444,0,129444
200340200401001,CONDO 501,Residential,11000,100890,0,111890
200340200401002,CONDO 501,Residential,11000,106566,0,117566
200340200401003,CONDO 501,Residential,11000,119036,0,130036
200342600101000,CONDO 501,Residential,11000,129481,0,140481
200342600101001,CONDO 501,Residential,11000,102685,0,113685
200342600101002,CONDO 501,Residential,11000,102596,0,113596
200342600101003,CONDO 501,Residential,11000,129551,0,140551
200342600201000,CONDO 501,Residential,11000,124342,0,135342
200342600201001,CONDO 501,Residential,11000,105624,0,116624
200342600201002,CONDO 501,Residential,11000,105382,0,116382
200342600201003,CONDO 501,Residential,11000,119890,0,130890
200342600301000,CONDO 501,Residential,11000,119160,0,130160
200342600301001,CONDO 501,Residential,11000,101395,0,112395
200342600301002,CONDO 501,Residential,11000,101234,0,112234
200342600301003,CONDO 501,Residential,11000,119299,0,130299
200342600400000,SW 432,Residential,20,0,0,20
200342600500000,SW 432,Residential,20,0,0,20
200342700601000,CONDO 504,Residential,12000,204880,0,216880
200342700601001,CONDO 504,Residential,12000,198230,0,210230
200342700601002,CONDO 504,Residential,12000,205760,0,217760
200342700601003,CONDO 504,Residential,12000,199198,0,211198
200342700601004,CONDO 504,Residential,12000,197897,0,209897
200342700601005,CONDO 504,Residential,12000,194047,0,206047
200342700601006,CONDO 504,Residential,12000,203103,0,215103
200342700601007,CONDO 504,Residential,12000,198740,0,210740
200342700601008,CONDO 504,Residential,12000,199862,0,211862
200342700601009,CONDO 504,Residential,12000,200041,0,212041
200342700601010,CONDO 504,Residential,12000,122497,0,134497
200342700601018,CONDO 504,Residential,12000,203103,0,215103
200342700601019,CONDO 504,Residential,12000,198740,0,210740
200342700601020,CONDO 504,Residential,12000,197897,0,209897
200342700601021,CONDO 504,Residential,12000,203355,0,215355
200342700601022,CONDO 504,Residential,12000,200041,0,212041
200342700601023,CONDO 504,Residential,12000,203103,0,215103
200342700601024,CONDO 504,Residential,12000,195239,0,207239
200342700601025,CONDO 504,Residential,12000,201923,0,213923
200342700601026,CONDO 504,Residential,12000,217142,0,229142
200342700601027,CONDO 504,Residential,12000,135284,0,147284
200342700601028,CONDO 504,Residential,12000,145279,0,157279
200342700601029,CONDO 504,Residential,12000,160472,0,172472
200342700601030,CONDO 504,Residential,12000,196137,0,208137
200342700601031,CONDO 504,Residential,12000,199198,0,211198
200342700601032,CONDO 504,Residential,12000,202736,0,214736
200342700601033,CONDO 504,Residential,12000,200819,0,212819
200342700601034,CONDO 504,Residential,12000,160643,0,172643
200342700601035,CONDO 504,Residential,12000,197897,0,209897
200342700601036,CONDO 504,Residential,12000,153448,0,165448
200342700601037,CONDO 504,Residential,12000,153448,0,165448
200342700601038,CONDO 504,Residential,12000,131683,0,143683
200342700601039,CONDO 504,Residential,12000,142290,0,154290
200342700601040,CONDO 504,Residential,12000,164929,0,176929
200342700801000,CONDO 501,Residential,13000,169556,0,182556
200342700801001,CONDO 501,Residential,13000,0,0,13000
200342700801002,CONDO 501,Residential,13000,0,0,13000
200342700801003,CONDO 501,Residential,13000,0,0,13000
200342700801004,CONDO 501,Residential,13000,0,0,13000
200342700801005,CONDO 501,Residential,13000,160783,0,173783
200342700801006,CONDO 501,Residential,13000,200617,0,213617
200342700801007,CONDO 501,Residential,13000,0,0,13000
200342700801008,CONDO 501,Residential,13000,0,0,13000
200342700801009,CONDO 501,Residential,13000,0,0,13000
200342700801010,CONDO 501,Residential,13000,0,0,13000
200342700801011,CONDO 501,Residential,13000,0,0,13000
200342700801012,CONDO 501,Residential,13000,221278,0,234278
200342700801013,CONDO 501,Residential,13000,235354,0,248354
200342700801014,CONDO 501,Residential,13000,192506,0,205506
200342700801015,CONDO 501,Residential,13000,203457,0,216457
200342700801016,CONDO 501,Residential,13000,206367,0,219367
200342700801017,CONDO 501,Residential,13000,214655,0,227655
200342700801018,CONDO 501,Residential,13000,210175,0,223175
200342700801019,CONDO 501,Residential,13000,210352,0,223352
200342800101000,CONDO 501,Residential,12000,205329,0,217329
200342800101001,CONDO 501,Residential,12000,189015,0,201015
200342800101002,CONDO 501,Residential,12000,188657,0,200657
200342800101003,CONDO 501,Residential,12000,172361,0,184361
200342800101004,CONDO 501,Residential,12000,182892,0,194892
200342800101005,CONDO 501,Residential,12000,174330,0,186330
200342800101006,CONDO 501,Residential,12000,0,0,12000
200342800101007,CONDO 501,Residential,12000,0,0,12000
200342800101008,CONDO 501,Residential,12000,0,0,12000
200342800101009,CONDO 501,Residential,12000,0,0,12000
200342800101010,CONDO 501,Residential,12000,177337,0,189337
200342800101011,CONDO 501,Residential,12000,141614,0,153614
200342800101012,CONDO 501,Residential,12000,0,0,12000
200342800101013,CONDO 501,Residential,12000,0,0,12000
200342800101014,CONDO 501,Residential,12000,157516,0,169516
200342800101015,CONDO 501,Residential,12000,171787,0,183787
200342800101016,CONDO 501,Residential,12000,154437,0,166437
200342800101017,CONDO 501,Residential,12000,161189,0,173189
200342800101018,CONDO 501,Residential,12000,155619,0,167619
200342800101019,CONDO 501,Residential,12000,178071,0,190071
200342800101020,CONDO 501,Residential,12000,138444,0,150444
200342800101021,CONDO 501,Residential,12000,151702,0,163702
200342800101022,CONDO 501,Residential,12000,0,0,12000
200342800101023,CONDO 501,Residential,12000,0,0,12000
200342800101024,CONDO 501,Residential,12000,0,0,12000
200342800101025,CONDO 501,Residential,12000,0,0,12000
200342800101026,CONDO 501,Residential,12000,0,0,12000
200342800101027,CONDO 501,Residential,12000,0,0,12000
200342800101028,CONDO 501,Residential,12000,0,0,12000
200342800101029,CONDO 501,Residential,12000,144002,0,156002
200342800101030,CONDO 501,Residential,12000,0,0,12000
200342800101031,CONDO 501,Residential,12000,130353,0,142353
200342800101032,CONDO 501,Residential,12000,0,0,12000
200342800101033,CONDO 501,Residential,12000,0,0,12000
200342800101034,CONDO 501,Residential,12000,0,0,12000
201110100100000,SW 422,Ag Land,50936,0,0,50936
201112600100000,SW 422,Ag Land,30140,0,0,30140
201212600100000,INDUSTRIAL,Industrial,1307345,0,22580486,23887831
201237600100000,SW 418,Ag Land,15736,0,0,15736
201237700100000,SW 418,Ag Land,745,0,0,745
201240100100000,SW 418,Ag Land,16055,0,0,16055
201240100200000,Empty,Other,0,0,0,0
201240200100000,SW 418,Ag Land,12688,0,0,12688
201242600100000,SW 418,Ag Land,27538,0,0,27538
201245100100000,SW 418,Ag Land,31403,0,0,31403
201245200100000,SW 418,Ag Land,6462,0,0,6462
201247600100000,SW 418,Ag Land,52437,0,0,52437
202410100100000,Empty,Exempt,0,0,0,0
202525100100000,Empty,Exempt,0,0,0,0
202610100100000,Empty,Exempt,0,0,0,0
202612600100000,Empty,Exempt,0,0,0,0
